id,burst_time,priority,arrival_time,turnaround_time,cpu_time_acquired,waiting_time
1,3,-12,7,23,0,20
2,2,1,0,2,0,0
3,6,-13,6,13,0,7
4,6,14,2,6,0,0
5,7,-1,10,31,0,24
6,4,19,10,35,0,31
7,7,-7,10,42,0,35
8,4,10,7,27,0,23
9,8,16,6,21,0,13
10,5,-12,4,9,0,4
