id,burst_time,priority,arrival_time,turnaround_time,cpu_time_acquired,waiting_time
1,18,-1,808,622761,18,622743
2,9,-5,932,488312,9,488303
3,8,0,243,630659,8,630651
4,6,1,99,659207,6,659201
5,7,-13,286,224562,7,224555
6,18,11,809,996727,18,996709
7,9,-11,482,291897,9,291888
8,7,-7,835,423501,7,423494
9,17,-1,485,620456,17,620439
10,18,3,966,749245,18,749227
11,10,-8,338,382606,10,382596
12,20,-2,141,586157,20,586137
13,13,11,277,992873,13,992860
14,5,14,397,1070590,5,1070585
15,17,0,181,649634,17,649617
16,11,11,329,993250,11,993239
17,12,11,713,995934,12,995922
18,10,11,941,988698,10,988688
19,14,-10,259,337003,14,336989
20,5,16,876,1143295,5,1143290
21,15,-5,737,496440,15,496425
22,12,4,302,775361,12,775349
23,13,-3,117,554632,13,554619
24,12,17,566,1182043,12,1182031
25,16,16,533,1150880,16,1150864
26,18,2,453,714027,18,714009
27,11,-20,704,28206,11,28195
28,17,-17,481,119052,17,119035
29,12,3,851,748254,12,748242
30,6,-10,969,333239,6,333233
31,15,19,578,1245532,15,1245517
32,8,-17,132,96162,8,96154
33,9,-1,621,607340,9,607331
34,13,12,895,1028833,13,1028820
35,19,17,315,1180325,19,1180306
36,9,5,961,802004,9,801995
37,8,13,393,1039164,8,1039156
38,5,0,429,634636,5,634631
39,14,1,911,686945,14,686931
40,13,18,168,1210294,13,1210281
41,16,-4,313,524528,16,524512
42,6,5,262,787146,6,787140
43,11,-3,855,560600,11,560589
44,12,-2,763,590828,12,590816
45,17,-2,106,585925,17,585908
46,20,-11,543,308108,20,308088
47,12,-2,109,585955,12,585943
48,16,10,896,966659,16,966643
49,9,17,98,1157328,9,1157319
50,12,16,915,1153669,12,1153657
51,14,-12,24,272666,14,272652
52,12,1,672,685129,12,685117
53,14,-7,499,432058,14,432044
54,17,16,798,1152828,17,1152811
55,17,-6,188,460609,17,460592
56,13,19,731,1246715,13,1246702
57,12,-3,665,559075,12,559063
58,13,-5,84,491513,13,491500
59,18,1,616,684692,18,684674
60,11,19,75,1241378,11,1241367
61,12,-6,455,462612,12,462600
62,6,16,189,1129193,6,1129187
63,9,-17,913,112833,9,112824
64,8,10,482,947715,8,947707
65,20,-14,808,215850,20,215830
66,5,12,944,1019903,5,1019898
67,10,-13,85,220184,10,220174
68,6,16,339,1132320,6,1132314
69,20,8,201,899541,20,899521
70,18,-5,207,492463,18,492445
71,20,-6,963,466414,20,466394
72,17,11,258,992685,17,992668
73,14,-19,46,54218,14,54204
74,9,16,11,1125408,9,1125399
75,12,13,994,1060574,12,1060562
76,20,-10,604,339576,20,339556
77,10,-18,705,77524,10,77514
78,13,-17,681,120611,13,120598
79,13,-11,313,306283,13,306270
80,18,3,238,743668,18,743650
81,16,11,184,992111,16,992095
82,11,16,657,1151812,11,1151801
83,13,-16,90,147553,13,147540
84,7,13,887,1049786,7,1049779
85,16,-8,117,398723,16,398707
86,20,5,955,810832,20,810812
87,20,15,648,1121537,20,1121517
88,17,14,240,1087290,17,1087273
89,11,-5,981,498232,11,498221
90,13,7,191,868380,13,868367
91,6,15,31,1095133,6,1095127
92,10,-6,972,457456,10,457446
93,13,-16,1000,154310,13,154297
94,6,14,843,1080719,6,1080713
95,17,-14,201,210854,17,210837
96,6,-8,264,381051,6,381045
97,7,-5,332,475463,7,475456
98,8,-14,977,207822,8,207814
99,11,-3,468,557359,11,557348
100,12,2,622,715201,12,715189
101,9,-8,95,377386,9,377377
102,18,-17,328,117900,18,117882
103,13,5,234,805560,13,805547
104,7,-17,70,94874,7,94867
105,20,18,845,1215111,20,1215091
106,5,18,846,1204639,5,1204634
107,10,-10,170,316370,10,316360
108,7,15,868,1112931,7,1112924
109,15,14,364,1088266,15,1088251
110,9,-15,863,173828,9,173819
111,12,0,979,655786,12,655774
112,10,-17,180,97201,10,97191
113,14,0,25,648407,14,648393
114,18,10,714,965362,18,965344
115,5,1,971,678163,5,678158
116,6,6,825,830850,6,830844
117,5,-3,688,545969,5,545964
118,13,2,588,714988,13,714975
119,15,13,100,1053964,15,1053949
120,15,6,236,837555,15,837540
121,7,7,201,849024,7,849017
122,9,-2,533,574031,9,574022
123,17,5,55,804241,17,804224
124,9,-17,724,108983,9,108974
125,12,19,871,1247843,12,1247831
126,14,-6,453,462594,14,462580
127,18,-9,723,372084,18,372066
128,18,9,209,930608,18,930590
129,6,6,438,822335,6,822329
130,16,14,472,1089112,16,1089096
131,13,-6,159,460343,13,460330
132,18,-15,670,182761,18,182743
133,9,-3,420,539692,9,539683
134,17,-3,827,560401,17,560384
135,10,-5,107,470471,10,470461
136,18,7,668,871947,18,871929
137,11,-4,539,526179,11,526168
138,20,-12,764,278134,20,278114
139,7,5,709,796395,7,796388
140,12,1,293,682164,12,682152
141,19,-13,551,245096,19,245077
142,14,5,345,806321,14,806307
143,10,6,622,826344,10,826334
144,14,11,923,997600,14,997586
145,16,-11,468,307496,16,307480
146,6,4,757,767093,6,767087
147,5,-12,296,255990,5,255985
148,10,5,355,788857,10,788847
149,11,-2,659,590075,11,590064
150,19,12,908,1028995,19,1028976
151,10,17,452,1165017,10,1165007
152,13,-18,458,88721,13,88708
153,18,-3,774,560017,18,559999
154,12,0,806,654451,12,654439
155,18,18,128,1209957,18,1209939
156,20,-6,990,466685,20,466665
157,11,-19,582,58633,11,58622
158,15,10,726,965449,15,965434
159,10,-12,261,255097,10,255087
160,8,3,164,722308,8,722300
161,12,-14,55,209734,12,209722
162,12,-7,319,430763,12,430751
163,15,0,224,649927,15,649912
164,11,18,234,1210835,11,1210824
165,16,3,616,746440,16,746424
166,6,14,687,1077469,6,1077463
167,19,1,531,684080,19,684061
168,14,13,971,1060429,14,1060415
169,12,13,201,1054724,12,1054712
170,16,3,307,744242,16,744226
171,6,-14,45,187542,6,187536
172,8,1,598,670237,8,670229
173,12,-5,747,496503,12,496491
174,15,-1,536,620834,15,620819
175,10,3,3,718926,10,718916
176,11,-11,340,306440,11,306429
177,15,-20,596,27327,15,27312
178,16,2,267,712560,16,712544
179,14,-16,717,152162,14,152148
180,20,15,747,1122351,20,1122331
181,5,-8,731,391023,5,391018
182,6,10,495,947983,6,947977
183,5,2,742,704242,5,704237
184,17,2,823,716618,17,716601
185,11,2,573,714876,11,714865
186,12,-4,518,526021,12,526009
187,7,-5,399,476705,7,476698
188,19,7,820,872927,19,872908
189,14,-15,200,179181,14,179167
190,10,2,951,708468,10,708458
191,20,10,975,967289,20,967269
192,20,-8,274,399801,20,399781
193,15,0,935,655345,15,655330
194,17,-2,824,591391,17,591374
195,18,-19,703,59452,18,59434
196,17,-6,654,464129,17,464112
197,11,6,925,843115,11,843104
198,14,-6,337,461771,14,461757
199,6,-6,477,447005,6,446999
200,17,-13,779,246848,17,246831
201,11,-11,430,307206,11,307195
202,5,-13,848,236721,5,236716
203,14,12,497,1025695,14,1025681
204,18,3,178,743186,18,743168
205,12,4,10,773355,12,773343
206,19,4,370,775913,19,775894
207,18,11,678,995660,18,995642
208,13,4,825,779350,13,779337
209,8,2,613,701540,8,701532
210,16,3,103,742612,16,742596
211,17,-20,952,29997,17,29980
212,20,17,500,1181627,20,1181607
213,11,17,871,1184528,11,1184517
214,20,-3,108,554554,20,554534
215,14,5,16,803893,14,803879
216,13,6,467,839519,13,839506
217,17,6,54,836179,17,836162
218,20,16,665,1151901,20,1151881
219,19,3,471,745362,19,745343
220,18,19,140,1241897,18,1241879
221,16,2,133,711610,16,711594
222,19,8,356,900774,19,900755
223,10,-10,468,322879,10,322869
224,18,-12,615,276970,18,276952
225,17,-11,27,303861,17,303844
226,12,11,622,995289,12,995277
227,14,-12,626,277049,14,277035
228,19,-12,654,277320,19,277301
229,11,-5,823,496970,11,496959
230,11,15,243,1118585,11,1118574
231,10,3,858,737363,10,737353
232,12,0,335,650550,12,650538
233,5,17,657,1169367,5,1169362
234,5,-8,9,375491,5,375486
235,15,-10,257,336973,15,336958
236,18,7,257,868893,18,868875
237,15,-7,835,434377,15,434362
238,9,5,427,790354,9,790345
239,6,18,428,1195855,6,1195849
240,12,-10,153,336227,12,336215
241,9,9,20,907130,9,907121
242,16,5,482,807344,16,807328
243,13,4,60,773670,13,773657
244,17,-13,989,248489,17,248472
245,10,17,234,1160160,10,1160150
246,11,-18,708,90390,11,90379
247,14,1,890,686734,14,686720
248,17,-12,718,277791,17,277774
249,14,-11,206,305344,14,305330
250,17,-16,660,151799,17,151782
251,6,-17,206,97747,6,97741
252,9,-11,437,290901,9,290892
253,15,15,97,1117507,15,1117492
254,14,-18,996,92449,14,92435
255,13,1,510,683870,13,683857
256,8,-19,393,40013,8,40005
257,18,16,308,1149345,18,1149327
258,17,-16,674,151877,17,151860
259,20,-13,574,245290,20,245270
260,10,10,285,943531,10,943521
261,7,6,422,821886,7,821879
262,17,9,697,934187,17,934170
263,6,3,441,728292,6,728286
264,10,19,985,1239241,10,1239231
265,5,7,432,854077,5,854072
266,16,7,860,873215,16,873199
267,7,-10,290,318784,7,318777
268,19,8,699,903536,19,903517
269,11,14,89,1086130,11,1086119
270,7,-1,594,606846,7,606839
271,9,17,1000,1176820,9,1176811
272,17,12,778,1027822,17,1027805
273,18,16,601,1151342,18,1151324
274,18,-17,549,119621,18,119603
275,13,-14,748,215273,13,215260
276,17,-3,487,557557,17,557540
277,10,10,860,956012,10,956002
278,11,4,358,775803,11,775792
279,17,8,715,903666,17,903649
280,17,10,263,961789,17,961772
281,6,-7,582,418394,6,418388
282,17,17,361,1180675,17,1180658
283,15,7,158,868181,15,868166
284,13,10,273,961876,13,961863
285,6,12,226,1004049,6,1004043
286,7,16,482,1135522,7,1135515
287,5,5,119,784004,5,783999
288,18,-1,6,616543,18,616525
289,14,-7,962,435444,14,435430
290,15,18,263,1211090,15,1211075
291,10,1,209,661757,10,661747
292,6,-12,21,250018,6,250012
293,7,12,529,1010423,7,1010416
294,5,11,408,977247,5,977242
295,18,-18,747,90686,18,90668
296,16,11,156,991925,16,991909
297,12,-9,756,372444,12,372432
298,10,-9,865,362913,10,362903
299,20,14,643,1090442,20,1090422
300,18,4,213,774794,18,774776
301,13,-13,25,241253,13,241240
302,20,-19,742,59856,20,59836
303,17,-15,243,179510,17,179493
304,15,-12,693,277593,15,277578
305,8,18,399,1195243,8,1195235
306,7,-16,210,128578,7,128571
307,13,-11,340,306443,13,306430
308,14,17,604,1182349,14,1182335
309,9,11,282,974319,9,974310
310,20,-6,178,460539,20,460519
311,16,-8,473,401128,16,401112
312,20,-3,491,557600,20,557580
313,6,-4,225,504446,6,504440
314,13,4,137,774246,13,774233
315,9,2,373,696747,9,696738
316,16,-10,7,335159,16,335143
317,10,-16,988,145277,10,145267
318,14,12,610,1026529,14,1026515
319,7,15,629,1107825,7,1107818
320,20,2,173,711910,20,711890
321,5,14,987,1083923,5,1083918
322,11,-3,343,556306,11,556295
323,6,-17,5,93586,6,93580
324,19,10,207,961396,19,961377
325,11,3,363,744609,11,744598
326,6,16,343,1132444,6,1132438
327,9,-1,204,598147,9,598138
328,13,13,723,1058603,13,1058590
329,17,-19,927,60988,17,60971
330,6,-7,180,409689,6,409683
331,6,-16,958,144618,6,144612
332,11,-10,370,337716,11,337705
333,16,-5,545,495065,16,495049
334,5,7,480,855160,5,855155
335,8,-5,477,478305,8,478297
336,6,0,198,629866,6,629860
337,18,-14,634,214502,18,214484
338,13,-7,313,430679,13,430666
339,19,-13,31,241320,19,241301
340,20,-6,681,464312,20,464292
341,10,-17,731,109157,10,109147
342,12,11,620,995280,12,995268
343,19,-12,66,273017,19,272998
344,8,-2,371,570529,8,570521
345,10,10,435,946823,10,946813
346,9,-5,654,482161,9,482152
347,12,1,708,685310,12,685298
348,18,-11,496,307718,18,307700
349,11,-1,283,618781,11,618770
350,8,13,777,1047415,8,1047407
351,10,11,5,968543,10,968533
352,13,16,988,1154160,13,1154147
353,14,10,24,960012,14,959998
354,8,5,981,802342,8,802334
355,5,6,967,834027,5,834022
356,18,8,398,901120,18,901102
357,8,-9,732,359722,8,359714
358,16,19,64,1241250,16,1241234
359,11,-1,572,621053,11,621042
360,19,-12,857,278886,19,278867
361,18,-15,827,183987,18,183969
362,6,18,12,1186824,6,1186818
363,10,10,24,938038,10,938028
364,13,-13,912,247897,13,247884
365,7,3,949,739451,7,739444
366,15,-8,230,399544,15,399529
367,18,12,584,1026348,18,1026330
368,14,3,850,748253,14,748239
369,13,-17,34,115799,13,115786
370,15,-14,511,213477,15,213462
371,6,6,847,831384,6,831378
372,8,11,140,971374,8,971366
373,14,-3,238,555443,14,555429
374,8,8,147,878256,8,878248
375,20,-8,853,403912,20,403892
376,6,-4,122,501964,6,501958
377,18,18,217,1210741,18,1210723
378,5,-15,745,171392,5,171387
379,12,2,979,717735,12,717723
380,8,16,228,1130065,8,1130057
381,16,6,964,843423,16,843407
382,11,-17,99,116341,11,116330
383,11,-3,115,554606,11,554595
384,11,18,819,1214877,11,1214866
385,19,-18,892,91693,19,91674
386,6,10,756,953702,6,953696
387,12,13,174,1054479,12,1054467
388,20,6,319,838236,20,838216
389,9,8,174,878864,9,878855
390,17,5,404,806709,17,806692
391,18,-6,875,465725,18,465707
392,12,-1,884,623356,12,623344
393,14,-5,17,490894,14,490880
394,7,-6,451,446393,7,446386
395,17,-5,6,490813,17,490796
396,14,2,496,714361,14,714347
397,7,7,814,862043,7,862036
398,17,-3,69,554268,17,554251
399,20,-8,92,398607,20,398587
400,20,16,841,1153162,20,1153142
401,20,-14,796,215749,20,215729
402,11,9,494,932655,11,932644
403,7,3,427,727974,7,727967
404,8,17,929,1175217,8,1175209
405,17,-19,688,59370,17,59353
406,10,-19,281,37682,10,37672
407,20,-17,708,120818,20,120798
408,14,11,696,995749,14,995735
409,9,-11,559,293554,9,293545
410,18,-11,388,306839,18,306821
411,14,10,595,964491,14,964477
412,17,11,82,991458,17,991441
413,5,11,452,978065,5,978060
414,16,18,387,1211909,16,1211893
415,20,-10,134,336126,20,336106
416,16,-8,4,397856,16,397840
417,10,3,304,725548,10,725538
418,10,5,747,797218,10,797208
419,8,-7,241,410881,8,410873
420,17,-7,179,429648,17,429631
421,6,8,25,875620,6,875614
422,5,19,60,1218738,5,1218733
423,11,1,626,684773,11,684762
424,9,13,160,1034053,9,1034044
425,20,-8,247,399667,20,399647
426,6,10,519,948568,6,948562
427,7,-19,488,41961,7,41954
428,19,-2,311,587461,19,587442
429,13,17,182,1179238,13,1179225
430,17,-3,999,561736,17,561719
431,5,-2,289,568998,5,568993
432,11,14,795,1091677,11,1091666
433,18,15,963,1123860,18,1123842
434,8,-8,35,376093,8,376085
435,6,1,862,675760,6,675754
436,10,0,233,630494,10,630484
437,11,-18,265,87349,11,87338
438,13,12,610,1026532,13,1026519
439,15,2,964,717678,15,717663
440,5,-1,807,611155,5,611150
441,9,-16,883,142979,9,142970
442,10,18,977,1207495,10,1207485
443,20,6,461,839441,20,839421
444,8,-10,404,321374,8,321366
445,8,-14,833,204679,8,204671
446,17,17,854,1184419,17,1184402
447,18,-20,598,27346,18,27328
448,18,8,87,898595,18,898577
449,5,-15,185,159316,5,159311
450,8,-6,62,438110,8,438102
451,20,10,794,966053,20,966033
452,17,17,693,1183061,17,1183044
453,18,-1,708,622024,18,622006
454,18,-9,404,369711,18,369693
455,6,-8,407,383853,6,383847
456,12,-5,929,497850,12,497838
457,5,-12,997,271363,5,271358
458,15,13,46,1053558,15,1053543
459,20,10,51,960250,20,960230
460,16,5,152,804891,16,804875
461,7,6,661,827193,7,827186
462,6,-8,410,383896,6,383890
463,16,4,970,780360,16,780344
464,15,7,637,871675,15,871660
465,18,3,226,743579,18,743561
466,14,0,628,652978,14,652964
467,9,5,682,795781,9,795772
468,16,-11,890,310665,16,310649
469,11,9,130,930041,11,930030
470,11,0,116,649141,11,649130
471,13,9,877,935565,13,935552
472,13,0,585,652691,13,652678
473,13,15,217,1118428,13,1118415
474,17,11,124,991709,17,991692
475,18,19,595,1245621,18,1245603
476,8,16,969,1145468,8,1145460
477,11,-4,587,526511,11,526500
478,14,4,864,779714,14,779700
479,15,-20,710,28251,15,28236
480,12,-20,411,25915,12,25903
481,20,3,911,748702,20,748682
482,16,-17,321,117868,16,117852
483,7,-9,923,364334,7,364327
484,14,-11,877,310608,14,310594
485,14,16,200,1148543,14,1148529
486,19,3,713,747277,19,747258
487,13,11,881,997272,13,997259
488,10,4,352,758115,10,758105
489,18,-11,440,307279,18,307261
490,13,-8,229,399523,13,399510
491,12,6,182,837125,12,837113
492,7,-1,299,600480,7,600473
493,20,-18,509,89008,20,88988
494,5,-15,896,174429,5,174424
495,11,10,348,962435,11,962424
496,15,1,944,687223,15,687208
497,16,-5,729,496377,16,496361
498,18,1,19,679899,18,679881
499,16,-3,502,557664,16,557648
500,10,-7,455,415590,10,415580
501,20,-1,277,618718,20,618698
502,19,12,152,1023111,19,1023092
503,18,-2,930,592205,18,592187
504,9,1,748,673291,9,673282
505,11,-7,499,432059,11,432048
506,15,-11,708,309259,15,309244
507,13,-20,700,28177,13,28164
508,13,-15,619,182307,13,182294
509,15,-6,701,464512,15,464497
510,5,-9,593,356917,5,356912
511,16,-1,891,623386,16,623370
512,14,13,682,1058368,14,1058354
513,15,-14,572,214022,15,214007
514,17,10,540,963970,17,963953
515,16,19,331,1243447,16,1243431
516,20,-4,854,528346,20,528326
517,5,-10,532,324082,5,324077
518,18,1,325,682479,18,682461
519,11,19,569,1245421,11,1245410
520,15,-2,167,586291,15,586276
521,15,5,61,804274,15,804259
522,19,-5,241,492777,19,492758
523,5,0,218,630207,5,630202
524,15,-18,603,89601,15,89586
525,5,3,300,725405,5,725400
526,6,13,80,1032443,6,1032437
527,6,19,295,1224028,6,1224022
528,5,15,457,1104109,5,1104104
529,12,19,67,1241282,12,1241270
530,7,-1,165,597268,7,597261
531,10,0,1,625174,10,625164
532,19,7,410,870076,19,870057
533,5,15,398,1102860,5,1102855
534,16,15,531,1120632,16,1120616
535,6,-9,642,357803,6,357797
536,20,-8,241,399604,20,399584
537,5,12,242,1004419,5,1004414
538,12,-14,102,210113,12,210101
539,16,-18,312,87688,16,87672
540,19,14,134,1086518,19,1086499
541,6,4,168,754224,6,754218
542,8,17,712,1170458,8,1170450
543,20,-4,194,523568,20,523548
544,12,-10,871,341616,12,341604
545,10,11,519,979541,10,979531
546,6,-18,978,83711,6,83705
547,13,-1,203,618103,13,618090
548,10,-2,898,581991,10,581981
549,17,-13,309,243357,17,243340
550,11,4,492,776770,11,776759
551,13,12,91,1022722,13,1022709
552,5,-9,571,356522,5,356517
553,15,16,897,1153468,15,1153453
554,12,19,941,1248349,12,1248337
555,14,6,674,841182,14,841168
556,15,4,234,774973,15,774958
557,17,-8,347,400345,17,400328
558,13,6,858,842586,13,842573
559,20,5,599,808170,20,808150
560,15,-12,91,273200,15,273185
561,20,-12,834,278670,20,278650
562,10,-6,635,450432,10,450422
563,12,7,195,868387,12,868375
564,17,18,168,1210301,17,1210284
565,19,14,896,1092486,19,1092467
566,9,-2,374,570624,9,570615
567,19,-6,432,462450,19,462431
568,9,-13,702,233224,9,233215
569,19,-13,695,246050,19,246031
570,8,-6,698,451810,8,451802
571,17,3,180,743209,17,743192
572,15,13,283,1055264,15,1055249
573,14,-13,238,242779,14,242765
574,20,-10,675,340195,20,340175
575,16,13,954,1060320,16,1060304
576,5,-20,320,7140,5,7135
577,10,-16,80,125580,10,125570
578,16,-6,615,463838,16,463822
579,13,3,614,746407,13,746394
580,20,-3,421,556923,20,556903
581,10,7,693,859472,10,859462
582,5,-12,639,263347,5,263342
583,9,6,470,823050,9,823041
584,11,-13,713,246260,11,246249
585,8,-14,525,197938,8,197930
586,5,-16,82,125641,5,125636
587,18,7,551,871094,18,871076
588,12,11,648,995450,12,995438
589,18,11,83,991472,18,991454
590,6,-14,345,194169,6,194163
591,5,3,881,737822,5,737817
592,15,12,116,1022894,15,1022879
593,15,9,742,934486,15,934471
594,17,14,681,1090813,17,1090796
595,13,-18,75,85800,13,85787
596,14,8,388,901041,14,901027
597,10,7,501,855504,10,855494
598,19,-5,791,496743,19,496724
599,9,-13,437,227516,9,227507
600,15,5,427,806851,15,806836
601,12,-7,36,428593,12,428581
602,14,16,609,1151396,14,1151382
603,8,13,893,1049939,8,1049931
604,5,16,987,1145763,5,1145758
605,11,-10,96,335844,11,335833
606,15,2,88,711198,15,711183
607,17,6,587,840513,17,840496
608,11,-10,598,339526,11,339515
609,6,-15,360,163162,6,163156
610,6,-18,124,65208,6,65202
611,18,6,0,835736,18,835718
612,6,16,113,1127414,6,1127408
613,8,9,385,914780,8,914772
614,19,-6,725,464682,19,464663
615,15,-12,135,273541,15,273526
616,5,-5,48,468903,5,468898
617,13,-8,494,401271,13,401258
618,20,-2,202,586618,20,586598
619,14,-5,644,495725,14,495711
620,19,0,56,648664,19,648645
621,15,-2,992,592657,15,592642
622,18,-19,579,58605,18,58587
623,15,1,732,685556,15,685541
624,19,19,779,1247099,19,1247080
625,14,-5,727,496355,14,496341
626,13,4,588,777505,13,777492
627,9,5,789,798074,9,798065
628,15,-12,165,273738,15,273723
629,16,-20,296,25110,16,25094
630,16,-13,218,242629,16,242613
631,20,-10,708,340413,20,340393
632,13,-20,618,27488,13,27475
633,14,-14,635,214505,14,214491
634,8,-9,484,354548,8,354540
635,16,-3,524,557910,16,557894
636,8,-11,586,294180,8,294172
637,6,-2,693,577599,6,577593
638,7,-17,469,103471,7,103464
639,9,0,77,626899,9,626890
640,7,9,552,918376,7,918369
641,15,-11,233,305523,15,305508
642,19,2,287,712743,19,712724
643,7,-5,141,471130,7,471123
644,8,-5,349,475790,8,475782
645,5,13,723,1046206,5,1046201
646,16,-7,667,433099,16,433083
647,15,-11,514,307841,15,307826
648,14,11,127,991721,14,991707
649,9,-15,442,164949,9,164940
650,12,11,401,993837,12,993825
651,5,-1,225,598737,5,598732
652,17,-15,221,179329,17,179312
653,15,11,741,996159,15,996144
654,20,5,404,806719,20,806699
655,12,13,274,1055182,12,1055170
656,15,-3,669,559122,15,559107
657,15,9,222,930703,15,930688
658,20,10,652,964959,20,964939
659,5,-12,608,262604,5,262599
660,9,19,872,1236957,9,1236948
661,14,16,257,1148972,14,1148958
662,18,-12,832,278629,18,278611
663,7,10,253,942807,7,942800
664,12,0,555,652408,12,652396
665,18,8,38,898156,18,898138
666,14,2,564,714826,14,714812
667,11,-8,387,400613,11,400602
668,12,2,349,713212,12,713200
669,5,-13,264,223989,5,223984
670,10,-3,448,540444,10,540434
671,5,-10,345,320080,5,320075
672,12,18,767,1214501,12,1214489
673,19,0,178,649590,19,649571
674,13,0,900,655106,13,655093
675,7,18,271,1192817,7,1192810
676,17,13,73,1053774,17,1053757
677,17,2,370,713395,17,713378
678,18,10,213,961438,18,961420
679,15,12,54,1022463,15,1022448
680,13,10,323,962273,13,962260
681,14,-11,278,305895,14,305881
682,15,-19,57,54271,15,54256
683,19,-8,708,402898,19,402879
684,17,15,613,1121269,17,1121252
685,12,14,946,1092872,12,1092860
686,9,13,370,1038652,9,1038643
687,19,-16,454,150385,19,150366
688,5,-4,63,500709,5,500704
689,18,10,228,961562,18,961544
690,6,-19,606,44787,6,44781
691,13,8,648,903108,13,903095
692,9,-18,693,77225,9,77216
693,9,15,689,1109030,9,1109021
694,20,7,592,871378,20,871358
695,20,-9,76,367213,20,367193
696,13,16,860,1153233,13,1153220
697,6,-5,161,471587,6,471581
698,15,-16,890,153504,15,153489
699,15,-6,974,466499,15,466484
700,20,15,101,1117543,20,1117523
701,7,9,517,917711,7,917704
702,9,-12,559,261633,9,261624
703,9,-19,802,48997,9,48988
704,7,-11,202,285499,7,285492
705,16,-13,934,248093,16,248077
706,20,-7,713,433502,20,433482
707,14,-3,901,561021,14,561007
708,19,12,745,1027618,19,1027599
709,16,0,183,649658,16,649642
710,6,-15,358,163143,6,163137
711,20,-10,314,337353,20,337333
712,9,-18,108,64876,9,64867
713,10,2,228,693480,10,693470
714,14,13,839,1059518,14,1059504
715,15,-19,386,56992,15,56977
716,12,-15,943,184963,12,184951
717,9,-5,862,486693,9,486684
718,17,10,273,961883,17,961866
719,8,1,544,669210,8,669202
720,13,-1,651,621612,13,621599
721,15,12,76,1022578,15,1022563
722,18,-3,463,557343,18,557325
723,17,-8,873,404058,17,404041
724,11,-10,724,340520,11,340509
725,14,15,519,1120534,14,1120520
726,16,4,752,778791,16,778775
727,7,-16,421,133080,7,133073
728,10,-15,306,162046,10,162036
729,10,9,448,916088,10,916078
730,18,-15,114,178647,18,178629
731,12,1,67,680285,12,680273
732,14,7,818,872910,14,872896
733,8,14,381,1070230,8,1070222
734,9,-19,470,41659,9,41650
735,6,-2,818,580287,6,580281
736,19,-9,92,367305,19,367286
737,6,0,74,626859,6,626853
738,13,9,583,933351,13,933338
739,12,-15,769,183503,12,183491
740,12,5,952,810794,12,810782
741,18,7,663,871864,18,871846
742,17,15,343,1119315,17,1119298
743,16,0,951,655491,16,655475
744,6,3,978,740282,6,740276
745,11,15,579,1120982,11,1120971
746,12,-6,192,460663,12,460651
747,12,4,388,776021,12,776009
748,15,-9,166,367756,15,367741
749,19,-8,590,401965,19,401946
750,14,17,215,1179476,14,1179462
751,19,-11,145,304871,19,304852
752,15,-9,969,374142,15,374127
753,17,6,20,835967,17,835950
754,20,15,36,1117033,20,1117013
755,12,16,36,1147320,12,1147308
756,7,14,733,1078493,7,1078486
757,20,8,904,905016,20,904996
758,12,14,112,1086358,12,1086346
759,15,-5,597,495450,15,495435
760,20,-5,127,491904,20,491884
761,8,19,1,1217345,8,1217337
762,13,5,725,809065,13,809052
763,10,-3,179,534206,10,534196
764,16,15,51,1117171,16,1117155
765,19,18,310,1211328,19,1211309
766,16,11,636,995378,16,995362
767,17,-4,217,523792,17,523775
768,15,-2,251,587023,15,587008
769,5,2,33,689330,5,689325
770,16,14,828,1091952,16,1091936
771,18,0,366,650808,18,650790
772,6,-11,159,284635,6,284629
773,17,-17,832,121725,17,121708
774,20,-14,749,215285,20,215265
775,12,-6,988,466666,12,466654
776,15,-16,118,147792,15,147777
777,18,10,439,963178,18,963160
778,14,5,562,807867,14,807853
779,18,-16,450,150366,18,150348
780,19,14,726,1091155,19,1091136
781,9,-14,566,198860,9,198851
782,16,0,395,651079,16,651063
783,10,18,49,1187712,10,1187702
784,12,19,712,1246530,12,1246518
785,11,-2,741,590660,11,590649
786,17,-1,988,624092,17,624075
787,19,-3,887,560895,19,560876
788,16,-19,624,58923,16,58907
789,14,-15,476,181300,14,181286
790,12,18,632,1213497,12,1213485
791,10,7,286,850896,10,850886
792,8,6,261,818118,8,818110
793,5,-18,62,63733,5,63728
794,12,11,482,994377,12,994365
795,7,-8,925,395092,7,395085
796,15,10,230,961574,15,961559
797,12,0,861,654757,12,654745
798,16,4,535,777135,16,777119
799,9,-1,284,600151,9,600142
800,15,-4,577,526456,15,526441
801,10,-11,741,297149,10,297139
802,9,14,59,1063092,9,1063083
803,14,-13,484,244535,14,244521
804,8,-9,856,362699,8,362691
805,19,11,894,997371,19,997352
806,13,14,258,1087422,13,1087409
807,19,-18,896,91709,19,91690
808,12,-14,950,216850,12,216838
809,6,11,520,979554,6,979548
810,18,17,157,1178999,18,1178981
811,8,5,717,796526,8,796518
812,17,2,899,717173,17,717156
813,10,14,586,1074802,10,1074792
814,5,12,190,1003276,5,1003271
815,5,18,318,1193604,5,1193599
816,12,3,638,746644,12,746632
817,5,10,492,947941,5,947936
818,19,-9,992,374191,19,374172
819,9,-10,283,318621,9,318612
820,5,-16,277,130026,5,130021
821,17,-4,563,526336,17,526319
822,15,-7,66,428771,15,428756
823,15,3,351,744539,15,744524
824,20,-6,691,464435,20,464415
825,6,-13,933,238566,6,238560
826,8,10,340,944709,8,944701
827,15,-16,698,152036,15,152021
828,12,13,337,1055711,12,1055699
829,9,16,82,1126880,9,1126871
830,8,0,892,644726,8,644718
831,7,0,604,638406,7,638399
832,16,10,7,959886,16,959870
833,19,-12,639,277197,19,277178
834,8,-10,658,326867,8,326859
835,19,6,517,839972,19,839953
836,19,-5,724,496312,19,496293
837,12,14,987,1093195,12,1093183
838,11,5,680,808742,11,808731
839,10,-15,24,155861,10,155851
840,13,-6,886,465826,13,465813
841,10,-10,302,319060,10,319050
842,6,19,760,1234314,6,1234308
843,5,-6,879,455535,5,455530
844,14,-12,850,278826,14,278812
845,13,9,299,931135,13,931122
846,13,10,927,966978,13,966965
847,18,14,399,1088552,18,1088534
848,8,7,588,857308,8,857300
849,12,-19,945,61133,12,61121
850,12,5,11,803855,12,803843
851,7,-20,469,10015,7,10008
852,6,1,761,673530,6,673524
853,10,10,634,951203,10,951193
854,18,17,455,1181345,18,1181327
855,18,-2,105,585911,18,585893
856,15,9,207,930592,15,930577
857,6,-8,496,385646,6,385640
858,6,-12,114,252014,6,252008
859,6,8,634,889089,6,889083
860,6,-17,660,107707,6,107701
861,18,-6,612,463823,18,463805
862,15,8,931,905199,15,905184
863,5,8,380,883465,5,883460
864,15,-12,28,272708,15,272693
865,19,-2,118,586006,19,585987
866,10,-9,788,361196,10,361186
867,8,12,333,1006434,8,1006426
868,8,3,695,733951,8,733943
869,10,19,317,1224605,10,1224595
870,16,1,321,682413,16,682397
871,17,3,929,748900,17,748883
872,8,11,523,979642,8,979634
873,10,12,28,999648,10,999638
874,12,1,580,684476,12,684464
875,17,-5,460,494438,17,494421
876,18,-4,273,524200,18,524182
877,16,8,965,905446,16,905430
878,14,15,850,1122973,14,1122959
879,15,2,268,712564,15,712549
880,19,10,506,963726,19,963707
881,12,-8,199,399311,12,399299
882,7,-5,67,469324,7,469317
883,5,-20,143,3155,5,3150
884,10,6,691,827898,10,827888
885,8,11,778,985111,8,985103
886,11,-16,358,149529,11,149518
887,8,-4,560,511481,8,511473
888,14,-6,563,463493,14,463479
889,7,-4,790,516286,7,516279
890,11,-8,299,399967,11,399956
891,16,7,42,867346,16,867330
892,12,-19,267,56098,12,56086
893,5,8,655,889487,5,889482
894,19,-8,98,398629,19,398610
895,13,-4,699,527346,13,527333
896,7,-19,579,44263,7,44256
897,13,6,913,843062,13,843049
898,13,9,149,930146,13,930133
899,5,-15,532,166936,5,166931
900,7,9,230,911607,7,911600
901,12,-19,960,61219,12,61207
902,6,-20,421,8985,6,8979
903,19,11,157,991939,19,991920
904,11,12,633,1026728,11,1026717
905,18,-14,186,210726,18,210708
906,19,-18,375,88092,19,88073
907,5,17,39,1156162,5,1156157
908,10,19,4,1217502,10,1217492
909,19,10,286,961965,19,961946
910,19,-16,610,151509,19,151490
911,14,5,344,806304,14,806290
912,18,2,665,715559,18,715541
913,16,13,588,1057730,16,1057714
914,11,16,587,1151243,11,1151232
915,16,-1,9,616561,16,616545
916,18,-1,800,622727,18,622709
917,19,12,896,1028841,19,1028822
918,19,-19,204,55688,19,55669
919,10,-8,570,387454,10,387444
920,10,12,501,1009819,10,1009809
921,9,-19,12,31692,9,31683
922,14,16,84,1147667,14,1147653
923,12,-4,226,523870,12,523858
924,10,-12,479,259954,10,259944
925,19,-7,818,434242,19,434223
926,12,2,18,710578,12,710566
927,10,6,265,818174,10,818164
928,6,19,717,1233410,6,1233404
929,19,-12,491,276120,19,276101
930,14,-4,768,527784,14,527770
931,8,19,455,1227980,8,1227972
932,18,-1,181,617894,18,617876
933,19,15,854,1123017,19,1122998
934,7,-5,616,481349,7,481342
935,13,16,976,1154109,13,1154096
936,20,13,233,1054949,20,1054929
937,5,-19,297,37975,5,37970
938,6,-14,827,204532,6,204526
939,18,3,323,744351,18,744333
940,8,8,419,884393,8,884385
941,17,9,839,935293,17,935276
942,11,-8,242,399615,11,399604
943,18,-4,909,528908,18,528890
944,17,-14,314,211832,17,211815
945,17,6,42,836138,17,836121
946,11,15,746,1122334,11,1122323
947,14,-13,685,245983,14,245969
948,18,-3,220,555323,18,555305
949,6,-14,733,202673,6,202667
950,8,0,100,627619,8,627611
951,5,-4,769,515863,5,515858
952,17,-5,46,491192,17,491175
953,11,14,586,1089944,11,1089933
954,15,13,841,1059528,15,1059513
955,14,-9,241,368325,14,368311
956,16,-7,767,433884,16,433868
957,15,-17,899,122166,15,122151
958,14,-1,497,620535,14,620521
959,20,9,165,930294,20,930274
960,6,-17,942,113299,6,113293
961,8,5,958,801898,8,801890
962,8,0,436,634720,8,634712
963,12,-16,11,146804,12,146792
964,13,-17,103,116353,13,116340
965,20,15,765,1122442,20,1122422
966,13,2,879,717047,13,717034
967,5,-14,410,195790,5,195785
968,9,14,800,1079817,9,1079808
969,7,-19,468,41564,7,41557
970,18,-11,609,308608,18,308590
971,19,-7,874,434688,19,434669
972,18,-14,937,216778,18,216760
973,11,-5,970,498197,11,498186
974,15,-12,821,278541,15,278526
975,20,-13,165,242230,20,242210
976,5,13,68,1032234,5,1032229
977,12,-12,70,273053,12,273041
978,8,-2,908,582272,8,582264
979,7,4,755,767039,7,767032
980,5,0,366,633165,5,633160
981,13,19,786,1247159,13,1247146
982,11,6,909,843011,11,843000
983,10,11,385,976734,10,976724
984,19,-20,778,28822,19,28803
985,16,-2,932,592212,16,592196
986,17,17,293,1180158,17,1180141
987,18,-3,102,554507,18,554489
988,6,-9,462,353820,6,353814
989,10,5,819,798718,10,798708
990,19,7,924,873597,19,873578
991,16,16,228,1148728,16,1148712
992,7,-5,994,489596,7,489589
993,6,14,721,1078252,6,1078246
994,6,-13,111,220775,6,220769
995,13,6,328,838335,13,838322
996,11,16,253,1148917,11,1148906
997,5,-10,54,313777,5,313772
998,15,7,789,872734,15,872719
999,13,-14,441,212939,13,212926
1000,19,-1,441,620053,19,620034
1001,8,-20,357,7846,8,7838
1002,7,14,560,1074295,7,1074288
1003,14,-12,464,275901,14,275887
1004,13,17,608,1182384,13,1182371
1005,13,3,793,747834,13,747821
1006,8,4,631,764278,8,764270
1007,6,-2,443,572180,6,572174
1008,14,19,225,1242529,14,1242515
1009,10,16,197,1129340,10,1129330
1010,7,6,789,830022,7,830015
1011,8,-6,724,452384,8,452376
1012,9,15,692,1109116,9,1109107
1013,11,12,380,1024842,11,1024831
1014,16,-9,447,370117,16,370101
1015,20,7,348,869564,20,869544
1016,6,2,599,701206,6,701200
1017,7,3,146,721982,7,721975
1018,16,-19,392,57060,16,57044
1019,14,-13,231,242746,14,242732
1020,7,11,864,986917,7,986910
1021,5,-8,569,387405,5,387400
1022,19,-12,254,274372,19,274353
1023,9,12,61,1000425,9,1000416
1024,10,-19,908,51064,10,51054
1025,11,-8,504,401359,11,401348
1026,12,-7,13,428379,12,428367
1027,6,12,932,1019624,6,1019618
1028,10,15,32,1095160,10,1095150
1029,20,-2,234,586896,20,586876
1030,10,1,131,660048,10,660038
1031,12,13,54,1053644,12,1053632
1032,9,8,563,887521,9,887512
1033,10,13,785,1047632,10,1047622
1034,20,-10,552,339183,20,339163
1035,9,-20,978,21575,9,21566
1036,11,-12,124,273474,11,273463
1037,10,-4,826,516909,10,516899
1038,12,18,436,1212258,12,1212246
1039,19,-19,548,58256,19,58237
1040,5,-15,680,169993,5,169988
1041,12,12,287,1024249,12,1024237
1042,5,-3,74,532106,5,532101
1043,10,-11,114,283608,10,283598
1044,14,2,977,717725,14,717711
1045,5,-8,778,392024,5,392019
1046,14,16,631,1151598,14,1151584
1047,17,14,893,1092453,17,1092436
1048,15,-5,562,495187,15,495172
1049,14,-6,445,462511,14,462497
1050,5,12,100,1001261,5,1001256
1051,16,-11,175,305141,16,305125
1052,16,-9,243,368340,16,368324
1053,8,8,551,887292,8,887284
1054,5,-12,793,266641,5,266636
1055,18,-19,506,57877,18,57859
1056,11,10,869,966479,11,966468
1057,15,-13,841,247298,15,247283
1058,8,1,746,673264,8,673256
1059,12,13,291,1055367,12,1055355
1060,14,12,975,1029619,14,1029605
1061,17,-10,574,339336,17,339319
1062,13,14,235,1087248,13,1087235
1063,10,1,369,665315,10,665305
1064,14,-18,597,89551,14,89537
1065,8,10,359,945117,8,945109
1066,6,-17,94,95485,6,95479
1067,12,-17,814,121623,12,121611
1068,11,19,304,1243188,11,1243177
1069,17,-12,696,277622,17,277605
1070,12,18,187,1210494,12,1210482
1071,18,19,350,1243592,18,1243574
1072,10,4,349,758030,10,758020
1073,12,-6,483,462867,12,462855
1074,5,10,584,950082,5,950077
1075,15,-18,152,86412,15,86397
1076,15,0,685,653504,15,653489
1077,20,0,686,653516,20,653496
1078,12,2,450,714004,12,713992
1079,9,-6,448,446293,9,446284
1080,10,-3,742,546993,10,546983
1081,20,9,779,934811,20,934791
1082,10,-10,931,332399,10,332389
1083,14,-1,482,620436,14,620422
1084,18,-17,683,120633,18,120615
1085,14,4,113,774085,14,774071
1086,20,-8,613,402167,20,402147
1087,10,-5,562,480217,10,480207
1088,15,-11,638,308794,15,308779
1089,15,-19,859,60609,15,60594
1090,7,13,15,1031104,7,1031097
1091,9,5,174,785156,9,785147
1092,13,8,2,897928,13,897915
1093,13,-2,354,587758,13,587745
1094,14,19,418,1244269,14,1244255
1095,10,-7,804,422797,10,422787
1096,10,10,114,940098,10,940088
1097,12,-15,87,178446,12,178434
1098,5,17,216,1159787,5,1159782
1099,11,-10,46,335511,11,335500
1100,8,-7,276,411712,8,411704
1101,10,12,842,1017498,10,1017488
1102,10,9,839,924646,10,924636
1103,7,-16,245,129400,7,129393
1104,20,4,812,779234,20,779214
1105,19,12,143,1023060,19,1023041
1106,15,5,722,809059,15,809044
1107,9,14,947,1083045,9,1083036
1108,16,1,402,683051,16,683035
1109,8,8,724,891192,8,891184
1110,9,-1,132,596665,9,596656
1111,17,3,180,743216,17,743199
1112,20,-9,943,374045,20,374025
1113,13,10,793,966005,13,965992
1114,9,9,611,919737,9,919728
1115,6,-2,642,576369,6,576363
1116,14,3,228,743592,14,743578
1117,13,-12,828,278603,13,278590
1118,9,8,127,877772,9,877763
1119,12,5,736,809148,12,809136
1120,13,-9,365,369384,13,369371
1121,19,13,95,1053948,19,1053929
1122,16,18,318,1211405,16,1211389
1123,7,13,809,1048205,7,1048198
1124,16,0,361,650759,16,650743
1125,8,1,867,675859,8,675851
1126,7,13,915,1050232,7,1050225
1127,7,0,183,629520,7,629513
1128,16,-3,999,561742,16,561726
1129,14,-10,821,341252,14,341238
1130,10,16,879,1143351,10,1143341
1131,7,6,850,831450,7,831443
1132,20,-19,202,55665,20,55645
1133,15,-10,46,335516,15,335501
1134,12,-1,926,623645,12,623633
1135,5,18,721,1201719,5,1201714
1136,18,-10,238,336810,18,336792
1137,10,-8,875,394027,10,394017
1138,15,-9,153,367681,15,367666
1139,18,3,165,743065,18,743047
1140,19,3,992,749460,19,749441
1141,20,-1,902,623453,20,623433
1142,17,6,697,841421,17,841404
1143,15,17,740,1183397,15,1183382
1144,7,18,334,1193983,7,1193976
1145,11,-4,484,525713,11,525702
1146,15,-18,150,86388,15,86373
1147,7,-7,712,420954,7,420947
1148,20,15,339,1119266,20,1119246
1149,11,-11,376,306763,11,306752
1150,7,-17,46,94491,7,94484
1151,11,14,869,1092218,11,1092207
1152,13,-4,836,528181,13,528168
1153,14,-13,349,243619,14,243605
1154,5,5,798,798273,5,798268
1155,6,0,312,631913,6,631907
1156,9,1,42,657955,9,657946
1157,11,-12,19,272630,11,272619
1158,13,-18,183,86710,13,86697
1159,17,-19,50,54245,17,54228
1160,17,-14,168,210567,17,210550
1161,9,-13,71,219879,9,219870
1162,12,-15,501,181468,12,181456
1163,18,19,765,1246961,18,1246943
1164,7,3,506,729633,7,729626
1165,18,12,539,1026001,18,1025983
1166,18,9,775,934773,18,934755
1167,12,-12,41,272791,12,272779
1168,7,-6,592,449529,7,449522
1169,12,-18,998,92468,12,92456
1170,17,7,867,873280,17,873263
1171,15,-16,486,150590,15,150575
1172,12,-8,149,398975,12,398963
1173,17,10,660,964998,17,964981
1174,8,2,266,694338,8,694330
1175,7,-10,897,331762,7,331755
1176,19,-14,623,214401,19,214382
1177,11,-16,349,149489,11,149478
1178,13,-13,819,247121,13,247108
1179,13,-2,922,592136,13,592123
1180,6,17,300,1161767,6,1161761
1181,15,2,457,714086,15,714071
1182,14,-7,287,430460,14,430446
1183,18,-9,352,369262,18,369244
1184,6,7,861,863099,6,863093
1185,9,-4,398,508310,9,508301
1186,14,-2,497,588890,14,588876
1187,15,18,544,1212943,15,1212928
1188,15,13,407,1056271,15,1056256
1189,18,-10,378,337789,18,337771
1190,13,-7,175,429627,13,429614
1191,19,19,171,1242117,19,1242098
1192,14,-11,535,308039,14,308025
1193,7,-13,758,234644,7,234637
1194,11,12,393,1024932,11,1024921
1195,8,19,830,1235867,8,1235859
1196,10,10,994,958710,10,958700
1197,15,-20,658,27835,15,27820
1198,9,-12,495,260278,9,260269
1199,9,5,566,793277,9,793268
1200,6,15,880,1113152,6,1113146
1201,8,-8,18,375740,8,375732
1202,18,-11,760,309648,18,309630
1203,9,9,961,927201,9,927192
1204,5,11,524,979666,5,979661
1205,18,16,647,1151766,18,1151748
1206,6,-13,77,220029,6,220023
1207,5,-5,98,470242,5,470237
1208,12,13,552,1057413,12,1057401
1209,12,16,710,1152151,12,1152139
1210,16,10,192,961310,16,961294
1211,7,6,642,826796,7,826789
1212,11,11,999,998004,11,997993
1213,16,-6,965,466433,16,466417
1214,8,4,396,759160,8,759152
1215,13,-6,740,464815,13,464802
1216,6,14,155,1065316,6,1065310
1217,6,-18,841,80545,6,80539
1218,10,14,516,1073310,10,1073300
1219,17,15,605,1121214,17,1121197
1220,10,-19,840,49904,10,49894
1221,17,6,24,836007,17,835990
1222,15,14,693,1090922,15,1090907
1223,16,-15,925,184792,16,184776
1224,15,16,620,1151457,15,1151442
1225,9,3,323,725955,9,725946
1226,11,6,530,840086,11,840075
1227,19,3,530,745710,19,745691
1228,5,-1,187,597702,5,597697
1229,7,4,975,771805,7,771798
1230,15,13,260,1055106,15,1055091
1231,9,-11,419,290441,9,290432
1232,10,6,206,816708,10,816698
1233,18,-11,852,310381,18,310363
1234,11,-3,96,554469,11,554458
1235,6,3,817,736410,6,736404
1236,13,-1,236,618438,13,618425
1237,8,12,750,1015411,8,1015403
1238,20,16,345,1149624,20,1149604
1239,18,13,155,1054348,18,1054330
1240,20,-19,675,59230,20,59210
1241,8,-6,660,450912,8,450904
1242,6,-15,993,176561,6,176555
1243,16,-20,479,26372,16,26356
1244,15,17,430,1181129,15,1181114
1245,7,4,655,764750,7,764743
1246,17,-3,248,555535,17,555518
1247,15,-20,175,24100,15,24085
1248,20,-7,676,433195,20,433175
1249,11,-11,536,308052,11,308041
1250,10,18,479,1196997,10,1196987
1251,8,-19,654,45918,8,45910
1252,18,-11,948,311092,18,311074
1253,8,-2,490,573242,8,573234
1254,19,-14,87,209992,19,209973
1255,10,-17,191,97427,10,97417
1256,13,-17,920,122318,13,122305
1257,19,6,562,840302,19,840283
1258,12,1,861,686512,12,686500
1259,20,-14,965,216981,20,216961
1260,6,-1,227,598805,6,598799
1261,16,19,144,1241933,16,1241917
1262,18,19,21,1240861,18,1240843
1263,13,8,30,898098,13,898085
1264,15,-18,628,89798,15,89783
1265,13,-7,626,432896,13,432883
1266,5,-8,714,390692,5,390687
1267,9,18,603,1199394,9,1199385
1268,18,-15,965,185121,18,185103
1269,11,11,926,997632,11,997621
1270,14,11,435,994059,14,994045
1271,11,-11,570,308265,11,308254
1272,14,0,275,650185,14,650171
1273,5,-13,959,239142,5,239137
1274,18,2,509,714463,18,714445
1275,16,16,452,1150397,16,1150381
1276,11,-20,735,28428,11,28417
1277,16,-15,862,184310,16,184294
1278,13,18,219,1210748,13,1210735
1279,8,13,873,1049530,8,1049522
1280,15,-18,585,89490,15,89475
1281,12,2,148,711716,12,711704
1282,10,17,759,1171448,10,1171438
1283,10,14,182,1065777,10,1065767
1284,14,-16,673,151865,14,151851
1285,19,-18,261,87332,19,87313
1286,10,17,303,1161811,10,1161801
1287,14,4,99,774004,14,773990
1288,9,-9,250,349046,9,349037
1289,5,16,60,1126461,5,1126456
1290,5,5,763,797501,5,797496
1291,20,-16,929,153782,20,153762
1292,14,-11,234,305527,14,305513
1293,13,-15,945,184983,13,184970
1294,10,8,282,881388,10,881378
1295,15,-2,921,592124,15,592109
1296,15,-14,415,212796,15,212781
1297,5,15,92,1096401,5,1096396
1298,17,3,835,748078,17,748061
1299,15,-4,131,523042,15,523027
1300,18,-11,68,304220,18,304202
1301,16,-8,248,399672,16,399656
1302,20,-15,557,181884,20,181864
1303,12,15,736,1122234,12,1122222
1304,6,-19,558,43644,6,43638
1305,12,-13,581,245331,12,245319
1306,14,-14,429,212870,14,212856
1307,13,-7,33,428587,13,428574
1308,20,4,480,776707,20,776687
1309,15,-20,899,29721,15,29706
1310,13,-14,626,214438,13,214425
1311,17,-7,169,429578,17,429561
1312,19,16,886,1153367,19,1153348
1313,8,1,343,664735,8,664727
1314,9,12,27,999639,9,999630
1315,9,-4,926,519237,9,519228
1316,17,-5,394,493925,17,493908
1317,14,-10,215,336654,14,336640
1318,13,-14,797,215767,13,215754
1319,9,15,978,1115303,9,1115294
1320,8,2,597,701172,8,701164
1321,5,18,484,1197082,5,1197077
1322,18,-2,620,589815,18,589797
1323,20,-20,125,23696,20,23676
1324,17,-3,30,554021,17,554004
1325,10,4,519,761788,10,761778
1326,15,4,1000,780566,15,780551
1327,7,-15,528,166820,7,166813
1328,16,-12,935,279542,16,279526
1329,15,8,573,902460,15,902445
1330,18,-14,918,216674,18,216656
1331,6,18,747,1202425,6,1202419
1332,8,17,422,1164258,8,1164250
1333,11,11,277,992874,11,992863
1334,5,15,102,1096697,5,1096692
1335,9,1,495,668148,9,668139
1336,10,14,961,1083307,10,1083297
1337,5,-19,503,42337,5,42332
1338,18,9,217,930644,18,930626
1339,7,-20,879,19550,7,19543
1340,12,19,835,1247524,12,1247512
1341,5,-4,875,518174,5,518169
1342,15,-6,196,460671,15,460656
1343,17,-1,718,622122,17,622105
1344,7,-20,406,8830,7,8823
1345,8,-10,425,321867,8,321859
1346,12,-17,280,117552,12,117540
1347,17,7,433,870263,17,870246
1348,5,2,84,690371,5,690366
1349,9,0,85,627118,9,627109
1350,19,-2,376,587894,19,587875
1351,14,-17,785,121448,14,121434
1352,5,-20,376,8249,5,8244
1353,6,-15,679,169979,6,169973
1354,20,-2,20,585292,20,585272
1355,8,1,542,669194,8,669186
1356,9,16,897,1143732,9,1143723
1357,14,-10,49,335517,14,335503
1358,18,6,305,838091,18,838073
1359,11,-13,452,244291,11,244280
1360,20,-10,773,340888,20,340868
1361,14,-15,550,181854,14,181840
1362,17,-19,758,59920,17,59903
1363,15,11,583,995026,15,995011
1364,12,-19,166,55346,12,55334
1365,7,9,839,924653,7,924646
1366,9,7,83,846637,9,846628
1367,20,1,164,681170,20,681150
1368,6,-9,769,360750,6,360744
1369,12,-3,87,554373,12,554361
1370,7,-20,113,2461,7,2454
1371,12,-5,235,492712,12,492700
1372,8,-9,541,355854,8,355846
1373,7,14,612,1075476,7,1075469
1374,18,-20,634,27586,18,27568
1375,14,-20,840,29322,14,29308
1376,19,19,615,1245784,19,1245765
1377,18,8,905,905030,18,905012
1378,15,10,204,961370,15,961355
1379,9,12,763,1015630,9,1015621
1380,16,-17,561,119709,16,119693
1381,11,-16,184,148256,11,148245
1382,11,-3,844,560511,11,560500
1383,15,0,409,651165,15,651150
1384,8,-3,606,544012,8,544004
1385,13,2,495,714358,13,714345
1386,20,1,217,681600,20,681580
1387,6,-1,517,605251,6,605245
1388,20,10,82,960468,20,960448
1389,13,18,249,1210978,13,1210965
1390,10,-15,939,175409,10,175399
1391,6,-14,47,187582,6,187576
1392,18,5,468,807250,18,807232
1393,10,15,695,1109226,10,1109216
1394,15,12,709,1027400,15,1027385
1395,5,-14,754,203139,5,203134
1396,14,-12,211,274020,14,274006
1397,19,4,593,777590,19,777571
1398,15,-3,137,554741,15,554726
1399,7,-11,334,288464,7,288457
1400,11,-14,90,210027,11,210016
1401,18,-20,363,25606,18,25588
1402,11,13,410,1056284,11,1056273
1403,20,12,478,1025551,20,1025531
1404,12,4,588,777507,12,777495
1405,8,-9,759,360496,8,360488
1406,9,2,650,702352,9,702343
1407,12,-5,932,497889,12,497877
1408,18,-14,875,216307,18,216289
1409,16,-1,759,622379,16,622363
1410,20,8,791,904203,20,904183
1411,20,-10,913,341920,20,341900
1412,9,12,182,1003122,9,1003113
1413,13,17,21,1178003,13,1177990
1414,16,-15,311,180016,16,180000
1415,13,19,790,1247189,13,1247176
1416,12,-16,411,149935,12,149923
1417,11,8,721,903704,11,903693
1418,16,-14,775,215588,16,215572
1419,15,9,7,929098,15,929083
1420,17,10,673,965110,17,965093
1421,7,2,620,701722,7,701715
1422,16,-18,503,88976,16,88960
1423,12,2,342,713178,12,713166
1424,8,-14,42,187433,8,187425
1425,20,-7,555,432506,20,432486
1426,12,4,82,773838,12,773826
1427,13,-1,525,620753,13,620740
1428,9,8,603,888336,9,888327
1429,13,-6,239,461031,13,461018
1430,6,9,916,926215,6,926209
1431,19,11,24,991046,19,991027
1432,18,-16,432,150171,18,150153
1433,8,4,13,750774,8,750766
1434,6,-17,375,101514,6,101508
1435,14,-15,238,179466,14,179452
1436,17,-6,163,460382,17,460365
1437,19,4,107,774052,19,774033
1438,16,-13,506,244768,16,244752
1439,19,-2,418,588256,19,588237
1440,13,-3,126,554697,13,554684
1441,6,-3,329,537592,6,537586
1442,10,4,363,758382,10,758372
1443,15,-8,754,403227,15,403212
1444,5,-16,739,139845,5,139840
1445,11,-13,778,246838,11,246827
1446,17,15,479,1120146,17,1120129
1447,15,-15,871,184374,15,184359
1448,7,18,356,1194333,7,1194326
1449,19,-1,417,619873,19,619854
1450,6,-12,265,255205,6,255199
1451,19,6,230,837484,19,837465
1452,15,8,111,898811,15,898796
1453,15,8,661,903160,15,903145
1454,7,-12,847,267957,7,267950
1455,18,11,516,994590,18,994572
1456,19,-1,120,617479,19,617460
1457,10,17,230,1160078,10,1160068
1458,16,13,408,1056276,16,1056260
1459,18,-2,18,585258,18,585240
1460,19,2,816,716551,19,716532
1461,19,-8,896,404271,19,404252
1462,18,-19,386,57000,18,56982
1463,6,19,739,1233905,6,1233899
1464,14,9,573,933281,14,933267
1465,19,-10,61,335656,19,335637
1466,8,-16,675,138555,8,138547
1467,17,-9,830,373112,17,373095
1468,17,15,955,1123796,17,1123779
1469,5,10,423,946556,5,946551
1470,15,-16,702,152078,15,152063
1471,10,1,321,664204,10,664194
1472,14,-12,380,275323,14,275309
1473,13,15,30,1117006,13,1116993
1474,13,-16,440,150255,13,150242
1475,11,2,712,715968,11,715957
1476,9,16,955,1145011,9,1145002
1477,14,18,873,1215315,14,1215301
1478,6,-14,63,187864,6,187858
1479,11,-5,295,493249,11,493238
1480,5,0,304,631796,5,631791
1481,9,8,941,895636,9,895627
1482,12,-6,593,463654,12,463642
1483,14,-20,37,21061,14,21047
1484,14,19,551,1245288,14,1245274
1485,14,-7,551,432479,14,432465
1486,6,7,10,844968,6,844962
1487,11,-5,550,495071,11,495060
1488,9,-19,386,39829,9,39820
1489,17,-20,59,23227,17,23210
1490,12,8,72,898434,12,898422
1491,18,-16,40,147038,18,147020
1492,20,-10,409,338040,20,338020
1493,5,6,683,827692,5,827687
1494,13,16,835,1153120,13,1153107
1495,16,10,198,961351,16,961335
1496,15,16,174,1148328,15,1148313
1497,16,-9,282,368639,16,368623
1498,18,19,808,1247328,18,1247310
1499,9,-13,150,221563,9,221554
1500,16,9,667,933978,16,933962
1501,18,-12,540,276547,18,276529
1502,14,9,772,934706,14,934692
1503,14,7,564,871155,14,871141
1504,20,19,705,1246482,20,1246462
1505,11,17,517,1181772,11,1181761
1506,15,2,769,716288,15,716273
1507,9,9,756,922559,9,922550
1508,7,-18,712,77712,7,77705
1509,9,-5,394,476625,9,476616
1510,9,0,601,638362,9,638353
1511,6,-7,133,408568,6,408562
1512,8,-13,209,222791,8,222783
1513,6,-4,703,514531,6,514525
1514,12,-15,338,180215,12,180203
1515,5,9,16,907075,5,907070
1516,16,13,718,1058584,16,1058568
1517,8,-13,132,221172,8,221164
1518,15,14,320,1087936,15,1087921
1519,19,19,801,1247269,19,1247250
1520,5,-4,78,501019,5,501014
1521,16,-8,6,397896,16,397880
1522,19,12,572,1026230,19,1026211
1523,18,-19,365,56827,18,56809
1524,9,11,415,977357,9,977348
1525,17,-16,173,148158,17,148141
1526,17,9,931,936021,17,936004
1527,13,12,457,1025382,13,1025369
1528,20,10,927,966988,20,966968
1529,7,8,998,896880,7,896873
1530,19,5,219,805484,19,805465
1531,7,-4,902,518779,7,518772
1532,5,0,487,635958,5,635953
1533,14,0,421,651316,14,651302
1534,10,-2,274,568672,10,568662
1535,16,12,779,1027827,16,1027811
1536,17,9,125,929976,17,929959
1537,10,9,941,926727,10,926717
1538,5,-14,227,191637,5,191632
1539,12,-1,760,622382,12,622370
1540,10,6,268,818258,10,818248
1541,19,6,19,835955,19,835936
1542,10,10,692,952428,10,952418
1543,13,-10,280,337089,13,337076
1544,12,-9,337,369135,12,369123
1545,16,-4,926,529000,16,528984
1546,8,-20,490,10477,8,10469
1547,14,-4,609,526666,14,526652
1548,19,11,62,991342,19,991323
1549,19,-12,799,278362,19,278343
1550,17,3,38,742105,17,742088
1551,20,-11,305,306182,20,306162
1552,18,9,655,933888,18,933870
1553,18,-18,143,86291,18,86273
1554,10,12,329,1006352,10,1006342
1555,15,-11,340,306448,15,306433
1556,20,-12,134,273537,20,273517
1557,11,9,345,931537,11,931526
1558,16,-11,879,310627,16,310611
1559,11,13,834,1059475,11,1059464
1560,15,5,228,805531,15,805516
1561,7,-17,706,108606,7,108599
1562,7,-7,484,416210,7,416203
1563,14,-19,857,60593,14,60579
1564,8,-5,771,484547,8,484539
1565,9,18,822,1204108,9,1204099
1566,8,-7,563,417948,8,417940
1567,5,-9,888,363520,5,363515
1568,11,-3,206,555229,11,555218
1569,11,12,62,1022500,11,1022489
1570,6,10,231,942427,6,942421
1571,5,0,997,647088,5,647083
1572,18,-19,861,60622,18,60604
1573,16,-8,70,398493,16,398477
1574,10,0,723,641273,10,641263
1575,20,-5,61,491288,20,491268
1576,17,-17,269,117466,17,117449
1577,16,-3,697,559319,16,559303
1578,6,-8,189,379554,6,379548
1579,5,-15,397,163976,5,163971
1580,5,-8,318,382138,5,382133
1581,17,8,876,904733,17,904716
1582,19,-20,664,27914,19,27895
1583,6,-7,557,417823,6,417817
1584,11,5,340,806272,11,806261
1585,16,-12,409,275514,16,275498
1586,13,15,16,1116890,13,1116877
1587,11,4,929,780117,11,780106
1588,13,-14,599,214247,13,214234
1589,5,-2,291,569051,5,569046
1590,16,5,709,808970,16,808954
1591,18,-12,30,272716,18,272698
1592,6,9,351,914136,6,914130
1593,7,-12,1,249631,7,249624
1594,7,-7,883,424713,7,424706
1595,5,16,381,1133270,5,1133265
1596,17,-14,996,217239,17,217222
1597,10,9,710,921698,10,921688
1598,5,10,361,945165,5,945160
1599,10,10,230,942399,10,942389
1600,19,-8,630,402275,19,402256
1601,18,-11,198,305304,18,305286
1602,18,19,806,1247308,18,1247290
1603,13,16,202,1148555,13,1148542
1604,20,2,819,716580,20,716560
1605,14,17,637,1182578,14,1182564
1606,8,13,42,1031666,8,1031658
1607,15,18,990,1216237,15,1216222
1608,15,10,592,964457,15,964442
1609,8,2,559,700428,8,700420
1610,8,13,122,1033344,8,1033336
1611,19,-16,719,152192,19,152173
1612,20,9,615,933633,20,933613
1613,15,-4,527,526114,15,526099
1614,18,-7,842,434421,18,434403
1615,17,-20,599,27352,17,27335
1616,19,14,288,1087634,19,1087615
1617,7,-17,620,106841,7,106834
1618,7,9,428,915636,7,915629
1619,16,6,255,837684,16,837668
1620,11,-4,855,528346,11,528335
1621,16,17,389,1180851,16,1180835
1622,12,-20,478,26364,12,26352
1623,9,-14,498,197422,9,197413
1624,11,-19,426,57269,11,57258
1625,17,18,5,1208944,17,1208927
1626,7,2,615,701574,7,701567
1627,20,-5,848,497185,20,497165
1628,18,1,854,686460,18,686442
1629,15,-2,778,590960,15,590945
1630,12,2,93,711255,12,711243
1631,13,7,693,872088,13,872075
1632,12,-4,216,523782,12,523770
1633,5,9,365,914409,5,914404
1634,19,-3,793,560168,19,560149
1635,12,16,219,1148710,12,1148698
1636,17,-20,725,28356,17,28339
1637,14,15,460,1120033,14,1120019
1638,5,7,370,852734,5,852729
1639,7,14,469,1072239,7,1072232
1640,15,14,7,1085393,15,1085378
1641,13,-5,567,495209,13,495196
1642,20,8,0,897923,20,897903
1643,19,11,70,991401,19,991382
1644,7,-16,592,136882,7,136875
1645,16,-11,677,309115,16,309099
1646,11,-5,84,491514,11,491503
1647,17,0,868,654839,17,654822
1648,10,15,823,1111877,10,1111867
1649,13,-20,39,21942,13,21929
1650,7,-13,515,229294,7,229287
1651,8,-11,546,293329,8,293321
1652,6,-11,722,296770,6,296764
1653,17,-19,829,60357,17,60340
1654,7,6,293,818811,7,818804
1655,14,3,264,743886,14,743872
1656,5,0,217,630183,5,630178
1657,12,-16,13,146834,12,146822
1658,6,-9,246,348935,6,348929
1659,15,3,886,748464,15,748449
1660,9,9,635,920272,9,920263
1661,17,-3,566,558271,17,558254
1662,13,-6,865,465641,13,465628
1663,18,9,129,930041,18,930023
1664,15,14,975,1093067,15,1093052
1665,10,5,794,798209,10,798199
1666,14,19,985,1248663,14,1248649
1667,10,-20,878,19504,10,19494
1668,14,-10,775,340900,14,340886
1669,6,-9,48,344663,6,344657
1670,12,-7,246,430107,12,430095
1671,19,-11,283,305934,19,305915
1672,19,19,707,1246508,19,1246489
1673,12,3,561,745940,12,745928
1674,11,19,418,1244270,11,1244259
1675,18,-3,979,561636,18,561618
1676,11,17,625,1182491,11,1182480
1677,14,0,853,654704,14,654690
1678,8,18,530,1198146,8,1198138
1679,5,-5,117,470652,5,470647
1680,15,9,693,934156,15,934141
1681,12,-14,169,210570,12,210558
1682,13,-6,36,459420,13,459407
1683,11,-18,398,88282,11,88271
1684,13,11,671,995606,13,995593
1685,11,19,137,1241848,11,1241837
1686,17,-11,502,307763,17,307746
1687,7,-12,89,251468,7,251461
1688,14,3,649,746745,14,746731
1689,15,-11,391,306865,15,306850
1690,7,-9,141,346591,7,346584
1691,8,-15,750,171495,8,171487
1692,14,15,953,1123779,14,1123765
1693,5,-12,229,254469,5,254464
1694,10,-4,315,506355,10,506345
1695,15,15,231,1118527,15,1118512
1696,18,-5,152,492130,18,492112
1697,12,-16,501,150677,12,150665
1698,13,-19,96,54671,13,54658
1699,20,-5,931,497883,20,497863
1700,13,17,609,1182386,13,1182373
1701,19,6,886,842844,19,842825
1702,8,-5,835,486035,8,486027
1703,7,4,766,767299,7,767292
1704,15,3,292,744099,15,744084
1705,5,-10,763,328957,5,328952
1706,20,-1,414,619844,20,619824
1707,9,-6,826,454530,9,454521
1708,14,5,558,807827,14,807813
1709,10,12,260,1004917,10,1004907
1710,19,2,391,713557,19,713538
1711,17,-15,117,178677,17,178660
1712,15,-5,968,498180,15,498165
1713,11,-2,519,589041,11,589030
1714,16,0,602,652809,16,652793
1715,16,-6,992,466694,16,466678
1716,11,-13,745,246533,11,246522
1717,13,8,409,901247,13,901234
1718,18,-14,998,217271,18,217253
1719,12,-16,735,152283,12,152271
1720,16,12,545,1026076,16,1026060
1721,8,-8,303,381789,8,381781
1722,18,-7,701,433406,18,433388
1723,9,-7,390,414336,9,414327
1724,10,-7,448,415446,10,415436
1725,10,19,812,1235497,10,1235487
1726,9,2,938,708160,9,708151
1727,16,-3,552,558141,16,558125
1728,15,-9,542,370988,15,370973
1729,14,10,12,959911,14,959897
1730,18,-5,964,498111,18,498093
1731,9,4,305,757118,9,757109
1732,13,-18,966,92227,13,92214
1733,10,8,544,887102,10,887092
1734,16,0,762,654136,16,654120
1735,13,-5,319,493469,13,493456
1736,16,-12,156,273669,16,273653
1737,19,-13,331,243491,19,243472
1738,11,15,254,1118669,11,1118658
1739,5,0,918,645284,5,645279
1740,9,5,470,791369,9,791360
1741,5,9,690,921250,5,921245
1742,7,18,401,1195278,7,1195271
1743,5,15,329,1101504,5,1101499
1744,11,10,877,966537,11,966526
1745,7,5,983,802439,7,802432
1746,11,-18,473,88810,11,88799
1747,13,-15,781,183593,13,183580
1748,5,-6,278,442865,5,442860
1749,18,2,935,717404,18,717386
1750,10,1,613,670626,10,670616
1751,9,-10,76,314365,9,314356
1752,12,16,690,1152013,12,1152001
1753,8,11,713,983699,8,983691
1754,15,0,229,649938,15,649923
1755,12,8,961,905418,12,905406
1756,11,4,825,779351,11,779340
1757,19,-15,317,180063,19,180044
1758,18,-13,863,247469,18,247451
1759,19,-7,351,431000,19,430981
1760,8,-19,653,45875,8,45867
1761,13,5,86,804427,13,804414
1762,16,6,51,836159,16,836143
1763,15,-19,839,60458,15,60443
1764,16,12,41,1022388,16,1022372
1765,19,-14,198,210827,19,210808
1766,5,-19,468,41569,5,41564
1767,5,17,666,1169611,5,1169606
1768,20,-15,522,181589,20,181569
1769,5,-2,291,569056,5,569051
1770,5,1,502,668245,5,668240
1771,11,18,356,1211654,11,1211643
1772,6,4,105,752906,6,752900
1773,5,-5,317,475098,5,475093
1774,11,1,329,682519,11,682508
1775,14,-17,230,117130,14,117116
1776,19,7,432,870257,19,870238
1777,16,0,600,652771,16,652755
1778,6,-13,967,239289,6,239283
1779,10,-11,664,295756,10,295746
1780,7,-1,232,598963,7,598956
1781,18,-4,41,522348,18,522330
1782,9,4,786,767756,9,767747
1783,17,-14,717,215112,17,215095
1784,17,-13,115,241883,17,241866
1785,14,7,541,871009,14,870995
1786,10,4,722,766238,10,766228
1787,8,14,62,1063203,8,1063195
1788,14,-19,374,56906,14,56892
1789,14,-11,271,305861,14,305847
1790,7,9,223,911525,7,911518
1791,12,3,51,742200,12,742188
1792,19,4,557,777288,19,777269
1793,7,10,903,956855,7,956848
1794,17,16,598,1151316,17,1151299
1795,19,13,945,1060238,19,1060219
1796,16,-9,687,371841,16,371825
1797,15,-6,774,465056,15,465041
1798,5,-1,730,609518,5,609513
1799,13,-4,726,527512,13,527499
1800,7,-1,192,597801,7,597794
1801,14,-5,623,495587,14,495573
1802,18,9,802,934979,18,934961
1803,14,-13,221,242670,14,242656
1804,12,19,672,1246213,12,1246201
1805,20,-3,435,557077,20,557057
1806,18,15,307,1119048,18,1119030
1807,5,16,277,1131015,5,1131010
1808,20,-18,256,87309,20,87289
1809,16,-7,626,432902,16,432886
1810,14,5,169,805009,14,804995
1811,20,-3,258,555592,20,555572
1812,11,8,312,900401,11,900390
1813,14,15,307,1119052,14,1119038
1814,19,8,144,899078,19,899059
1815,10,-16,653,138129,10,138119
1816,13,-6,191,460634,13,460621
1817,7,-4,343,507008,7,507001
1818,5,-13,200,222701,5,222696
1819,20,-7,773,433939,20,433919
1820,7,-5,260,473794,7,473787
1821,13,4,249,775055,13,775042
1822,7,14,15,1062090,7,1062083
1823,5,-17,650,107489,5,107484
1824,19,-15,332,180176,19,180157
1825,14,13,602,1057822,14,1057808
1826,8,-5,974,489224,8,489216
1827,11,-2,438,588426,11,588415
1828,9,-14,558,198588,9,198579
1829,5,-13,952,239021,5,239016
1830,5,-15,169,159014,5,159009
1831,5,15,898,1113559,5,1113554
1832,8,13,519,1041846,8,1041838
1833,5,-11,577,293924,5,293919
1834,6,11,890,987674,6,987668
1835,5,-18,321,69506,5,69501
1836,15,1,24,679972,15,679957
1837,9,9,385,914789,9,914780
1838,11,-14,601,214253,11,214242
1839,15,-2,933,592241,15,592226
1840,20,4,920,780047,20,780027
1841,7,-19,704,46940,7,46933
1842,7,5,939,801413,7,801406
1843,17,-9,810,372964,17,372947
1844,14,9,186,930429,14,930415
1845,8,12,184,1003178,8,1003170
1846,5,-8,803,392500,5,392495
1847,6,1,952,677715,6,677709
1848,7,-2,323,569670,7,569663
1849,7,-17,557,105455,7,105448
1850,5,11,546,980157,5,980152
1851,15,4,147,774313,15,774298
1852,11,-9,657,371684,11,371673
1853,8,9,832,924424,8,924416
1854,7,7,726,860096,7,860089
1855,6,13,698,1045730,6,1045724
1856,11,0,127,649217,11,649206
1857,14,-4,884,528701,14,528687
1858,15,-11,286,305960,15,305945
1859,12,9,311,931263,12,931251
1860,9,12,808,1016610,9,1016601
1861,10,9,422,915513,10,915503
1862,18,15,598,1121143,18,1121125
1863,8,-8,289,381500,8,381492
1864,11,7,331,869431,11,869420
1865,10,6,510,823917,10,823907
1866,13,-7,747,433698,13,433685
1867,20,3,924,748834,20,748814
1868,15,-16,869,153377,15,153362
1869,15,18,122,1209909,15,1209894
1870,18,-13,632,245716,18,245698
1871,18,6,750,841794,18,841776
1872,15,-19,341,56678,15,56663
1873,12,13,65,1053697,12,1053685
1874,13,7,133,867991,13,867978
1875,16,10,290,961997,16,961981
1876,9,-5,19,468170,9,468161
1877,7,14,21,1062240,7,1062233
1878,16,-12,948,279647,16,279631
1879,19,2,789,716404,19,716385
1880,11,15,3,1116739,11,1116728
1881,10,0,946,645880,10,645870
1882,8,-6,988,457891,8,457883
1883,10,9,25,907278,10,907268
1884,19,-7,407,431422,19,431403
1885,8,13,707,1045905,8,1045897
1886,16,9,784,934836,16,934820
1887,6,18,327,1193782,6,1193776
1888,16,3,21,741937,16,741921
1889,16,13,166,1054416,16,1054400
1890,15,-11,961,311242,15,311227
1891,11,10,184,961262,11,961251
1892,6,2,733,704100,6,704094
1893,12,15,423,1119765,12,1119753
1894,5,2,961,708754,5,708749
1895,18,18,248,1210964,18,1210946
1896,9,18,591,1199174,9,1199165
1897,6,-16,868,142700,6,142694
1898,20,-20,693,28161,20,28141
1899,19,-2,427,588339,19,588320
1900,20,-14,592,214190,20,214170
1901,20,-6,370,461984,20,461964
1902,12,-16,755,152476,12,152464
1903,18,3,449,745216,18,745198
1904,14,0,357,650725,14,650711
1905,18,-9,328,369015,18,368997
1906,18,18,951,1215968,18,1215950
1907,18,-19,495,57783,18,57765
1908,16,17,236,1179607,16,1179591
1909,7,-12,299,256089,7,256082
1910,14,-20,641,27655,14,27641
1911,15,3,26,741970,15,741955
1912,9,-15,163,158916,9,158907
1913,12,15,909,1123395,12,1123383
1914,15,-7,314,430691,15,430676
1915,15,4,35,773537,15,773522
1916,8,14,13,1062016,8,1062008
1917,13,16,386,1149895,13,1149882
1918,20,1,438,683258,20,683238
1919,14,19,474,1244694,14,1244680
1920,16,15,880,1123188,16,1123172
1921,7,2,153,691828,7,691821
1922,15,-5,415,494077,15,494062
1923,14,-20,895,29694,14,29680
1924,9,19,920,1237896,9,1237887
1925,10,17,277,1161267,10,1161257
1926,18,11,295,993071,18,993053
1927,13,4,324,775536,13,775523
1928,13,12,663,1027014,13,1027001
1929,12,-20,797,28985,12,28973
1930,20,-9,687,371851,20,371831
1931,20,12,786,1027909,20,1027889
1932,10,-13,544,229894,10,229884
1933,13,-10,967,342352,13,342339
1934,13,-2,721,590579,13,590566
1935,11,5,869,810092,11,810081
1936,6,2,10,688702,6,688696
1937,17,18,744,1214330,17,1214313
1938,19,-20,995,30408,19,30389
1939,16,-13,853,247384,16,247368
1940,7,-1,1000,615485,7,615478
1941,11,3,909,748673,11,748662
1942,13,5,635,808442,13,808429
1943,14,-8,231,399549,14,399535
1944,18,-11,860,310451,18,310433
1945,12,15,212,1118391,12,1118379
1946,8,-7,245,410999,8,410991
1947,10,-15,234,160320,10,160310
1948,14,-8,895,404241,14,404227
1949,15,13,828,1059434,15,1059419
1950,6,12,958,1020210,6,1020204
1951,14,17,186,1179293,14,1179279
1952,17,-14,771,215563,17,215546
1953,11,-1,961,623842,11,623831
1954,11,14,221,1087122,11,1087111
1955,13,-12,462,275861,13,275848
1956,18,-19,742,59864,18,59846
1957,6,-5,175,471929,6,471923
1958,15,-13,933,248088,15,248073
1959,10,-6,417,445674,10,445664
1960,16,-6,715,464585,16,464569
1961,19,-7,322,430796,19,430777
1962,7,-13,295,224745,7,224738
1963,19,-18,104,86023,19,86004
1964,15,-4,93,522747,15,522732
1965,16,17,654,1182716,16,1182700
1966,19,-4,558,526295,19,526276
1967,20,-6,639,464054,20,464034
1968,8,11,389,976848,8,976840
1969,7,-17,967,113821,7,113814
1970,9,5,64,783017,9,783008
1971,19,-6,565,463508,19,463489
1972,13,6,92,836436,13,836423
1973,13,-18,341,87849,13,87836
1974,16,-4,683,527262,16,527246
1975,6,14,239,1067104,6,1067098
1976,18,19,825,1247433,18,1247415
1977,6,2,555,700340,6,700334
1978,14,14,254,1087408,14,1087394
1979,10,8,779,892374,10,892364
1980,16,8,815,904354,16,904338
1981,15,-9,183,367857,15,367842
1982,20,6,420,839136,20,839116
1983,9,-5,800,485176,9,485167
1984,16,1,302,682237,16,682221
1985,12,-7,173,429602,12,429590
1986,13,13,784,1059097,13,1059084
1987,15,-13,321,243456,15,243441
1988,18,-17,730,121035,18,121017
1989,20,-7,316,430744,20,430724
1990,14,-6,557,463477,14,463463
1991,6,10,422,946545,6,946539
1992,8,-3,943,551592,8,551584
1993,11,-8,895,404242,11,404231
1994,8,12,648,1013281,8,1013273
1995,8,-19,972,52347,8,52339
1996,7,11,609,981510,7,981503
1997,5,13,533,1042100,5,1042095
1998,13,-4,161,523281,13,523268
1999,7,12,249,1004578,7,1004571
2000,14,-20,285,25006,14,24992
2001,16,19,429,1244395,16,1244379
2002,11,-17,318,117845,11,117834
2003,20,-5,868,497350,20,497330
2004,5,5,96,783599,5,783594
2005,16,14,923,1092633,16,1092617
2006,18,-20,603,27382,18,27364
2007,7,-12,69,251082,7,251075
2008,6,-13,855,236875,6,236869
2009,20,11,473,994311,20,994291
2010,17,-20,887,29614,17,29597
2011,5,5,439,790620,5,790615
2012,18,4,556,777273,18,777255
2013,12,-4,733,527558,12,527546
2014,11,-3,43,554100,11,554089
2015,8,-3,708,546393,8,546385
2016,17,-8,754,403234,17,403217
2017,12,9,101,929820,12,929808
2018,6,9,691,921292,6,921286
2019,9,11,90,970341,9,970332
2020,10,-9,347,351267,10,351257
2021,20,-12,976,279917,20,279897
2022,11,15,913,1123451,11,1123440
2023,16,-19,979,61325,16,61309
2024,12,0,81,648813,12,648801
2025,8,-15,434,164833,8,164825
2026,16,14,333,1088052,16,1088036
2027,19,18,506,1212646,19,1212627
2028,14,18,82,1209578,14,1209564
2029,16,-11,819,310085,16,310069
2030,6,3,76,720436,6,720430
2031,5,-4,205,503971,5,503966
2032,6,-16,529,135547,6,135541
2033,8,10,941,957766,8,957758
2034,18,-6,853,465576,18,465558
2035,5,-14,207,191060,5,191055
2036,20,-5,628,495640,20,495620
2037,12,-6,684,464350,12,464338
2038,10,4,774,767493,10,767483
2039,9,3,729,734679,9,734670
2040,19,-18,406,88323,19,88304
2041,18,14,975,1093075,18,1093057
2042,20,-8,526,401544,20,401524
2043,19,-1,182,617905,19,617886
2044,11,-19,382,56973,11,56962
2045,14,-1,316,619095,14,619081
2046,18,-19,517,57972,18,57954
2047,6,-4,737,515230,6,515224
2048,19,2,148,711725,19,711706
2049,7,-16,708,139208,7,139201
2050,6,6,615,826192,6,826186
2051,19,13,468,1056688,19,1056669
2052,9,-17,125,96042,9,96033
2053,8,-8,153,378748,8,378740
2054,10,6,421,821864,10,821854
2055,7,-1,214,598383,7,598376
2056,11,15,843,1122937,11,1122926
2057,16,19,370,1243776,16,1243760
2058,18,5,178,805108,18,805090
2059,7,-15,939,175416,7,175409
2060,5,1,476,667586,5,667581
2061,5,-1,481,604592,5,604587
2062,5,-17,699,108431,5,108426
2063,14,3,814,747978,14,747964
2064,9,-2,35,563559,9,563550
2065,6,3,928,738962,6,738956
2066,7,-14,368,194751,7,194744
2067,19,-10,749,340732,19,340713
2068,14,-17,812,121599,14,121585
2069,11,19,760,1246926,11,1246915
2070,9,-3,961,552032,9,552023
2071,6,7,290,851030,6,851024
2072,20,13,366,1055918,20,1055898
2073,18,11,899,997413,18,997395
2074,15,14,326,1087993,15,1087978
2075,17,-5,85,491540,17,491523
2076,10,10,69,938961,10,938951
2077,8,19,510,1229126,8,1229118
2078,18,-4,778,527854,18,527836
2079,7,7,732,860274,7,860267
2080,10,6,534,824428,10,824418
2081,11,-16,474,150526,11,150515
2082,17,10,614,964646,17,964629
2083,10,17,727,1170811,10,1170801
2084,7,15,112,1096883,7,1096876
2085,5,-1,307,600676,5,600671
2086,19,6,352,838509,19,838490
2087,20,4,971,780373,20,780353
2088,19,3,886,748473,19,748454
2089,7,-7,966,426462,7,426455
2090,12,-11,984,311408,12,311396
2091,11,5,758,809280,11,809269
2092,7,0,765,642176,7,642169
2093,17,-19,378,56956,17,56939
2094,13,15,410,1119681,13,1119668
2095,8,17,944,1175502,8,1175494
2096,11,-12,924,279481,11,279470
2097,18,-11,738,309439,18,309421
2098,20,17,431,1181144,20,1181124
2099,6,1,330,664458,6,664452
2100,15,-2,839,591524,15,591509
2101,7,7,911,864081,7,864074
2102,8,10,889,956571,8,956563
2103,5,15,742,1110266,5,1110261
2104,19,1,278,682085,19,682066
2105,16,11,146,991888,16,991872
2106,13,-8,428,400862,13,400849
2107,16,13,800,1059259,16,1059243
2108,19,-1,314,619092,19,619073
2109,20,2,645,715382,20,715362
2110,13,6,867,842673,13,842660
2111,13,-1,919,623582,13,623569
2112,6,-13,756,234551,6,234545
2113,19,-3,366,556486,19,556467
2114,6,-18,257,68044,6,68038
2115,8,8,260,880793,8,880785
2116,16,16,503,1150671,16,1150655
2117,12,9,895,935687,12,935675
2118,18,6,82,836324,18,836306
2119,10,6,849,831444,10,831434
2120,6,-9,606,357132,6,357126
2121,8,18,595,1199229,8,1199221
2122,5,-6,292,443171,5,443166
2123,20,16,868,1153263,20,1153243
2124,17,10,785,965910,17,965893
2125,9,10,227,942325,9,942316
2126,6,8,110,877396,6,877390
2127,15,-3,809,560289,15,560274
2128,11,-19,974,61282,11,61271
2129,19,13,223,1054878,19,1054859
2130,12,-8,686,402766,12,402754
2131,11,4,209,774730,11,774719
2132,19,-15,348,180332,19,180313
2133,11,11,107,991626,11,991615
2134,8,-18,730,78133,8,78125
2135,10,19,385,1226231,10,1226221
2136,16,7,299,869162,16,869146
2137,20,10,931,967022,20,967002
2138,5,-9,625,357446,5,357441
2139,20,-2,631,589856,20,589836
2140,15,8,846,904532,15,904517
2141,17,11,63,991348,17,991331
2142,13,5,945,810730,13,810717
2143,6,-4,888,518489,6,518483
2144,15,-5,789,496720,15,496705
2145,6,18,981,1207586,6,1207580
2146,14,-14,24,209505,14,209491
2147,18,-5,676,495926,18,495908
2148,5,17,692,1170086,5,1170081
2149,20,19,553,1245306,20,1245286
2150,13,-18,511,89016,13,89003
2151,18,18,2,1208923,18,1208905
2152,10,-4,28,499912,10,499902
2153,16,8,460,901596,16,901580
2154,16,-4,415,525335,16,525319
2155,16,-8,521,401486,16,401470
2156,12,-3,674,559159,12,559147
2157,10,17,706,1170337,10,1170327
2158,10,-5,228,473008,10,472998
2159,6,-17,313,100253,6,100247
2160,7,-8,614,388427,7,388420
2161,14,11,313,993157,14,993143
2162,16,-17,149,116579,16,116563
2163,6,4,118,753101,6,753095
2164,10,7,645,858422,10,858412
2165,9,-7,640,419393,9,419384
2166,6,-15,448,165076,6,165070
2167,10,0,935,645657,10,645647
2168,14,18,784,1214657,14,1214643
2169,13,3,644,746686,13,746673
2170,5,-1,257,599451,5,599446
2171,19,-8,209,399370,19,399351
2172,9,-8,686,390128,9,390119
2173,10,-4,660,513641,10,513631
2174,18,12,751,1027646,18,1027628
2175,17,8,367,900828,17,900811
2176,20,17,832,1184201,20,1184181
2177,17,-9,427,369940,17,369923
2178,6,16,738,1140404,6,1140398
2179,5,-20,394,8524,5,8519
2180,17,-14,598,214230,17,214213
2181,8,-9,312,350433,8,350425
2182,10,-5,509,479011,10,479001
2183,20,-6,88,459726,20,459706
2184,18,5,800,809594,18,809576
2185,6,-20,103,2268,6,2262
2186,13,16,147,1148133,13,1148120
2187,6,-15,998,176782,6,176776
2188,9,1,734,672988,9,672979
2189,11,-14,310,211783,11,211772
2190,5,17,161,1158638,5,1158633
2191,6,11,563,980514,6,980508
2192,15,-7,457,431777,15,431762
2193,20,6,106,836552,20,836532
2194,11,-7,544,432446,11,432435
2195,5,-5,14,468030,5,468025
2196,15,15,807,1122667,15,1122652
2197,17,1,298,682208,17,682191
2198,15,-4,814,528078,15,528063
2199,9,-8,179,379342,9,379333
2200,15,4,90,773915,15,773900
2201,11,-2,20,585293,11,585282
2202,13,-17,107,116360,13,116347
2203,7,7,992,865785,7,865778
2204,5,-3,119,532991,5,532986
2205,10,4,149,753801,10,753791
2206,10,17,330,1162471,10,1162461
2207,16,8,379,900921,16,900905
2208,5,5,672,795482,5,795477
2209,14,3,636,746635,14,746621
2210,19,-19,529,58107,19,58088
2211,14,6,418,839125,14,839111
2212,18,-1,599,621242,18,621224
2213,14,11,916,997540,14,997526
2214,12,5,892,810238,12,810226
2215,9,-14,704,202092,9,202083
2216,13,-19,782,60074,13,60061
2217,5,9,789,923431,5,923426
2218,18,8,263,900019,18,900001
2219,19,-9,152,367677,19,367658
2220,12,-10,111,335918,12,335906
2221,16,-9,43,366929,16,366913
2222,12,-20,339,25448,12,25436
2223,17,-14,229,211185,17,211168
2224,17,12,154,1023160,17,1023143
2225,15,19,437,1244443,15,1244428
2226,19,-20,736,28436,19,28417
2227,14,16,82,1147658,14,1147644
2228,9,-20,973,21427,9,21418
2229,18,15,809,1122689,18,1122671
2230,18,16,98,1147759,18,1147741
2231,7,17,691,1170072,7,1170065
2232,17,-19,412,57180,17,57163
2233,11,-5,829,497005,11,496994
2234,16,17,859,1184456,16,1184440
2235,8,-9,418,352764,8,352756
2236,14,0,87,648866,14,648852
2237,17,5,258,805725,17,805708
2238,8,-6,410,445533,8,445525
2239,16,-19,562,58408,16,58392
2240,6,-10,249,317959,6,317953
2241,14,19,574,1245480,14,1245466
2242,11,-6,397,462143,11,462132
2243,9,-13,413,226920,9,226911
2244,15,1,535,684135,15,684120
2245,19,2,225,712276,19,712257
2246,11,17,992,1185422,11,1185411
2247,6,0,218,630213,6,630207
2248,5,-2,103,565027,5,565022
2249,12,-4,286,524291,12,524279
2250,7,1,7,657157,7,657150
2251,13,8,58,898319,13,898306
2252,12,0,336,650553,12,650541
2253,12,10,267,961852,12,961840
2254,15,8,506,901989,15,901974
2255,16,6,713,841553,16,841537
2256,19,-18,924,91911,19,91892
2257,6,-13,591,230998,6,230992
2258,18,-13,338,243535,18,243517
2259,11,7,660,871855,11,871844
2260,7,17,739,1171046,7,1171039
2261,15,9,114,929884,15,929869
2262,17,7,641,871707,17,871690
2263,14,-12,494,276168,14,276154
2264,7,-10,984,333668,7,333661
2265,8,6,926,833024,8,833016
2266,9,-13,858,236964,9,236955
2267,15,-4,848,528300,15,528285
2268,11,19,477,1244706,11,1244695
2269,6,15,556,1106287,6,1106281
2270,16,10,333,962350,16,962334
2271,7,11,699,983283,7,983276
2272,10,-3,405,539333,10,539323
2273,5,8,789,892531,5,892526
2274,14,3,974,749322,14,749308
2275,7,9,424,915566,7,915559
2276,12,12,924,1029161,12,1029149
2277,17,9,432,932166,17,932149
2278,5,-13,950,238991,5,238986
2279,11,-12,695,277603,11,277592
2280,11,15,286,1118912,11,1118901
2281,16,0,350,650687,16,650671
2282,17,1,600,684546,17,684529
2283,13,-2,294,587373,13,587360
2284,7,1,0,656958,7,656951
2285,6,0,357,632901,6,632895
2286,6,-13,381,226341,6,226335
2287,9,-4,107,501698,9,501689
2288,7,19,146,1220691,7,1220684
2289,16,-10,38,335441,16,335425
2290,11,19,481,1244728,11,1244717
2291,7,16,447,1134834,7,1134827
2292,6,-11,773,297779,6,297773
2293,11,14,570,1089858,11,1089847
2294,9,-12,436,259007,9,258998
2295,16,-8,669,402635,16,402619
2296,5,-11,508,292508,5,292503
2297,14,8,137,899011,14,898997
2298,15,11,328,993238,15,993223
2299,20,5,558,807837,20,807817
2300,8,3,453,728540,8,728532
2301,9,-16,954,144465,9,144456
2302,13,7,788,872723,13,872710
2303,11,-9,575,371249,11,371238
2304,6,-20,0,6,6,0
2305,9,5,893,800360,9,800351
2306,17,1,853,686440,17,686423
2307,15,9,291,931052,15,931037
2308,17,-3,647,558936,17,558919
2309,14,-11,62,304155,14,304141
2310,19,-14,770,215549,19,215530
2311,11,-16,490,150613,11,150602
2312,14,2,763,716275,14,716261
2313,11,-7,606,432782,11,432771
2314,14,16,210,1148631,14,1148617
2315,15,6,972,843526,15,843511
2316,7,5,763,797508,7,797501
2317,10,0,841,643631,10,643621
2318,17,11,396,993776,17,993759
2319,5,1,484,667814,5,667809
2320,16,2,456,714082,16,714066
2321,5,4,903,770447,5,770442
2322,16,8,929,905177,16,905161
2323,6,14,251,1067397,6,1067391
2324,19,-18,988,92393,19,92374
2325,5,16,756,1140779,5,1140774
2326,7,3,292,725238,7,725231
2327,20,-3,716,559470,20,559450
2328,7,14,618,1075637,7,1075630
2329,18,-5,632,495673,18,495655
2330,11,16,964,1154011,11,1154000
2331,12,5,842,809907,12,809895
2332,14,-11,214,305399,14,305385
2333,8,14,459,1072025,8,1072017
2334,14,-5,267,493005,14,492991
2335,15,9,141,930101,15,930086
2336,6,-13,700,233143,6,233137
2337,18,-7,983,435593,18,435575
2338,10,7,946,864734,10,864724
2339,17,-15,198,179171,17,179154
2340,17,-4,610,526677,17,526660
2341,11,-2,308,587443,11,587432
2342,6,0,609,638526,6,638520
2343,10,1,987,678421,10,678411
2344,14,-1,276,618697,14,618683
2345,15,15,421,1119746,15,1119731
2346,5,-5,571,480385,5,480380
2347,20,19,136,1241843,20,1241823
2348,12,14,997,1093317,12,1093305
2349,18,16,982,1154144,18,1154126
2350,6,-13,741,234164,6,234158
2351,16,-10,810,341206,16,341190
2352,17,15,832,1122879,17,1122862
2353,17,-12,820,278537,17,278520
2354,6,13,483,1041079,6,1041073
2355,15,-11,351,306551,15,306536
2356,5,2,178,692540,5,692535
2357,5,4,959,771519,5,771514
2358,10,-4,349,507210,10,507200
2359,7,-16,743,139946,7,139939
2360,5,19,197,1221841,5,1221836
2361,7,-16,964,144762,7,144755
2362,16,4,854,779664,16,779648
2363,17,-6,978,466558,17,466541
2364,11,-15,972,185153,11,185142
2365,13,7,505,870750,13,870737
2366,13,-14,961,216926,13,216913
2367,12,-14,709,215052,12,215040
2368,11,-15,47,178125,11,178114
2369,10,7,547,856440,10,856430
2370,20,-12,357,275213,20,275193
2371,11,-19,592,58672,11,58661
2372,19,3,53,742233,19,742214
2373,18,1,322,682449,18,682431
2374,6,16,867,1143064,6,1143058
2375,5,-16,392,132389,5,132384
2376,17,-6,177,460514,17,460497
2377,11,-4,183,523494,11,523483
2378,15,10,10,959899,15,959884
2379,15,9,852,935384,15,935369
2380,16,-12,24,272672,16,272656
2381,7,-7,235,410776,7,410769
2382,9,16,243,1130369,9,1130360
2383,13,10,801,966124,13,966111
2384,13,7,664,871879,13,871866
2385,20,10,34,960108,20,960088
2386,6,-8,522,386319,6,386313
2387,20,6,429,839198,20,839178
2388,11,-18,884,91598,11,91587
2389,9,-12,278,255552,9,255543
2390,17,-15,341,180276,17,180259
2391,15,-10,556,339217,15,339202
2392,18,17,163,1179073,18,1179055
2393,5,10,64,938847,5,938842
2394,20,-14,768,215536,20,215516
2395,9,15,783,1111067,9,1111058
2396,13,-15,57,178192,13,178179
2397,17,5,114,804626,17,804609
2398,7,4,162,754071,7,754064
2399,11,-12,867,279000,11,278989
2400,15,-5,88,491582,15,491567
2401,10,-9,737,359920,10,359910
2402,13,8,628,902940,13,902927
2403,8,-7,324,412937,8,412929
2404,12,-16,932,153788,12,153776
2405,19,13,162,1054393,19,1054374
2406,14,-8,125,398752,14,398738
2407,16,-17,12,115645,16,115629
2408,6,-14,256,192391,6,192385
2409,11,-10,935,342091,11,342080
2410,14,8,2,897932,14,897918
2411,19,9,733,934426,19,934407
2412,19,15,610,1121240,19,1121221
2413,12,14,440,1088901,12,1088889
2414,17,6,746,841765,17,841748
2415,5,-7,245,411004,5,410999
2416,16,13,776,1059041,16,1059025
2417,10,15,278,1100473,10,1100463
2418,20,2,389,713544,20,713524
2419,5,-11,849,299302,5,299297
2420,18,-9,126,367524,18,367506
2421,15,11,191,992174,15,992159
2422,8,-14,261,192497,8,192489
2423,15,4,575,777431,15,777416
2424,14,-14,246,211341,14,211327
2425,19,7,624,871595,19,871576
2426,7,-13,231,223275,7,223268
2427,16,5,681,808754,16,808738
2428,19,-6,661,464184,19,464165
2429,8,6,533,824409,8,824401
2430,8,-4,302,506053,8,506045
2431,10,8,136,877986,10,877976
2432,20,-2,604,589673,20,589653
2433,20,-19,865,60652,20,60632
2434,15,-3,850,560575,15,560560
2435,13,-1,835,622959,13,622946
2436,11,-19,369,56853,11,56842
2437,10,-9,91,345542,10,345532
2438,14,-1,397,619723,14,619709
2439,5,-2,698,577774,5,577769
2440,7,16,119,1127502,7,1127495
2441,7,18,972,1207332,7,1207325
2442,14,17,115,1178667,14,1178653
2443,17,17,817,1184072,17,1184055
2444,15,19,355,1243634,15,1243619
2445,19,2,827,716653,19,716634
2446,10,16,874,1143240,10,1143230
2447,9,6,127,814901,9,814892
2448,5,-2,492,573277,5,573272
2449,20,-12,118,273405,20,273385
2450,14,-2,565,589372,14,589358
2451,16,10,304,962079,16,962063
2452,10,-12,765,266070,10,266060
2453,11,14,488,1089236,11,1089225
2454,16,16,744,1152393,16,1152377
2455,11,-19,904,60843,11,60832
2456,12,5,633,808421,12,808409
2457,18,-11,574,308273,18,308255
2458,5,-1,49,594842,5,594837
2459,19,-15,633,182455,19,182436
2460,6,-12,134,252485,6,252479
2461,9,10,333,944573,9,944564
2462,12,0,938,655375,12,655363
2463,5,-9,239,348742,5,348737
2464,18,-7,741,433668,18,433650
2465,15,19,523,1245130,15,1245115
2466,6,5,912,800760,6,800754
2467,20,-17,511,119330,20,119310
2468,6,-14,532,198028,6,198022
2469,14,8,970,905489,14,905475
2470,6,-3,235,535503,6,535497
2471,9,4,86,752463,9,752454
2472,13,-2,544,589192,13,589179
2473,9,1,400,665905,9,665896
2474,7,10,386,945717,7,945710
2475,10,10,638,951318,10,951308
2476,7,8,493,885978,7,885971
2477,14,9,789,934885,14,934871
2478,20,3,325,744359,20,744339
2479,14,-13,873,247566,14,247552
2480,8,4,334,757726,8,757718
2481,19,13,757,1058885,19,1058866
2482,14,-18,851,91372,14,91358
2483,18,17,632,1182558,18,1182540
2484,5,0,425,634551,5,634546
2485,14,3,358,744566,14,744552
2486,6,19,55,1218591,6,1218585
2487,13,15,386,1119594,13,1119581
2488,5,6,342,820050,5,820045
2489,14,1,679,685156,14,685142
2490,18,-11,164,305052,18,305034
2491,16,-14,948,216850,16,216834
2492,6,1,146,660358,6,660352
2493,7,-18,166,66093,7,66086
2494,20,-10,595,339498,20,339478
2495,5,19,211,1222156,5,1222151
2496,10,16,968,1145431,10,1145421
2497,20,0,542,652313,20,652293
2498,7,11,638,982050,7,982043
2499,18,10,425,963081,18,963063
2500,19,10,397,962808,19,962789
2501,9,-3,289,536682,9,536673
2502,6,4,381,758870,6,758864
2503,19,17,318,1180355,19,1180336
2504,7,-18,571,74686,7,74679
2505,17,-5,818,496924,17,496907
2506,13,1,545,684213,13,684200
2507,17,-5,827,496996,17,496979
2508,8,13,656,1044893,8,1044885
2509,11,1,748,685686,11,685675
2510,8,-2,382,570802,8,570794
2511,9,-13,841,236602,9,236593
2512,7,3,856,737301,7,737294
2513,19,19,52,1241137,19,1241118
2514,7,8,456,885146,7,885139
2515,16,-13,22,241221,16,241205
2516,9,10,654,951668,9,951659
2517,6,-1,331,601220,6,601214
2518,14,17,713,1183210,14,1183196
2519,18,-14,409,212739,18,212721
2520,5,-8,188,379529,5,379524
2521,13,7,194,868386,13,868373
2522,8,-13,875,237302,8,237294
2523,5,0,82,627016,5,627011
2524,7,-5,856,486548,7,486541
2525,6,-3,104,532628,6,532622
2526,19,-12,133,273521,19,273502
2527,18,-2,441,588445,18,588427
2528,17,-5,58,491258,17,491241
2529,6,12,9,999202,6,999196
2530,6,7,962,865072,6,865066
2531,19,-14,307,211784,19,211765
2532,16,-16,57,147210,16,147194
2533,10,-5,295,474565,10,474555
2534,6,-13,859,236969,6,236963
2535,12,-1,893,623396,12,623384
2536,5,-5,392,476578,5,476573
2537,14,-7,38,428609,14,428595
2538,10,1,412,666175,10,666165
2539,6,-18,465,72446,6,72440
2540,14,-11,488,307612,14,307598
2541,9,-12,978,270929,9,270920
2542,20,0,695,653608,20,653588
2543,18,-19,879,60749,18,60731
2544,5,19,295,1224033,5,1224028
2545,6,-9,624,357423,6,357417
2546,12,17,87,1178478,12,1178466
2547,18,-19,96,54679,18,54661
2548,15,-8,467,401084,15,401069
2549,8,1,396,665801,8,665793
2550,15,-19,594,58686,15,58671
2551,13,-16,730,152258,13,152245
2552,19,-17,147,116551,19,116532
2553,14,10,168,961165,14,961151
2554,9,-19,320,38450,9,38441
2555,20,-18,593,89533,20,89513
2556,8,-14,83,188387,8,188379
2557,12,5,558,807839,12,807827
2558,16,-9,247,368390,16,368374
2559,15,0,437,651393,15,651378
2560,18,1,93,680516,18,680498
2561,6,-9,708,359165,6,359159
2562,5,-18,136,65441,5,65436
2563,6,13,83,1032509,6,1032503
2564,19,-20,878,29564,19,29545
2565,19,15,570,1120915,19,1120896
2566,10,-16,373,131996,10,131986
2567,19,2,328,713067,19,713048
2568,17,-7,120,429166,17,429149
2569,20,-15,736,183286,20,183266
2570,20,5,466,807219,20,807199
2571,6,-4,987,520709,6,520703
2572,6,12,935,1019663,6,1019657
2573,11,1,281,682098,11,682087
2574,15,16,254,1148930,15,1148915
2575,11,0,635,653044,11,653033
2576,7,7,417,853771,7,853764
2577,20,-15,363,180425,20,180405
2578,16,5,217,805434,16,805418
2579,14,9,51,929468,14,929454
2580,15,9,950,936171,15,936156
2581,18,-16,684,151917,18,151899
2582,16,-17,77,116069,16,116053
2583,13,17,138,1178880,13,1178867
2584,13,11,856,997062,13,997049
2585,16,-10,544,339132,16,339116
2586,15,-13,459,244329,15,244314
2587,20,9,68,929541,20,929521
2588,6,1,779,673933,6,673927
2589,18,-12,873,279027,18,279009
2590,5,15,703,1109360,5,1109355
2591,12,17,188,1179315,12,1179303
2592,11,14,973,1093056,11,1093045
2593,5,10,149,940777,5,940772
2594,15,-6,138,460145,15,460130
2595,15,-3,735,559612,15,559597
2596,11,5,976,810962,11,810951
2597,5,8,359,882999,5,882994
2598,20,12,427,1025178,20,1025158
2599,10,3,915,738660,10,738650
2600,16,7,134,867996,16,867980
2601,5,-1,271,599794,5,599789
2602,15,-15,255,179616,15,179601
2603,15,1,13,679819,15,679804
2604,8,0,618,638779,8,638771
2605,15,-4,701,527349,15,527334
2606,6,16,127,1127693,6,1127687
2607,19,-1,285,618818,19,618799
2608,20,18,884,1215397,20,1215377
2609,12,-15,782,183594,12,183582
2610,14,-16,209,148470,14,148456
2611,19,-12,626,277058,19,277039
2612,12,7,25,867172,12,867160
2613,12,-4,909,528910,12,528898
2614,17,19,264,1242840,17,1242823
2615,7,-17,115,95884,7,95877
2616,14,-6,460,462667,14,462653
2617,12,14,263,1087467,12,1087455
2618,10,3,709,734256,10,734246
2619,7,-18,684,77030,7,77023
2620,7,-10,557,324681,7,324674
2621,19,-15,815,183877,19,183858
2622,18,5,111,804604,18,804586
2623,18,0,663,653316,18,653298
2624,6,0,267,631143,6,631137
2625,5,7,818,862121,5,862116
2626,10,5,715,796510,10,796500
2627,18,-4,967,529368,18,529350
2628,11,-11,956,311185,11,311174
2629,11,2,601,715078,11,715067
2630,8,12,420,1008056,8,1008048
2631,12,-18,45,85525,12,85513
2632,20,-13,803,247022,20,247002
2633,19,19,359,1243676,19,1243657
2634,13,-16,533,150909,13,150896
2635,17,-6,836,465461,17,465444
2636,14,17,437,1181165,14,1181151
2637,18,-2,385,587949,18,587931
2638,12,-16,842,153055,12,153043
2639,13,-14,329,211982,13,211969
2640,13,-6,259,461185,13,461172
2641,9,-7,577,418279,9,418270
2642,10,3,305,725557,10,725547
2643,6,-18,719,77877,6,77871
2644,12,2,163,711828,12,711816
2645,20,-14,227,211160,20,211140
2646,20,-20,197,24379,20,24359
2647,5,-15,977,176252,5,176247
2648,8,-17,181,97218,8,97210
2649,14,-11,261,305757,14,305743
2650,17,19,746,1246844,17,1246827
2651,20,1,644,684923,20,684903
2652,10,-2,976,583698,10,583688
2653,10,-17,116,95920,10,95910
2654,7,-7,924,425606,7,425599
2655,14,19,312,1243292,14,1243278
2656,13,6,385,838790,13,838777
2657,9,-5,14,468039,9,468030
2658,14,10,552,964078,14,964064
2659,9,-7,922,425555,9,425546
2660,16,-5,226,492639,16,492623
2661,12,5,161,804959,12,804947
2662,17,-15,464,181216,17,181199
2663,8,-6,167,440408,8,440400
2664,9,-8,251,380808,9,380799
2665,14,-10,980,342483,14,342469
2666,6,9,644,920381,6,920375
2667,9,2,607,701415,9,701406
2668,6,19,795,1235086,6,1235080
2669,9,18,770,1203005,9,1202996
2670,12,-12,241,274288,12,274276
2671,15,-20,175,24105,15,24090
2672,7,-3,440,540194,7,540187
2673,12,-1,731,622206,12,622194
2674,5,-8,152,378717,5,378712
2675,11,11,343,993352,11,993341
2676,19,5,78,804355,19,804336
2677,18,5,223,805519,18,805501
2678,16,-17,511,119336,16,119320
2679,19,7,130,867963,19,867944
2680,16,-19,228,55841,16,55825
2681,12,-1,527,620757,12,620745
2682,17,1,92,680488,17,680471
2683,18,15,710,1122031,18,1122013
2684,13,-2,68,585658,13,585645
2685,13,-4,965,529341,13,529328
2686,16,6,387,838814,16,838798
2687,17,-9,48,367012,17,366995
2688,11,-7,867,434651,11,434640
2689,17,3,105,742636,17,742619
2690,6,-16,993,145478,6,145472
2691,16,-1,458,620200,16,620184
2692,13,13,268,1055155,13,1055142
2693,12,12,959,1029484,12,1029472
2694,16,-2,851,591621,16,591605
2695,13,3,286,744074,13,744061
2696,9,-4,182,503384,9,503375
2697,18,9,897,935698,18,935680
2698,11,-17,436,118687,11,118676
2699,19,2,26,710657,19,710638
2700,15,-19,500,57830,15,57815
2701,20,13,127,1054147,20,1054127
2702,8,3,893,738060,8,738052
2703,8,-1,86,595638,8,595630
2704,16,-15,81,178364,16,178348
2705,14,12,540,1026024,14,1026010
2706,20,4,377,775942,20,775922
2707,16,5,51,804176,16,804160
2708,7,-8,475,385089,7,385082
2709,17,0,84,648842,17,648825
2710,10,-4,231,504635,10,504625
2711,19,-1,351,619389,19,619370
2712,11,5,906,810395,11,810384
2713,15,7,528,870935,15,870920
2714,19,4,461,776564,19,776545
2715,15,-11,229,305496,15,305481
2716,9,-2,310,569439,9,569430
2717,16,2,410,713771,16,713755
2718,16,15,921,1123511,16,1123495
2719,19,-3,236,555439,19,555420
2720,9,17,618,1168449,9,1168440
2721,18,19,140,1241905,18,1241887
2722,11,12,880,1028671,11,1028660
2723,19,-7,787,433999,19,433980
2724,16,3,843,748179,16,748163
2725,16,12,973,1029593,16,1029577
2726,5,10,613,950712,5,950707
2727,11,1,991,687486,11,687475
2728,9,-6,968,457381,9,457372
2729,12,11,545,994770,12,994758
2730,5,3,720,734469,5,734464
2731,17,3,981,749383,17,749366
2732,14,2,846,716811,14,716797
2733,13,10,770,965779,13,965766
2734,7,-11,248,286451,7,286444
2735,17,-15,652,182661,17,182644
2736,15,9,777,934789,15,934774
2737,9,17,984,1176493,9,1176484
2738,11,-13,509,244789,11,244778
2739,16,7,591,871363,16,871347
2740,8,-5,257,473696,8,473688
2741,15,14,608,1090144,15,1090129
2742,11,4,271,775142,11,775131
2743,9,15,706,1109425,9,1109416
2744,13,5,131,804706,13,804693
2745,12,-12,78,273100,12,273088
2746,11,-18,291,87486,11,87475
2747,10,-11,774,297818,10,297808
2748,18,-12,385,275334,18,275316
2749,15,-12,391,275369,15,275354
2750,9,-15,315,162192,9,162183
2751,13,19,732,1246717,13,1246704
2752,11,13,160,1054380,11,1054369
2753,13,-2,855,591636,13,591623
2754,9,14,65,1063310,9,1063301
2755,14,8,272,900069,14,900055
2756,8,14,463,1072124,8,1072116
2757,14,13,87,1053876,14,1053862
2758,14,3,919,748763,14,748749
2759,7,12,224,1004030,7,1004023
2760,6,-12,492,260191,6,260185
2761,20,9,434,932185,20,932165
2762,6,3,331,726121,6,726115
2763,13,13,541,1057260,13,1057247
2764,19,19,277,1242985,19,1242966
2765,9,11,758,984648,9,984639
2766,6,-11,53,282219,6,282213
2767,7,-18,178,66379,7,66372
2768,11,-9,49,367012,11,367001
2769,19,-8,369,400473,19,400454
2770,7,11,432,977683,7,977676
2771,16,-14,991,217208,16,217192
2772,13,-7,647,433015,13,433002
2773,8,-15,354,163060,8,163052
2774,9,5,169,785036,9,785027
2775,19,-5,127,491913,19,491894
2776,20,12,413,1025061,20,1025041
2777,19,17,649,1182684,19,1182665
2778,20,4,663,778080,20,778060
2779,16,9,790,934890,16,934874
2780,8,-8,384,383368,8,383360
2781,6,-4,206,504015,6,504009
2782,17,15,291,1118954,17,1118937
2783,11,-7,242,430070,11,430059
2784,13,13,260,1055109,13,1055096
2785,5,-7,278,411740,5,411735
2786,20,-7,419,431489,20,431469
2787,17,12,576,1026263,17,1026246
2788,8,8,855,893738,8,893730
2789,17,-9,782,372736,17,372719
2790,6,-13,486,228560,6,228554
2791,14,3,103,742616,14,742602
2792,12,-19,323,56503,12,56491
2793,6,17,170,1158853,6,1158847
2794,9,5,878,800089,9,800080
2795,13,-12,953,279715,13,279702
2796,12,-20,662,27887,12,27875
2797,20,10,581,964368,20,964348
2798,10,-19,188,35736,10,35726
2799,20,3,253,743799,20,743779
2800,9,11,231,973067,9,973058
2801,11,16,82,1147659,11,1147648
2802,20,15,196,1118274,20,1118254
2803,15,-5,994,498296,15,498281
2804,8,-7,477,416026,8,416018
2805,7,-19,967,52254,7,52247
2806,12,4,516,776987,12,776975
2807,19,-18,908,91802,19,91783
2808,16,11,457,994169,16,994153
2809,15,-18,308,87622,15,87607
2810,17,-13,70,241550,17,241533
2811,9,-2,628,576108,9,576099
2812,11,0,713,653738,11,653727
2813,15,-11,676,309096,15,309081
2814,10,12,544,1010844,10,1010834
2815,19,5,442,806985,19,806966
2816,7,-15,460,165332,7,165325
2817,13,-10,928,342047,13,342034
2818,10,-4,65,500757,10,500747
2819,7,5,816,798643,7,798636
2820,15,-15,207,179220,15,179205
2821,9,2,305,695166,9,695157
2822,10,-8,520,386265,10,386255
2823,8,-6,206,441351,8,441343
2824,9,-1,567,606263,9,606254
2825,5,9,654,920529,5,920524
2826,6,18,8,1186713,6,1186707
2827,13,12,248,1023875,13,1023862
2828,13,-18,73,85762,13,85749
2829,17,18,453,1212343,17,1212326
2830,6,6,300,818991,6,818985
2831,8,-1,706,609078,8,609070
2832,8,-2,947,583129,8,583121
2833,9,-19,721,47347,9,47338
2834,12,12,852,1028482,12,1028470
2835,11,13,300,1055406,11,1055395
2836,9,-5,525,479428,9,479419
2837,19,-1,665,621684,19,621665
2838,13,-12,745,277954,13,277941
2839,12,-14,685,214908,12,214896
2840,20,-11,302,306142,20,306122
2841,13,-1,509,620582,13,620569
2842,15,8,921,905128,15,905113
2843,10,7,573,856977,10,856967
2844,11,-8,508,401397,11,401386
2845,6,15,674,1108697,6,1108691
2846,17,-20,299,25127,17,25110
2847,10,17,781,1171941,10,1171931
2848,7,13,749,1046797,7,1046790
2849,7,2,60,689933,7,689926
2850,8,-6,703,451897,8,451889
2851,11,3,630,746589,11,746578
2852,8,3,591,731377,8,731369
2853,6,-6,795,453841,6,453835
2854,8,-7,271,411562,8,411554
2855,10,-5,619,481404,10,481394
2856,13,-13,727,246383,13,246370
2857,17,11,965,997780,17,997763
2858,14,1,314,682334,14,682320
2859,6,-10,24,313107,6,313101
2860,15,-5,836,497088,15,497073
2861,11,19,532,1245167,11,1245156
2862,18,-12,503,276288,18,276270
2863,12,4,24,773415,12,773403
2864,9,-12,652,263663,9,263654
2865,6,13,831,1048596,6,1048590
2866,15,-17,876,121998,15,121983
2867,17,-7,319,430770,17,430753
2868,6,14,928,1082508,6,1082502
2869,7,1,1,656984,7,656977
2870,13,10,65,960324,13,960311
2871,9,7,789,861534,9,861525
2872,7,-10,546,324427,7,324420
2873,10,1,555,669454,10,669444
2874,18,8,958,905390,18,905372
2875,8,14,296,1068385,8,1068377
2876,5,3,855,737258,5,737253
2877,13,15,879,1123175,13,1123162
2878,6,-10,256,318118,6,318112
2879,6,-13,582,230782,6,230776
2880,7,-20,71,1565,7,1558
2881,11,13,260,1055110,11,1055099
2882,18,-20,77,23371,18,23353
2883,15,-15,128,178752,15,178737
2884,15,-7,955,435393,15,435378
2885,16,-8,77,398575,16,398559
2886,5,5,225,786400,5,786395
2887,10,-20,362,7936,10,7926
2888,6,10,377,945501,6,945495
2889,12,-10,841,341399,12,341387
2890,20,11,921,997596,20,997576
2891,13,0,850,654681,13,654668
2892,11,9,801,934972,11,934961
2893,18,4,513,776966,18,776948
2894,20,-5,986,498260,20,498240
2895,11,5,45,804096,11,804085
2896,12,-7,545,432447,12,432435
2897,15,-5,38,491128,15,491113
2898,13,-13,960,248296,13,248283
2899,12,10,12,959913,12,959901
2900,19,15,283,1118881,19,1118862
2901,16,4,0,773327,16,773311
2902,16,0,472,651701,16,651685
2903,19,-2,741,590669,19,590650
2904,9,7,281,850806,9,850797
2905,12,4,488,776752,12,776740
2906,6,-13,862,237012,6,237006
2907,14,12,672,1027116,14,1027102
2908,19,-6,528,463223,19,463204
2909,18,12,543,1026058,18,1026040
2910,16,-14,388,212593,16,212577
2911,17,-14,345,212070,17,212053
2912,13,6,368,838612,13,838599
2913,20,-20,690,28142,20,28122
2914,11,18,358,1211693,11,1211682
2915,10,6,813,830642,10,830632
2916,6,-20,922,20355,6,20349
2917,8,-19,135,34575,8,34567
2918,20,6,699,841451,20,841431
2919,20,10,10,959909,20,959889
2920,18,17,111,1178628,18,1178610
2921,18,-11,817,310060,18,310042
2922,12,-3,100,554482,12,554470
2923,11,19,227,1242537,11,1242526
2924,20,14,600,1090061,20,1090041
2925,14,9,894,935680,14,935666
2926,15,7,750,872425,15,872410
2927,16,-13,773,246798,16,246782
2928,5,-12,781,266387,5,266382
2929,16,6,984,843593,16,843577
2930,20,6,293,838005,20,837985
2931,16,8,511,902015,16,901999
2932,14,4,622,777804,14,777790
2933,16,11,568,994938,16,994922
2934,16,9,913,935846,16,935830
2935,13,-10,891,341791,13,341778
2936,15,19,402,1244076,15,1244061
2937,9,0,97,627500,9,627491
2938,17,-6,703,464526,17,464509
2939,14,13,513,1057052,14,1057038
2940,16,14,172,1086788,16,1086772
2941,7,-19,964,52150,7,52143
2942,9,-11,394,289848,9,289839
2943,10,2,758,704619,10,704609
2944,9,-20,309,6960,9,6951
2945,10,-1,42,594729,10,594719
2946,15,12,115,1022890,15,1022875
2947,15,-18,342,87874,15,87859
2948,5,-14,750,202976,5,202971
2949,6,-8,335,382542,6,382536
2950,13,-10,638,339864,13,339851
2951,8,13,69,1032271,8,1032263
2952,7,-9,178,347338,7,347331
2953,18,11,165,992012,18,991994
2954,18,9,566,933229,18,933211
2955,14,11,869,997176,14,997162
2956,10,17,725,1170734,10,1170724
2957,17,4,401,776085,17,776068
2958,8,6,900,832483,8,832475
2959,13,11,639,995390,13,995377
2960,9,17,478,1165536,9,1165527
2961,14,-8,134,398828,14,398814
2962,13,18,602,1213226,13,1213213
2963,17,1,759,685770,17,685753
2964,9,-9,561,356273,9,356264
2965,7,-16,564,136294,7,136287
2966,16,-8,883,404105,16,404089
2967,15,0,22,648385,15,648370
2968,11,-8,513,401446,11,401435
2969,14,4,542,777189,14,777175
2970,16,4,611,777727,16,777711
2971,19,16,393,1149985,19,1149966
2972,17,10,689,965235,17,965218
2973,18,17,21,1178011,18,1177993
2974,9,15,708,1109499,9,1109490
2975,10,7,190,848812,10,848802
2976,8,-14,206,191019,8,191011
2977,10,19,287,1223845,10,1223835
2978,7,-11,452,291222,7,291215
2979,13,16,100,1147762,13,1147749
2980,5,-3,598,543851,5,543846
2981,15,6,463,839476,15,839461
2982,9,12,841,1017443,9,1017434
2983,8,-11,620,294882,8,294874
2984,18,5,746,809229,18,809211
2985,19,5,912,810421,19,810402
2986,6,7,172,848388,6,848382
2987,13,15,123,1117733,13,1117720
2988,20,17,368,1180714,20,1180694
2989,17,8,762,903981,17,903964
2990,14,-3,491,557604,14,557590
2991,19,12,329,1024525,19,1024506
2992,16,1,843,686370,16,686354
2993,17,-18,480,88861,17,88844
2994,11,16,983,1154145,11,1154134
2995,17,-7,678,433212,17,433195
2996,14,17,445,1181248,14,1181234
2997,12,12,545,1026078,12,1026066
2998,16,15,215,1118426,16,1118410
2999,13,-19,306,56355,13,56342
3000,16,8,135,898987,16,898971
3001,9,-8,644,389156,9,389147
3002,14,-19,669,59191,14,59177
3003,9,-20,548,11981,9,11972
3004,9,16,631,1138455,9,1138446
3005,9,-15,568,167627,9,167618
3006,20,-16,513,150780,20,150760
3007,15,-7,723,433564,15,433549
3008,14,17,826,1184144,14,1184130
3009,16,14,213,1087058,16,1087042
3010,20,18,62,1209439,20,1209419
3011,7,-18,269,68360,7,68353
3012,20,1,534,684121,20,684101
3013,12,-10,101,335875,12,335863
3014,17,16,789,1152725,17,1152708
3015,11,19,792,1247194,11,1247183
3016,9,4,865,769675,9,769666
3017,12,-2,498,588902,12,588890
3018,6,2,344,696046,6,696040
3019,8,-17,93,95460,8,95452
3020,19,-1,55,616980,19,616961
3021,19,-7,354,431032,19,431013
3022,10,12,530,1010442,10,1010432
3023,20,-2,865,591723,20,591703
3024,12,10,671,965085,12,965073
3025,9,-19,279,37620,9,37611
3026,18,6,684,841266,18,841248
3027,18,-18,31,85429,18,85411
3028,7,16,787,1141428,7,1141421
3029,5,-18,45,63329,5,63324
3030,6,-9,680,358492,6,358486
3031,19,-14,701,215002,19,214983
3032,14,-17,501,119238,14,119224
3033,12,3,320,744343,12,744331
3034,17,5,114,804633,17,804616
3035,8,8,901,894740,8,894732
3036,7,-5,822,485697,7,485690
3037,17,-18,311,87675,17,87658
3038,20,-10,531,338996,20,338976
3039,10,13,883,1049686,10,1049676
3040,10,-6,464,446715,10,446705
3041,16,-9,299,368760,16,368744
3042,5,-17,223,98203,5,98198
3043,5,0,45,626263,5,626258
3044,19,16,834,1153118,19,1153099
3045,20,-7,514,432208,20,432188
3046,5,-6,263,442550,5,442545
3047,20,12,857,1028508,20,1028488
3048,7,-8,755,391523,7,391516
3049,8,-14,166,190042,8,190034
3050,11,-19,114,54881,11,54870
3051,5,16,488,1135571,5,1135566
3052,19,-8,447,400959,19,400940
3053,16,-7,861,434610,16,434594
3054,9,2,145,691701,9,691692
3055,12,-14,890,216437,12,216425
3056,6,3,73,720340,6,720334
3057,12,13,238,1054968,12,1054956
3058,14,-17,745,121167,14,121153
3059,10,-17,949,113485,10,113475
3060,20,0,626,652954,20,652934
3061,14,9,721,934367,14,934353
3062,5,-7,194,409926,5,409921
3063,17,-17,715,120864,17,120847
3064,6,-14,255,192356,6,192350
3065,18,-1,593,621194,18,621176
3066,7,13,892,1049895,7,1049888
3067,19,-9,634,371546,19,371527
3068,11,13,762,1058931,11,1058920
3069,15,11,467,994254,15,994239
3070,16,1,74,680334,16,680318
3071,10,7,614,857796,10,857786
3072,17,16,2,1147114,17,1147097
3073,12,-3,361,556448,12,556436
3074,7,8,359,883006,7,882999
3075,9,-19,794,48823,9,48814
3076,18,13,33,1053448,18,1053430
3077,14,-5,610,495538,14,495524
3078,12,-19,140,55124,12,55112
3079,16,-18,378,88141,16,88125
3080,11,-4,236,523964,11,523953
3081,6,-4,854,517609,6,517603
3082,13,-9,985,374174,13,374161
3083,14,-14,607,214298,14,214284
3084,13,-8,111,398666,13,398653
3085,19,-19,181,55467,19,55448
3086,9,13,758,1047015,9,1047006
3087,16,7,267,868925,16,868909
3088,9,19,563,1230209,9,1230200
3089,19,-18,173,86623,19,86604
3090,16,-12,101,273254,16,273238
3091,19,18,932,1215790,19,1215771
3092,13,-15,735,183277,13,183264
3093,15,-3,693,559282,15,559267
3094,13,14,947,1092883,13,1092870
3095,11,6,924,843113,11,843102
3096,11,-20,541,26931,11,26920
3097,14,-2,598,589593,14,589579
3098,6,-1,314,600871,6,600865
3099,10,18,949,1206806,10,1206796
3100,20,-2,274,587187,20,587167
3101,13,18,91,1209643,13,1209630
3102,14,-10,719,340474,14,340460
3103,8,-17,113,95829,8,95821
3104,8,-5,304,474798,8,474790
3105,16,15,714,1122076,16,1122060
3106,14,-11,688,309171,14,309157
3107,10,-14,474,196928,10,196918
3108,16,1,950,687291,16,687275
3109,11,10,162,961129,11,961118
3110,6,-11,718,296623,6,296617
3111,18,9,180,930406,18,930388
3112,20,-20,900,29742,20,29722
3113,7,-4,655,513493,7,513486
3114,11,-14,469,213123,11,213112
3115,8,-17,811,110733,8,110725
3116,10,-14,820,204443,10,204433
3117,9,-11,659,295643,9,295634
3118,8,-16,57,125074,8,125066
3119,9,2,279,694590,9,694581
3120,11,5,14,803872,11,803861
3121,19,-6,579,463573,19,463554
3122,9,-14,857,205153,9,205144
3123,17,18,370,1211812,17,1211795
3124,15,-18,42,85512,15,85497
3125,12,-1,765,622425,12,622413
3126,10,-19,710,47118,10,47108
3127,11,-17,957,122521,11,122510
3128,11,-18,458,88722,11,88711
3129,10,-13,741,234174,10,234164
3130,9,-8,302,381762,9,381753
3131,9,17,655,1169344,9,1169335
3132,12,4,495,776777,12,776765
3133,18,-3,435,557085,18,557067
3134,12,2,852,716843,12,716831
3135,15,-4,501,525869,15,525854
3136,18,5,430,806889,18,806871
3137,12,12,546,1026079,12,1026067
3138,11,-20,40,22351,11,22340
3139,10,1,863,675796,10,675786
3140,17,-16,97,147632,17,147615
3141,16,-15,1000,185402,16,185386
3142,7,16,678,1139404,7,1139397
3143,5,18,898,1205770,5,1205765
3144,20,-13,647,245758,20,245738
3145,8,1,807,674523,8,674515
3146,14,-1,224,618325,14,618311
3147,8,8,79,876728,8,876720
3148,19,12,666,1027042,19,1027023
3149,15,2,711,715948,15,715933
3150,17,-14,377,212460,17,212443
3151,9,1,181,661120,9,661111
3152,8,-12,635,263204,8,263196
3153,5,8,695,890442,5,890437
3154,5,-18,806,79840,5,79835
3155,10,16,57,1126351,10,1126341
3156,10,8,166,878716,10,878706
3157,10,19,227,1222570,10,1222560
3158,12,-17,170,116726,12,116714
3159,16,-10,919,341994,16,341978
3160,14,13,488,1056814,14,1056800
3161,10,0,250,630815,10,630805
3162,12,-16,618,151601,12,151589
3163,19,16,928,1153760,19,1153741
3164,19,-20,718,28259,19,28240
3165,10,16,957,1145078,10,1145068
3166,13,11,327,993234,13,993221
3167,14,-6,157,460329,14,460315
3168,5,11,666,982624,5,982619
3169,16,-14,122,210234,16,210218
3170,20,-16,177,148213,20,148193
3171,19,7,141,868075,19,868056
3172,12,10,769,965759,12,965747
3173,7,-12,541,261349,7,261342
3174,6,2,261,694244,6,694238
3175,6,14,814,1080248,6,1080242
3176,15,-1,724,622179,15,622164
3177,17,11,806,996694,17,996677
3178,20,-11,308,306232,20,306212
3179,20,14,187,1086885,20,1086865
3180,16,-19,342,56683,16,56667
3181,6,-11,115,283633,6,283627
3182,18,-13,10,241109,18,241091
3183,8,14,105,1064189,8,1064181
3184,13,-12,194,273876,13,273863
3185,15,-18,322,87746,15,87731
3186,13,4,904,779944,13,779931
3187,9,14,930,1082613,9,1082604
3188,18,9,655,933896,18,933878
3189,6,-8,758,391589,6,391583
3190,13,8,453,901560,13,901547
3191,12,17,795,1183849,12,1183837
3192,9,13,738,1046569,9,1046560
3193,16,-20,59,23233,16,23217
3194,14,-13,477,244487,14,244473
3195,10,-3,16,530942,10,530932
3196,8,-12,899,269170,8,269162
3197,7,2,712,703680,7,703673
3198,16,2,570,714858,16,714842
3199,17,1,132,680879,17,680862
3200,14,-4,838,528188,14,528174
3201,14,0,924,655295,14,655281
3202,9,10,34,938261,9,938252
3203,12,3,82,742436,12,742424
3204,16,3,220,743509,16,743493
3205,9,-9,352,351338,9,351329
3206,6,-5,133,470959,6,470953
3207,13,-11,130,304708,13,304695
3208,20,3,442,745149,20,745129
3209,8,-3,812,548561,8,548553
3210,5,8,227,880100,5,880095
3211,8,-18,665,76699,8,76691
3212,17,3,261,743860,17,743843
3213,20,3,239,743688,20,743668
3214,19,7,974,873918,19,873899
3215,18,-19,754,59910,18,59892
3216,20,-8,942,404547,20,404527
3217,10,-16,336,131147,10,131137
3218,6,-2,916,582461,6,582455
3219,8,-12,118,252096,8,252088
3220,14,-16,420,150016,14,150002
3221,12,8,198,899504,12,899492
3222,9,17,50,1156439,9,1156430
3223,12,16,746,1152393,12,1152381
3224,20,-17,31,115771,20,115751
3225,11,14,540,1089668,11,1089657
3226,20,3,296,744135,20,744115
3227,20,-14,873,216298,20,216278
3228,13,-19,885,60764,13,60751
3229,9,3,722,734521,9,734512
3230,5,-2,67,564321,5,564316
3231,18,3,761,747600,18,747582
3232,5,-10,783,329301,5,329296
3233,20,16,128,1147972,20,1147952
3234,18,-5,673,495904,18,495886
3235,7,6,908,832672,7,832665
3236,12,18,32,1209128,12,1209116
3237,8,5,417,790108,8,790100
3238,9,-8,966,396009,9,396000
3239,13,-6,579,463576,13,463563
3240,16,-5,234,492701,16,492685
3241,6,-6,169,440442,6,440436
3242,8,-7,455,415598,8,415590
3243,5,-12,496,260328,5,260323
3244,12,-16,728,152235,12,152223
3245,13,-7,426,431505,13,431492
3246,16,14,73,1086013,16,1085997
3247,6,1,366,665251,6,665245
3248,6,3,827,736625,6,736619
3249,14,-10,237,336803,14,336789
3250,17,-3,300,555985,17,555968
3251,16,-8,259,399724,16,399708
3252,11,-14,205,210908,11,210897
3253,12,17,105,1178589,12,1178577
3254,13,-16,798,152746,13,152733
3255,13,18,194,1210584,13,1210571
3256,18,-19,102,54729,18,54711
3257,7,-3,633,544726,7,544719
3258,15,4,810,779222,15,779207
3259,6,7,958,864997,6,864991
3260,18,-2,443,588453,18,588435
3261,9,1,52,658194,9,658185
3262,11,1,418,683137,11,683126
3263,12,17,537,1181855,12,1181843
3264,16,17,791,1183800,16,1183784
3265,10,-8,81,377193,10,377183
3266,10,12,814,1016747,10,1016737
3267,11,0,401,651102,11,651091
3268,15,-20,812,29143,15,29128
3269,7,-1,940,614258,7,614251
3270,20,1,178,681281,20,681261
3271,14,-10,656,340001,14,339987
3272,9,4,519,761797,9,761788
3273,13,2,910,717259,13,717246
3274,18,11,781,996500,18,996482
3275,16,-18,786,90973,16,90957
3276,12,-1,322,619116,12,619104
3277,5,-13,264,223994,5,223989
3278,18,-1,153,617705,18,617687
3279,16,12,294,1024299,16,1024283
3280,16,8,584,902530,16,902514
3281,12,-16,446,150309,12,150297
3282,18,-10,633,339770,18,339752
3283,8,-16,292,130329,8,130321
3284,12,-3,1000,561764,12,561752
3285,14,-1,280,618733,14,618719
3286,19,-2,611,589725,19,589706
3287,14,4,352,775769,14,775755
3288,18,0,296,650301,18,650283
3289,17,18,22,1209047,17,1209030
3290,15,15,531,1120637,15,1120622
3291,19,6,398,838975,19,838956
3292,18,-13,857,247435,18,247417
3293,11,19,18,1240814,11,1240803
3294,20,19,673,1246222,20,1246202
3295,17,5,531,807647,17,807630
3296,14,-9,859,373378,14,373364
3297,11,-20,519,26730,11,26719
3298,19,-16,781,152647,19,152628
3299,19,-11,641,308840,19,308821
3300,8,-6,970,457412,8,457404
3301,16,14,77,1086049,16,1086033
3302,14,-8,419,400808,14,400794
3303,19,-3,801,560220,19,560201
3304,7,10,503,948204,7,948197
3305,20,17,367,1180702,20,1180682
3306,14,6,577,840447,14,840433
3307,17,-2,450,588534,17,588517
3308,9,-20,576,12557,9,12548
3309,11,15,502,1120351,11,1120340
3310,7,17,824,1173008,7,1173001
3311,13,-16,445,150304,13,150291
3312,14,6,461,839445,14,839431
3313,18,-10,131,336088,18,336070
3314,11,-7,539,432406,11,432395
3315,12,-10,941,342181,12,342169
3316,5,3,300,725410,5,725405
3317,6,16,611,1137989,6,1137983
3318,12,-3,117,554634,12,554622
3319,6,-15,571,167700,6,167694
3320,16,-15,195,179127,16,179111
3321,6,3,491,729342,6,729336
3322,8,-2,903,582137,8,582129
3323,7,-9,865,362920,7,362913
3324,16,9,671,933990,16,933974
3325,11,-12,298,274722,11,274711
3326,15,1,125,680807,15,680792
3327,13,-15,405,180743,13,180730
3328,9,12,41,999989,9,999980
3329,16,-13,702,246154,16,246138
3330,7,3,274,724791,7,724784
3331,12,-9,108,367373,12,367361
3332,5,-2,65,564260,5,564255
3333,19,-12,290,274645,19,274626
3334,15,4,422,776283,15,776268
3335,19,-15,574,182034,19,182015
3336,8,-14,189,190529,8,190521
3337,8,7,563,856749,8,856741
3338,17,-19,985,61371,17,61354
3339,6,8,268,881006,6,881000
3340,16,-9,219,368106,16,368090
3341,15,-9,343,369202,15,369187
3342,17,12,54,1022470,17,1022453
3343,12,-16,987,154181,12,154169
3344,11,-1,897,623412,11,623401
3345,17,3,574,746109,17,746092
3346,17,-2,168,586297,17,586280
3347,12,-14,403,212710,12,212698
3348,7,-5,667,482408,7,482401
3349,11,3,805,747913,11,747902
3350,20,-19,588,58668,20,58648
3351,12,-8,65,398432,12,398420
3352,15,16,52,1147451,15,1147436
3353,5,-19,84,33262,5,33257
3354,10,-5,72,469450,10,469440
3355,18,19,896,1248029,18,1248011
3356,5,-13,18,218658,5,218653
3357,11,-1,122,617481,11,617470
3358,13,-2,239,586950,13,586937
3359,11,-1,282,618753,11,618742
3360,11,-9,669,371736,11,371725
3361,16,17,263,1179856,16,1179840
3362,18,-10,534,339030,18,339012
3363,11,-6,274,461319,11,461308
3364,12,-12,473,275991,12,275979
3365,16,10,705,965333,16,965317
3366,6,-18,858,80916,6,80910
3367,12,-2,597,589590,12,589578
3368,13,2,354,713279,13,713266
3369,19,-14,472,213172,19,213153
3370,17,11,809,996734,17,996717
3371,20,-2,423,588286,20,588266
3372,8,-15,451,165151,8,165143
3373,8,3,729,734687,8,734679
3374,16,18,196,1210605,16,1210589
3375,19,-7,466,431849,19,431830
3376,15,19,368,1243761,15,1243746
3377,14,10,798,966089,14,966075
3378,13,12,459,1025402,13,1025389
3379,19,-3,399,556716,19,556697
3380,11,3,793,747835,11,747824
3381,7,11,294,974634,7,974627
3382,15,-19,147,55177,15,55162
3383,19,3,31,742016,19,741997
3384,9,-5,963,488981,9,488972
3385,19,17,295,1180188,19,1180169
3386,7,-14,358,194466,7,194459
3387,19,-5,544,495050,19,495031
3388,11,-6,489,462911,11,462900
3389,15,-1,355,619449,15,619434
3390,16,-12,792,278306,16,278290
3391,8,-6,721,452309,8,452301
3392,16,16,45,1147395,16,1147379
3393,11,-6,361,461914,11,461903
3394,14,-14,434,212893,14,212879
3395,16,19,925,1248208,16,1248192
3396,18,-18,293,87525,18,87507
3397,14,8,703,903549,14,903535
3398,14,-1,994,624118,14,624104
3399,20,6,364,838564,20,838544
3400,13,-5,33,491061,13,491048
3401,6,16,84,1126944,6,1126938
3402,8,-6,300,443332,8,443324
3403,20,-17,1,115539,20,115519
3404,7,19,521,1229359,7,1229352
3405,17,-15,427,180965,17,180948
3406,14,-19,382,56977,14,56963
3407,15,10,53,960253,15,960238
3408,15,6,556,840229,15,840214
3409,17,-9,371,369423,17,369406
3410,20,-12,208,273976,20,273956
3411,7,15,377,1102441,7,1102434
3412,12,5,274,805836,12,805824
3413,8,-8,288,381476,8,381468
3414,20,-6,128,460038,20,460018
3415,17,1,315,682351,17,682334
3416,12,7,446,870343,12,870331
3417,6,-3,435,540086,6,540080
3418,20,-12,861,278944,20,278924
3419,19,0,154,649359,19,649340
3420,6,11,532,979853,6,979847
3421,13,-18,513,89029,13,89016
3422,18,14,94,1086203,18,1086185
3423,20,-10,532,339006,20,338986
3424,14,1,30,680009,14,679995
3425,12,-16,963,154028,12,154016
3426,9,7,544,856383,9,856374
3427,17,16,870,1153283,17,1153266
3428,11,6,434,839222,11,839211
3429,19,-4,54,522443,19,522424
3430,16,-6,597,463693,16,463677
3431,6,-3,682,545877,6,545871
3432,11,4,825,779352,11,779341
3433,12,11,964,997753,12,997741
3434,8,11,236,973212,8,973204
3435,16,-8,514,401451,16,401435
3436,19,8,894,904892,19,904873
3437,6,1,78,658679,6,658673
3438,17,-10,407,338011,17,337994
3439,16,-7,479,431927,16,431911
3440,16,4,557,777294,16,777278
3441,19,7,363,869640,19,869621
3442,5,1,89,658913,5,658908
3443,20,11,610,995221,20,995201
3444,9,19,137,1220425,9,1220416
3445,19,8,761,903970,19,903951
3446,12,5,408,806748,12,806736
3447,20,16,789,1152735,20,1152715
3448,14,14,388,1088426,14,1088412
3449,19,-9,758,372502,19,372483
3450,10,-8,970,396112,10,396102
3451,5,-7,820,423137,5,423132
3452,5,-4,899,518737,5,518732
3453,10,19,834,1235999,10,1235989
3454,7,-5,867,486799,7,486792
3455,16,-2,696,590394,16,590378
3456,9,5,859,799551,9,799542
3457,12,9,448,932286,12,932274
3458,14,12,328,1024517,14,1024503
3459,16,3,77,742407,16,742391
3460,17,8,965,905453,17,905436
3461,18,-6,772,465050,18,465032
3462,5,15,600,1107192,5,1107187
3463,20,-3,619,558711,20,558691
3464,18,-1,547,620890,18,620872
3465,20,10,30,960081,20,960061
3466,14,-16,519,150832,14,150818
3467,10,9,107,909029,10,909019
3468,15,15,448,1119965,15,1119950
3469,11,-11,739,309446,11,309435
3470,18,-20,397,25834,18,25816
3471,10,18,17,1186910,10,1186900
3472,12,1,369,682813,12,682801
3473,16,12,654,1026900,16,1026884
3474,8,12,117,1001683,8,1001675
3475,5,2,636,702062,5,702057
3476,10,7,976,865400,10,865390
3477,7,-15,906,174656,7,174649
3478,13,-11,836,310228,13,310215
3479,19,13,165,1054406,19,1054387
3480,9,2,416,697618,9,697609
3481,8,13,990,1051842,8,1051834
3482,17,-10,134,336133,17,336116
3483,6,9,699,921462,6,921456
3484,9,15,312,1101150,9,1101141
3485,15,19,76,1241393,15,1241378
3486,7,4,989,772090,7,772083
3487,10,-17,648,107391,10,107381
3488,17,0,303,650342,17,650325
3489,6,-7,725,421194,6,421188
3490,15,11,900,997420,15,997405
3491,9,2,626,701857,9,701848
3492,20,16,262,1148997,20,1148977
3493,18,19,961,1248501,18,1248483
3494,20,6,461,839455,20,839435
3495,18,10,24,960020,18,960002
3496,11,13,147,1054273,11,1054262
3497,6,-12,747,265649,6,265643
3498,10,-2,250,568098,10,568088
3499,15,-16,955,153926,15,153911
3500,6,-4,17,499679,6,499673
3501,8,-7,885,424801,8,424793
3502,5,3,720,734474,5,734469
3503,16,-13,427,244135,16,244119
3504,10,-16,813,141484,10,141474
3505,18,7,672,871978,18,871960
3506,13,0,365,650800,13,650787
3507,13,-20,843,29342,13,29329
3508,9,-3,31,531207,9,531198
3509,19,15,266,1118751,19,1118732
3510,5,5,495,791873,5,791868
3511,19,-6,867,465658,19,465639
3512,6,-12,510,260721,6,260715
3513,11,16,813,1152951,11,1152940
3514,12,-1,84,617208,12,617196
3515,15,13,165,1054411,15,1054396
3516,15,-14,319,211865,15,211850
3517,9,-19,397,40168,9,40159
3518,15,13,209,1054772,15,1054757
3519,15,15,247,1118619,15,1118604
3520,8,0,980,646670,8,646662
3521,16,16,858,1153223,16,1153207
3522,16,6,160,836954,16,836938
3523,18,-7,564,432557,18,432539
3524,17,-12,992,280037,17,280020
3525,8,9,122,909338,8,909330
3526,8,12,981,1020725,8,1020717
3527,8,-15,628,168946,8,168938
3528,12,19,521,1245095,12,1245083
3529,19,16,614,1151437,19,1151418
3530,5,-19,183,35620,5,35615
3531,16,-16,767,152539,16,152523
3532,8,-7,834,423465,8,423457
3533,17,16,755,1152440,17,1152423
3534,19,-1,233,618411,19,618392
3535,6,-6,73,438310,6,438304
3536,19,0,126,649211,19,649192
3537,9,0,124,628138,9,628129
3538,14,-6,783,465135,14,465121
3539,16,1,576,684442,16,684426
3540,18,14,855,1092073,18,1092055
3541,5,14,607,1075379,5,1075374
3542,9,-20,802,17750,9,17741
3543,18,2,13,710556,18,710538
3544,13,11,787,996535,13,996522
3545,16,-14,229,211191,16,211175
3546,18,7,104,867778,18,867760
3547,17,-4,105,522834,17,522817
3548,10,-3,659,545320,10,545310
3549,10,-10,501,323544,10,323534
3550,20,5,283,805931,20,805911
3551,5,13,857,1049148,5,1049143
3552,11,-15,80,178332,11,178321
3553,9,-13,110,220761,9,220752
3554,15,19,319,1243329,15,1243314
3555,8,-9,530,355621,8,355613
3556,10,13,330,1037826,10,1037816
3557,5,-18,114,64935,5,64930
3558,15,-20,771,28748,15,28733
3559,5,7,212,849236,5,849231
3560,16,-2,658,590075,16,590059
3561,14,8,293,900273,14,900259
3562,15,18,156,1210227,15,1210212
3563,17,-7,797,434057,17,434040
3564,16,11,575,995005,16,994989
3565,12,4,383,775980,12,775968
3566,6,-8,250,380790,6,380784
3567,16,7,764,872517,16,872501
3568,20,-19,532,58128,20,58108
3569,8,-3,110,532796,8,532788
3570,10,-7,869,424288,10,424278
3571,17,2,191,712004,17,711987
3572,15,-19,548,58261,15,58246
3573,20,1,305,682262,20,682242
3574,12,0,286,650212,12,650200
3575,12,2,460,714102,12,714090
3576,12,-13,924,247976,12,247964
3577,20,17,988,1185399,20,1185379
3578,12,-11,823,310125,12,310113
3579,7,-16,727,139622,7,139615
3580,12,1,54,680208,12,680196
3581,5,19,380,1226099,5,1226094
3582,15,-12,272,274530,15,274515
3583,13,-12,894,279205,13,279192
3584,7,-9,292,349960,7,349953
3585,9,15,842,1112325,9,1112316
3586,15,-14,230,211216,15,211201
3587,14,16,797,1152813,14,1152799
3588,13,-1,775,622519,13,622506
3589,7,15,439,1103687,7,1103680
3590,15,-18,574,89402,15,89387
3591,18,18,392,1211932,18,1211914
3592,16,-18,413,88372,16,88356
3593,15,6,779,841992,15,841977
3594,8,10,124,940388,8,940380
3595,10,-19,646,45763,10,45753
3596,17,-1,654,621642,17,621625
3597,8,-1,107,596113,8,596105
3598,11,6,4,835758,11,835747
3599,8,15,488,1104800,8,1104792
3600,10,-5,171,471825,10,471815
3601,10,7,471,854902,10,854892
3602,13,-2,433,588407,13,588394
3603,12,-18,568,89356,12,89344
3604,20,12,85,1022697,20,1022677
3605,10,-5,456,477816,10,477806
3606,15,11,699,995773,15,995758
3607,9,6,290,818734,9,818725
3608,19,17,237,1179648,19,1179629
3609,6,3,717,734439,6,734433
3610,12,-1,426,619941,12,619929
3611,10,-3,335,537778,10,537768
3612,17,-11,353,306570,17,306553
3613,8,-5,554,479976,8,479968
3614,13,11,846,996993,13,996980
3615,13,12,974,1029605,13,1029592
3616,5,-15,327,162452,5,162447
3617,19,15,844,1122948,19,1122929
3618,14,-14,465,213110,14,213096
3619,16,19,79,1241426,16,1241410
3620,19,-14,13,209437,19,209418
3621,14,-16,197,148386,14,148372
3622,18,11,276,992845,18,992827
3623,8,9,822,924181,8,924173
3624,14,-16,644,151730,14,151716
3625,9,-12,411,258594,9,258585
3626,12,3,614,746409,12,746397
3627,11,13,667,1058265,11,1058254
3628,16,0,207,649812,16,649796
3629,15,5,51,804181,15,804166
3630,9,-19,912,51135,9,51126
3631,7,-7,363,413803,7,413796
3632,7,-1,659,608099,7,608092
3633,11,-14,43,209640,11,209629
3634,8,12,226,1004057,8,1004049
3635,8,1,261,662916,8,662908
3636,13,-7,655,433057,13,433044
3637,16,-18,134,86225,16,86209
3638,20,13,84,1053856,20,1053836
3639,8,-10,661,326932,8,326924
3640,9,-18,961,83352,9,83343
3641,19,13,93,1053907,19,1053888
3642,10,3,579,731201,10,731191
3643,8,18,777,1203149,8,1203141
3644,6,-19,44,32453,6,32447
3645,7,3,415,727696,7,727689
3646,9,-9,342,351144,9,351135
3647,11,-5,484,494647,11,494636
3648,8,-3,129,533202,8,533194
3649,8,18,1,1186532,8,1186524
3650,15,-2,217,586761,15,586746
3651,14,12,529,1025915,14,1025901
3652,18,15,25,1116976,18,1116958
3653,15,-3,321,556114,15,556099
3654,5,6,441,822387,5,822382
3655,8,-4,667,513786,8,513778
3656,10,-7,173,409486,10,409476
3657,18,6,320,838257,18,838239
3658,16,15,171,1118060,16,1118044
3659,8,-11,140,284189,8,284181
3660,15,-8,47,398256,15,398241
3661,20,-19,948,61152,20,61132
3662,14,8,1,897926,14,897912
3663,12,-6,763,464956,12,464944
3664,19,-5,628,495649,19,495630
3665,17,15,255,1118675,17,1118658
3666,10,-8,209,379947,10,379937
3667,16,-3,702,559370,16,559354
3668,7,-10,480,323137,7,323130
3669,5,12,211,1003736,5,1003731
3670,16,3,391,744821,16,744805
3671,6,7,922,864339,6,864333
3672,17,-5,267,493012,17,492995
3673,19,3,235,743654,19,743635
3674,14,14,720,1091132,14,1091118
3675,6,-10,590,325380,6,325374
3676,11,-19,506,57878,11,57867
3677,10,-20,22,555,10,545
3678,14,2,541,714669,14,714655
3679,16,-13,144,242051,16,242035
3680,7,18,519,1197912,7,1197905
3681,6,-6,28,437479,6,437473
3682,19,-5,470,494523,19,494504
3683,16,-2,2,585139,16,585123
3684,11,-3,365,556452,11,556441
3685,15,13,330,1055648,15,1055633
3686,19,13,199,1054710,19,1054691
3687,9,18,790,1203495,9,1203486
3688,13,-14,666,214719,13,214706
3689,5,-5,752,484232,5,484227
3690,12,0,774,654190,12,654178
3691,6,4,153,753858,6,753852
3692,20,-9,742,372304,20,372284
3693,6,4,248,756067,6,756061
3694,14,7,605,871486,14,871472
3695,13,16,806,1152903,13,1152890
3696,11,12,499,1025717,11,1025706
3697,20,-18,122,86133,20,86113
3698,11,9,80,929625,11,929614
3699,12,-6,108,459866,12,459854
3700,20,-5,678,495949,20,495929
3701,12,17,407,1180929,12,1180917
3702,17,-14,458,213032,17,213015
3703,12,12,960,1029500,12,1029488
3704,20,9,416,932058,20,932038
3705,19,-13,320,243441,19,243422
3706,19,10,502,963668,19,963649
3707,14,15,47,1117137,14,1117123
3708,16,8,377,900908,16,900892
3709,13,-18,900,91746,13,91733
3710,6,-10,340,319955,6,319949
3711,10,-12,226,254439,10,254429
3712,17,17,922,1184828,17,1184811
3713,7,4,213,755271,7,755264
3714,17,19,322,1243345,17,1243328
3715,5,-2,255,568238,5,568233
3716,11,13,497,1056897,11,1056886
3717,19,17,529,1181811,19,1181792
3718,20,17,163,1179083,20,1179063
3719,17,-20,282,24994,17,24977
3720,16,-6,583,463605,16,463589
3721,7,-6,978,457644,7,457637
3722,5,17,660,1169453,5,1169448
3723,6,7,128,847542,6,847536
3724,18,14,189,1086898,18,1086880
3725,5,-19,371,39502,5,39497
3726,9,-11,522,292774,9,292765
3727,14,14,227,1087178,14,1087164
3728,17,3,846,748204,17,748187
3729,14,-19,161,55319,14,55305
3730,15,8,700,903544,15,903529
3731,7,0,262,631033,7,631026
3732,10,17,184,1159151,10,1159141
3733,12,-14,249,211357,12,211345
3734,12,-11,189,305239,12,305227
3735,15,17,683,1182921,15,1182906
3736,5,18,168,1190480,5,1190475
3737,14,10,76,960426,14,960412
3738,19,-9,427,369949,19,369930
3739,18,5,902,810359,18,810341
3740,20,18,78,1209565,20,1209545
3741,17,7,712,872185,17,872168
3742,8,6,222,817123,8,817115
3743,10,12,815,1016776,10,1016766
3744,11,7,244,868754,11,868743
3745,5,9,809,923904,5,923899
3746,7,-19,527,42973,7,42966
3747,10,8,56,876256,10,876246
3748,16,12,974,1029611,16,1029595
3749,17,4,170,774508,17,774491
3750,14,8,415,901283,14,901269
3751,19,-11,327,306358,19,306339
3752,20,7,990,874055,20,874035
3753,5,8,317,882183,5,882178
3754,19,2,515,714532,19,714513
3755,20,4,487,776741,20,776721
3756,5,-10,1,312529,5,312524
3757,19,8,425,901362,19,901343
3758,16,-3,67,554237,16,554221
3759,19,-18,704,90356,19,90337
3760,7,18,860,1204887,7,1204880
3761,19,1,679,685165,19,685146
3762,10,-8,173,379208,10,379198
3763,5,8,974,896345,5,896340
3764,14,7,1000,874124,14,874110
3765,19,5,217,805443,19,805424
3766,14,11,270,992799,14,992785
3767,16,13,433,1056464,16,1056448
3768,9,-7,246,411039,9,411030
3769,8,-13,992,239797,8,239789
3770,15,9,781,934825,15,934810
3771,20,4,49,773601,20,773581
3772,13,1,179,681301,13,681288
3773,8,19,716,1233383,8,1233375
3774,9,-13,641,231986,9,231977
3775,12,-18,278,87415,12,87403
3776,18,12,88,1022709,18,1022691
3777,15,9,8,929103,15,929088
3778,17,14,317,1087882,17,1087865
3779,19,-19,152,55267,19,55248
3780,17,18,332,1211527,17,1211510
3781,11,-4,344,524767,11,524756
3782,5,15,876,1113082,5,1113077
3783,19,-10,396,337916,19,337897
3784,16,17,651,1182712,16,1182696
3785,19,-18,712,90428,19,90409
3786,12,18,226,1210784,12,1210772
3787,11,19,763,1246934,11,1246923
3788,20,14,389,1088453,20,1088433
3789,18,-4,984,529517,18,529499
3790,13,4,578,777446,13,777433
3791,18,-5,840,497109,18,497091
3792,11,-6,89,459726,11,459715
3793,10,-8,169,379104,10,379094
3794,20,6,606,840650,20,840630
3795,20,16,75,1147607,20,1147587
3796,20,-11,48,303998,20,303978
3797,14,9,480,932531,14,932517
3798,9,17,94,1157263,9,1157254
3799,6,-15,719,170850,6,170844
3800,8,-10,322,319503,8,319495
3801,11,-11,584,308398,11,308387
3802,16,18,330,1211507,16,1211491
3803,5,-1,408,602883,5,602878
3804,19,-2,272,587166,19,587147
3805,18,-8,7,397903,18,397885
3806,10,-1,113,596200,10,596190
3807,10,4,591,763390,10,763380
3808,8,7,46,845807,8,845799
3809,6,5,901,800594,6,800588
3810,10,5,408,789958,10,789948
3811,19,-11,849,310351,19,310332
3812,6,-9,579,356697,6,356691
3813,20,1,767,685855,20,685835
3814,10,8,920,895139,10,895129
3815,9,-15,405,164189,9,164180
3816,10,-6,278,442875,10,442865
3817,7,1,28,657651,7,657644
3818,14,8,997,905702,14,905688
3819,6,18,546,1198450,6,1198444
3820,10,18,733,1201983,10,1201973
3821,10,15,289,1100743,10,1100733
3822,5,-6,387,445086,5,445081
3823,16,-8,433,400883,16,400867
3824,6,-3,178,534167,6,534161
3825,14,10,182,961245,14,961231
3826,16,-20,136,23781,16,23765
3827,12,-7,79,428832,12,428820
3828,5,-8,393,383647,5,383642
3829,13,5,664,808624,13,808611
3830,20,10,777,965841,20,965821
3831,10,13,806,1048150,10,1048140
3832,13,-20,510,26668,13,26655
3833,19,13,977,1060453,19,1060434
3834,15,12,484,1025622,15,1025607
3835,10,-3,151,533668,10,533658
3836,9,-9,996,365503,9,365494
3837,20,13,479,1056770,20,1056750
3838,20,-17,544,119574,20,119554
3839,10,-15,595,168231,10,168221
3840,15,-6,597,463698,15,463683
3841,20,15,861,1123069,20,1123049
3842,16,-9,936,374002,16,373986
3843,12,-2,452,588550,12,588538
3844,19,-2,544,589201,19,589182
3845,16,-16,72,147324,16,147308
3846,15,-11,268,305838,15,305823
3847,10,5,490,791781,10,791771
3848,16,7,207,868463,16,868447
3849,13,3,933,748919,13,748906
3850,11,4,867,779722,11,779711
3851,5,-19,21,31934,5,31929
3852,16,2,839,716770,16,716754
3853,13,-9,566,371154,13,371141
3854,17,-20,20,11749,17,11732
3855,10,-14,847,204935,10,204925
3856,6,14,522,1073479,6,1073473
3857,20,0,876,654885,20,654865
3858,14,-19,640,59049,14,59035
3859,12,-19,839,60460,12,60448
3860,7,-2,178,566500,7,566493
3861,20,-12,120,273436,20,273416
3862,16,-7,830,434306,16,434290
3863,12,16,551,1151006,12,1150994
3864,11,-3,440,557115,11,557104
3865,8,18,520,1197939,8,1197931
3866,14,15,884,1123221,14,1123207
3867,7,5,394,789709,7,789702
3868,7,5,865,799775,7,799768
3869,11,18,771,1214546,11,1214535
3870,14,7,46,867389,14,867375
3871,7,15,964,1115016,7,1115009
3872,17,-4,992,529561,17,529544
3873,14,-17,961,122556,14,122542
3874,10,15,515,1105479,10,1105469
3875,18,7,173,868237,18,868219
3876,8,15,923,1114070,8,1114062
3877,15,-2,341,587648,15,587633
3878,19,13,356,1055852,19,1055833
3879,7,-1,934,614139,7,614132
3880,10,3,857,737318,10,737308
3881,17,17,953,1185024,17,1185007
3882,14,-13,342,243568,14,243554
3883,15,6,933,843186,15,843171
3884,18,10,624,964747,18,964729
3885,12,-18,422,88460,12,88448
3886,17,-3,994,561698,17,561681
3887,7,-19,191,35787,7,35780
3888,5,14,666,1076894,5,1076889
3889,14,19,436,1244439,14,1244425
3890,14,17,728,1183335,14,1183321
3891,20,18,488,1212550,20,1212530
3892,13,5,543,807742,13,807729
3893,19,-5,762,496594,19,496575
3894,18,-16,725,152229,18,152211
3895,11,-19,230,55852,11,55841
3896,12,-16,468,150485,12,150473
3897,12,-17,499,119230,12,119218
3898,5,12,41,999994,5,999989
3899,8,9,532,918003,8,917995
3900,11,11,873,997196,11,997185
3901,19,19,148,1241956,19,1241937
3902,13,0,979,655789,13,655776
3903,15,13,411,1056294,15,1056279
3904,9,18,637,1200255,9,1200246
3905,13,14,364,1088269,13,1088256
3906,6,-3,832,548940,6,548934
3907,7,-19,644,45707,7,45700
3908,15,6,138,836817,15,836802
3909,13,-6,404,462210,13,462197
3910,20,-6,987,466659,20,466639
3911,10,0,451,635166,10,635156
3912,16,-2,601,589646,16,589630
3913,15,2,155,711758,15,711743
3914,19,16,710,1152160,19,1152141
3915,7,-13,815,236002,7,235995
3916,17,2,369,713377,17,713360
3917,9,1,168,660850,9,660841
3918,16,-12,901,279286,16,279270
3919,19,19,549,1245278,19,1245259
3920,12,-19,89,54610,12,54598
3921,9,-11,935,301157,9,301148
3922,13,-19,520,58000,13,57987
3923,20,2,565,714835,20,714815
3924,18,-16,458,150428,18,150410
3925,16,16,877,1153322,16,1153306
3926,14,2,9,710527,14,710513
3927,20,13,411,1056304,20,1056284
3928,8,4,350,758057,8,758049
3929,19,-9,475,370397,19,370378
3930,5,-2,201,567035,5,567030
3931,15,-5,939,497926,15,497911
3932,11,11,461,994207,11,994196
3933,18,4,469,776633,18,776615
3934,15,-10,164,336304,15,336289
3935,19,-20,501,26566,19,26547
3936,11,-15,932,184863,11,184852
3937,18,15,220,1118469,18,1118451
3938,14,12,340,1024610,14,1024596
3939,7,2,714,703720,7,703713
3940,10,-13,478,228405,10,228395
3941,20,-2,395,588041,20,588021
3942,8,-7,937,425848,8,425840
3943,10,-1,549,605933,10,605923
3944,13,4,806,779167,13,779154
3945,16,19,687,1246345,16,1246329
3946,13,2,301,712836,13,712823
3947,16,4,67,773741,16,773725
3948,10,8,473,885480,10,885470
3949,5,16,910,1144046,5,1144041
3950,18,13,670,1058277,18,1058259
3951,7,0,405,634104,7,634097
3952,15,-15,285,179830,15,179815
3953,10,7,101,846975,10,846965
3954,18,3,100,742545,18,742527
3955,20,-20,508,26639,20,26619
3956,19,-8,805,403632,19,403613
3957,18,-10,935,342099,18,342081
3958,6,0,10,625411,6,625405
3959,20,17,807,1183985,20,1183965
3960,9,-5,726,483674,9,483665
3961,10,14,220,1066557,10,1066547
3962,20,15,478,1120140,20,1120120
3963,20,-8,565,401847,20,401827
3964,18,-9,467,370299,18,370281
3965,19,-20,184,24228,19,24209
3966,14,-2,426,588324,14,588310
3967,5,-9,402,352366,5,352361
3968,15,5,748,809237,15,809222
3969,13,6,197,837205,13,837192
3970,11,13,334,1055706,11,1055695
3971,6,-13,726,233886,6,233880
3972,18,-13,27,241285,18,241267
3973,11,-14,878,216347,11,216336
3974,13,-8,763,403285,13,403272
3975,19,-18,576,89437,19,89418
3976,6,9,841,924675,6,924669
3977,7,3,154,722100,7,722093
3978,7,14,560,1074302,7,1074295
3979,5,-11,171,284804,5,284799
3980,6,-18,312,69352,6,69346
3981,13,-5,575,495269,13,495256
3982,6,-18,203,66892,6,66886
3983,6,13,667,1045133,6,1045127
3984,15,-20,57,23203,15,23188
3985,19,19,794,1247203,19,1247184
3986,15,0,934,655333,15,655318
3987,18,-12,591,276818,18,276800
3988,10,0,678,640184,10,640174
3989,8,-5,408,476860,8,476852
3990,6,-17,592,106254,6,106248
3991,19,-15,850,184188,19,184169
3992,17,5,267,805801,17,805784
3993,17,-17,38,115831,17,115814
3994,19,-10,75,335783,19,335764
3995,15,-3,787,560126,15,560111
3996,13,-17,505,119275,13,119262
3997,11,8,294,900283,11,900272
3998,12,4,293,775300,12,775288
3999,19,-11,19,303811,19,303792
4000,8,3,551,730411,8,730403
4001,10,-18,107,64858,10,64848
4002,5,-11,623,294943,5,294938
4003,17,-1,51,616962,17,616945
4004,7,-1,749,609884,7,609877
4005,7,-1,629,607469,7,607462
4006,19,-16,953,153920,19,153901
4007,15,10,156,961062,15,961047
4008,11,6,701,841468,11,841457
4009,12,-2,506,588951,12,588939
4010,18,-1,86,617220,18,617202
4011,19,-17,480,119042,19,119023
4012,5,2,781,704916,5,704911
4013,18,7,727,872295,18,872277
4014,14,-14,751,215302,14,215288
4015,11,-18,882,91598,11,91587
4016,9,9,728,922023,9,922014
4017,11,-6,924,466129,11,466118
4018,8,-2,32,563456,8,563448
4019,9,0,565,637509,9,637500
4020,12,-8,883,404107,12,404095
4021,12,2,945,717506,12,717494
4022,8,10,378,945539,8,945531
4023,14,-13,577,245311,14,245297
4024,6,-8,421,384019,6,384013
4025,10,-14,491,197290,10,197280
4026,17,17,791,1183807,17,1183790
4027,8,0,252,630837,8,630829
4028,6,-3,962,552047,6,552041
4029,17,8,375,900877,17,900860
4030,18,-18,407,88330,18,88312
4031,11,-10,686,340270,11,340259
4032,13,-5,36,491093,13,491080
4033,18,-5,425,494131,18,494113
4034,5,5,872,799945,5,799940
4035,14,10,616,964655,14,964641
4036,5,8,530,886883,5,886878
4037,12,18,136,1210041,12,1210029
4038,10,18,733,1201993,10,1201983
4039,19,-16,286,149054,19,149035
4040,17,14,65,1085968,17,1085951
4041,19,6,721,841614,19,841595
4042,14,-15,84,178413,14,178399
4043,14,18,909,1215587,14,1215573
4044,16,16,5,1147134,16,1147118
4045,18,-3,435,557093,18,557075
4046,16,0,854,654722,16,654706
4047,7,-20,984,21731,7,21724
4048,11,6,407,839038,11,839027
4049,13,6,774,841962,13,841949
4050,18,-20,971,30132,18,30114
4051,6,1,486,667854,6,667848
4052,12,7,534,870965,12,870953
4053,13,7,782,872655,13,872642
4054,5,-12,596,262391,5,262386
4055,15,10,150,961019,15,961004
4056,17,4,588,777514,17,777497
4057,19,4,289,775281,19,775262
4058,20,8,520,902110,20,902090
4059,12,-17,538,119518,12,119506
4060,13,-16,526,150874,13,150861
4061,10,16,232,1130179,10,1130169
4062,18,-4,137,523114,18,523096
4063,20,17,135,1178858,20,1178838
4064,20,18,185,1210489,20,1210469
4065,14,-15,814,183853,14,183839
4066,14,-3,244,555474,14,555460
4067,9,-4,989,520753,9,520744
4068,14,16,212,1148641,14,1148627
4069,5,4,590,763371,5,763366
4070,14,9,897,935702,14,935688
4071,10,19,129,1220274,10,1220264
4072,14,-9,484,370494,14,370480
4073,6,17,524,1166536,6,1166530
4074,16,-3,167,554950,16,554934
4075,17,-2,864,591706,17,591689
4076,11,-20,859,29406,11,29395
4077,19,4,218,774849,19,774830
4078,12,-3,241,555460,12,555448
4079,14,6,320,838261,14,838247
4080,18,-19,592,58680,18,58662
4081,9,11,33,969190,9,969181
4082,10,-14,134,189369,10,189359
4083,16,14,417,1088709,16,1088693
4084,9,-13,374,226194,9,226185
4085,6,3,369,726805,6,726799
4086,7,-17,603,106523,7,106516
4087,13,-14,850,216145,13,216132
4088,16,0,379,650956,16,650940
4089,16,-6,403,462196,16,462180
4090,5,15,684,1108968,5,1108963
4091,10,-15,104,157694,10,157684
4092,10,-16,17,124299,10,124289
4093,5,12,470,1009170,5,1009165
4094,13,19,375,1243801,13,1243788
4095,14,13,100,1053968,14,1053954
4096,7,7,669,859011,7,859004
4097,15,-15,677,182803,15,182788
4098,9,-6,704,451934,9,451925
4099,13,-18,309,87639,13,87626
4100,19,11,771,996424,19,996405
4101,6,8,219,879921,6,879915
4102,13,-8,694,402800,13,402787
4103,19,-11,792,309887,19,309868
4104,20,13,437,1056506,20,1056486
4105,10,-11,676,296023,10,296013
4106,20,12,846,1028437,20,1028417
4107,12,16,166,1148268,12,1148256
4108,8,-12,84,251376,8,251368
4109,9,-18,87,64394,9,64385
4110,11,-17,302,117764,11,117753
4111,6,-1,938,614199,6,614193
4112,5,14,282,1068093,5,1068088
4113,16,14,865,1092171,16,1092155
4114,19,-10,555,339211,19,339192
4115,15,4,677,778224,15,778209
4116,18,7,800,872802,18,872784
4117,19,-15,83,178410,19,178391
4118,17,3,907,748653,17,748636
4119,8,-9,949,364876,8,364868
4120,6,17,262,1160792,6,1160786
4121,17,-11,419,307076,17,307059
4122,11,-19,122,54980,11,54969
4123,14,-14,27,209544,14,209530
4124,15,-3,203,555221,15,555206
4125,10,2,709,703593,10,703583
4126,8,12,596,1011828,8,1011820
4127,15,-9,694,371925,15,371910
4128,6,-4,708,514623,6,514617
4129,9,-18,832,80390,9,80381
4130,7,-1,274,599854,7,599847
4131,7,17,195,1159407,7,1159400
4132,19,15,512,1120485,19,1120466
4133,12,-6,14,459233,12,459221
4134,19,-14,87,210001,19,209982
4135,6,3,483,729151,6,729145
4136,11,-3,376,556576,11,556565
4137,11,7,274,868974,11,868963
4138,5,1,348,664798,5,664793
4139,11,15,883,1123210,11,1123199
4140,14,-19,564,58449,14,58435
4141,7,0,880,644395,7,644388
4142,10,-1,360,602001,10,601991
4143,9,7,830,862418,9,862409
4144,13,-3,747,559722,13,559709
4145,11,-15,980,185201,11,185190
4146,6,-2,502,573461,6,573455
4147,18,4,4,773344,18,773326
4148,18,13,658,1058213,18,1058195
4149,10,15,267,1100249,10,1100239
4150,5,-13,912,238073,5,238068
4151,8,-15,3,155392,8,155384
4152,18,11,493,994444,18,994426
4153,12,11,866,997135,12,997123
4154,12,11,965,997782,12,997770
4155,12,9,679,934051,12,934039
4156,6,-9,852,362599,6,362593
4157,17,-7,512,432183,17,432166
4158,5,-1,233,599005,5,599000
4159,7,17,916,1174986,7,1174979
4160,15,-17,281,117579,15,117564
4161,18,-7,465,431838,18,431820
4162,9,1,455,667149,9,667140
4163,7,-15,609,168512,7,168505
4164,12,11,226,992420,12,992408
4165,13,9,321,931342,13,931329
4166,5,-5,803,485242,5,485237
4167,11,11,11,990950,11,990939
4168,13,17,428,1181100,13,1181087
4169,18,-7,981,435570,18,435552
4170,8,8,228,880146,8,880138
4171,20,8,711,903624,20,903604
4172,17,-16,249,148797,17,148780
4173,18,-13,840,247294,18,247276
4174,11,-15,649,182619,11,182608
4175,8,-14,416,195933,8,195925
4176,20,0,377,650930,20,650910
4177,16,3,989,749441,16,749425
4178,17,-5,933,497906,17,497889
4179,9,-20,400,8634,9,8625
4180,7,4,986,771998,7,771991
4181,11,9,33,929293,11,929282
4182,8,17,664,1169528,8,1169520
4183,13,-10,594,339475,13,339462
4184,15,7,269,868946,15,868931
4185,14,-18,717,90465,14,90451
4186,11,8,784,904151,11,904140
4187,12,17,730,1183350,12,1183338
4188,11,-5,877,497484,11,497473
4189,10,6,795,830204,10,830194
4190,18,12,241,1023830,18,1023812
4191,13,-3,932,561238,13,561225
4192,9,-4,526,510878,9,510869
4193,15,-1,672,621727,15,621712
4194,10,16,133,1127912,10,1127902
4195,19,15,440,1119906,19,1119887
4196,14,-11,426,307157,14,307143
4197,18,-6,927,466149,18,466131
4198,13,9,231,930717,13,930704
4199,20,-18,756,90780,20,90760
4200,8,12,196,1003363,8,1003355
4201,12,15,3,1116741,12,1116729
4202,14,-13,797,246951,14,246937
4203,8,2,780,704904,8,704896
4204,15,-13,149,242102,15,242087
4205,17,14,237,1087268,17,1087251
4206,13,19,999,1248782,13,1248769
4207,7,17,39,1156169,7,1156162
4208,6,12,541,1010762,6,1010756
4209,12,-16,497,150656,12,150644
4210,8,-17,100,95624,8,95616
4211,6,14,826,1080434,6,1080428
4212,17,-10,736,340626,17,340609
4213,12,-1,188,617937,12,617925
4214,17,3,705,747200,17,747183
4215,17,1,71,680316,17,680299
4216,7,4,64,751987,7,751980
4217,13,-1,811,622810,13,622797
4218,12,3,224,743543,12,743531
4219,9,16,125,1127650,9,1127641
4220,11,12,360,1024712,11,1024701
4221,6,19,994,1239436,6,1239430
4222,14,1,32,680023,14,680009
4223,16,2,131,711600,16,711584
4224,18,16,962,1153983,18,1153965
4225,10,7,235,849769,10,849759
4226,7,-1,571,606326,7,606319
4227,11,6,903,842956,11,842945
4228,19,0,745,654021,19,654002
4229,8,-13,938,238699,8,238691
4230,11,-16,366,149574,11,149563
4231,17,14,156,1086702,17,1086685
4232,9,15,99,1096590,9,1096581
4233,8,7,81,846574,8,846566
4234,7,6,864,831751,7,831744
4235,13,-12,937,279556,13,279543
4236,5,4,248,756072,5,756067
4237,15,0,699,653642,15,653627
4238,16,-9,256,368454,16,368438
4239,6,13,722,1046182,6,1046176
4240,13,-9,865,373431,13,373418
4241,6,16,768,1140978,6,1140972
4242,18,9,157,930224,18,930206
4243,11,-19,697,59437,11,59426
4244,5,-5,105,470412,5,470407
4245,8,14,861,1081095,8,1081087
4246,16,12,838,1028311,16,1028295
4247,5,7,92,846830,5,846825
4248,12,13,658,1058215,12,1058203
4249,13,-10,414,338091,13,338078
4250,8,4,256,756165,8,756157
4251,8,-17,6,93593,8,93585
4252,16,6,901,842930,16,842914
4253,12,-19,206,55711,12,55699
4254,9,-1,739,609740,9,609731
4255,11,7,835,873035,11,873024
4256,8,-5,113,470548,8,470540
4257,17,11,387,993727,17,993710
4258,16,8,105,898742,16,898726
4259,8,-5,933,488378,8,488370
4260,9,-18,195,66704,9,66695
4261,14,-12,949,279669,14,279655
4262,13,1,384,682934,13,682921
4263,17,5,599,808177,17,808160
4264,5,9,287,912655,5,912650
4265,14,11,792,996583,14,996569
4266,6,-9,855,362667,6,362661
4267,16,5,72,804344,16,804328
4268,11,11,192,992186,11,992175
4269,18,1,514,683927,18,683909
4270,18,15,53,1117195,18,1117177
4271,18,-7,309,430666,18,430648
4272,6,-1,598,606930,6,606924
4273,5,-14,159,189936,5,189931
4274,17,11,9,990928,17,990911
4275,8,1,773,673803,8,673795
4276,13,2,5,710521,13,710508
4277,20,1,714,685362,20,685342
4278,9,-15,844,173364,9,173355
4279,5,9,990,927846,5,927841
4280,19,-12,299,274740,19,274721
4281,15,0,889,655035,15,655020
4282,7,-3,749,547174,7,547167
4283,20,-2,934,592258,20,592238
4284,9,2,157,691935,9,691926
4285,10,-11,374,289476,10,289466
4286,19,1,563,684351,19,684332
4287,17,-10,824,341298,17,341281
4288,19,-2,996,592681,19,592662
4289,15,-9,785,372768,15,372753
4290,14,-3,359,556431,14,556417
4291,16,13,831,1059460,16,1059444
4292,11,7,859,873192,11,873181
4293,14,-2,381,587922,14,587908
4294,13,7,639,871689,13,871676
4295,8,4,232,755697,8,755689
4296,13,-13,885,247641,13,247628
4297,11,-20,333,25435,11,25424
4298,10,-6,435,446066,10,446056
4299,10,-7,530,417197,10,417187
4300,6,18,932,1206453,6,1206447
4301,7,-19,891,50850,7,50843
4302,13,8,114,898826,13,898813
4303,11,-18,862,91466,11,91455
4304,11,15,779,1122506,11,1122495
4305,9,-17,954,113569,9,113560
4306,16,1,467,683517,16,683501
4307,9,-6,509,447815,9,447806
4308,16,-17,13,115659,16,115643
4309,14,-10,84,335817,14,335803
4310,10,2,233,693557,10,693547
4311,6,9,829,924350,6,924344
4312,10,-7,319,412804,10,412794
4313,6,-14,682,201648,6,201642
4314,20,15,701,1121932,20,1121912
4315,6,-12,253,254948,6,254942
4316,7,11,241,973345,7,973338
4317,14,-3,179,555044,14,555030
4318,18,-2,394,588009,18,587991
4319,10,17,121,1157828,10,1157818
4320,15,1,890,686739,15,686724
4321,11,-5,196,492395,11,492384
4322,8,6,436,822263,8,822255
4323,6,8,526,886783,6,886777
4324,14,8,678,903352,14,903338
4325,8,-15,175,159152,8,159144
4326,14,-5,825,496980,14,496966
4327,8,-12,389,258015,8,258007
4328,19,14,347,1088124,19,1088105
4329,11,9,810,935031,11,935020
4330,11,-14,857,216192,11,216181
4331,10,17,617,1168435,10,1168425
4332,6,17,785,1172026,6,1172020
4333,15,12,28,1022285,15,1022270
4334,9,13,113,1033148,9,1033139
4335,16,1,545,684219,16,684203
4336,16,11,4,990885,16,990869
4337,7,-6,74,438316,7,438309
4338,5,17,130,1157997,5,1157992
4339,11,-13,463,244352,11,244341
4340,5,16,427,1134379,5,1134374
4341,11,4,589,777529,11,777518
4342,16,6,813,842300,16,842284
4343,17,-18,23,85376,17,85359
4344,5,6,779,829738,5,829733
4345,19,-18,452,88663,19,88644
4346,9,16,131,1127830,9,1127821
4347,5,-12,463,259586,5,259581
4348,8,-1,948,614394,8,614386
4349,17,-15,435,181016,17,180999
4350,18,9,332,931429,18,931411
4351,13,-20,323,25349,13,25336
4352,9,-20,350,7703,9,7694
4353,5,17,834,1173251,5,1173246
4354,20,6,557,840244,20,840224
4355,9,16,6,1125322,9,1125313
4356,14,16,685,1152004,14,1151990
4357,14,-19,484,57673,14,57659
4358,11,-13,189,242447,11,242436
4359,20,1,89,680467,20,680447
4360,5,-7,169,409402,5,409397
4361,7,-19,719,47314,7,47307
4362,5,13,701,1045798,5,1045793
4363,11,3,865,748363,11,748352
4364,17,-14,362,212224,17,212207
4365,18,-11,109,304544,18,304526
4366,19,-19,4,53912,19,53893
4367,16,7,469,870503,16,870487
4368,8,-9,434,353190,8,353182
4369,5,-7,453,415513,5,415508
4370,15,-17,724,120977,15,120962
4371,10,-20,61,1280,10,1270
4372,9,-20,686,15196,9,15187
4373,6,5,276,787411,6,787405
4374,14,17,552,1181986,14,1181972
4375,5,0,667,639958,5,639953
4376,6,10,323,944385,6,944379
4377,8,5,819,798726,8,798718
4378,15,-16,499,150677,15,150662
4379,13,-16,164,148123,13,148110
4380,11,7,544,871049,11,871038
4381,12,-6,74,459611,12,459599
4382,14,3,822,748012,14,747998
4383,19,-19,918,60913,19,60894
4384,10,-4,933,519378,10,519368
4385,20,-9,297,368737,20,368717
4386,20,-6,636,464032,20,464012
4387,17,-4,860,528423,17,528406
4388,18,14,616,1090209,18,1090191
4389,12,3,858,748293,12,748281
4390,9,13,747,1046754,9,1046745
4391,10,-2,176,566419,10,566409
4392,10,-1,898,613259,10,613249
4393,6,2,46,689585,6,689579
4394,16,11,799,996661,16,996645
4395,11,-19,471,57592,11,57581
4396,19,-16,559,151108,19,151089
4397,10,-17,505,104385,10,104375
4398,12,-18,273,87378,12,87366
4399,15,-9,372,369431,15,369416
4400,14,-6,450,462563,14,462549
4401,14,6,275,837855,14,837841
4402,8,11,272,974063,8,974055
4403,19,-8,213,399415,19,399396
4404,20,11,563,994898,20,994878
4405,17,12,210,1023603,17,1023586
4406,19,2,165,711839,19,711820
4407,13,-19,710,59532,13,59519
4408,15,7,203,868438,15,868423
4409,14,-12,482,276053,14,276039
4410,13,-8,950,404623,13,404610
4411,17,-2,19,585271,17,585254
4412,13,17,620,1182445,13,1182432
4413,8,13,999,1052191,8,1052183
4414,7,-19,375,39577,7,39570
4415,8,-7,428,415046,8,415038
4416,13,10,203,961365,13,961352
4417,13,19,413,1244203,13,1244190
4418,6,-19,366,39393,6,39387
4419,13,6,529,840081,13,840068
4420,7,-3,756,547357,7,547350
4421,19,17,33,1178120,19,1178101
4422,14,-8,144,398907,14,398893
4423,17,-12,170,273750,17,273733
4424,10,-2,245,568012,10,568002
4425,12,15,602,1121191,12,1121179
4426,9,17,74,1156915,9,1156906
4427,6,-4,860,517782,6,517776
4428,12,-8,791,403538,12,403526
4429,16,10,123,960857,16,960841
4430,16,1,345,682646,16,682630
4431,7,11,897,987802,7,987795
4432,10,18,938,1206548,10,1206538
4433,18,11,218,992369,18,992351
4434,17,2,662,715554,17,715537
4435,16,-8,762,403273,16,403257
4436,13,-5,871,497388,13,497375
4437,7,-12,786,266466,7,266459
4438,11,7,388,869890,11,869879
4439,20,10,642,964869,20,964849
4440,12,-17,265,117427,12,117415
4441,7,-17,141,96376,7,96369
4442,11,5,394,806665,11,806654
4443,20,17,643,1182627,20,1182607
4444,20,5,102,804533,20,804513
4445,15,-19,982,61342,15,61327
4446,9,-5,763,484455,9,484446
4447,19,-14,545,213674,19,213655
4448,13,-20,934,29893,13,29880
4449,12,-13,18,241170,12,241158
4450,17,12,539,1026008,17,1025991
4451,7,-6,51,437917,7,437910
4452,18,-5,552,495102,18,495084
4453,13,1,226,681688,13,681675
4454,11,2,933,717384,11,717373
4455,19,-7,292,430530,19,430511
4456,5,4,525,761951,5,761946
4457,15,16,958,1153914,15,1153899
4458,6,-10,292,318833,6,318827
4459,7,-2,886,581830,7,581823
4460,6,4,197,754878,6,754872
4461,7,-20,435,9286,7,9279
4462,7,-16,676,138561,7,138554
4463,9,12,123,1001804,9,1001795
4464,9,-5,740,484007,9,483998
4465,11,-9,83,367272,11,367261
4466,15,8,499,901910,15,901895
4467,11,-5,267,493013,11,493002
4468,19,-13,613,245604,19,245585
4469,14,12,658,1026918,14,1026904
4470,12,-16,463,150474,12,150462
4471,15,14,93,1086176,15,1086161
4472,11,-2,838,591510,11,591499
4473,10,12,350,1006764,10,1006754
4474,12,6,781,842008,12,841996
4475,5,6,168,815801,5,815796
4476,12,4,74,773784,12,773772
4477,13,-5,561,495181,13,495168
4478,11,8,929,905178,11,905167
4479,7,7,803,861763,7,861756
4480,5,-13,257,223847,5,223842
4481,9,12,601,1012041,9,1012032
4482,12,-18,492,88906,12,88894
4483,11,19,589,1245578,11,1245567
4484,20,7,143,868083,20,868063
4485,9,-4,677,514019,9,514010
4486,13,-8,407,400786,13,400773
4487,12,-8,967,404766,12,404754
4488,11,-15,265,179672,11,179661
4489,10,-10,723,328193,10,328183
4490,15,2,137,711628,15,711613
4491,8,-15,880,174147,8,174139
4492,13,-8,723,402996,13,402983
4493,9,3,206,723298,9,723289
4494,10,7,147,847908,10,847898
4495,14,0,861,654761,14,654747
4496,18,11,636,995386,18,995368
4497,9,5,141,784510,9,784501
4498,17,-16,595,151379,17,151362
4499,5,-20,794,17517,5,17512
4500,17,-14,265,211486,17,211469
4501,14,-3,397,556707,14,556693
4502,10,7,336,852075,10,852065
4503,6,-18,503,73292,6,73286
4504,8,-4,345,507058,8,507050
4505,19,-7,710,433479,19,433460
4506,16,18,526,1212847,16,1212831
4507,10,17,865,1174010,10,1174000
4508,20,1,869,686570,20,686550
4509,11,15,453,1119989,11,1119978
4510,15,-14,624,214416,15,214401
4511,14,6,913,843066,14,843052
4512,12,8,811,904332,12,904320
4513,19,8,752,903874,19,903855
4514,17,-2,18,585265,17,585248
4515,18,15,483,1120223,18,1120205
4516,17,-12,347,275128,17,275111
4517,11,-12,963,279794,11,279783
4518,11,16,83,1147662,11,1147651
4519,13,-18,621,89708,13,89695
4520,13,-18,127,86188,13,86175
4521,6,-5,365,476121,6,476115
4522,20,14,134,1086528,20,1086508
4523,17,-8,711,402911,17,402894
4524,14,-13,830,247184,14,247170
4525,15,9,321,931347,15,931332
4526,13,18,21,1209036,13,1209023
4527,6,-19,847,50061,6,50055
4528,16,13,388,1056099,16,1056083
4529,8,-16,433,133450,8,133442
4530,15,17,380,1180776,15,1180761
4531,17,6,710,841527,17,841510
4532,5,-10,336,319842,5,319837
4533,15,-5,654,495787,15,495772
4534,8,10,601,950492,8,950484
4535,11,6,564,840320,11,840309
4536,14,1,954,687304,14,687290
4537,8,0,420,634471,8,634463
4538,15,-6,660,464160,15,464145
4539,9,3,463,728736,9,728727
4540,11,14,395,1088481,11,1088470
4541,15,-2,575,589445,15,589430
4542,9,13,628,1044311,9,1044302
4543,10,15,133,1097374,10,1097364
4544,15,-5,270,493029,15,493014
4545,10,13,801,1047983,10,1047973
4546,5,-20,513,11041,5,11036
4547,10,16,303,1131574,10,1131564
4548,19,15,586,1121050,19,1121031
4549,6,11,32,969162,6,969156
4550,17,15,965,1123875,17,1123858
4551,13,16,927,1153752,13,1153739
4552,7,-15,253,160844,7,160837
4553,19,0,434,651374,19,651355
4554,9,-2,983,583845,9,583836
4555,6,-13,433,227452,6,227446
4556,18,-8,848,403890,18,403872
4557,14,-16,744,152331,14,152317
4558,12,19,900,1248077,12,1248065
4559,9,-19,201,36046,9,36037
4560,7,8,604,888379,7,888372
4561,5,-3,729,546777,5,546772
4562,8,4,719,766139,8,766131
4563,13,-9,782,372739,13,372726
4564,16,-1,173,617855,16,617839
4565,10,-8,822,392958,10,392948
4566,17,17,136,1178864,17,1178847
4567,9,-17,174,97055,9,97046
4568,5,-8,588,387715,5,387710
4569,11,9,674,934025,11,934014
4570,6,13,918,1050273,6,1050267
4571,13,10,66,960338,13,960325
4572,6,17,194,1159361,6,1159355
4573,5,7,248,850098,5,850093
4574,13,-14,488,213253,13,213240
4575,6,-7,66,407362,6,407356
4576,15,-8,593,401987,15,401972
4577,10,-5,441,477527,10,477517
4578,6,-6,581,449262,6,449256
4579,10,18,360,1194465,10,1194455
4580,10,19,397,1226567,10,1226557
4581,13,1,761,685789,13,685776
4582,14,0,833,654589,14,654575
4583,12,-20,444,26168,12,26156
4584,9,-9,824,361939,9,361930
4585,20,8,499,901920,20,901900
4586,17,7,375,869750,17,869733
4587,17,-1,948,623785,17,623768
4588,15,3,876,748403,15,748388
4589,12,-17,955,122506,12,122494
4590,14,-10,939,342167,14,342153
4591,13,14,550,1089758,13,1089745
4592,18,1,972,687424,18,687406
4593,10,-12,2,249650,10,249640
4594,10,14,354,1069581,10,1069571
4595,12,-8,460,401035,12,401023
4596,17,14,363,1088244,17,1088227
4597,7,12,412,1007886,7,1007879
4598,19,16,965,1154022,19,1154003
4599,14,13,699,1058492,14,1058478
4600,14,-9,681,371808,14,371794
4601,17,-11,142,304838,17,304821
4602,9,-2,54,564067,9,564058
4603,13,-11,655,308962,13,308949
4604,11,-12,128,273499,11,273488
4605,7,8,26,875655,7,875648
4606,8,9,108,909041,8,909033
4607,17,-3,569,558297,17,558280
4608,15,14,649,1090517,15,1090502
4609,17,1,446,683347,17,683330
4610,6,-4,146,502525,6,502519
4611,16,-2,598,589599,16,589583
4612,5,9,918,926254,5,926249
4613,11,-2,918,592122,11,592111
4614,13,0,782,654216,13,654203
4615,15,15,994,1124098,15,1124083
4616,5,19,38,1218213,5,1218208
4617,9,-11,426,290639,9,290630
4618,7,-4,566,511594,7,511587
4619,17,-18,652,90014,17,89997
4620,15,7,456,870435,15,870420
4621,10,7,583,857200,10,857190
4622,14,-14,627,214443,14,214429
4623,8,-9,711,359250,8,359242
4624,9,-4,417,508696,9,508687
4625,15,14,916,1092575,15,1092560
4626,13,-7,570,432592,13,432579
4627,5,11,163,971836,5,971831
4628,5,-14,287,192978,5,192973
4629,11,14,664,1090636,11,1090625
4630,20,5,490,807390,20,807370
4631,18,19,143,1241928,18,1241910
4632,18,14,453,1088994,18,1088976
4633,11,9,787,934852,11,934841
4634,19,-18,921,91897,19,91878
4635,5,16,344,1132458,5,1132453
4636,12,-10,60,335638,12,335626
4637,9,-1,555,606062,9,606053
4638,19,18,957,1215996,19,1215977
4639,10,1,625,670851,10,670841
4640,17,-7,955,435400,17,435383
4641,18,-3,778,560071,18,560053
4642,5,19,469,1228204,5,1228199
4643,11,11,21,991013,11,991002
4644,12,-16,839,153036,12,153024
4645,17,-18,645,89929,17,89912
4646,7,16,850,1142749,7,1142742
4647,15,4,498,776819,15,776804
4648,16,-7,660,433069,16,433053
4649,8,-4,362,507494,8,507486
4650,15,4,706,778402,15,778387
4651,5,13,109,1033068,5,1033063
4652,6,-10,113,314978,6,314972
4653,14,17,128,1178801,14,1178787
4654,19,-8,779,403428,19,403409
4655,5,-19,915,51177,5,51172
4656,12,19,736,1246765,12,1246753
4657,15,18,431,1212209,15,1212194
4658,16,19,231,1242552,16,1242536
4659,14,-20,617,27471,14,27457
4660,13,-17,403,118424,13,118411
4661,19,-9,571,371243,19,371224
4662,10,7,976,865410,10,865400
4663,18,-4,271,524175,18,524157
4664,12,-17,364,118172,12,118160
4665,7,-14,504,197517,7,197510
4666,16,16,502,1150657,16,1150641
4667,19,-4,870,528539,19,528520
4668,5,-12,467,259662,5,259657
4669,11,-13,936,248110,11,248099
4670,5,6,621,826306,5,826301
4671,16,-16,364,149570,16,149554
4672,16,-6,126,460015,16,459999
4673,12,3,382,744733,12,744721
4674,5,-12,754,265841,5,265836
4675,10,11,213,972708,10,972698
4676,19,12,13,1022179,19,1022160
4677,13,-7,884,434809,13,434796
4678,12,19,328,1243412,12,1243400
4679,15,-10,132,336093,15,336078
4680,12,-3,455,557287,12,557275
4681,17,-4,788,527911,17,527894
4682,5,-8,824,392971,5,392966
4683,20,-1,199,618044,20,618024
4684,19,-8,5,397877,19,397858
4685,9,-2,88,564693,9,564684
4686,12,8,864,904675,12,904663
4687,12,9,915,935885,12,935873
4688,9,18,417,1195629,9,1195620
4689,7,15,663,1108488,7,1108481
4690,7,19,986,1239287,7,1239280
4691,6,-12,143,252639,6,252633
4692,16,18,207,1210687,16,1210671
4693,5,-15,591,168139,5,168134
4694,20,-5,234,492711,20,492691
4695,5,14,6,1061811,5,1061806
4696,14,-5,688,496048,14,496034
4697,18,16,267,1149039,18,1149021
4698,18,18,4,1208932,18,1208914
4699,14,5,801,809597,14,809583
4700,6,18,395,1195142,6,1195136
4701,8,-10,322,319511,8,319503
4702,18,-6,693,464471,18,464453
4703,14,-12,925,279493,14,279479
4704,15,-4,889,528745,15,528730
4705,17,11,980,997900,17,997883
4706,19,-3,974,561556,19,561537
4707,16,-4,392,525175,16,525159
4708,19,11,496,994464,19,994445
4709,6,15,603,1107263,6,1107257
4710,19,6,220,837363,19,837344
4711,14,16,811,1152928,14,1152914
4712,11,8,550,902271,11,902260
4713,7,-5,298,474654,7,474647
4714,19,10,380,962658,19,962639
4715,11,-13,818,247097,11,247086
4716,11,-15,607,182218,11,182207
4717,7,7,698,859559,7,859552
4718,15,14,111,1086349,15,1086334
4719,18,-9,114,367430,18,367412
4720,19,-13,910,247852,19,247833
4721,14,4,302,775365,14,775351
4722,13,-7,483,431958,13,431945
4723,7,-15,722,170923,7,170916
4724,17,-1,810,622795,17,622778
4725,8,7,433,854111,8,854103
4726,15,16,848,1153171,15,1153156
4727,13,-5,68,491355,13,491342
4728,13,-11,189,305242,13,305229
4729,20,-13,781,246862,20,246842
4730,9,-3,342,537943,9,537934
4731,12,9,300,931149,12,931137
4732,14,15,902,1123358,14,1123344
4733,11,-16,524,150856,11,150845
4734,17,4,349,775735,17,775718
4735,20,7,427,870193,20,870173
4736,5,6,305,819097,5,819092
4737,7,11,608,981484,7,981477
4738,12,10,764,965732,12,965720
4739,17,-13,137,241979,17,241962
4740,10,-19,605,44772,10,44762
4741,6,8,554,887352,6,887346
4742,19,7,517,870870,19,870851
4743,8,7,510,855747,8,855739
4744,18,0,547,652369,18,652351
4745,11,-15,859,184279,11,184268
4746,15,9,569,933247,15,933232
4747,14,18,413,1212103,14,1212089
4748,12,-16,932,153790,12,153778
4749,5,-10,499,323447,5,323442
4750,18,-6,229,460963,18,460945
4751,14,18,301,1211281,14,1211267
4752,8,-2,953,583217,8,583209
4753,14,1,799,686090,14,686076
4754,16,3,625,746521,16,746505
4755,18,-9,251,368429,18,368411
4756,9,4,323,757471,9,757462
4757,12,16,128,1147974,12,1147962
4758,15,-4,752,527652,15,527637
4759,8,6,53,813317,8,813309
4760,15,0,287,650218,15,650203
4761,18,-6,251,461106,18,461088
4762,14,2,296,712823,14,712809
4763,15,-17,375,118255,15,118240
4764,19,15,180,1118152,19,1118133
4765,13,2,574,714881,13,714868
4766,12,17,253,1179791,12,1179779
4767,16,14,870,1092234,16,1092218
4768,14,17,596,1182270,14,1182256
4769,20,11,240,992529,20,992509
4770,7,-12,56,250773,7,250766
4771,14,19,789,1247187,14,1247173
4772,13,-3,370,556515,13,556502
4773,6,5,598,794050,6,794044
4774,15,16,171,1148303,15,1148288
4775,11,15,975,1123967,11,1123956
4776,18,8,733,903786,18,903768
4777,19,1,169,681201,19,681182
4778,5,6,700,828193,5,828188
4779,17,9,871,935502,17,935485
4780,5,-17,915,112855,5,112850
4781,19,8,768,904037,19,904018
4782,16,-12,894,279211,16,279195
4783,16,-17,951,122494,16,122478
4784,14,-17,885,122071,14,122057
4785,16,-19,883,60760,16,60744
4786,17,-10,717,340445,17,340428
4787,13,-17,169,116716,13,116703
4788,12,-20,472,26323,12,26311
4789,6,19,152,1220818,6,1220812
4790,10,15,187,1098488,10,1098478
4791,15,-4,357,524908,15,524893
4792,7,-7,734,421380,7,421373
4793,7,-13,1000,240026,7,240019
4794,16,4,991,780508,16,780492
4795,6,-19,54,32601,6,32595
4796,15,6,46,836149,15,836134
4797,7,3,786,735668,7,735661
4798,18,5,458,807136,18,807118
4799,14,7,2,867020,14,867006
4800,7,10,88,939441,7,939434
4801,18,-6,398,462157,18,462139
4802,18,4,114,774092,18,774074
4803,18,-1,205,618139,18,618121
4804,15,3,917,748750,15,748735
4805,12,0,568,652521,12,652509
4806,12,-4,20,522185,12,522173
4807,5,-2,931,582728,5,582723
4808,5,-4,286,505752,5,505747
4809,19,-8,799,403596,19,403577
4810,16,4,162,774433,16,774417
4811,11,0,785,654221,11,654210
4812,12,-15,517,181571,12,181559
4813,11,9,22,929190,11,929179
4814,11,-18,723,90524,11,90513
4815,7,16,38,1125973,7,1125966
4816,11,5,241,805610,11,805599
4817,9,3,939,739224,9,739215
4818,10,18,124,1189517,10,1189507
4819,7,11,279,974224,7,974217
4820,19,-5,99,491686,19,491667
4821,6,0,587,638087,6,638081
4822,10,-9,534,355750,10,355740
4823,5,-9,615,357314,5,357309
4824,12,-10,196,336509,12,336497
4825,5,6,343,820073,5,820068
4826,15,4,213,774799,15,774784
4827,17,-13,661,245833,17,245816
4828,11,-17,504,119253,11,119242
4829,8,3,664,733105,8,733097
4830,19,-19,793,60146,19,60127
4831,11,10,104,960695,11,960684
4832,6,-18,86,64350,6,64344
4833,12,4,703,778377,12,778365
4834,19,-4,884,528710,19,528691
4835,10,1,892,676398,10,676388
4836,15,-2,491,588853,15,588838
4837,8,17,666,1169619,8,1169611
4838,10,17,181,1159055,10,1159045
4839,13,13,217,1054844,13,1054831
4840,9,12,989,1020900,9,1020891
4841,10,-16,733,139742,10,139732
4842,14,-8,976,404855,14,404841
4843,10,4,848,769373,10,769363
4844,19,7,80,867607,19,867588
4845,19,3,383,744749,19,744730
4846,7,7,788,861491,7,861484
4847,16,4,673,778163,16,778147
4848,18,8,77,898504,18,898486
4849,12,-2,149,586196,12,586184
4850,13,-6,32,459409,13,459396
4851,5,9,824,924210,5,924205
4852,10,-20,566,12353,10,12343
4853,10,-4,315,506365,10,506355
4854,16,-1,741,622280,16,622264
4855,9,4,72,752173,9,752164
4856,20,-12,462,275871,20,275851
4857,12,6,612,840673,12,840661
4858,16,-15,149,178911,16,178895
4859,17,-5,845,497158,17,497141
4860,11,4,106,774044,11,774033
4861,5,2,953,708511,5,708506
4862,12,18,868,1215281,12,1215269
4863,11,16,558,1151054,11,1151043
4864,16,-16,236,148715,16,148699
4865,9,-4,555,511405,9,511396
4866,11,15,397,1119649,11,1119638
4867,15,7,238,868669,15,868654
4868,17,-6,489,462918,17,462901
4869,13,-4,68,522541,13,522528
4870,7,17,399,1163811,7,1163804
4871,8,-15,128,158265,8,158257
4872,6,-19,964,52156,6,52150
4873,15,13,115,1054065,15,1054050
4874,14,18,530,1212865,14,1212851
4875,8,2,540,700073,8,700065
4876,17,-4,356,524895,17,524878
4877,9,19,319,1224660,9,1224651
4878,14,-4,691,527300,14,527286
4879,20,-9,465,370247,20,370227
4880,16,-13,776,246834,16,246818
4881,17,-11,107,304533,17,304516
4882,8,3,21,719268,8,719260
4883,19,8,838,904485,19,904466
4884,15,10,465,963404,15,963389
4885,14,5,215,805430,14,805416
4886,19,13,370,1055943,19,1055924
4887,6,0,85,627124,6,627118
4888,14,-14,463,213077,14,213063
4889,9,-17,6,93602,9,93593
4890,18,1,722,685452,18,685434
4891,7,14,288,1068175,7,1068168
4892,7,-20,247,5519,7,5512
4893,6,-12,596,262397,6,262391
4894,13,10,76,960429,13,960416
4895,18,12,524,1025862,18,1025844
4896,19,2,320,712966,19,712947
4897,5,15,499,1104984,5,1104979
4898,5,-11,857,299488,5,299483
4899,5,19,377,1226027,5,1226022
4900,13,3,652,746767,13,746754
4901,19,7,731,872353,19,872334
4902,6,9,568,918716,6,918710
4903,19,-4,58,522472,19,522453
4904,18,14,45,1085771,18,1085753
4905,11,-8,707,402886,11,402875
4906,6,-15,136,158389,6,158383
4907,15,-4,932,529041,15,529026
4908,19,6,90,836409,19,836390
4909,17,-15,674,182783,17,182766
4910,10,-20,533,11526,10,11516
4911,14,-13,603,245479,14,245465
4912,18,9,878,935592,18,935574
4913,18,-10,297,337202,18,337184
4914,12,4,451,776475,12,776463
4915,14,5,570,807927,14,807913
4916,9,-3,381,538809,9,538800
4917,15,-7,708,433459,15,433444
4918,20,-3,563,558233,20,558213
4919,8,19,578,1230579,8,1230571
4920,12,-3,626,558764,12,558752
4921,6,-11,336,288498,6,288492
4922,19,-9,840,373165,19,373146
4923,18,-15,411,180793,18,180775
4924,5,-16,489,134718,5,134713
4925,6,-3,844,549239,6,549233
4926,14,-11,627,308711,14,308697
4927,16,-14,906,216558,16,216542
4928,10,-1,83,595602,10,595592
4929,14,0,165,649483,14,649469
4930,20,-3,649,558962,20,558942
4931,14,-10,164,336308,14,336294
4932,18,-7,99,428975,18,428957
4933,5,9,942,926751,5,926746
4934,6,-12,845,267918,6,267912
4935,19,-19,93,54635,19,54616
4936,18,3,998,749526,18,749508
4937,15,-4,610,526682,15,526667
4938,16,10,887,966598,16,966582
4939,12,-11,135,304784,12,304772
4940,9,13,406,1039541,9,1039532
4941,13,-4,582,526482,13,526469
4942,13,-19,984,61365,13,61352
4943,17,-12,214,274058,17,274041
4944,12,-17,693,120687,12,120675
4945,14,19,973,1248600,14,1248586
4946,18,-16,212,148515,18,148497
4947,7,11,476,978611,7,978604
4948,8,13,222,1035479,8,1035471
4949,12,17,972,1185230,12,1185218
4950,19,-7,103,429026,19,429007
4951,16,7,733,872359,16,872343
4952,9,3,332,726159,9,726150
4953,9,-5,738,483970,9,483961
4954,20,19,7,1240693,20,1240673
4955,7,-3,102,532604,7,532597
4956,6,12,841,1017449,6,1017443
4957,12,-19,346,56704,12,56692
4958,5,1,30,657684,5,657679
4959,20,-15,860,184291,20,184271
4960,17,4,674,778180,17,778163
4961,5,16,575,1137260,5,1137255
4962,10,-12,175,253261,10,253251
4963,16,-14,191,210773,16,210757
4964,16,-15,854,184235,16,184219
4965,13,1,93,680519,13,680506
4966,10,-11,969,302005,10,301995
4967,16,17,184,1179263,16,1179247
4968,7,8,780,892398,7,892391
4969,7,4,891,770220,7,770213
4970,7,-13,578,230684,7,230677
4971,10,3,410,727591,10,727581
4972,18,7,156,868154,18,868136
4973,20,-7,173,429612,20,429592
4974,11,12,45,1022424,11,1022413
4975,8,-3,47,531575,8,531567
4976,14,-20,54,23187,14,23173
4977,9,5,976,802238,9,802229
4978,15,-16,786,152690,15,152675
4979,14,-2,996,592685,14,592671
4980,19,5,532,807668,19,807649
4981,9,-8,789,392238,9,392229
4982,10,-4,413,508583,10,508573
4983,5,18,895,1205711,5,1205706
4984,12,-7,869,434651,12,434639
4985,18,-12,437,275669,18,275651
4986,11,19,857,1247733,11,1247722
4987,14,-18,16,85320,14,85306
4988,11,4,935,780136,11,780125
4989,16,5,949,810768,16,810752
4990,6,10,230,942405,6,942399
4991,14,-15,245,179535,14,179521
4992,10,1,276,663171,10,663161
4993,12,17,458,1181365,12,1181353
4994,7,-16,575,136500,7,136493
4995,16,-13,705,246188,16,246172
4996,8,18,767,1202899,8,1202891
4997,13,-9,570,371230,13,371217
4998,17,-3,499,557639,17,557622
4999,6,-16,237,129250,6,129244
5000,11,19,588,1245571,11,1245560
5001,8,-6,479,447051,8,447043
5002,14,3,399,744873,14,744859
5003,6,-9,800,361472,6,361466
5004,8,-16,148,127217,8,127209
5005,7,7,459,854657,7,854650
5006,15,17,376,1180742,15,1180727
5007,13,14,259,1087435,13,1087422
5008,19,6,112,836630,19,836611
5009,18,-8,398,400735,18,400717
5010,20,14,83,1086063,20,1086043
5011,20,8,848,904562,20,904542
5012,12,-4,572,526393,12,526381
5013,10,-15,317,162251,10,162241
5014,12,-8,476,401138,12,401126
5015,16,-20,726,28361,16,28345
5016,5,8,753,891734,5,891729
5017,5,4,161,754035,5,754030
5018,12,-12,658,277372,12,277360
5019,9,-10,84,314493,9,314484
5020,17,9,589,933426,17,933409
5021,10,-17,634,107187,10,107177
5022,10,-2,345,570094,10,570084
5023,17,6,314,838165,17,838148
5024,20,-4,222,523853,20,523833
5025,9,19,318,1224642,9,1224633
5026,19,8,336,900627,19,900608
5027,9,-9,947,364815,9,364806
5028,5,8,141,878133,5,878128
5029,6,-9,182,347427,6,347421
5030,18,5,807,809663,18,809645
5031,12,13,763,1058959,12,1058947
5032,18,-20,502,26595,18,26577
5033,9,-9,917,364271,9,364262
5034,13,11,787,996538,13,996525
5035,17,-7,124,429206,17,429189
5036,20,-2,907,592045,20,592025
5037,12,-8,327,400194,12,400182
5038,12,3,12,741895,12,741883
5039,19,10,364,962585,19,962566
5040,18,-1,749,622323,18,622305
5041,15,14,332,1088044,15,1088029
5042,8,-12,26,250146,8,250138
5043,6,-5,780,484689,6,484683
5044,10,-7,99,407951,10,407941
5045,11,18,273,1211153,11,1211142
5046,18,-18,465,88792,18,88774
5047,13,0,556,652420,13,652407
5048,5,-14,115,188986,5,188981
5049,14,-15,156,178948,14,178934
5050,20,2,712,715978,20,715958
5051,11,11,427,993976,11,993965
5052,12,-10,56,335576,12,335564
5053,11,-4,369,524972,11,524961
5054,5,17,405,1163904,5,1163899
5055,11,-11,99,304468,11,304457
5056,17,-13,561,245152,17,245135
5057,16,9,71,929589,16,929573
5058,13,15,171,1118063,13,1118050
5059,6,-18,533,73857,6,73851
5060,9,1,545,669285,9,669276
5061,13,-18,2,85205,13,85192
5062,14,-16,761,152502,14,152488
5063,10,5,826,798872,10,798862
5064,20,-16,12,146829,20,146809
5065,8,-3,374,538599,8,538591
5066,17,9,194,930472,17,930455
5067,18,-12,274,274557,18,274539
5068,17,3,335,744424,17,744407
5069,7,15,250,1099889,7,1099882
5070,19,-7,762,433832,19,433813
5071,20,-19,979,61335,20,61315
5072,10,-12,141,252581,10,252571
5073,16,-18,420,88436,16,88420
5074,5,19,456,1228004,5,1227999
5075,9,-14,462,196659,9,196650
5076,9,-11,359,289093,9,289084
5077,16,0,379,650962,16,650946
5078,20,-6,727,464715,20,464695
5079,18,8,277,900141,18,900123
5080,20,14,834,1091967,20,1091947
5081,16,-19,895,60812,16,60796
5082,12,6,242,837583,12,837571
5083,16,8,837,904449,16,904433
5084,7,13,706,1045898,7,1045891
5085,8,17,669,1169682,8,1169674
5086,8,4,36,751349,8,751341
5087,5,-4,244,504954,5,504949
5088,19,5,54,804235,19,804216
5089,10,2,672,702815,10,702805
5090,5,-10,294,318866,5,318861
5091,13,-19,978,61318,13,61305
5092,14,-4,165,523328,14,523314
5093,17,3,991,749452,17,749435
5094,10,12,670,1013768,10,1013758
5095,7,19,710,1233218,7,1233211
5096,16,-15,384,180579,16,180563
5097,10,-7,402,414651,10,414641
5098,19,-5,964,498120,19,498101
5099,15,1,249,681867,15,681852
5100,17,-13,40,241347,17,241330
5101,15,1,606,684614,15,684599
5102,17,3,474,745378,17,745361
5103,9,18,958,1207043,9,1207034
5104,15,-17,351,118093,15,118078
5105,9,19,103,1219773,9,1219764
5106,14,18,296,1211262,14,1211248
5107,19,-1,340,619293,19,619274
5108,10,6,299,818976,10,818966
5109,9,9,483,916897,9,916888
5110,12,11,71,991405,12,991393
5111,18,2,616,715175,18,715157
5112,6,-4,299,505990,6,505984
5113,16,-5,699,496143,16,496127
5114,14,-20,507,26630,14,26616
5115,9,-9,891,363622,9,363613
5116,9,12,446,1008600,9,1008591
5117,9,14,276,1067948,9,1067939
5118,12,-16,959,153985,12,153973
5119,8,-2,125,565525,8,565517
5120,10,-13,59,219690,10,219680
5121,8,-10,64,314022,8,314014
5122,19,15,751,1122391,19,1122372
5123,20,6,403,839010,20,838990
5124,10,9,500,917242,10,917232
5125,10,-7,377,414082,10,414072
5126,5,15,71,1095951,5,1095946
5127,7,-16,161,127470,7,127463
5128,20,1,484,683692,20,683672
5129,10,14,225,1066742,10,1066732
5130,15,1,123,680788,15,680773
5131,9,-5,801,485211,9,485202
5132,10,19,624,1231468,10,1231458
5133,12,16,851,1153178,12,1153166
5134,20,15,283,1118891,20,1118871
5135,18,10,608,964600,18,964582
5136,10,-12,141,252591,10,252581
5137,19,-15,136,178829,19,178810
5138,5,15,571,1106579,5,1106574
5139,10,-8,123,377951,10,377941
5140,8,-12,803,266836,8,266828
5141,16,5,236,805577,16,805561
5142,15,10,122,960851,15,960836
5143,10,-16,92,125981,10,125971
5144,18,4,64,773717,18,773699
5145,16,-5,893,497578,16,497562
5146,12,12,335,1024584,12,1024572
5147,10,19,97,1219614,10,1219604
5148,12,1,703,685284,12,685272
5149,11,8,762,903982,11,903971
5150,18,-9,437,370039,18,370021
5151,10,8,788,892507,10,892497
5152,9,-5,820,485647,9,485638
5153,7,-17,236,98456,7,98449
5154,7,3,2,718907,7,718900
5155,11,-3,55,554176,11,554165
5156,18,-7,387,431271,18,431253
5157,12,10,695,965254,12,965242
5158,12,2,656,715513,12,715501
5159,14,17,106,1178603,14,1178589
5160,18,-17,395,118400,18,118382
5161,15,-16,790,152723,15,152708
5162,12,3,848,748216,12,748204
5163,16,11,804,996675,16,996659
5164,13,-10,52,335538,13,335525
5165,7,4,584,763160,7,763153
5166,17,0,794,654298,17,654281
5167,14,10,381,962667,14,962653
5168,13,-6,861,465637,13,465624
5169,17,-18,315,87706,17,87689
5170,9,-20,306,6844,9,6835
5171,7,15,423,1103342,7,1103335
5172,15,7,374,869713,15,869698
5173,20,6,223,837416,20,837396
5174,20,2,453,714037,20,714017
5175,10,-19,247,37016,10,37006
5176,12,-18,514,89030,12,89018
5177,11,9,305,931197,11,931186
5178,12,15,849,1122968,12,1122956
5179,18,11,825,996807,18,996789
5180,18,-19,147,55185,18,55167
5181,13,-4,5,522068,13,522055
5182,12,-19,758,59922,12,59910
5183,6,-19,7,31606,6,31600
5184,6,-9,135,346417,6,346411
5185,9,1,319,664138,9,664129
5186,11,-20,632,27573,11,27562
5187,7,9,346,914026,7,914019
5188,15,-3,283,555772,15,555757
5189,15,14,601,1090082,15,1090067
5190,17,-13,176,242315,17,242298
5191,7,10,293,943679,7,943672
5192,17,13,180,1054523,17,1054506
5193,11,-19,477,57633,11,57622
5194,11,-14,692,214947,11,214936
5195,5,-9,630,357531,5,357526
5196,8,-9,200,347819,8,347811
5197,9,0,465,635485,9,635476
5198,9,-2,114,565326,9,565317
5199,13,6,547,840174,13,840161
5200,13,2,821,716588,13,716575
5201,15,-17,599,120019,15,120004
5202,10,16,784,1141357,10,1141347
5203,12,-19,658,59139,12,59127
5204,11,-10,559,339221,11,339210
5205,8,5,21,782018,8,782010
5206,5,2,322,695556,5,695551
5207,17,-4,7,522105,17,522088
5208,9,2,833,705948,9,705939
5209,15,3,695,747162,15,747147
5210,14,-6,873,465683,14,465669
5211,10,0,703,640745,10,640735
5212,9,9,506,917403,9,917394
5213,13,-6,986,466612,13,466599
5214,10,13,53,1031906,10,1031896
5215,8,-11,901,300489,8,300481
5216,9,9,915,926210,9,926201
5217,14,-7,954,435388,14,435374
5218,14,-13,527,244925,14,244911
5219,6,18,116,1189336,6,1189330
5220,12,-6,398,462159,12,462147
5221,15,10,860,966419,15,966404
5222,6,13,723,1046212,6,1046206
5223,19,-14,844,216082,19,216063
5224,19,17,782,1183708,19,1183689
5225,17,-15,17,177951,17,177934
5226,16,-4,995,529572,16,529556
5227,12,-7,543,432445,12,432433
5228,10,-15,227,160209,10,160199
5229,11,9,118,929909,11,929898
5230,19,17,116,1178684,19,1178665
5231,8,13,747,1046762,8,1046754
5232,6,9,210,911221,6,911215
5233,9,11,387,976802,9,976793
5234,7,0,202,629904,7,629897
5235,10,16,824,1142280,10,1142270
5236,13,-4,202,523652,13,523639
5237,8,3,361,726661,8,726653
5238,14,5,924,810556,14,810542
5239,8,-19,958,52066,8,52058
5240,15,13,802,1059274,15,1059259
5241,15,-6,420,462364,15,462349
5242,14,-9,116,367451,14,367437
5243,16,13,123,1054139,16,1054123
5244,6,10,26,938080,6,938074
5245,6,18,907,1205924,6,1205918
5246,12,1,137,680944,12,680932
5247,9,-17,124,96016,9,96007
5248,5,-16,931,144003,5,143998
5249,7,-6,545,448620,7,448613
5250,7,12,438,1008508,7,1008501
5251,17,13,0,1053227,17,1053210
5252,10,-8,460,384792,10,384782
5253,6,12,246,1004478,6,1004472
5254,17,-2,981,592614,17,592597
5255,19,-5,946,497972,19,497953
5256,9,14,848,1080827,9,1080818
5257,8,6,786,829941,8,829933
5258,12,-6,722,464662,12,464650
5259,7,11,96,970515,7,970508
5260,17,-14,586,214127,17,214110
5261,14,6,667,841139,14,841125
5262,19,-12,2,272507,19,272488
5263,17,-13,928,248033,17,248016
5264,12,0,58,648669,12,648657
5265,11,12,112,1022880,11,1022869
5266,8,19,625,1231475,8,1231467
5267,18,4,54,773643,18,773625
5268,11,-17,363,118166,11,118155
5269,15,-5,120,491863,15,491848
5270,15,-3,196,555147,15,555132
5271,10,8,664,889669,10,889659
5272,7,6,166,815778,7,815771
5273,16,18,31,1209120,16,1209104
5274,13,6,242,837586,13,837573
5275,13,12,763,1027699,13,1027686
5276,9,-1,87,595666,9,595657
5277,8,8,731,891350,8,891342
5278,6,-13,524,229460,6,229454
5279,8,-5,773,484588,8,484580
5280,20,11,660,995543,20,995523
5281,19,-6,378,462054,19,462035
5282,8,13,426,1039938,8,1039930
5283,15,10,504,963687,15,963672
5284,17,14,61,1085901,17,1085884
5285,6,7,194,848874,6,848868
5286,16,-5,645,495734,16,495718
5287,9,-12,812,267112,9,267103
5288,6,9,124,909380,6,909374
5289,6,-5,465,478054,6,478048
5290,18,-12,265,274480,18,274462
5291,7,-8,547,386894,7,386887
5292,10,11,970,989225,10,989215
5293,10,-4,561,511490,10,511480
5294,7,8,409,884188,7,884181
5295,5,-4,691,514317,5,514312
5296,7,8,195,879369,7,879362
5297,17,-16,203,148434,17,148417
5298,8,7,738,860451,8,860443
5299,15,-18,108,86054,15,86039
5300,7,-19,677,46359,7,46352
5301,20,-6,37,459429,20,459409
5302,9,18,81,1188498,9,1188489
5303,12,-7,243,430071,12,430059
5304,18,-5,73,491407,18,491389
5305,18,15,116,1117654,18,1117636
5306,13,3,800,747868,13,747855
5307,20,-6,116,459950,20,459930
5308,17,13,574,1057600,17,1057583
5309,8,-10,340,319963,8,319955
5310,8,16,979,1145662,8,1145654
5311,13,19,663,1246143,13,1246130
5312,10,-12,945,270160,10,270150
5313,14,10,896,966663,14,966649
5314,7,-18,393,70854,7,70847
5315,19,0,410,651183,19,651164
5316,14,9,287,931025,14,931011
5317,16,17,731,1183355,16,1183339
5318,15,10,993,967395,15,967380
5319,10,-3,134,533313,10,533303
5320,5,-7,770,422198,5,422193
5321,11,-11,950,311144,11,311133
5322,11,-3,720,559488,11,559477
5323,7,-3,629,544539,7,544532
5324,8,-3,926,551211,8,551203
5325,14,13,763,1058963,14,1058949
5326,8,-8,96,377398,8,377390
5327,10,-10,477,323091,10,323081
5328,13,-16,481,150556,13,150543
5329,6,-13,758,234650,6,234644
5330,15,17,269,1179939,15,1179924
5331,11,12,765,1027736,11,1027725
5332,9,-18,826,80340,9,80331
5333,7,0,734,641508,7,641501
5334,10,9,82,908439,10,908429
5335,13,-17,701,120752,13,120739
5336,13,-2,915,592111,13,592098
5337,11,-3,657,559028,11,559017
5338,9,-9,499,354978,9,354969
5339,10,11,809,985805,10,985795
5340,19,0,78,648780,19,648761
5341,16,-13,50,241416,16,241400
5342,12,-20,447,26190,12,26178
5343,13,10,979,967304,13,967291
5344,12,-10,77,335796,12,335784
5345,17,-7,999,435764,17,435747
5346,9,-5,597,480993,9,480984
5347,11,0,849,654679,11,654668
5348,13,2,324,713034,13,713021
5349,10,4,465,760585,10,760575
5350,15,11,20,991000,15,990985
5351,20,16,772,1152555,20,1152535
5352,13,-1,569,621030,13,621017
5353,12,10,126,960870,12,960858
5354,18,-20,83,23400,18,23382
5355,8,0,607,638483,8,638475
5356,14,-19,92,54627,14,54613
5357,10,6,50,813266,10,813256
5358,11,-11,517,307848,11,307837
5359,18,-7,492,432011,18,431993
5360,6,4,603,763698,6,763692
5361,19,-13,732,246426,19,246407
5362,5,9,835,924513,5,924508
5363,5,-5,315,475038,5,475033
5364,14,16,890,1153411,14,1153397
5365,19,7,34,867265,19,867246
5366,5,14,790,1079636,5,1079631
5367,11,7,823,872952,11,872941
5368,11,-14,243,211302,11,211291
5369,14,1,982,687462,14,687448
5370,11,0,745,654022,11,654011
5371,11,17,885,1184578,11,1184567
5372,7,-7,664,419796,7,419789
5373,14,2,920,717322,14,717308
5374,17,-10,55,335552,17,335535
5375,10,-11,176,284991,10,284981
5376,11,-15,272,179740,11,179729
5377,19,-14,415,212805,19,212786
5378,6,15,269,1100331,6,1100325
5379,7,3,968,739997,7,739990
5380,13,9,581,933339,13,933326
5381,12,-8,687,402768,12,402756
5382,14,0,153,649349,14,649335
5383,15,9,731,934401,15,934386
5384,15,-2,269,587142,15,587127
5385,20,13,697,1058471,20,1058451
5386,7,15,519,1105534,7,1105527
5387,20,8,896,904940,20,904920
5388,14,-5,320,493472,14,493458
5389,9,12,461,1008972,9,1008963
5390,17,-12,211,274027,17,274010
5391,11,14,748,1091299,11,1091288
5392,10,-6,1000,458119,10,458109
5393,9,-12,301,256177,9,256168
5394,20,9,553,933088,20,933068
5395,6,-14,59,187814,6,187808
5396,11,-5,967,498171,11,498160
5397,18,-12,989,280014,18,279996
5398,13,-6,328,461714,13,461701
5399,8,-9,999,365578,8,365570
5400,10,-11,619,294855,10,294845
5401,7,18,38,1187406,7,1187399
5402,19,-6,266,461246,19,461227
5403,15,-13,267,243067,15,243052
5404,20,16,695,1152053,20,1152033
5405,13,-18,992,92425,13,92412
5406,12,7,632,871639,12,871627
5407,6,-6,153,440043,6,440037
5408,17,-4,62,522514,17,522497
5409,15,-6,334,461749,15,461734
5410,20,-16,968,154074,20,154054
5411,11,-16,664,151806,11,151795
5412,11,-18,436,88523,11,88512
5413,11,-13,827,247144,11,247133
5414,18,-2,125,586045,18,586027
5415,9,-16,520,135355,9,135346
5416,6,-16,487,134670,6,134664
5417,8,6,212,816803,8,816795
5418,17,-4,320,524584,17,524567
5419,8,12,512,1010029,8,1010021
5420,15,-3,788,560135,15,560120
5421,12,18,810,1214827,12,1214815
5422,8,-3,19,530963,8,530955
5423,8,10,268,943184,8,943176
5424,9,-16,708,139217,9,139208
5425,10,-11,482,291907,10,291897
5426,9,5,369,789235,9,789226
5427,20,-20,324,25362,20,25342
5428,13,-19,842,60494,13,60481
5429,17,-13,857,247442,17,247425
5430,15,11,885,997284,15,997269
5431,14,-14,68,209810,14,209796
5432,12,-14,239,211268,12,211256
5433,18,6,698,841428,18,841410
5434,10,0,454,635233,10,635223
5435,11,0,66,648734,11,648723
5436,20,2,453,714047,20,714027
5437,14,1,993,687508,14,687494
5438,20,-11,758,309629,20,309609
5439,13,-16,344,149413,13,149400
5440,13,1,190,681375,13,681362
5441,16,7,776,872616,16,872600
5442,20,-19,236,55891,20,55871
5443,7,9,739,922234,7,922227
5444,8,14,121,1064540,8,1064532
5445,6,-5,750,484189,6,484183
5446,19,6,886,842853,19,842834
5447,12,-5,477,494571,12,494559
5448,15,-16,174,148166,15,148151
5449,18,-13,604,245508,18,245490
5450,5,6,691,827903,5,827898
5451,16,-15,937,184889,16,184873
5452,16,-2,872,591761,16,591745
5453,8,-15,749,171460,8,171452
5454,7,0,336,632464,7,632457
5455,14,-8,960,404705,14,404691
5456,10,-4,575,511859,10,511849
5457,14,18,127,1209935,14,1209921
5458,11,14,407,1088635,11,1088624
5459,16,-16,400,149803,16,149787
5460,8,-3,214,534957,8,534949
5461,14,10,363,962547,14,962533
5462,12,-1,933,623709,12,623697
5463,20,-13,177,242334,20,242314
5464,16,9,678,934038,16,934022
5465,5,2,122,691225,5,691220
5466,13,5,896,810285,13,810272
5467,18,-4,832,528145,18,528127
5468,20,5,825,809790,20,809770
5469,12,10,838,966275,12,966263
5470,8,-17,132,96170,8,96162
5471,8,14,694,1077654,8,1077646
5472,18,-6,476,462801,18,462783
5473,19,5,290,805980,19,805961
5474,13,-16,134,147937,13,147924
5475,8,13,635,1044415,8,1044407
5476,7,17,284,1161460,7,1161453
5477,14,-12,113,273367,14,273353
5478,6,-9,52,344753,6,344747
5479,14,15,709,1122019,14,1122005
5480,17,2,890,717133,17,717116
5481,17,-13,880,247618,17,247601
5482,13,11,103,991601,13,991588
5483,16,1,761,685795,16,685779
5484,11,-9,464,370234,11,370223
5485,9,-5,716,483480,9,483471
5486,12,6,490,839706,12,839694
5487,16,-8,613,402173,16,402157
5488,7,-2,581,575060,7,575053
5489,16,-12,651,277296,16,277280
5490,19,-7,945,435308,19,435289
5491,5,-2,530,573962,5,573957
5492,14,7,139,868047,14,868033
5493,11,-18,430,88503,11,88492
5494,15,-10,718,340463,15,340448
5495,19,11,864,997106,19,997087
5496,11,15,36,1117034,11,1117023
5497,14,10,111,960737,14,960723
5498,20,4,453,776511,20,776491
5499,10,-18,875,81311,10,81301
5500,18,-14,687,214922,18,214904
5501,19,-3,197,555155,19,555136
5502,12,-14,168,210569,12,210557
5503,8,9,440,915918,8,915910
5504,5,17,705,1170319,5,1170314
5505,15,17,356,1180625,15,1180610
5506,16,-3,7,553908,16,553892
5507,7,-19,203,36109,7,36102
5508,16,-3,267,555664,16,555648
5509,14,3,431,745082,14,745068
5510,15,1,471,683565,15,683550
5511,18,11,807,996716,18,996698
5512,18,-14,493,213318,18,213300
5513,13,12,631,1026704,13,1026691
5514,20,16,113,1147858,20,1147838
5515,12,-7,314,430693,12,430681
5516,14,-20,503,26619,14,26605
5517,7,5,652,795031,7,795024
5518,6,7,83,846643,6,846637
5519,8,1,220,662010,8,662002
5520,17,16,677,1151960,17,1151943
5521,19,-18,913,91864,19,91845
5522,9,-16,706,139166,9,139157
5523,18,12,576,1026271,18,1026253
5524,10,-18,858,80926,10,80916
5525,15,-17,419,118527,15,118512
5526,20,-18,344,87905,20,87885
5527,16,0,195,649733,16,649717
5528,10,-3,884,550193,10,550183
5529,7,-6,502,447618,7,447611
5530,20,14,476,1089129,20,1089109
5531,18,-15,486,181349,18,181331
5532,6,-5,6,467898,6,467892
5533,17,0,361,650766,17,650749
5534,11,5,596,808124,11,808113
5535,5,-9,203,347891,5,347886
5536,13,-15,215,179284,13,179271
5537,5,-2,61,564157,5,564152
5538,10,8,529,886879,10,886869
5539,14,-8,30,398114,14,398100
5540,5,10,414,946374,5,946369
5541,10,-9,469,354078,10,354068
5542,9,2,281,694620,9,694611
5543,11,5,973,810943,11,810932
5544,14,1,472,683568,14,683554
5545,6,-20,744,16321,6,16315
5546,16,-2,975,592577,16,592561
5547,6,19,282,1223730,6,1223724
5548,7,-17,310,100210,7,100203
5549,5,-20,750,16524,5,16519
5550,5,-5,609,481271,5,481266
5551,10,4,707,765804,10,765794
5552,6,14,549,1074100,6,1074094
5553,12,15,779,1122508,12,1122496
5554,17,8,918,905120,17,905103
5555,5,2,161,692055,5,692050
5556,13,-3,643,558921,13,558908
5557,14,6,213,837295,14,837281
5558,8,-14,955,207231,8,207223
5559,14,18,788,1214721,14,1214707
5560,16,16,288,1149210,16,1149194
5561,16,19,68,1241291,16,1241275
5562,10,-4,691,514327,10,514317
5563,12,3,237,743658,12,743646
5564,7,-17,115,95891,7,95884
5565,11,0,320,650391,11,650380
5566,8,-11,708,296490,8,296482
5567,16,15,868,1123127,16,1123111
5568,20,-4,74,522611,20,522591
5569,18,8,322,900491,18,900473
5570,17,15,598,1121150,17,1121133
5571,17,-9,630,371522,17,371505
5572,16,13,258,1055082,16,1055066
5573,20,-4,789,527929,20,527909
5574,8,-5,28,468449,8,468441
5575,14,-13,883,247640,14,247626
5576,8,2,417,697645,8,697637
5577,15,-4,318,524579,15,524564
5578,8,-16,666,138336,8,138328
5579,19,-4,261,524121,19,524102
5580,10,-1,693,608793,10,608783
5581,7,-13,886,237515,7,237508
5582,10,-15,37,156111,10,156101
5583,11,2,767,716285,11,716274
5584,16,-2,340,587637,16,587621
5585,11,-13,239,242806,11,242795
5586,11,18,328,1211494,11,1211483
5587,19,1,540,684165,19,684146
5588,19,-19,98,54710,19,54691
5589,15,-13,973,248392,15,248377
5590,7,-19,572,44048,7,44041
5591,8,-11,399,289980,8,289972
5592,6,17,504,1166095,6,1166089
5593,7,-4,763,515684,7,515677
5594,6,-18,776,79212,6,79206
5595,8,-12,869,268520,8,268512
5596,6,-20,582,12693,6,12687
5597,5,-6,756,453025,5,453020
5598,19,3,966,749254,19,749235
5599,6,6,239,817516,6,817510
5600,6,-7,764,422024,6,422018
5601,13,-16,455,150405,13,150392
5602,16,13,495,1056890,16,1056874
5603,6,2,871,706705,6,706699
5604,13,10,427,963100,13,963087
5605,12,-2,790,591062,12,591050
5606,19,17,463,1181386,19,1181367
5607,13,19,47,1241079,13,1241066
5608,8,-6,30,437525,8,437517
5609,11,-16,949,153883,11,153872
5610,11,-20,852,29376,11,29365
5611,8,12,304,1005855,8,1005847
5612,5,-9,112,345936,5,345931
5613,14,5,534,807704,14,807690
5614,15,-1,129,617537,15,617522
5615,20,-8,954,404655,20,404635
5616,19,-17,333,117960,19,117941
5617,12,2,158,711785,12,711773
5618,18,9,740,934471,18,934453
5619,5,2,708,703565,5,703560
5620,20,-20,190,24321,20,24301
5621,5,-15,479,165861,5,165856
5622,11,-11,927,310931,11,310920
5623,12,-6,288,461424,12,461412
5624,9,-11,559,293563,9,293554
5625,15,14,218,1087106,15,1087091
5626,8,-4,566,511602,8,511594
5627,8,-7,9,406180,8,406172
5628,17,-11,755,309588,17,309571
5629,15,-6,427,462423,15,462408
5630,17,5,730,809083,17,809066
5631,5,11,948,988766,5,988761
5632,17,-14,879,216367,17,216350
5633,10,-14,564,198795,10,198785
5634,5,-9,517,355302,5,355297
5635,20,1,886,686705,20,686685
5636,7,7,235,849776,7,849769
5637,17,15,791,1122581,17,1122564
5638,16,-5,694,496096,16,496080
5639,14,4,262,775087,14,775073
5640,20,0,711,653713,20,653693
5641,18,0,895,655068,18,655050
5642,19,7,602,871475,19,871456
5643,19,-7,336,430883,19,430864
5644,19,-4,711,527432,19,527413
5645,19,-14,604,214274,19,214255
5646,14,4,916,780021,14,780007
5647,12,11,999,998006,12,997994
5648,7,14,673,1077075,7,1077068
5649,5,-3,642,544892,5,544887
5650,13,14,679,1090773,13,1090760
5651,18,15,146,1117900,18,1117882
5652,7,-13,80,220075,7,220068
5653,18,-16,625,151635,18,151617
5654,13,-19,625,58939,13,58926
5655,11,2,728,716069,11,716058
5656,6,-3,823,548766,6,548760
5657,11,10,939,967041,11,967030
5658,6,-20,309,6966,6,6960
5659,8,12,975,1020558,8,1020550
5660,6,-12,516,260842,6,260836
5661,18,1,232,681718,18,681700
5662,7,7,636,858236,7,858229
5663,10,4,759,767121,10,767111
5664,5,-3,441,540238,5,540233
5665,11,4,99,774005,11,773994
5666,7,-18,230,67530,7,67523
5667,12,-7,969,435477,12,435465
5668,14,-15,334,180181,14,180167
5669,12,4,530,777103,12,777091
5670,7,-8,432,384259,7,384252
5671,7,0,410,634221,7,634214
5672,6,5,73,783180,6,783174
5673,15,-6,302,461520,15,461505
5674,16,7,628,871597,16,871581
5675,9,13,30,1031408,9,1031399
5676,17,2,372,713410,17,713393
5677,10,17,160,1158624,10,1158614
5678,7,17,53,1156498,7,1156491
5679,5,-17,368,101379,5,101374
5680,7,-19,173,35443,7,35436
5681,18,9,772,934714,18,934696
5682,15,19,753,1246872,15,1246857
5683,13,-2,364,587799,13,587786
5684,18,-17,552,119636,18,119618
5685,9,-8,604,388104,9,388095
5686,5,-20,530,11430,5,11425
5687,19,-4,896,528789,19,528770
5688,19,-15,275,179766,19,179747
5689,6,1,493,668045,6,668039
5690,20,-5,689,496071,20,496051
5691,9,-16,379,132111,9,132102
5692,6,17,307,1161954,6,1161948
5693,17,-2,238,586942,17,586925
5694,7,-13,672,232462,7,232455
5695,15,3,801,747877,15,747862
5696,5,-8,698,390441,5,390436
5697,13,11,841,996952,13,996939
5698,11,-6,856,465610,11,465599
5699,20,-15,528,181646,20,181626
5700,20,-18,447,88602,20,88582
5701,6,-7,956,426281,6,426275
5702,13,-17,805,121586,13,121573
5703,12,-15,429,180976,12,180964
5704,7,-1,338,601476,7,601469
5705,20,-15,246,179560,20,179540
5706,13,-19,22,54040,13,54027
5707,19,8,936,905244,19,905225
5708,5,-13,633,231891,5,231886
5709,13,4,413,776195,13,776182
5710,18,-7,444,431641,18,431623
5711,10,-10,925,332292,10,332282
5712,16,-4,846,528262,16,528246
5713,8,-2,347,570121,8,570113
5714,7,-8,26,375907,7,375900
5715,17,5,960,810889,17,810872
5716,16,1,903,686866,16,686850
5717,9,-1,889,613018,9,613009
5718,12,-20,804,29045,12,29033
5719,8,11,872,987233,8,987225
5720,12,-10,343,337544,12,337532
5721,19,-1,61,617017,19,616998
5722,8,13,576,1043158,8,1043150
5723,17,-11,807,310000,17,309983
5724,10,13,852,1049061,10,1049051
5725,12,-16,145,147996,12,147984
5726,5,-19,526,42937,5,42932
5727,14,-2,405,588142,14,588128
5728,11,-1,28,616741,11,616730
5729,9,16,768,1140987,9,1140978
5730,15,-5,350,493707,15,493692
5731,10,14,953,1083146,10,1083136
5732,6,2,596,701132,6,701126
5733,10,11,124,971060,10,971050
5734,11,7,839,873084,11,873073
5735,7,-7,950,426112,7,426105
5736,13,4,610,777722,13,777709
5737,15,-18,144,86301,15,86286
5738,19,-2,673,590175,19,590156
5739,5,-19,58,32650,5,32645
5740,10,-20,5,114,10,104
5741,5,18,394,1195137,5,1195132
5742,19,6,24,836016,19,835997
5743,16,-9,313,368904,16,368888
5744,20,-6,618,463879,20,463859
5745,19,-18,538,89175,19,89156
5746,9,12,48,1000147,9,1000138
5747,12,-3,338,556276,12,556264
5748,9,-16,820,141594,9,141585
5749,10,15,733,1110105,10,1110095
5750,17,0,12,648278,17,648261
5751,13,-13,772,246779,13,246766
5752,12,-14,538,213628,12,213616
5753,19,12,396,1024963,19,1024944
5754,16,15,355,1119395,16,1119379
5755,18,-17,999,122754,18,122736
5756,18,6,947,843300,18,843282
5757,6,-12,75,251205,6,251199
5758,8,2,938,708168,8,708160
5759,10,-7,749,421682,10,421672
5760,14,-20,176,24128,14,24114
5761,14,10,133,960923,14,960909
5762,19,-14,559,213813,19,213794
5763,11,-20,863,29428,11,29417
5764,13,8,475,901691,13,901678
5765,17,-5,209,492491,17,492474
5766,17,8,75,898467,17,898450
5767,20,1,18,679879,20,679859
5768,10,12,520,1010202,10,1010192
5769,15,1,494,683768,15,683753
5770,5,19,110,1219876,5,1219871
5771,12,-6,173,460444,12,460432
5772,11,-12,806,278398,11,278387
5773,6,13,195,1034871,6,1034865
5774,17,19,757,1246916,17,1246899
5775,18,0,947,655429,18,655411
5776,14,-6,60,459534,14,459520
5777,6,11,924,988458,6,988452
5778,9,10,69,938970,9,938961
5779,7,-9,904,363954,7,363947
5780,20,-6,537,463314,20,463294
5781,6,-10,181,316563,6,316557
5782,7,11,263,973852,7,973845
5783,19,7,546,871056,19,871037
5784,15,15,46,1117125,15,1117110
5785,19,-14,441,212948,19,212929
5786,19,3,892,748532,19,748513
5787,19,6,234,837532,19,837513
5788,17,-1,919,623589,17,623572
5789,11,12,799,1027993,11,1027982
5790,20,16,515,1150750,20,1150730
5791,8,-12,828,267497,8,267489
5792,13,19,22,1240873,13,1240860
5793,13,14,808,1091792,13,1091779
5794,15,4,747,778758,15,778743
5795,12,-1,32,616782,12,616770
5796,12,2,309,712905,12,712893
5797,9,-7,530,417206,9,417197
5798,19,8,220,899706,19,899687
5799,6,6,405,821522,6,821516
5800,14,19,564,1245377,14,1245363
5801,11,18,486,1212529,11,1212518
5802,10,-13,58,219648,10,219638
5803,6,14,988,1083967,6,1083961
5804,20,15,795,1122603,20,1122583
5805,9,9,769,922905,9,922896
5806,10,-2,795,579663,10,579653
5807,20,19,222,1242501,20,1242481
5808,19,-4,246,524044,19,524025
5809,6,-2,515,573692,6,573686
5810,7,-6,88,438622,7,438615
5811,14,-13,171,242288,14,242274
5812,9,14,929,1082530,9,1082521
5813,9,11,63,969830,9,969821
5814,5,-4,320,506494,5,506489
5815,8,14,706,1077864,8,1077856
5816,19,11,761,996348,19,996329
5817,20,-2,778,590970,20,590950
5818,20,8,75,898477,20,898457
5819,5,-18,965,83425,5,83420
5820,13,0,898,655101,13,655088
5821,10,13,260,1036183,10,1036173
5822,15,5,62,804282,15,804267
5823,12,-16,622,151615,12,151603
5824,11,-13,17,241169,11,241158
5825,9,-20,534,11559,9,11550
5826,5,7,493,855394,5,855389
5827,19,-13,158,242177,19,242158
5828,13,17,199,1179375,13,1179362
5829,19,-18,442,88554,19,88535
5830,16,3,638,746650,16,746634
5831,12,8,439,901492,12,901480
5832,6,2,652,702396,6,702390
5833,20,2,687,715767,20,715747
5834,11,-16,795,152730,11,152719
5835,5,15,724,1109877,5,1109872
5836,7,-19,303,38076,7,38069
5837,13,13,938,1060194,13,1060181
5838,6,10,183,941461,6,941455
5839,7,11,836,986292,7,986285
5840,12,-15,718,183132,12,183120
5841,8,1,847,675383,8,675375
5842,13,-6,147,460247,13,460234
5843,9,-7,124,408448,9,408439
5844,16,5,811,809701,16,809685
5845,12,-10,736,340628,12,340616
5846,16,5,411,806759,16,806743
5847,17,-8,309,400058,17,400041
5848,18,-13,945,248164,18,248146
5849,13,5,854,809962,13,809949
5850,6,-11,28,281638,6,281632
5851,18,-17,46,115885,18,115867
5852,8,-7,218,410498,8,410490
5853,20,8,943,905289,20,905269
5854,20,-17,147,116561,20,116541
5855,19,-8,946,404572,19,404553
5856,6,17,65,1156708,6,1156702
5857,17,-16,442,150267,17,150250
5858,11,-13,88,241669,11,241658
5859,9,-17,587,106200,9,106191
5860,14,10,807,966154,14,966140
5861,12,11,527,994677,12,994665
5862,18,-13,272,243102,18,243084
5863,10,8,277,881236,10,881226
5864,11,-16,735,152284,11,152273
5865,6,-9,191,347605,6,347599
5866,12,12,660,1026960,12,1026948
5867,18,1,547,684234,18,684216
5868,14,8,5,897946,14,897932
5869,17,12,535,1025960,17,1025943
5870,18,14,194,1086939,18,1086921
5871,17,-4,282,524257,17,524240
5872,16,13,189,1054597,16,1054581
5873,19,12,560,1026152,19,1026133
5874,20,9,419,932085,20,932065
5875,17,15,137,1117824,17,1117807
5876,13,-18,182,86708,13,86695
5877,11,9,168,930305,11,930294
5878,5,16,423,1134265,5,1134260
5879,18,-15,172,179013,18,178995
5880,20,-2,908,592069,20,592049
5881,18,-11,442,307305,18,307287
5882,20,-9,21,366758,20,366738
5883,5,-17,985,114262,5,114257
5884,5,12,65,1000494,5,1000489
5885,13,-3,488,557580,13,557567
5886,14,-9,244,368356,14,368342
5887,18,6,945,843284,18,843266
5888,16,-20,508,26645,16,26629
5889,13,-1,902,623456,13,623443
5890,20,-4,244,524025,20,524005
5891,16,-6,260,461202,16,461186
5892,10,-10,333,319771,10,319761
5893,18,9,1000,936515,18,936497
5894,16,3,234,743644,16,743628
5895,14,-11,358,306631,14,306617
5896,17,5,744,809215,17,809198
5897,14,-4,855,528350,14,528336
5898,5,-2,713,578059,5,578054
5899,15,-18,332,87793,15,87778
5900,10,8,161,878588,10,878578
5901,18,-14,516,213518,18,213500
5902,12,-20,324,25364,12,25352
5903,18,-3,677,559205,18,559187
5904,5,11,954,988878,5,988873
5905,13,-8,710,402905,13,402892
5906,20,13,392,1056137,20,1056117
5907,7,8,191,879235,7,879228
5908,17,-9,162,367732,17,367715
5909,11,-5,341,493661,11,493650
5910,14,-13,695,246054,14,246040
5911,5,6,517,824050,5,824045
5912,6,9,12,906951,6,906945
5913,16,-11,998,311500,16,311484
5914,13,-9,768,372623,13,372610
5915,15,-12,832,278634,15,278619
5916,11,18,487,1212538,11,1212527
5917,8,-6,867,455272,8,455264
5918,15,-15,375,180539,15,180524
5919,11,0,576,652615,11,652604
5920,20,0,797,654348,20,654328
5921,17,12,970,1029574,17,1029557
5922,17,9,146,930134,17,930117
5923,18,-5,429,494152,18,494134
5924,5,-19,850,50093,5,50088
5925,14,-20,169,24045,14,24031
5926,15,18,654,1213687,15,1213672
5927,5,18,960,1207086,5,1207081
5928,15,16,115,1147885,15,1147870
5929,9,18,900,1205793,9,1205784
5930,14,-17,845,121798,14,121784
5931,15,-20,179,24164,15,24149
5932,14,11,783,996510,14,996496
5933,13,13,236,1054959,13,1054946
5934,8,-12,410,258551,8,258543
5935,15,-1,367,619528,15,619513
5936,14,0,429,651359,14,651345
5937,13,-9,441,370070,13,370057
5938,6,16,621,1138191,6,1138185
5939,16,-3,276,555730,16,555714
5940,19,-9,46,366971,19,366952
5941,9,1,201,661573,9,661564
5942,14,14,927,1092663,14,1092649
5943,5,-4,98,501484,5,501479
5944,5,4,643,764517,5,764512
5945,9,15,811,1111569,9,1111560
5946,10,1,874,676010,10,676000
5947,19,17,34,1178128,19,1178109
5948,10,9,790,923460,10,923450
5949,14,-1,237,618441,14,618427
5950,17,9,630,933744,17,933727
5951,20,13,427,1056418,20,1056398
5952,15,15,98,1117516,15,1117501
5953,17,9,298,931126,17,931109
5954,11,15,244,1118594,11,1118583
5955,20,-10,450,338400,20,338380
5956,10,10,425,946607,10,946597
5957,11,14,383,1088403,11,1088392
5958,13,-14,234,211246,13,211233
5959,15,8,101,898711,15,898696
5960,12,7,437,870282,12,870270
5961,14,15,596,1121102,14,1121088
5962,16,17,509,1181739,16,1181723
5963,5,-1,581,606587,5,606582
5964,13,19,693,1246377,13,1246364
5965,14,-4,972,529427,14,529413
5966,18,-7,417,431459,18,431441
5967,9,13,768,1047264,9,1047255
5968,8,-20,85,1923,8,1915
5969,20,-14,862,216253,20,216233
5970,5,-11,544,293288,5,293283
5971,7,-5,180,472052,7,472045
5972,16,17,790,1183795,16,1183779
5973,7,4,149,753808,7,753801
5974,20,18,643,1213612,20,1213592
5975,15,19,996,1248747,15,1248732
5976,11,-14,153,210485,11,210474
5977,12,-6,863,465639,12,465627
5978,5,-6,95,438775,5,438770
5979,11,-18,79,85826,11,85815
5980,12,1,778,685923,12,685911
5981,12,8,898,904965,12,904953
5982,14,4,91,773922,14,773908
5983,19,-10,569,339317,19,339298
5984,7,-6,732,452560,7,452553
5985,6,-2,610,575753,6,575747
5986,20,14,884,1092368,20,1092348
5987,15,17,79,1178466,15,1178451
5988,11,1,440,683286,11,683275
5989,17,19,100,1241562,17,1241545
5990,19,13,641,1058087,19,1058068
5991,10,-1,300,600499,10,600489
5992,12,1,284,682127,12,682115
5993,19,16,836,1153128,19,1153109
5994,13,-11,528,307960,13,307947
5995,17,-16,85,147482,17,147465
5996,11,-5,495,494669,11,494658
5997,16,4,679,778234,16,778218
5998,18,15,201,1118308,18,1118290
5999,15,-16,654,151783,15,151768
6000,11,-17,204,116943,11,116932
6001,11,4,370,775914,11,775903
6002,15,-1,775,622524,15,622509
6003,19,-3,141,554793,19,554774
6004,12,15,674,1121714,12,1121702
6005,16,-17,649,120336,16,120320
6006,13,11,193,992188,13,992175
6007,18,7,967,873848,18,873830
6008,14,5,872,810128,14,810114
6009,7,15,948,1114698,7,1114691
6010,12,-17,877,122018,12,122006
6011,9,11,851,986704,9,986695
6012,10,16,870,1143140,10,1143130
6013,7,-11,325,288280,7,288273
6014,9,2,110,690945,9,690936
6015,6,-10,109,314907,6,314901
6016,7,9,872,925205,7,925198
6017,19,-16,581,151285,19,151266
6018,7,13,773,1047356,7,1047349
6019,18,-3,531,558028,18,558010
6020,6,-5,630,481659,6,481653
6021,13,-17,397,118401,13,118388
6022,6,-4,725,514946,6,514940
6023,15,19,353,1243631,15,1243616
6024,12,16,705,1152128,12,1152116
6025,10,6,462,822823,10,822813
6026,6,14,308,1068623,6,1068617
6027,15,-19,770,59987,15,59972
6028,10,13,829,1048565,10,1048555
6029,12,7,322,869375,12,869363
6030,18,10,30,960089,18,960071
6031,5,8,425,884521,5,884516
6032,14,-14,526,213572,14,213558
6033,19,-9,843,373225,19,373206
6034,19,10,834,966261,19,966242
6035,14,5,194,805277,14,805263
6036,8,16,241,1130336,8,1130328
6037,15,-14,656,214633,15,214618
6038,9,-14,212,191245,9,191236
6039,19,11,294,993045,19,993026
6040,9,15,301,1101003,9,1100994
6041,16,19,29,1240926,16,1240910
6042,7,11,724,983953,7,983946
6043,9,-20,330,7373,9,7364
6044,9,-1,677,608434,9,608425
6045,8,9,44,907706,8,907698
6046,18,3,10,741869,18,741851
6047,5,7,289,850989,5,850984
6048,14,12,744,1027598,14,1027584
6049,11,-2,755,590764,11,590753
6050,14,-16,445,150308,14,150294
6051,12,5,790,809515,12,809503
6052,6,-13,512,229216,6,229210
6053,13,12,152,1023114,13,1023101
6054,12,15,535,1120673,12,1120661
6055,20,-19,110,54834,20,54814
6056,7,8,500,886209,7,886202
6057,20,-13,7,241087,20,241067
6058,5,-17,807,110695,5,110690
6059,14,-17,728,121026,14,121012
6060,10,16,129,1127783,10,1127773
6061,9,14,102,1064108,9,1064099
6062,18,-15,580,182069,18,182051
6063,5,13,153,1033906,5,1033901
6064,17,-9,236,368290,17,368273
6065,11,2,217,712216,11,712205
6066,14,-12,49,272844,14,272830
6067,8,-7,611,418842,8,418834
6068,19,1,941,687192,19,687173
6069,19,14,358,1088215,19,1088196
6070,9,5,864,799715,9,799706
6071,11,18,34,1209142,11,1209131
6072,14,-7,60,428741,14,428727
6073,19,-15,301,179969,19,179950
6074,19,-12,746,277971,19,277952
6075,9,-7,775,422295,9,422286
6076,7,-10,800,329752,7,329745
6077,20,17,594,1182254,20,1182234
6078,5,3,853,737255,5,737250
6079,20,6,932,843176,20,843156
6080,5,-7,727,421232,5,421227
6081,20,6,859,842606,20,842586
6082,16,-19,320,56471,16,56455
6083,18,-12,121,273443,18,273425
6084,19,-8,116,398693,19,398674
6085,13,15,172,1118086,13,1118073
6086,6,15,493,1104858,6,1104852
6087,10,18,435,1196037,10,1196027
6088,12,13,523,1057097,12,1057085
6089,11,16,824,1153007,11,1152996
6090,10,12,866,1018054,10,1018044
6091,7,19,283,1223745,7,1223738
6092,9,-2,824,580446,9,580437
6093,12,-19,766,59977,12,59965
6094,11,16,6,1147148,11,1147137
6095,13,-19,434,57343,13,57330
6096,9,5,982,802378,9,802369
6097,15,16,298,1149291,15,1149276
6098,13,11,706,995848,13,995835
6099,8,16,723,1140116,8,1140108
6100,19,16,102,1147780,19,1147761
6101,20,-8,61,398394,20,398374
6102,14,9,687,934109,14,934095
6103,18,5,446,807025,18,807007
6104,14,-7,50,428659,14,428645
6105,10,-3,927,551244,10,551234
6106,20,5,507,807495,20,807475
6107,20,15,164,1117986,20,1117966
6108,12,-12,753,278029,12,278017
6109,9,-17,165,96897,9,96888
6110,8,15,16,1094795,8,1094787
6111,6,-8,535,386637,6,386631
6112,15,-9,731,372149,15,372134
6113,7,13,91,1032696,7,1032689
6114,11,17,434,1181150,11,1181139
6115,13,12,581,1026306,13,1026293
6116,13,-10,199,336538,13,336525
6117,9,18,162,1190350,9,1190341
6118,20,-8,79,398583,20,398563
6119,6,12,316,1006104,6,1006098
6120,13,-7,510,432161,13,432148
6121,16,-19,128,55040,16,55024
6122,18,-15,458,181133,18,181115
6123,16,7,434,870275,16,870259
6124,19,-9,864,373417,19,373398
6125,5,-2,232,567683,5,567678
6126,17,2,753,716236,17,716219
6127,10,-6,488,447249,10,447239
6128,10,5,378,789432,10,789422
6129,17,-10,502,338804,17,338787
6130,17,-4,381,525062,17,525045
6131,18,10,594,964477,18,964459
6132,15,9,72,929593,15,929578
6133,16,-12,438,275674,16,275658
6134,19,-12,391,275378,19,275359
6135,6,-3,657,545251,6,545245
6136,9,3,891,738014,9,738005
6137,9,18,691,1201202,9,1201193
6138,7,4,145,753674,7,753667
6139,11,-6,163,460383,11,460372
6140,13,11,407,993864,13,993851
6141,15,14,76,1086036,15,1086021
6142,16,-11,833,310205,16,310189
6143,14,3,267,743900,14,743886
6144,11,6,298,838050,11,838039
6145,15,6,36,836089,15,836074
6146,13,-2,678,590214,13,590201
6147,19,0,713,653747,19,653728
6148,18,14,304,1087785,18,1087767
6149,17,-16,593,151362,17,151345
6150,12,13,47,1053559,12,1053547
6151,19,-17,169,116725,19,116706
6152,5,-15,92,157391,5,157386
6153,19,-19,922,60959,19,60940
6154,16,-12,766,278159,16,278143
6155,19,-7,947,435328,19,435309
6156,17,-12,160,273710,17,273693
6157,17,4,225,774889,17,774872
6158,9,18,949,1206815,9,1206806
6159,18,5,945,810738,18,810720
6160,13,-1,28,616744,13,616731
6161,5,-20,338,7458,5,7453
6162,15,3,724,747336,15,747321
6163,14,-19,185,55524,14,55510
6164,17,10,562,964178,17,964161
6165,5,-7,71,407432,5,407427
6166,5,0,690,640474,5,640469
6167,14,18,269,1211128,14,1211114
6168,5,7,83,846648,5,846643
6169,19,-11,56,304101,19,304082
6170,20,-14,798,215789,20,215769
6171,15,11,981,997904,15,997889
6172,13,3,679,747004,13,746991
6173,6,-17,460,103286,6,103280
6174,9,14,607,1075388,9,1075379
6175,14,-12,838,278696,14,278682
6176,8,9,233,911642,8,911634
6177,14,16,213,1148663,14,1148649
6178,16,-11,744,309483,16,309467
6179,12,-14,292,211677,12,211665
6180,11,18,104,1209769,11,1209758
6181,13,1,773,685883,13,685870
6182,12,16,756,1152441,12,1152429
6183,9,6,23,812748,9,812739
6184,10,4,304,757085,10,757075
6185,8,15,597,1107068,8,1107060
6186,17,14,868,1092208,17,1092191
6187,7,-17,543,105155,7,105148
6188,19,-3,741,559659,19,559640
6189,16,-18,265,87355,16,87339
6190,9,12,526,1010340,9,1010331
6191,20,0,192,649711,20,649691
6192,20,7,764,872527,20,872507
6193,20,10,291,962006,20,961986
6194,10,-14,551,198411,10,198401
6195,19,9,922,935957,19,935938
6196,11,-20,681,28040,11,28029
6197,14,-7,254,430163,14,430149
6198,16,17,387,1180797,16,1180781
6199,7,1,507,668339,7,668332
6200,10,-5,446,477601,10,477591
6201,20,-3,403,556765,20,556745
6202,14,14,737,1091204,14,1091190
6203,6,9,501,917272,6,917266
6204,8,3,48,719840,8,719832
6205,14,17,224,1179505,14,1179491
6206,9,-12,684,264297,9,264288
6207,13,-12,918,279452,13,279439
6208,11,-4,708,527407,11,527396
6209,11,4,311,775411,11,775400
6210,19,-11,364,306659,19,306640
6211,19,16,904,1153541,19,1153522
6212,18,-9,248,368406,18,368388
6213,7,0,684,640315,7,640308
6214,15,-4,271,524180,15,524165
6215,18,-5,780,496653,18,496635
6216,10,6,616,826231,10,826221
6217,18,-7,589,432747,18,432729
6218,11,-13,204,242547,11,242536
6219,8,-13,355,225778,8,225770
6220,19,9,946,936134,19,936115
6221,15,3,221,743539,15,743524
6222,13,10,731,965511,13,965498
6223,16,-2,331,587591,16,587575
6224,16,-4,80,522651,16,522635
6225,11,17,504,1181666,11,1181655
6226,20,-4,391,525150,20,525130
6227,7,4,733,766563,7,766556
6228,17,-5,2,490771,17,490754
6229,20,2,646,715397,20,715377
6230,19,5,209,805400,19,805381
6231,6,-11,75,282744,6,282738
6232,18,1,683,685184,18,685166
6233,5,-17,418,102292,5,102287
6234,12,-18,907,91789,12,91777
6235,16,18,704,1214043,16,1214027
6236,9,-2,869,581377,9,581368
6237,20,-6,338,461795,20,461775
6238,9,-16,814,141502,9,141493
6239,15,-7,977,435555,15,435540
6240,12,-1,513,620645,12,620633
6241,20,-10,469,338576,20,338556
6242,19,16,961,1153949,19,1153930
6243,14,14,752,1091346,14,1091332
6244,6,-3,241,535685,6,535679
6245,18,9,158,930240,18,930222
6246,15,2,670,715632,15,715617
6247,11,0,643,653117,11,653106
6248,13,17,37,1178142,13,1178129
6249,15,8,607,902727,15,902712
6250,12,12,652,1026896,12,1026884
6251,9,-20,806,17912,9,17903
6252,11,-18,321,87727,11,87716
6253,8,-5,26,468367,8,468359
6254,7,14,756,1078902,7,1078895
6255,13,-6,596,463661,13,463648
6256,18,5,472,807270,18,807252
6257,5,16,743,1140573,5,1140568
6258,11,1,868,686561,11,686550
6259,17,12,950,1029415,17,1029398
6260,14,8,696,903482,14,903468
6261,14,-8,366,400430,14,400416
6262,20,14,227,1087188,20,1087168
6263,10,-1,440,603603,10,603593
6264,15,11,818,996780,15,996765
6265,14,12,203,1023506,14,1023492
6266,19,17,744,1183419,19,1183400
6267,20,9,764,934605,20,934585
6268,16,-10,856,341521,16,341505
6269,14,1,755,685740,14,685726
6270,14,3,486,745450,14,745436
6271,15,-15,937,184894,15,184879
6272,5,-14,613,200147,5,200142
6273,13,11,432,994009,13,993996
6274,15,12,455,1025370,15,1025355
6275,7,11,507,979298,7,979291
6276,11,-10,308,337264,11,337253
6277,8,5,818,798679,8,798671
6278,12,8,646,903107,12,903095
6279,12,2,369,713379,12,713367
6280,16,-15,773,183539,16,183523
6281,15,-13,379,243817,15,243802
6282,14,-3,380,556607,14,556593
6283,14,7,628,871601,14,871587
6284,8,-19,809,49108,8,49100
6285,5,-16,556,136120,5,136115
6286,18,3,778,747704,18,747686
6287,10,-11,870,299740,10,299730
6288,10,12,148,1002325,10,1002315
6289,6,2,643,702171,6,702165
6290,12,4,750,778786,12,778774
6291,16,-10,26,335325,16,335309
6292,19,-2,823,591366,19,591347
6293,20,14,936,1092770,20,1092750
6294,17,-5,555,495133,17,495116
6295,14,-15,141,178877,14,178863
6296,7,11,657,982442,7,982435
6297,17,-12,981,279966,17,279949
6298,10,18,974,1207374,10,1207364
6299,9,4,623,764118,9,764109
6300,17,19,777,1247080,17,1247063
6301,20,-20,432,26039,20,26019
6302,6,1,351,664878,6,664872
6303,12,12,76,1022580,12,1022568
6304,19,9,377,931791,19,931772
6305,6,-13,635,231929,6,231923
6306,19,19,880,1247914,19,1247895
6307,12,-8,131,398802,12,398790
6308,12,16,309,1149355,12,1149343
6309,8,-9,343,351161,8,351153
6310,5,-5,988,489497,5,489492
6311,17,6,41,836118,17,836101
6312,18,2,89,711207,18,711189
6313,15,19,740,1246799,15,1246784
6314,16,7,202,868434,16,868418
6315,8,1,443,666797,8,666789
6316,6,12,799,1016401,6,1016395
6317,7,16,568,1137152,7,1137145
6318,18,9,813,935058,18,935040
6319,6,7,985,865638,6,865632
6320,16,16,230,1148745,16,1148729
6321,5,-16,463,134235,5,134230
6322,11,-2,966,592483,11,592472
6323,9,12,273,1005303,9,1005294
6324,10,-11,896,300320,10,300310
6325,7,2,167,692224,7,692217
6326,16,8,919,905125,16,905109
6327,8,6,230,817377,8,817369
6328,20,18,653,1213675,20,1213655
6329,8,-15,904,174646,8,174638
6330,20,6,190,837184,20,837164
6331,12,5,721,809055,12,809043
6332,20,7,483,870638,20,870618
6333,18,7,407,870055,18,870037
6334,15,6,932,843181,15,843166
6335,19,8,60,898330,19,898311
6336,6,-3,31,531213,6,531207
6337,5,10,198,941753,5,941748
6338,17,-18,66,85705,17,85688
6339,6,12,131,1001963,6,1001957
6340,16,18,943,1215853,16,1215837
6341,14,16,428,1150219,14,1150205
6342,20,6,615,840710,20,840690
6343,20,10,503,963679,20,963659
6344,19,17,912,1184772,19,1184753
6345,19,12,419,1025095,19,1025076
6346,15,-10,243,336834,15,336819
6347,9,15,863,1112831,9,1112822
6348,7,-4,991,520777,7,520770
6349,16,14,496,1089333,16,1089317
6350,12,10,214,961458,12,961446
6351,16,-6,633,463994,16,463978
6352,5,-19,34,32228,5,32223
6353,14,15,627,1121372,14,1121358
6354,18,6,143,836837,18,836819
6355,7,-13,694,232958,7,232951
6356,11,11,284,992917,11,992906
6357,8,-5,979,489347,8,489339
6358,10,-12,366,257577,10,257567
6359,11,-13,766,246707,11,246696
6360,19,-11,940,311045,19,311026
6361,6,-13,732,233995,6,233989
6362,5,7,722,860006,5,860001
6363,12,17,361,1180677,12,1180665
6364,17,15,22,1116936,17,1116919
6365,20,-15,548,181819,20,181799
6366,12,12,637,1026757,12,1026745
6367,6,12,848,1017643,6,1017637
6368,14,-14,505,213378,14,213364
6369,5,3,100,720942,5,720937
6370,16,-6,12,459221,16,459205
6371,19,7,374,869722,19,869703
6372,12,7,207,868465,12,868453
6373,5,-16,294,130393,5,130388
6374,20,16,5,1147144,20,1147124
6375,11,-5,508,494768,11,494757
6376,19,1,860,686510,19,686491
6377,11,-11,568,308233,11,308222
6378,20,-18,939,92038,20,92018
6379,20,0,32,648490,20,648470
6380,17,-14,877,216343,17,216326
6381,20,17,582,1182139,20,1182119
6382,10,-3,397,539163,10,539153
6383,19,-11,49,304011,19,303992
6384,13,-1,481,620433,13,620420
6385,19,-18,780,90946,19,90927
6386,6,-5,444,477563,6,477557
6387,5,3,544,730232,5,730227
6388,15,-1,44,616911,15,616896
6389,16,14,816,1091877,16,1091861
6390,5,13,72,1032323,5,1032318
6391,15,6,213,837300,15,837285
6392,10,0,53,626412,10,626402
6393,15,4,850,779644,15,779629
6394,10,7,827,862359,10,862349
6395,6,-15,880,174153,6,174147
6396,10,-5,206,472450,10,472440
6397,7,-14,26,187042,7,187035
6398,17,11,617,995279,17,995262
6399,16,-13,852,247379,16,247363
6400,17,9,998,936509,17,936492
6401,11,18,761,1214457,11,1214446
6402,5,0,213,630098,5,630093
6403,18,-15,394,180639,18,180621
6404,17,-18,456,88694,17,88677
6405,10,-20,706,15579,10,15569
6406,20,-10,561,339258,20,339238
6407,20,6,899,842919,20,842899
6408,11,10,360,962540,11,962529
6409,10,1,172,660941,10,660931
6410,6,-5,111,470532,6,470526
6411,18,-20,872,29509,18,29491
6412,19,-16,554,151056,19,151037
6413,20,8,601,902688,20,902668
6414,12,16,807,1152911,12,1152899
6415,18,8,697,903503,18,903485
6416,11,14,559,1089808,11,1089797
6417,8,8,79,876736,8,876728
6418,12,-17,368,118205,12,118193
6419,11,16,464,1150428,11,1150417
6420,19,16,339,1149561,19,1149542
6421,18,-2,446,588470,18,588452
6422,20,-3,69,554278,20,554258
6423,17,-7,335,430867,17,430850
6424,17,-7,417,431466,17,431449
6425,6,12,928,1019546,6,1019540
6426,19,-12,495,276176,19,276157
6427,16,3,416,744993,16,744977
6428,13,8,952,905350,13,905337
6429,19,-4,625,526812,19,526793
6430,15,-10,745,340698,15,340683
6431,9,3,54,719998,9,719989
6432,12,-10,662,340075,12,340063
6433,18,-4,547,526253,18,526235
6434,6,-17,76,95006,6,95000
6435,20,0,652,653242,20,653222
6436,6,15,647,1108153,6,1108147
6437,13,-7,205,429839,13,429826
6438,10,-3,297,536863,10,536853
6439,11,3,402,744885,11,744874
6440,18,15,553,1120787,18,1120769
6441,17,-17,516,119385,17,119368
6442,7,-14,547,198301,7,198294
6443,5,19,298,1224137,5,1224132
6444,10,11,683,983024,10,983014
6445,17,7,659,871843,17,871826
6446,16,13,986,1060504,16,1060488
6447,11,-4,851,528317,11,528306
6448,6,-5,10,467970,6,467964
6449,7,3,138,721801,7,721794
6450,14,-4,377,525043,14,525029
6451,16,-20,783,28846,16,28830
6452,14,-13,179,242360,14,242346
6453,15,2,491,714307,15,714292
6454,17,-11,157,304977,17,304960
6455,18,2,283,712679,18,712661
6456,7,-19,480,41823,7,41816
6457,14,3,837,748110,14,748096
6458,17,1,620,684709,17,684692
6459,7,13,5,1030947,7,1030940
6460,5,4,583,763154,5,763149
6461,9,-7,717,421050,9,421041
6462,18,-7,314,430701,18,430683
6463,8,-5,229,473015,8,473007
6464,10,11,195,972455,10,972445
6465,19,-7,916,435088,19,435069
6466,9,-15,219,159955,9,159946
6467,11,4,316,775440,11,775429
6468,14,12,404,1024999,14,1024985
6469,6,-9,999,365584,6,365578
6470,15,-9,570,371235,15,371220
6471,16,-1,881,623335,16,623319
6472,14,-6,849,465556,14,465542
6473,20,8,610,902755,20,902735
6474,20,-15,848,184156,20,184136
6475,18,18,931,1215775,18,1215757
6476,20,-20,250,24683,20,24663
6477,10,-1,900,613317,10,613307
6478,5,-14,637,200758,5,200753
6479,10,-20,931,20514,10,20504
6480,10,-1,324,601061,10,601051
6481,11,11,454,994152,11,994141
6482,6,18,343,1194136,6,1194130
6483,9,8,189,879148,9,879139
6484,18,-11,105,304523,18,304505
6485,19,15,647,1121517,19,1121498
6486,19,-5,21,490942,19,490923
6487,16,-12,827,278588,16,278572
6488,20,-9,480,370464,20,370444
6489,15,3,644,746691,15,746676
6490,17,-2,22,585314,17,585297
6491,16,-20,192,24353,16,24337
6492,10,-11,992,302539,10,302529
6493,17,18,929,1215762,17,1215745
6494,6,11,447,977939,6,977933
6495,20,-5,483,494626,20,494606
6496,9,-7,350,413468,9,413459
6497,9,19,214,1222246,9,1222237
6498,12,16,497,1150630,12,1150618
6499,20,16,363,1149765,20,1149745
6500,19,-19,423,57246,19,57227
6501,15,-2,495,588886,15,588871
6502,14,-10,804,341178,14,341164
6503,14,-8,491,401246,14,401232
6504,8,-16,549,135961,8,135953
6505,11,5,149,804872,11,804861
6506,8,-9,527,355533,8,355525
6507,8,-1,189,597733,8,597725
6508,15,9,834,935247,15,935232
6509,17,5,912,810428,17,810411
6510,9,-9,570,356518,9,356509
6511,8,17,851,1173677,8,1173669
6512,14,-16,92,147579,14,147565
6513,8,10,285,943539,8,943531
6514,8,-7,515,416881,8,416873
6515,17,6,986,843621,17,843604
6516,10,12,178,1003015,10,1003005
6517,15,-7,699,433389,15,433374
6518,9,-15,641,169314,9,169305
6519,14,-5,327,493586,14,493572
6520,12,-13,276,243131,12,243119
6521,16,-5,20,490934,16,490918
6522,7,14,120,1064518,7,1064511
6523,5,1,460,667259,5,667254
6524,20,18,398,1211972,20,1211952
6525,7,-9,239,348749,7,348742
6526,13,-7,51,428665,13,428652
6527,5,1,517,668601,5,668596
6528,9,-14,925,206614,9,206605
6529,9,-8,929,395148,9,395139
6530,10,-12,508,260648,10,260638
6531,8,1,777,673907,8,673899
6532,10,4,472,760731,10,760721
6533,15,5,42,804078,15,804063
6534,20,-2,682,590260,20,590240
6535,6,15,393,1102790,6,1102784
6536,13,-15,690,182857,13,182844
6537,19,-4,855,528359,19,528340
6538,20,13,34,1053457,20,1053437
6539,13,11,806,996697,13,996684
6540,15,-12,16,272618,15,272603
6541,18,19,726,1246701,18,1246683
6542,13,-10,912,341911,13,341898
6543,15,5,370,806514,15,806499
6544,11,15,692,1121844,11,1121833
6545,5,5,268,787259,5,787254
6546,13,-6,552,463440,13,463427
6547,6,18,388,1195032,6,1195026
6548,14,-15,775,183556,14,183542
6549,5,-13,547,229953,5,229948
6550,17,15,530,1120616,17,1120599
6551,19,-12,786,278251,19,278232
6552,15,-20,888,29624,15,29609
6553,6,-18,364,70239,6,70233
6554,17,2,397,713612,17,713595
6555,7,-6,149,439944,7,439937
6556,8,18,119,1189420,8,1189412
6557,13,12,734,1027540,13,1027527
6558,14,-3,439,557113,14,557099
6559,17,-3,582,558387,17,558370
6560,11,9,158,930241,11,930230
6561,7,-18,487,72887,7,72880
6562,9,-19,667,46114,9,46105
6563,20,13,254,1055053,20,1055033
6564,7,-5,127,470843,7,470836
6565,9,-9,395,352290,9,352281
6566,6,8,533,886926,6,886920
6567,7,6,726,828781,7,828774
6568,9,19,276,1223581,9,1223572
6569,15,-7,995,435694,15,435679
6570,18,-8,75,398560,18,398542
6571,17,-13,80,241621,17,241604
6572,14,12,398,1024972,14,1024958
6573,20,-16,763,152526,20,152506
6574,13,-9,507,370663,13,370650
6575,8,16,874,1143248,8,1143240
6576,12,-5,585,495363,12,495351
6577,15,-18,645,89934,15,89919
6578,19,11,583,995035,19,995016
6579,19,6,553,840214,19,840195
6580,15,7,574,871252,15,871237
6581,13,2,16,710562,13,710549
6582,6,-16,66,125238,6,125232
6583,17,-15,748,183343,17,183326
6584,8,-1,622,607355,8,607347
6585,12,11,35,991137,12,991125
6586,7,-1,423,603186,7,603179
6587,12,-7,30,428567,12,428555
6588,5,19,404,1226685,5,1226680
6589,18,-3,382,556641,18,556623
6590,5,-13,473,228289,5,228284
6591,5,5,939,801418,5,801413
6592,20,9,768,934664,20,934644
6593,12,-18,199,86828,12,86816
6594,13,11,446,994084,13,994071
6595,9,0,532,636841,9,636832
6596,6,10,666,951925,6,951919
6597,18,-4,20,522193,18,522175
6598,7,-13,479,228421,7,228414
6599,6,3,782,735568,6,735562
6600,16,-2,471,588686,16,588670
6601,13,-13,875,247576,13,247563
6602,5,-15,468,165578,5,165573
6603,8,-10,600,325593,8,325585
6604,15,18,694,1213985,15,1213970
6605,11,-16,434,150184,11,150173
6606,9,-4,326,506645,9,506636
6607,17,-8,807,403650,17,403633
6608,9,-2,412,571454,9,571445
6609,13,7,471,870517,13,870504
6610,11,-17,959,122535,11,122524
6611,12,0,222,649904,12,649892
6612,8,1,322,664281,8,664273
6613,5,5,94,783563,5,783558
6614,16,-20,799,29005,16,28989
6615,18,-9,620,371480,18,371462
6616,16,-19,366,56833,16,56817
6617,20,8,599,902657,20,902637
6618,5,4,489,761072,5,761067
6619,5,10,927,957493,5,957488
6620,10,13,536,1042157,10,1042147
6621,7,-6,721,452316,7,452309
6622,15,-10,4,335145,15,335130
6623,8,-17,558,105491,8,105483
6624,5,-13,172,222011,5,222006
6625,17,9,355,931640,17,931623
6626,14,4,455,776514,14,776500
6627,9,-19,875,50587,9,50578
6628,16,-3,608,558590,16,558574
6629,12,-12,592,276828,12,276816
6630,14,0,952,655504,14,655490
6631,13,3,676,746991,13,746978
6632,8,18,157,1190207,8,1190199
6633,19,-12,147,273613,19,273594
6634,9,-7,923,425570,9,425561
6635,17,1,604,684597,17,684580
6636,6,-16,123,126754,6,126748
6637,13,9,319,931336,13,931323
6638,9,-8,346,382729,9,382720
6639,10,-3,643,544931,10,544921
6640,5,7,141,847854,5,847849
6641,13,3,604,746337,13,746324
6642,8,13,118,1033247,8,1033239
6643,14,-11,848,310326,14,310312
6644,14,-18,228,87062,14,87048
6645,9,-20,726,15957,9,15948
6646,14,-6,920,466109,14,466095
6647,17,1,377,682873,17,682856
6648,17,-20,564,27107,17,27090
6649,19,-17,423,118564,19,118545
6650,13,1,477,683621,13,683608
6651,12,16,211,1148633,12,1148621
6652,5,-1,753,609974,5,609969
6653,11,-3,664,559073,11,559062
6654,16,15,295,1118960,16,1118944
6655,8,-10,278,318551,8,318543
6656,9,13,972,1051546,9,1051537
6657,14,6,60,836216,14,836202
6658,8,16,106,1127326,8,1127318
6659,9,-9,111,345922,9,345913
6660,18,3,507,745608,18,745590
6661,11,14,396,1088504,11,1088493
6662,7,-14,589,199549,7,199542
6663,8,-19,810,49122,8,49114
6664,16,13,305,1055437,16,1055421
6665,5,-8,98,377431,5,377426
6666,5,16,815,1142100,5,1142095
6667,9,15,95,1096448,9,1096439
6668,5,15,606,1107323,5,1107318
6669,16,8,230,899845,16,899829
6670,15,-1,588,621160,15,621145
6671,17,19,440,1244464,17,1244447
6672,11,7,563,871152,11,871141
6673,10,-5,773,484598,10,484588
6674,6,2,10,688708,6,688702
6675,14,-8,115,398682,14,398668
6676,20,1,322,682459,20,682439
6677,13,3,188,743299,13,743286
6678,16,-8,953,404646,16,404630
6679,15,-16,101,147666,15,147651
6680,20,7,606,871495,20,871475
6681,14,-17,622,120155,14,120141
6682,14,-9,557,371128,14,371114
6683,5,3,456,728594,5,728589
6684,6,5,671,795461,6,795455
6685,11,-15,850,184189,11,184178
6686,13,13,505,1056984,13,1056971
6687,5,-19,607,44830,5,44825
6688,16,2,883,717071,16,717055
6689,9,12,115,1001641,9,1001632
6690,11,6,108,836583,11,836572
6691,12,16,357,1149729,12,1149717
6692,8,-6,128,439383,8,439375
6693,13,11,867,997150,13,997137
6694,9,-2,716,578123,9,578114
6695,19,-3,412,556846,19,556827
6696,11,-18,225,87025,11,87014
6697,14,-10,850,341479,14,341465
6698,7,15,965,1115042,7,1115035
6699,18,-17,381,118293,18,118275
6700,19,19,348,1243572,19,1243553
6701,10,-9,743,360064,10,360054
6702,18,2,333,713092,18,713074
6703,6,-13,249,223674,6,223668
6704,9,-13,131,221148,9,221139
6705,8,-16,280,130120,8,130112
6706,13,13,481,1056786,13,1056773
6707,6,10,481,947698,6,947692
6708,20,-20,630,27574,20,27554
6709,5,9,331,913702,5,913697
6710,8,12,751,1015428,8,1015420
6711,5,-4,70,500860,5,500855
6712,20,-15,978,185202,20,185182
6713,6,-6,852,454964,6,454958
6714,10,3,47,719823,10,719813
6715,19,10,344,962423,19,962404
6716,10,0,146,628613,10,628603
6717,6,3,578,731169,6,731163
6718,11,16,589,1151254,11,1151243
6719,17,7,396,869962,17,869945
6720,18,-10,161,336279,18,336261
6721,16,8,907,905054,16,905038
6722,15,-11,800,309937,15,309922
6723,7,14,692,1077628,7,1077621
6724,6,-12,821,267363,6,267357
6725,8,15,251,1099918,8,1099910
6726,20,15,695,1121896,20,1121876
6727,17,-8,172,399138,17,399121
6728,10,-16,632,137708,10,137698
6729,11,-1,90,617262,11,617251
6730,9,18,920,1206193,9,1206184
6731,12,1,770,685875,12,685863
6732,8,1,555,669462,8,669454
6733,9,-6,484,447167,9,447158
6734,20,12,841,1028383,20,1028363
6735,6,11,785,985219,6,985213
6736,10,-17,87,95297,10,95287
6737,5,4,473,760765,5,760760
6738,12,-3,123,554667,12,554655
6739,18,-5,791,496751,18,496733
6740,12,12,670,1027094,12,1027082
6741,20,-8,878,404102,20,404082
6742,12,2,523,714580,12,714568
6743,5,-9,140,346557,5,346552
6744,5,0,358,632925,5,632920
6745,12,-15,193,179123,12,179111
6746,8,18,813,1203908,8,1203900
6747,18,15,194,1118257,18,1118239
6748,14,1,795,686054,14,686040
6749,9,16,783,1141338,9,1141329
6750,15,-5,706,496185,15,496170
6751,8,-19,519,42759,8,42751
6752,7,17,838,1173325,7,1173318
6753,9,-3,228,535269,9,535260
6754,9,12,533,1010508,9,1010499
6755,7,-19,519,42766,7,42759
6756,11,6,586,840503,11,840492
6757,6,-15,747,171434,6,171428
6758,7,-2,823,580408,7,580401
6759,6,14,71,1063410,6,1063404
6760,14,12,768,1027747,14,1027733
6761,6,-15,696,170209,6,170203
6762,12,-10,949,342215,12,342203
6763,19,-16,412,149959,19,149940
6764,17,0,64,648722,17,648705
6765,7,-15,89,157307,7,157300
6766,14,-7,385,431259,14,431245
6767,12,1,408,683087,12,683075
6768,5,-1,799,611015,5,611010
6769,16,-10,588,339450,16,339434
6770,10,16,771,1141068,10,1141058
6771,17,-3,995,561704,17,561687
6772,16,-15,912,184717,16,184701
6773,19,-8,434,400893,19,400874
6774,8,-11,910,300681,8,300673
6775,9,-14,616,200228,9,200219
6776,15,-5,962,498090,15,498075
6777,6,-20,738,16213,6,16207
6778,6,19,64,1218860,6,1218854
6779,12,-18,696,90270,12,90258
6780,6,-1,41,594692,6,594686
6781,6,1,465,667351,6,667345
6782,20,7,238,868679,20,868659
6783,6,8,340,882659,6,882653
6784,18,12,866,1028583,18,1028565
6785,14,5,892,810242,14,810228
6786,8,14,727,1078356,8,1078348
6787,17,8,537,902197,17,902180
6788,14,5,986,811033,14,811019
6789,6,13,931,1050634,6,1050628
6790,13,11,835,996865,13,996852
6791,18,-1,408,619811,18,619793
6792,7,-19,671,46213,7,46206
6793,6,15,9,1094603,6,1094597
6794,6,16,875,1143271,6,1143265
6795,7,-17,669,107884,7,107877
6796,18,18,417,1212133,18,1212115
6797,8,3,538,730086,8,730078
6798,19,-20,544,26958,19,26939
6799,10,16,830,1142449,10,1142439
6800,17,18,974,1216135,17,1216118
6801,13,-18,777,90895,13,90882
6802,5,-1,287,600250,5,600245
6803,10,9,466,916459,10,916449
6804,11,-17,64,115956,11,115945
6805,9,7,536,856179,9,856170
6806,12,16,949,1153837,12,1153825
6807,8,13,222,1035487,8,1035479
6808,10,-19,316,38308,10,38298
6809,13,-8,270,399757,13,399744
6810,6,-13,865,237057,6,237051
6811,20,-14,561,213852,20,213832
6812,5,-1,79,595512,5,595507
6813,15,19,606,1245686,15,1245671
6814,17,-18,178,86676,17,86659
6815,13,5,438,806936,13,806923
6816,5,-20,674,14847,5,14842
6817,12,10,213,961440,12,961428
6818,13,4,813,779237,13,779224
6819,10,10,824,955338,10,955328
6820,12,9,823,935138,12,935126
6821,7,-15,363,163262,7,163255
6822,18,-11,389,306846,18,306828
6823,7,-12,552,261502,7,261495
6824,7,-1,194,597861,7,597854
6825,12,-18,758,90804,12,90792
6826,19,10,446,963213,19,963194
6827,11,-5,253,492886,11,492875
6828,11,11,387,993728,11,993717
6829,15,7,205,868449,15,868434
6830,14,-4,998,529588,14,529574
6831,5,8,583,887956,5,887951
6832,10,-2,341,569989,10,569979
6833,5,-20,454,9702,5,9697
6834,11,-6,99,459829,11,459818
6835,10,8,644,889319,10,889309
6836,19,9,389,931848,19,931829
6837,11,-16,221,148617,11,148606
6838,5,9,874,925253,5,925248
6839,6,12,245,1004457,6,1004451
6840,11,8,486,901784,11,901773
6841,19,12,233,1023755,19,1023736
6842,14,-10,494,338725,14,338711
6843,14,11,258,992689,14,992675
6844,15,-9,261,368512,15,368497
6845,12,15,278,1118844,12,1118832
6846,8,-1,493,604848,8,604840
6847,9,-1,855,612147,9,612138
6848,9,-16,256,129577,9,129568
6849,20,18,824,1214902,20,1214882
6850,17,-12,133,273528,17,273511
6851,16,-3,784,560101,16,560085
6852,10,18,143,1189964,10,1189954
6853,16,3,226,743585,16,743569
6854,16,17,464,1181403,16,1181387
6855,19,9,774,934743,19,934724
6856,5,1,121,659746,5,659741
6857,14,4,843,779539,14,779525
6858,6,-15,777,172031,6,172025
6859,18,-12,911,279432,18,279414
6860,16,12,316,1024418,16,1024402
6861,19,2,43,710842,19,710823
6862,15,-8,508,401402,15,401387
6863,16,-10,149,336210,16,336194
6864,10,18,566,1198802,10,1198792
6865,6,0,183,629526,6,629520
6866,18,12,772,1027791,18,1027773
6867,20,16,800,1152849,20,1152829
6868,13,-6,790,465171,13,465158
6869,19,-9,566,371163,19,371144
6870,7,2,204,693053,7,693046
6871,10,17,894,1174571,10,1174561
6872,18,-6,924,466137,18,466119
6873,5,-10,892,331681,5,331676
6874,12,-6,431,462442,12,462430
6875,12,14,644,1090450,12,1090438
6876,20,8,532,902174,20,902154
6877,16,-18,627,89794,16,89778
6878,12,-11,236,305532,12,305520
6879,19,3,403,744903,19,744884
6880,18,-14,841,216048,18,216030
6881,15,17,697,1183073,15,1183058
6882,14,-16,830,152982,14,152968
6883,9,-3,19,530972,9,530963
6884,14,5,7,803840,14,803826
6885,7,-20,458,9776,7,9769
6886,14,14,720,1091136,14,1091122
6887,13,14,823,1091898,13,1091885
6888,19,-15,641,182560,19,182541
6889,12,6,339,838419,12,838407
6890,20,11,234,992479,20,992459
6891,17,-2,383,587943,17,587926
6892,5,14,339,1069315,5,1069310
6893,20,-8,202,399338,20,399318
6894,7,-18,689,77104,7,77097
6895,13,-3,888,560897,13,560884
6896,11,-9,18,366734,11,366723
6897,10,17,942,1175460,10,1175450
6898,19,-19,837,60427,19,60408
6899,9,15,50,1095534,9,1095525
6900,6,-14,943,206966,6,206960
6901,11,15,679,1121758,11,1121747
6902,15,-3,379,556601,15,556586
6903,12,-12,393,275391,12,275379
6904,17,7,666,871922,17,871905
6905,18,11,106,991625,18,991607
6906,9,-4,447,509193,9,509184
6907,14,10,825,966242,14,966228
6908,5,-5,737,483956,5,483951
6909,19,-1,419,619887,19,619868
6910,11,18,917,1215632,11,1215621
6911,14,18,829,1214963,14,1214949
6912,9,12,872,1018230,9,1018221
6913,8,10,728,953182,8,953174
6914,7,-3,469,540971,7,540964
6915,17,-13,220,242651,17,242634
6916,18,-11,745,309504,18,309486
6917,11,-20,682,28046,11,28035
6918,8,1,61,658318,8,658310
6919,11,14,301,1087754,11,1087743
6920,11,-1,272,618681,11,618670
6921,8,-19,586,44382,8,44374
6922,20,-1,649,621574,20,621554
6923,8,8,58,876317,8,876309
6924,15,-4,981,529474,15,529459
6925,12,5,118,804642,12,804630
6926,20,5,194,805287,20,805267
6927,16,19,939,1248310,16,1248294
6928,10,8,363,883109,10,883099
6929,8,-7,50,407084,8,407076
6930,13,-7,129,429226,13,429213
6931,14,8,774,904093,14,904079
6932,19,-7,398,431365,19,431346
6933,17,-2,387,587960,17,587943
6934,12,16,924,1153735,12,1153723
6935,16,5,442,806991,16,806975
6936,7,-14,134,189376,7,189369
6937,17,14,634,1090367,17,1090350
6938,12,-10,431,338197,12,338185
6939,12,17,29,1178067,12,1178055
6940,5,-3,292,536731,5,536726
6941,13,14,824,1091905,13,1091892
6942,18,4,936,780147,18,780129
6943,17,5,634,808436,17,808419
6944,8,14,321,1068910,8,1068902
6945,6,-12,717,265008,6,265002
6946,12,8,355,900749,12,900737
6947,13,5,365,806464,13,806451
6948,8,3,742,734874,8,734866
6949,20,4,698,778351,20,778331
6950,7,-1,281,600010,7,600003
6951,9,-20,460,9800,9,9791
6952,13,12,862,1028557,13,1028544
6953,18,-15,421,180879,18,180861
6954,8,13,384,1038973,8,1038965
6955,8,8,263,880880,8,880872
6956,19,-14,558,213796,19,213777
6957,5,15,2,1094375,5,1094370
6958,6,-13,168,221901,6,221895
6959,17,-10,539,339079,17,339062
6960,19,9,437,932228,19,932209
6961,9,15,628,1107792,9,1107783
6962,11,-17,767,121339,11,121328
6963,16,-8,944,404558,16,404542
6964,7,9,58,907990,7,907983
6965,9,5,537,792753,9,792744
6966,7,-2,209,567173,7,567166
6967,9,-13,948,238923,9,238914
6968,5,-2,357,570295,5,570290
6969,15,12,664,1027028,15,1027013
6970,6,-8,917,394939,6,394933
6971,15,-15,49,178155,15,178140
6972,15,15,730,1122204,15,1122189
6973,9,-20,862,19060,9,19051
6974,14,14,42,1085737,14,1085723
6975,8,-20,372,8149,8,8141
6976,16,17,893,1184669,16,1184653
6977,9,8,420,884426,9,884417
6978,11,6,970,843506,11,843495
6979,17,11,837,996886,17,996869
6980,15,-2,567,589399,15,589384
6981,15,19,446,1244526,15,1244511
6982,9,5,815,798618,9,798609
6983,18,-4,112,522889,18,522871
6984,5,13,941,1050842,5,1050837
6985,14,-7,764,433847,14,433833
6986,17,-20,707,28231,17,28214
6987,6,4,1,750587,6,750581
6988,9,15,511,1105353,9,1105344
6989,14,-10,992,342645,14,342631
6990,12,-14,151,210456,12,210444
6991,19,-18,437,88533,19,88514
6992,11,19,988,1248712,11,1248701
6993,19,-14,113,210185,19,210166
6994,16,0,25,648413,16,648397
6995,16,0,693,653589,16,653573
6996,7,-11,574,293825,7,293818
6997,17,0,559,652449,17,652432
6998,10,-5,351,475835,10,475825
6999,5,-5,660,482301,5,482296
7000,19,3,712,747269,19,747250
7001,13,-12,598,276863,13,276850
7002,5,11,149,971556,5,971551
7003,11,8,705,903560,11,903549
7004,10,11,275,974136,10,974126
7005,9,1,326,664374,9,664365
7006,16,-14,297,211702,16,211686
7007,16,17,476,1181483,16,1181467
7008,14,7,600,871452,14,871438
7009,17,9,981,936410,17,936393
7010,11,8,101,898712,11,898701
7011,11,-20,11,6311,11,6300
7012,17,-13,373,243772,17,243755
7013,6,18,685,1201135,6,1201129
7014,9,-2,300,569246,9,569237
7015,16,8,206,899601,16,899585
7016,15,11,843,996970,15,996955
7017,17,-2,553,589311,17,589294
7018,15,-13,198,242527,15,242512
7019,19,-14,567,213965,19,213946
7020,7,16,904,1143900,7,1143893
7021,10,16,621,1138201,10,1138191
7022,10,6,404,821477,10,821467
7023,9,12,711,1014682,9,1014673
7024,10,8,17,875511,10,875501
7025,13,14,982,1093140,13,1093127
7026,9,7,993,865835,9,865826
7027,16,-1,839,622978,16,622962
7028,15,-17,791,121471,15,121456
7029,13,6,486,839666,13,839653
7030,7,15,207,1098899,7,1098892
7031,12,-6,293,461454,12,461442
7032,7,-20,169,3779,7,3772
7033,14,19,370,1243780,14,1243766
7034,8,9,665,920729,8,920721
7035,8,7,231,849718,8,849710
7036,19,-14,369,212349,19,212330
7037,7,-2,330,569810,7,569803
7038,15,14,92,1086172,15,1086157
7039,5,-4,963,520123,5,520118
7040,18,3,28,741991,18,741973
7041,5,-12,265,255220,5,255215
7042,17,-19,570,58505,17,58488
7043,11,-20,164,23997,11,23986
7044,16,-9,813,372994,16,372978
7045,11,10,978,967302,11,967291
7046,19,-13,378,243804,19,243785
7047,15,-17,841,121779,15,121764
7048,10,-4,152,502669,10,502659
7049,19,4,130,774167,19,774148
7050,17,-8,533,401592,17,401575
7051,10,-11,402,290023,10,290013
7052,14,13,952,1060302,14,1060288
7053,17,-18,34,85459,17,85442
7054,8,-3,271,536270,8,536262
7055,17,-10,743,340687,17,340670
7056,12,-9,298,368739,12,368727
7057,18,6,284,837938,18,837920
7058,16,-10,682,340222,16,340206
7059,12,17,606,1182367,12,1182355
7060,16,-15,856,184263,16,184247
7061,7,1,433,666597,7,666590
7062,16,-18,129,86206,16,86190
7063,9,-9,532,355684,9,355675
7064,15,-8,907,404354,15,404339
7065,20,11,280,992887,20,992867
7066,11,19,84,1241467,11,1241456
7067,19,19,577,1245523,19,1245504
7068,8,11,243,973440,8,973432
7069,10,-11,390,289744,10,289734
7070,6,2,419,697671,6,697665
7071,6,0,963,646305,6,646299
7072,11,-19,759,59929,11,59918
7073,18,19,43,1241041,18,1241023
7074,5,10,591,950199,5,950194
7075,20,12,796,1027992,20,1027972
7076,17,-13,604,245515,17,245498
7077,20,-20,517,26702,20,26682
7078,11,10,698,965275,11,965264
7079,8,0,165,629031,8,629023
7080,9,-12,502,260484,9,260475
7081,16,6,403,839016,16,839000
7082,16,1,413,683105,16,683089
7083,17,19,904,1248120,17,1248103
7084,9,-14,705,202100,9,202091
7085,16,7,590,871358,16,871342
7086,6,8,99,877172,6,877166
7087,10,16,299,1131507,10,1131497
7088,5,14,235,1067016,5,1067011
7089,11,-9,255,368445,11,368434
7090,6,-6,870,455313,6,455307
7091,20,6,235,837551,20,837531
7092,20,-1,512,620627,20,620607
7093,15,-7,12,428378,15,428363
7094,13,5,791,809524,13,809511
7095,14,-17,436,118691,14,118677
7096,15,-2,25,585317,15,585302
7097,16,-6,94,459790,16,459774
7098,14,-20,875,29544,14,29530
7099,6,2,510,699498,6,699492
7100,11,-1,452,620135,11,620124
7101,19,-17,631,120220,19,120201
7102,13,8,715,903669,13,903656
7103,10,10,814,955149,10,955139
7104,13,1,646,684933,13,684920
7105,16,15,698,1121913,16,1121897
7106,7,13,846,1048953,7,1048946
7107,13,13,383,1056044,13,1056031
7108,12,9,18,929177,12,929165
7109,15,4,816,779272,15,779257
7110,11,-9,777,372677,11,372666
7111,18,-3,621,558739,18,558721
7112,6,-13,392,226569,6,226563
7113,16,18,806,1214823,16,1214807
7114,19,9,205,930570,19,930551
7115,18,15,776,1122506,18,1122488
7116,15,-2,638,589903,15,589888
7117,5,12,600,1011989,5,1011984
7118,10,3,971,740106,10,740096
7119,14,-13,715,246282,14,246268
7120,19,2,915,717282,19,717263
7121,12,-2,466,588635,12,588623
7122,20,13,269,1055164,20,1055144
7123,9,-10,749,328750,9,328741
7124,20,-18,530,89154,20,89134
7125,7,8,593,888174,7,888167
7126,5,-17,622,106924,5,106919
7127,7,13,689,1045546,7,1045539
7128,20,19,855,1247694,20,1247674
7129,11,5,726,809065,11,809054
7130,14,-5,883,497513,14,497499
7131,19,-2,816,591275,19,591256
7132,5,3,688,733734,5,733729
7133,9,15,422,1103267,9,1103258
7134,16,2,390,713549,16,713533
7135,5,19,447,1227856,5,1227851
7136,14,-7,481,431940,14,431926
7137,6,-6,196,441179,6,441173
7138,13,11,586,995085,13,995072
7139,13,-9,50,367023,13,367010
7140,14,12,302,1024360,14,1024346
7141,5,-18,962,83364,5,83359
7142,16,-4,464,525574,16,525558
7143,8,10,514,948451,8,948443
7144,15,17,230,1179565,15,1179550
7145,10,3,732,734713,10,734703
7146,6,16,33,1125859,6,1125853
7147,7,-7,957,426307,7,426300
7148,17,0,198,649771,17,649754
7149,9,-1,240,599174,9,599165
7150,13,-20,231,24538,13,24525
7151,12,-8,259,399726,12,399714
7152,15,-11,900,310780,15,310765
7153,9,-20,572,12454,9,12445
7154,15,1,743,685654,15,685639
7155,14,-15,265,179676,14,179662
7156,18,0,886,655018,18,655000
7157,8,12,566,1011213,8,1011205
7158,13,19,472,1244682,13,1244669
7159,16,9,86,929675,16,929659
7160,5,-14,435,196177,5,196172
7161,13,0,837,654627,13,654614
7162,18,5,515,807544,18,807526
7163,10,-13,365,226003,10,225993
7164,9,9,550,918351,9,918342
7165,9,-20,173,3884,9,3875
7166,16,7,82,867636,16,867620
7167,19,1,603,684586,19,684567
7168,19,7,549,871065,19,871046
7169,9,-1,336,601421,9,601412
7170,9,13,863,1049327,9,1049318
7171,5,6,16,812546,5,812541
7172,19,-8,900,404301,19,404282
7173,12,-2,566,589373,12,589361
7174,11,3,139,742882,11,742871
7175,8,11,309,974972,8,974964
7176,7,-10,582,325199,7,325192
7177,14,3,857,748279,14,748265
7178,17,9,891,935648,17,935631
7179,12,0,980,655800,12,655788
7180,8,-5,632,481716,8,481708
7181,15,13,195,1054657,15,1054642
7182,9,1,391,665738,9,665729
7183,19,12,376,1024827,19,1024808
7184,11,14,958,1092929,11,1092918
7185,7,-17,910,112777,7,112770
7186,7,-14,520,197861,7,197854
7187,7,-1,936,614170,7,614163
7188,20,-4,850,528310,20,528290
7189,12,13,100,1053970,12,1053958
7190,20,5,615,808314,20,808294
7191,14,5,864,810055,14,810041
7192,7,0,946,645887,7,645880
7193,17,18,789,1214737,17,1214720
7194,16,-18,853,91395,16,91379
7195,12,8,289,900263,12,900251
7196,15,3,300,744161,15,744146
7197,16,14,841,1092012,16,1091996
7198,17,-1,89,617251,17,617234
7199,8,4,149,753816,8,753808
7200,13,5,575,807979,13,807966
7201,16,-12,656,277348,16,277332
7202,20,-1,308,619027,20,619007
7203,14,13,762,1058935,14,1058921
7204,16,-3,90,554405,16,554389
7205,5,-5,514,479119,5,479114
7206,6,-8,551,386981,6,386975
7207,7,6,282,818629,7,818622
7208,15,10,450,963241,15,963226
7209,14,-6,977,466552,14,466538
7210,7,-13,327,225295,7,225288
7211,19,10,911,966834,19,966815
7212,16,-11,315,306295,16,306279
7213,19,-18,217,86945,19,86926
7214,14,-6,544,463379,14,463365
7215,8,-1,992,615342,8,615334
7216,9,3,127,721577,9,721568
7217,8,-1,80,595559,8,595551
7218,12,4,927,780100,12,780088
7219,6,-1,87,595672,6,595666
7220,14,0,163,649449,14,649435
7221,14,0,398,651088,14,651074
7222,16,-13,350,243628,16,243612
7223,17,-4,296,524364,17,524347
7224,9,18,444,1196202,9,1196193
7225,18,1,530,684055,18,684037
7226,20,10,496,963591,20,963571
7227,6,-12,834,267659,6,267653
7228,14,-11,930,310959,14,310945
7229,6,4,845,769219,6,769213
7230,8,10,80,939223,8,939215
7231,8,17,475,1165475,8,1165467
7232,11,4,972,780374,11,780363
7233,17,3,895,748554,17,748537
7234,6,-12,297,256030,6,256024
7235,9,-16,721,139508,9,139499
7236,8,-8,477,385154,8,385146
7237,8,17,600,1168069,8,1168061
7238,6,-1,981,615019,6,615013
7239,19,3,149,742959,19,742940
7240,11,1,207,681519,11,681508
7241,14,-9,376,369469,14,369455
7242,6,8,84,876803,6,876797
7243,5,4,40,751394,5,751389
7244,12,0,335,650552,12,650540
7245,7,13,982,1051728,7,1051721
7246,10,-20,949,20880,10,20870
7247,6,19,324,1224813,6,1224807
7248,5,12,627,1012677,5,1012672
7249,6,10,634,951209,6,951203
7250,16,-18,520,89085,16,89069
7251,6,-9,412,352576,6,352570
7252,6,-17,964,113766,6,113760
7253,10,4,392,759097,10,759087
7254,13,-3,825,560387,13,560374
7255,18,-19,770,59995,18,59977
7256,18,-4,472,525621,18,525603
7257,8,-16,684,138671,8,138663
7258,16,-5,246,492814,16,492798
7259,14,-2,776,590931,14,590917
7260,19,15,5,1116782,19,1116763
7261,17,7,918,873566,17,873549
7262,17,-14,489,213259,17,213242
7263,8,-15,925,175094,8,175086
7264,19,8,627,902919,19,902900
7265,20,15,64,1117252,20,1117232
7266,11,-7,697,433374,11,433363
7267,13,-20,438,26122,13,26109
7268,17,13,892,1059891,17,1059874
7269,11,-18,976,92326,11,92315
7270,19,10,22,959994,19,959975
7271,17,-9,2,366645,17,366628
7272,12,-3,248,555537,12,555525
7273,7,-4,974,520383,7,520376
7274,19,-3,247,555507,19,555488
7275,11,13,15,1053336,11,1053325
7276,7,9,749,922430,7,922423
7277,20,17,348,1180575,20,1180555
7278,6,11,523,979648,6,979642
7279,12,-12,782,278235,12,278223
7280,10,2,322,695566,10,695556
7281,6,8,131,877873,6,877867
7282,19,10,127,960881,19,960862
7283,10,2,914,707620,10,707610
7284,12,-14,10,209418,12,209406
7285,9,-3,565,543209,9,543200
7286,16,6,367,838595,16,838579
7287,7,1,569,669749,7,669742
7288,13,-15,713,183066,13,183053
7289,12,14,193,1086932,12,1086920
7290,20,19,85,1241486,20,1241466
7291,15,-8,480,401172,15,401157
7292,6,3,843,737015,6,737009
7293,19,12,994,1029765,19,1029746
7294,13,-11,211,305365,13,305352
7295,7,18,215,1191495,7,1191488
7296,8,-5,944,488545,8,488537
7297,5,0,832,643380,5,643375
7298,19,-6,3,459159,19,459140
7299,18,-7,577,432663,18,432645
7300,16,14,996,1093291,16,1093275
7301,6,16,271,1130929,6,1130923
7302,11,-10,35,335418,11,335407
7303,8,0,59,626539,8,626531
7304,15,-6,939,466253,15,466238
7305,10,-18,568,74603,10,74593
7306,20,10,480,963479,20,963459
7307,10,14,416,1071096,10,1071086
7308,9,17,692,1170095,9,1170086
7309,7,-13,1,218348,7,218341
7310,14,0,765,654157,14,654143
7311,8,-14,105,188855,8,188847
7312,12,-5,817,496910,12,496898
7313,7,7,476,855104,7,855097
7314,7,3,897,738125,7,738118
7315,10,18,293,1193149,10,1193139
7316,9,-3,635,544750,9,544741
7317,15,5,397,806691,15,806676
7318,19,10,451,963253,19,963234
7319,12,0,993,655869,12,655857
7320,10,-19,647,45778,10,45768
7321,15,6,878,842772,15,842757
7322,6,-6,523,448090,6,448084
7323,17,-20,295,25101,17,25084
7324,8,-10,524,323906,8,323898
7325,8,-9,883,363398,8,363390
7326,15,19,526,1245149,15,1245134
7327,20,8,168,899284,20,899264
7328,19,-6,740,464824,19,464805
7329,5,8,387,883613,5,883608
7330,5,-13,417,227003,5,226998
7331,17,-9,842,373211,17,373194
7332,13,-11,3,303683,13,303670
7333,8,-1,543,605810,8,605802
7334,20,-10,742,340670,20,340650
7335,9,9,455,916241,9,916232
7336,19,-5,68,491364,19,491345
7337,12,14,747,1091289,12,1091277
7338,15,7,7,867070,15,867055
7339,16,17,892,1184649,16,1184633
7340,20,-9,264,368521,20,368501
7341,10,-9,344,351200,10,351190
7342,13,15,240,1118552,13,1118539
7343,8,3,114,721305,8,721297
7344,7,2,588,700950,7,700943
7345,10,-4,487,509887,10,509877
7346,16,10,758,965669,16,965653
7347,15,14,71,1086001,15,1085986
7348,8,-18,475,72623,8,72615
7349,19,-5,591,495398,19,495379
7350,11,-14,388,212594,11,212583
7351,5,-9,260,349324,5,349319
7352,9,-15,675,169863,9,169854
7353,15,10,402,962884,15,962869
7354,9,16,987,1145772,9,1145763
7355,18,-5,144,492042,18,492024
7356,5,1,235,662341,5,662336
7357,18,-5,482,494617,18,494599
7358,5,19,920,1237901,5,1237896
7359,15,-3,78,554331,15,554316
7360,8,-8,894,394443,8,394435
7361,16,-7,243,430077,16,430061
7362,5,13,47,1031740,5,1031735
7363,18,2,139,711645,18,711627
7364,18,18,226,1210792,18,1210774
7365,6,1,381,665521,6,665515
7366,12,16,741,1152380,12,1152368
7367,13,-14,575,214042,13,214029
7368,18,2,408,713738,18,713720
7369,9,-11,371,289392,9,289383
7370,11,12,58,1022488,11,1022477
7371,9,-15,738,171295,9,171286
7372,5,12,3,999105,5,999100
7373,9,-17,581,106062,9,106053
7374,15,7,751,872444,15,872429
7375,16,17,889,1184602,16,1184586
7376,5,15,858,1112719,5,1112714
7377,9,-17,470,103479,9,103470
7378,12,-1,797,622686,12,622674
7379,6,-5,477,478321,6,478315
7380,19,10,260,961772,19,961753
7381,6,-4,267,505398,6,505392
7382,16,-20,302,25159,16,25143
7383,18,10,62,960300,18,960282
7384,13,2,752,716225,13,716212
7385,12,-15,127,178741,12,178729
7386,9,14,263,1067663,9,1067654
7387,19,18,660,1213743,19,1213724
7388,10,14,757,1078931,10,1078921
7389,10,-8,457,384751,10,384741
7390,20,-3,774,560027,20,560007
7391,15,13,658,1058220,15,1058205
7392,7,0,702,640736,7,640729
7393,6,-19,480,41829,6,41823
7394,18,-16,504,150732,18,150714
7395,18,2,351,713250,18,713232
7396,19,14,891,1092435,19,1092416
7397,15,-2,804,591156,15,591141
7398,17,-13,972,248381,17,248364
7399,13,16,988,1154163,13,1154150
7400,10,-2,787,579504,10,579494
7401,20,6,494,839757,20,839737
7402,12,-3,299,555951,12,555939
7403,14,-20,509,26661,14,26647
7404,14,-6,320,461646,14,461632
7405,11,-10,303,337242,11,337231
7406,8,13,353,1038371,8,1038363
7407,11,-18,599,89575,11,89564
7408,8,5,441,790691,8,790683
7409,9,-10,754,328800,9,328791
7410,16,5,496,807409,16,807393
7411,12,-6,617,463852,12,463840
7412,13,-6,215,460812,13,460799
7413,18,19,836,1247539,18,1247521
7414,17,0,262,650123,17,650106
7415,14,-13,196,242497,14,242483
7416,7,12,77,1000754,7,1000747
7417,15,-19,394,57071,15,57056
7418,12,9,666,933973,12,933961
7419,5,-6,91,438684,5,438679
7420,14,12,641,1026820,14,1026806
7421,19,11,715,995948,19,995929
7422,18,-5,614,495549,18,495531
7423,8,-11,892,300245,8,300237
7424,11,-5,115,491801,11,491790
7425,6,-4,583,511977,6,511971
7426,16,-2,249,587005,16,586989
7427,15,3,900,748582,15,748567
7428,12,10,617,964667,12,964655
7429,17,-9,742,372311,17,372294
7430,5,1,907,676744,5,676739
7431,11,13,351,1055807,11,1055796
7432,12,7,504,870743,12,870731
7433,15,-8,886,404139,15,404124
7434,19,8,321,900472,19,900453
7435,20,8,430,901393,20,901373
7436,13,9,371,931769,13,931756
7437,5,-17,264,99102,5,99097
7438,6,18,69,1188310,6,1188304
7439,6,13,812,1048264,6,1048258
7440,11,17,159,1179048,11,1179037
7441,8,-1,980,614984,8,614976
7442,9,-4,733,515150,9,515141
7443,6,9,281,912522,6,912516
7444,8,0,848,643755,8,643747
7445,17,-16,689,151964,17,151947
7446,11,6,46,836150,11,836139
7447,13,-12,126,273491,13,273478
7448,19,11,774,996460,19,996441
7449,13,-3,484,557504,13,557491
7450,16,17,841,1184272,16,1184256
7451,16,-12,402,275448,16,275432
7452,8,-20,236,5292,8,5284
7453,10,-7,491,416332,10,416322
7454,16,13,319,1055524,16,1055508
7455,13,12,494,1025693,13,1025680
7456,8,10,375,945458,8,945450
7457,8,-12,663,263954,8,263946
7458,14,-3,747,559726,14,559712
7459,17,14,62,1085912,17,1085895
7460,14,1,46,680136,14,680122
7461,10,-16,70,125314,10,125304
7462,15,15,940,1123639,15,1123624
7463,5,-14,661,201134,5,201129
7464,20,14,59,1085876,20,1085856
7465,12,-15,702,182979,12,182967
7466,14,8,13,898020,14,898006
7467,16,7,252,868855,16,868839
7468,14,-13,265,243034,14,243020
7469,8,0,923,645420,8,645412
7470,7,1,505,668308,7,668301
7471,14,5,566,807886,14,807872
7472,13,-10,568,339309,13,339296
7473,15,-11,983,311392,15,311377
7474,18,-9,852,373319,18,373301
7475,5,16,88,1127019,5,1127014
7476,16,1,247,681823,16,681807
7477,11,-4,194,523569,11,523558
7478,14,13,889,1059868,14,1059854
7479,10,5,516,792315,10,792305
7480,6,-10,290,318790,6,318784
7481,20,-17,555,119654,20,119634
7482,13,1,498,683799,13,683786
7483,11,17,621,1182454,11,1182443
7484,14,-14,580,214079,14,214065
7485,20,-6,874,465701,20,465681
7486,12,-17,346,118067,12,118055
7487,19,-6,129,460046,19,460027
7488,7,19,741,1233948,7,1233941
7489,18,-13,668,245849,18,245831
7490,11,-7,543,432446,11,432435
7491,10,-4,871,518036,10,518026
7492,13,4,818,779278,13,779265
7493,20,-15,150,178920,20,178900
7494,14,-11,864,310493,14,310479
7495,13,-18,862,91469,13,91456
7496,20,19,75,1241388,20,1241368
7497,5,0,163,628955,5,628950
7498,20,3,555,745920,20,745900
7499,10,-17,728,109099,10,109089
7500,7,5,854,799419,7,799412
7501,15,-4,323,524607,15,524592
7502,5,0,706,640785,5,640780
7503,19,4,278,775196,19,775177
7504,16,-7,442,431635,16,431619
7505,16,-1,405,619797,16,619781
7506,10,0,335,632448,10,632438
7507,8,12,331,1006408,8,1006400
7508,11,12,422,1025120,11,1025109
7509,9,1,557,669519,9,669510
7510,7,14,315,1068717,7,1068710
7511,9,-5,647,482029,9,482020
7512,14,-16,519,150836,14,150822
7513,7,5,513,792211,7,792204
7514,6,-19,757,48179,6,48173
7515,6,-17,13,93847,6,93841
7516,17,10,907,966774,17,966757
7517,11,-2,139,586145,11,586134
7518,20,-17,368,118215,20,118195
7519,16,-10,951,342233,16,342217
7520,10,-4,371,507694,10,507684
7521,17,-9,768,372630,17,372613
7522,17,-11,606,308575,17,308558
7523,18,19,317,1243322,18,1243304
7524,6,-17,144,96428,6,96422
7525,13,-14,990,217196,13,217183
7526,8,-1,612,607140,8,607132
7527,14,-1,638,621482,14,621468
7528,11,11,379,993636,11,993625
7529,19,9,400,931939,19,931920
7530,12,19,407,1244141,12,1244129
7531,18,-14,982,217141,18,217123
7532,17,-13,452,244298,17,244281
7533,20,19,412,1244194,20,1244174
7534,15,-11,781,309835,15,309820
7535,5,7,337,852099,5,852094
7536,19,-4,948,529167,19,529148
7537,19,19,503,1244909,19,1244890
7538,9,-8,689,390235,9,390226
7539,20,-7,803,434127,20,434107
7540,19,0,604,652831,19,652812
7541,6,-19,484,41912,6,41906
7542,17,-6,8,459217,17,459200
7543,9,-13,387,226447,9,226438
7544,10,-1,776,610544,10,610534
7545,12,3,516,745638,12,745626
7546,8,-10,15,312868,8,312860
7547,14,-4,851,528321,14,528307
7548,17,-14,104,210132,17,210115
7549,16,-16,546,151016,16,151000
7550,6,8,460,885239,6,885233
7551,15,10,808,966159,15,966144
7552,14,-5,459,494426,14,494412
7553,7,5,593,793901,7,793894
7554,8,14,805,1079977,8,1079969
7555,17,-20,439,26139,17,26122
7556,6,14,896,1081923,6,1081917
7557,10,-13,987,239718,10,239708
7558,6,-4,80,501098,6,501092
7559,8,18,647,1200393,8,1200385
7560,5,-15,831,173154,5,173149
7561,19,-3,325,556149,19,556130
7562,18,19,51,1241119,18,1241101
7563,14,-10,108,335900,14,335886
7564,18,17,133,1178838,18,1178820
7565,16,-18,527,89139,16,89123
7566,8,-18,728,78078,8,78070
7567,11,10,44,960178,11,960167
7568,16,10,661,965014,16,964998
7569,13,-2,574,589441,13,589428
7570,16,3,85,742459,16,742443
7571,14,-20,748,28555,14,28541
7572,16,10,193,961328,16,961312
7573,5,-20,787,17296,5,17291
7574,20,-2,988,592648,20,592628
7575,18,15,288,1118921,18,1118903
7576,6,11,652,982349,6,982343
7577,5,-20,586,12769,5,12764
7578,12,-3,64,554210,12,554198
7579,7,3,593,731437,7,731430
7580,18,-3,376,556584,18,556566
7581,13,-7,78,428831,13,428818
7582,18,-20,802,29022,18,29004
7583,10,-2,426,571842,10,571832
7584,20,-1,914,623561,20,623541
7585,5,-6,844,454781,5,454776
7586,6,0,144,628575,6,628569
7587,17,-18,342,87881,17,87864
7588,7,-18,531,73826,7,73819
7589,16,2,666,715574,16,715558
7590,9,-16,224,128929,9,128920
7591,14,-15,971,185145,14,185131
7592,20,-5,239,492763,20,492743
7593,15,16,921,1153718,15,1153703
7594,6,-5,737,483962,6,483956
7595,7,8,48,876068,7,876061
7596,18,-14,169,210578,18,210560
7597,6,-6,998,458084,6,458078
7598,6,6,240,817521,6,817515
7599,12,-16,707,152091,12,152079
7600,18,-5,363,493752,18,493734
7601,8,-12,923,269655,8,269647
7602,17,-12,839,278702,17,278685
7603,18,4,476,776674,18,776656
7604,7,-9,878,363246,7,363239
7605,12,-13,748,246550,12,246538
7606,14,0,612,652865,14,652851
7607,13,10,459,963313,13,963300
7608,19,-17,473,118984,19,118965
7609,8,12,964,1020390,8,1020382
7610,10,11,513,979409,10,979399
7611,20,6,857,842584,20,842564
7612,14,-3,376,556588,14,556574
7613,12,12,855,1028495,12,1028483
7614,14,-13,774,246811,14,246797
7615,10,-17,204,97703,10,97693
7616,7,18,754,1202605,7,1202598
7617,11,-17,950,122479,11,122468
7618,19,-14,46,209685,19,209666
7619,8,-19,474,41748,8,41740
7620,7,-15,634,169091,7,169084
7621,14,15,664,1121675,14,1121661
7622,15,15,743,1122297,15,1122282
7623,9,-1,807,611164,9,611155
7624,18,-5,965,498154,18,498136
7625,12,11,21,991015,12,991003
7626,14,-3,460,557323,14,557309
7627,9,16,871,1143168,9,1143159
7628,12,17,590,1182219,12,1182207
7629,10,-20,515,11077,10,11067
7630,10,15,392,1102766,10,1102756
7631,20,7,289,869097,20,869077
7632,14,11,300,993105,14,993091
7633,13,-6,890,465848,13,465835
7634,19,-12,356,275190,19,275171
7635,15,2,73,711119,15,711104
7636,19,16,775,1152589,19,1152570
7637,14,-9,544,371007,14,370993
7638,15,-16,182,148239,15,148224
7639,18,-10,587,339426,18,339408
7640,11,-15,357,180367,11,180356
7641,11,-10,829,341321,11,341310
7642,7,-7,541,417475,7,417468
7643,12,-13,684,245980,12,245968
7644,9,0,278,631307,9,631298
7645,17,-1,645,621517,17,621500
7646,18,2,844,716809,18,716791
7647,5,12,6,999170,5,999165
7648,7,-7,437,415260,7,415253
7649,7,-16,115,126555,7,126548
7650,6,-8,604,388110,6,388104
7651,5,10,18,937856,5,937851
7652,20,-15,635,182470,20,182450
7653,14,14,854,1092048,14,1092034
7654,13,-10,374,337755,13,337742
7655,16,1,124,680799,16,680783
7656,16,8,480,901712,16,901696
7657,12,-3,0,553852,12,553840
7658,16,-9,449,370135,16,370119
7659,7,4,965,771612,7,771605
7660,8,-11,150,284431,8,284423
7661,6,12,946,1019942,6,1019936
7662,8,-18,285,68687,8,68679
7663,6,-12,188,253452,6,253446
7664,15,-3,730,559575,15,559560
7665,20,-6,525,463216,20,463196
7666,13,-10,599,339528,13,339515
7667,20,13,300,1055416,20,1055396
7668,10,11,185,972184,10,972174
7669,9,-16,402,132643,9,132634
7670,19,-18,720,90512,19,90493
7671,6,-9,414,352653,6,352647
7672,9,-19,207,36187,9,36178
7673,20,10,247,961671,20,961651
7674,16,-17,643,120293,16,120277
7675,20,9,479,932516,20,932496
7676,9,7,878,863454,9,863445
7677,13,-18,704,90359,13,90346
7678,14,-17,281,117583,14,117569
7679,9,-4,967,520226,9,520217
7680,17,-4,24,522220,17,522203
7681,20,9,651,933866,20,933846
7682,10,-2,864,581264,10,581254
7683,10,-18,430,71625,10,71615
7684,16,13,879,1059813,16,1059797
7685,6,-18,698,77326,6,77320
7686,14,-8,567,401862,14,401848
7687,8,-4,787,516224,8,516216
7688,5,-9,336,350950,5,350945
7689,8,1,186,661221,8,661213
7690,17,-7,133,429246,17,429229
7691,19,13,585,1057724,19,1057705
7692,10,-15,328,162486,10,162476
7693,8,13,783,1047554,8,1047546
7694,6,-16,725,139602,6,139596
7695,17,11,803,996670,17,996653
7696,8,10,906,956942,8,956934
7697,10,-10,334,319780,10,319770
7698,11,-2,695,590384,11,590373
7699,15,-4,678,527212,15,527197
7700,7,-18,532,73852,7,73845
7701,12,9,767,934651,12,934639
7702,12,-8,648,402421,12,402409
7703,9,-7,308,412515,9,412506
7704,8,-3,421,539709,8,539701
7705,12,-15,90,178474,12,178462
7706,9,-15,523,166683,9,166674
7707,20,-19,153,55278,20,55258
7708,11,19,864,1247785,11,1247774
7709,17,9,995,936497,17,936480
7710,19,-13,757,246629,19,246610
7711,15,-13,650,245791,15,245776
7712,16,-8,510,401437,16,401421
7713,13,-5,518,494871,13,494858
7714,11,0,182,649643,11,649632
7715,12,-2,287,587275,12,587263
7716,10,14,827,1080460,10,1080450
7717,19,-16,822,152944,19,152925
7718,13,10,996,967411,13,967398
7719,13,15,374,1119524,13,1119511
7720,20,15,705,1121960,20,1121940
7721,19,-16,264,148896,19,148877
7722,14,-19,68,54391,14,54377
7723,6,-8,769,391823,6,391817
7724,18,13,408,1056284,18,1056266
7725,14,-1,185,617917,14,617903
7726,12,9,490,932626,12,932614
7727,17,-16,546,151023,17,151006
7728,16,-14,594,214217,16,214201
7729,13,11,52,991258,13,991245
7730,20,10,700,965298,20,965278
7731,19,9,703,934253,19,934234
7732,12,18,810,1214829,12,1214817
7733,10,-6,72,438275,10,438265
7734,11,-8,805,403633,11,403622
7735,20,10,274,961899,20,961879
7736,20,9,88,929690,20,929670
7737,16,-12,461,275838,16,275822
7738,11,0,953,655526,11,655515
7739,15,14,938,1092802,15,1092787
7740,14,19,396,1244014,14,1244000
7741,19,10,583,964393,19,964374
7742,17,8,669,903249,17,903232
7743,20,-17,372,118233,20,118213
7744,12,-5,557,495136,12,495124
7745,14,-8,835,403819,14,403805
7746,16,-4,79,522628,16,522612
7747,5,-7,543,417546,5,417541
7748,11,-2,683,590277,11,590266
7749,12,-13,659,245811,12,245799
7750,19,-12,468,275943,19,275924
7751,18,-8,697,402815,18,402797
7752,17,2,248,712430,17,712413
7753,13,-2,357,587786,13,587773
7754,18,10,511,963785,18,963767
7755,6,17,865,1174016,6,1174010
7756,20,-13,501,244700,20,244680
7757,10,19,467,1228169,10,1228159
7758,10,5,989,802520,10,802510
7759,7,-19,420,40511,7,40504
7760,13,-4,168,523348,13,523335
7761,6,13,723,1046218,6,1046212
7762,16,-9,914,373834,16,373818
7763,12,1,733,685569,12,685557
7764,8,6,223,817180,8,817172
7765,14,-14,719,215114,14,215100
7766,15,4,92,773929,15,773914
7767,19,1,900,686816,19,686797
7768,20,19,297,1243129,20,1243109
7769,9,-7,838,423571,9,423562
7770,7,13,178,1034479,7,1034472
7771,11,9,620,933664,11,933653
7772,20,-20,650,27759,20,27739
7773,16,1,321,682419,16,682403
7774,7,-8,888,394324,7,394317
7775,11,12,830,1028241,11,1028230
7776,17,5,591,808099,17,808082
7777,10,-8,581,387597,10,387587
7778,19,-2,718,590555,19,590536
7779,6,-8,410,383902,6,383896
7780,8,-3,254,535945,8,535937
7781,20,3,179,743200,20,743180
7782,9,16,413,1134112,9,1134103
7783,9,-3,311,537179,9,537170
7784,11,-4,851,528322,11,528311
7785,6,5,100,783683,6,783677
7786,16,-19,855,60570,16,60554
7787,6,-5,333,475473,6,475467
7788,12,-8,930,404434,12,404422
7789,13,-14,555,213768,13,213755
7790,6,10,240,942548,6,942542
7791,14,1,13,679823,14,679809
7792,5,-5,470,478172,5,478167
7793,20,17,916,1184804,20,1184784
7794,7,-4,576,511880,7,511873
7795,12,-1,6,616545,12,616533
7796,14,-16,502,150696,14,150682
7797,15,-18,228,87067,15,87052
7798,18,10,870,966495,18,966477
7799,13,1,168,681193,13,681180
7800,18,-19,150,55227,18,55209
7801,16,-4,810,528055,16,528039
7802,10,8,595,888202,10,888192
7803,20,-2,572,589434,20,589414
7804,10,-10,969,333249,10,333239
7805,18,-10,499,338758,18,338740
7806,8,-11,408,290161,8,290153
7807,9,-11,126,283837,9,283828
7808,8,-19,879,50685,8,50677
7809,10,-3,489,541528,10,541518
7810,11,11,915,997529,11,997518
7811,11,-6,592,463653,11,463642
7812,12,-12,377,275310,12,275298
7813,5,-18,732,78174,5,78169
7814,19,9,70,929576,19,929557
7815,20,-11,250,305677,20,305657
7816,13,-1,417,619876,13,619863
7817,8,0,41,626158,8,626150
7818,15,-3,487,557562,15,557547
7819,8,-19,998,52828,8,52820
7820,11,-1,756,622355,11,622344
7821,7,1,172,660948,7,660941
7822,14,17,237,1179652,14,1179638
7823,20,2,94,711279,20,711259
7824,12,7,123,867902,12,867890
7825,20,-11,6,303726,20,303706
7826,17,-15,112,178627,17,178610
7827,8,6,808,830542,8,830534
7828,20,-14,324,211916,20,211896
7829,20,7,460,870464,20,870444
7830,12,12,844,1028429,12,1028417
7831,16,3,499,745549,16,745533
7832,12,-12,375,275297,12,275285
7833,10,-2,525,573913,10,573903
7834,10,17,737,1170991,10,1170981
7835,9,18,707,1201527,9,1201518
7836,14,-7,5,428295,14,428281
7837,18,-7,199,429780,18,429762
7838,18,3,946,749042,18,749024
7839,12,11,109,991638,12,991626
7840,12,-12,337,275015,12,275003
7841,7,6,367,820501,7,820494
7842,7,-11,884,300124,7,300117
7843,9,1,516,668568,9,668559
7844,8,9,150,909887,8,909879
7845,6,-19,403,40288,6,40282
7846,5,3,750,735080,5,735075
7847,6,-7,386,414235,6,414229
7848,16,-1,686,621834,16,621818
7849,6,-16,347,131387,6,131381
7850,9,-12,285,255718,9,255709
7851,7,-14,476,196958,7,196951
7852,11,0,981,655803,11,655792
7853,13,7,442,870336,13,870323
7854,10,-13,67,219771,10,219761
7855,17,-17,330,117925,17,117908
7856,18,-19,127,55023,18,55005
7857,12,8,269,900060,12,900048
7858,9,-7,71,407441,9,407432
7859,12,13,138,1054211,12,1054199
7860,10,17,359,1163000,10,1162990
7861,17,-17,710,120830,17,120813
7862,17,12,609,1026526,17,1026509
7863,6,16,10,1125390,6,1125384
7864,19,18,523,1212831,19,1212812
7865,11,-16,640,151709,11,151698
7866,19,1,773,685892,19,685873
7867,19,12,620,1026651,19,1026632
7868,10,2,225,693433,10,693423
7869,10,-1,887,612976,10,612966
7870,19,18,317,1211383,19,1211364
7871,12,8,872,904720,12,904708
7872,15,-9,388,369582,15,369567
7873,8,9,304,913093,8,913085
7874,20,-2,560,589347,20,589327
7875,16,-17,890,122117,16,122101
7876,11,0,119,649165,11,649154
7877,5,5,971,802133,5,802128
7878,11,6,184,837131,11,837120
7879,12,-1,756,622357,12,622345
7880,14,7,316,869308,14,869294
7881,20,-3,974,561566,20,561546
7882,12,5,838,809895,12,809883
7883,19,9,206,930584,19,930565
7884,8,-7,110,408173,8,408165
7885,14,16,403,1150023,14,1150009
7886,16,-8,300,399974,16,399958
7887,18,-3,403,556773,18,556755
7888,14,-14,605,214283,14,214269
7889,5,13,945,1050920,5,1050915
7890,7,-1,751,609943,7,609936
7891,14,-11,830,310185,14,310171
7892,19,-13,342,243577,19,243558
7893,11,-17,994,122725,11,122714
7894,13,8,530,902166,13,902153
7895,5,17,528,1166611,5,1166606
7896,9,12,668,1013685,9,1013676
7897,15,-13,338,243540,15,243525
7898,12,-15,215,179286,12,179274
7899,20,-19,43,54191,20,54171
7900,6,-1,124,596475,6,596469
7901,10,8,594,888183,10,888173
7902,18,-3,298,555949,18,555931
7903,11,-2,894,591965,11,591954
7904,13,0,575,652614,13,652601
7905,8,2,554,700318,8,700310
7906,10,-1,520,605356,10,605346
7907,17,19,580,1245540,17,1245523
7908,20,5,944,810727,20,810707
7909,6,-12,521,260903,6,260897
7910,14,18,838,1215037,14,1215023
7911,6,16,150,1128275,6,1128269
7912,9,-14,583,199330,9,199321
7913,10,-18,478,72706,10,72696
7914,9,-20,835,18533,9,18524
7915,12,2,931,717375,12,717363
7916,8,2,350,696174,8,696166
7917,13,-4,307,524460,13,524447
7918,13,-6,99,459832,13,459819
7919,15,10,763,965711,15,965696
7920,20,-15,156,178958,20,178938
7921,8,-7,194,409934,8,409926
7922,5,14,553,1074158,5,1074153
7923,6,5,128,784202,6,784196
7924,16,8,577,902481,16,902465
7925,9,-2,675,577132,9,577123
7926,15,5,974,810947,15,810932
7927,20,-11,350,306535,20,306515
7928,6,-1,42,594735,6,594729
7929,7,-10,833,330437,7,330430
7930,7,-7,182,409712,7,409705
7931,19,-10,466,338522,19,338503
7932,13,-11,477,307534,13,307521
7933,7,-12,935,269885,7,269878
7934,17,-7,715,433522,17,433505
7935,10,6,810,830592,10,830582
7936,6,-18,67,63860,6,63854
7937,12,-16,352,149497,12,149485
7938,10,-5,52,468991,10,468981
7939,19,1,397,683010,19,682991
7940,8,18,530,1198164,8,1198156
7941,14,17,177,1179211,14,1179197
7942,16,-6,922,466122,16,466106
7943,9,-4,420,508758,9,508749
7944,18,14,930,1092707,18,1092689
7945,10,-16,186,128064,10,128054
7946,20,17,280,1180032,20,1180012
7947,7,-12,774,266242,7,266235
7948,8,11,772,984992,8,984984
7949,9,-15,245,160603,9,160594
7950,8,4,608,763789,8,763781
7951,16,-15,365,180448,16,180432
7952,7,-9,268,349443,7,349436
7953,18,9,274,930947,18,930929
7954,19,-15,543,181764,19,181745
7955,12,9,460,932372,12,932360
7956,18,-1,615,621346,18,621328
7957,9,18,949,1206824,9,1206815
7958,11,-4,779,527875,11,527864
7959,5,6,328,819672,5,819667
7960,9,7,616,857831,9,857822
7961,13,18,827,1214961,13,1214948
7962,5,15,16,1094800,5,1094795
7963,15,-5,242,492800,15,492785
7964,9,-17,981,114169,9,114160
7965,10,14,17,1062148,10,1062138
7966,19,0,139,649286,19,649267
7967,16,15,126,1117760,16,1117744
7968,17,4,350,775745,17,775728
7969,19,-8,859,403968,19,403949
7970,16,-6,936,466221,16,466205
7971,16,-13,199,242532,16,242516
7972,17,3,542,745820,17,745803
7973,18,-19,957,61213,18,61195
7974,19,-3,180,555066,19,555047
7975,12,-18,757,90793,12,90781
7976,9,1,798,674404,9,674395
7977,15,17,239,1179675,15,1179660
7978,12,-12,595,276843,12,276831
7979,11,2,851,716842,11,716831
7980,11,7,839,873085,11,873074
7981,9,14,576,1074607,9,1074598
7982,13,-13,364,243701,13,243688
7983,6,-12,317,256471,6,256465
7984,5,0,635,639172,5,639167
7985,10,15,888,1113301,10,1113291
7986,12,-8,757,403250,12,403238
7987,8,13,807,1048187,8,1048179
7988,18,-17,834,121738,18,121720
7989,5,3,976,740253,5,740248
7990,14,-13,805,247033,14,247019
7991,7,-7,178,409612,7,409605
7992,19,13,356,1055861,19,1055842
7993,8,-15,799,172406,8,172398
7994,10,-4,123,502039,10,502029
7995,7,-18,921,82430,7,82423
7996,15,-12,295,274700,15,274685
7997,9,-3,198,534620,9,534611
7998,20,15,966,1123884,20,1123864
7999,12,19,356,1243640,12,1243628
8000,14,-4,109,522848,14,522834
8001,14,18,993,1216260,14,1216246
8002,17,0,759,654096,17,654079
8003,11,19,939,1248311,11,1248300
8004,15,12,813,1028082,15,1028067
8005,7,-15,901,174571,7,174564
8006,12,-9,840,373167,12,373155
8007,9,-18,488,72913,9,72904
8008,5,-10,49,313669,5,313664
8009,17,-11,204,305331,17,305314
8010,12,5,335,806242,12,806230
8011,8,13,608,1043902,8,1043894
8012,18,-12,798,278334,18,278316
8013,14,11,886,997295,14,997281
8014,5,5,947,801692,5,801687
8015,17,11,383,993659,17,993642
8016,16,8,732,903760,16,903744
8017,16,-17,288,117633,16,117617
8018,14,-9,823,373057,14,373043
8019,5,-4,279,505655,5,505650
8020,18,9,773,934729,18,934711
8021,9,-1,180,597557,9,597548
8022,17,6,892,842887,17,842870
8023,11,-4,565,526342,11,526331
8024,20,3,303,744198,20,744178
8025,17,16,725,1152277,17,1152260
8026,20,14,787,1091657,20,1091637
8027,17,-8,744,403148,17,403131
8028,17,-14,666,214726,17,214709
8029,7,13,54,1031942,7,1031935
8030,15,2,442,713983,15,713968
8031,16,-6,577,463548,16,463532
8032,19,14,246,1087345,19,1087326
8033,5,-17,839,111255,5,111250
8034,12,-8,8,397922,12,397910
8035,10,-8,49,376434,10,376424
8036,12,-9,29,366806,12,366794
8037,8,-6,525,448147,8,448139
8038,5,-10,397,321164,5,321159
8039,8,3,873,737681,8,737673
8040,10,13,975,1051608,10,1051598
8041,12,-15,234,179423,12,179411
8042,9,11,174,972002,9,971993
8043,17,-8,905,404320,17,404303
8044,16,11,402,993852,16,993836
8045,6,19,933,1238099,6,1238093
8046,17,-3,225,555337,17,555320
8047,11,-13,644,245732,11,245721
8048,5,-18,765,78991,5,78986
8049,5,4,166,754180,5,754175
8050,13,-7,484,431964,13,431951
8051,5,10,540,948992,5,948987
8052,13,-18,589,89515,13,89502
8053,14,8,317,900457,14,900443
8054,8,8,546,887138,8,887130
8055,11,16,233,1148762,11,1148751
8056,17,10,120,960846,17,960829
8057,14,15,56,1117217,14,1117203
8058,13,-8,331,400226,13,400213
8059,16,-1,865,623179,16,623163
8060,12,19,759,1246926,12,1246914
8061,8,-7,749,421690,8,421682
8062,19,15,866,1123107,19,1123088
8063,18,-12,674,277470,18,277452
8064,8,-9,851,362541,8,362533
8065,14,-12,783,278238,14,278224
8066,11,-20,130,23740,11,23729
8067,16,-17,280,117558,16,117542
8068,13,-18,407,88333,13,88320
8069,14,19,305,1243201,14,1243187
8070,20,16,347,1149644,20,1149624
8071,15,15,10,1116830,15,1116815
8072,7,-17,207,97782,7,97775
8073,16,7,932,873646,16,873630
8074,13,6,537,840110,13,840097
8075,6,14,637,1076182,6,1076176
8076,10,-14,907,206227,10,206217
8077,19,-10,361,337641,19,337622
8078,7,1,949,677654,7,677647
8079,12,17,532,1181842,12,1181830
8080,13,-12,659,277383,13,277370
8081,10,14,809,1080119,10,1080109
8082,8,11,611,981561,8,981553
8083,10,11,301,974806,10,974796
8084,5,-14,343,194149,5,194144
8085,10,4,447,760229,10,760219
8086,20,-7,811,434207,20,434187
8087,20,-16,959,153995,20,153975
8088,10,-20,272,6013,10,6003
8089,12,3,480,745415,12,745403
8090,7,-1,319,600985,7,600978
8091,7,-19,442,41030,7,41023
8092,13,3,978,749341,13,749328
8093,9,-7,237,410811,9,410802
8094,10,12,31,999755,10,999745
8095,14,0,5,648220,14,648206
8096,15,11,74,991426,15,991411
8097,18,-12,447,275748,18,275730
8098,19,-18,833,91273,19,91254
8099,8,-20,950,20913,8,20905
8100,9,-19,199,36029,9,36020
8101,9,8,229,880194,9,880185
8102,5,-4,232,504659,5,504654
8103,20,-20,437,26113,20,26093
8104,17,-11,942,311066,17,311049
8105,10,4,485,760995,10,760985
8106,7,9,736,922195,7,922188
8107,7,16,232,1130186,7,1130179
8108,10,-4,677,514029,10,514019
8109,11,-20,114,23609,11,23598
8110,10,9,465,916412,10,916402
8111,14,1,404,683065,14,683051
8112,14,-3,188,555102,14,555088
8113,11,6,802,842192,11,842181
8114,7,-5,659,482297,7,482290
8115,16,-2,705,590451,16,590435
8116,14,11,554,994818,14,994804
8117,7,4,595,763475,7,763468
8118,6,0,591,638176,6,638170
8119,12,-12,825,278556,12,278544
8120,20,8,147,899097,20,899077
8121,5,-2,570,574891,5,574886
8122,17,-7,76,428828,17,428811
8123,12,-18,132,86212,12,86200
8124,19,1,147,681008,19,680989
8125,15,5,940,810685,15,810670
8126,19,14,13,1085477,19,1085458
8127,8,-20,124,2749,8,2741
8128,14,-6,4,459176,14,459162
8129,9,-16,189,128141,9,128132
8130,13,-12,798,278337,13,278324
8131,7,-4,970,520301,7,520294
8132,8,17,97,1157293,8,1157285
8133,8,7,294,851096,8,851088
8134,13,6,640,840948,13,840935
8135,6,-11,411,290209,6,290203
8136,15,-16,132,147926,15,147911
8137,14,11,864,997110,14,997096
8138,13,-8,388,400618,13,400605
8139,16,2,244,712404,16,712388
8140,9,11,622,981765,9,981756
8141,17,17,605,1182363,17,1182346
8142,19,16,692,1152029,19,1152010
8143,15,-5,725,496337,15,496322
8144,16,-14,238,211262,16,211246
8145,17,4,216,774834,17,774817
8146,10,3,593,731447,10,731437
8147,15,-5,11,490828,15,490813
8148,19,2,59,710974,19,710955
8149,20,-20,317,25308,20,25288
8150,11,7,356,869604,11,869593
8151,14,13,49,1053596,14,1053582
8152,17,19,848,1247609,17,1247592
8153,10,-14,617,200260,10,200250
8154,10,-1,315,600914,10,600904
8155,10,-4,748,515410,10,515400
8156,13,-6,808,465321,13,465308
8157,9,-18,155,65868,9,65859
8158,13,17,954,1185027,13,1185014
8159,7,6,565,825015,7,825008
8160,14,18,757,1214437,14,1214423
8161,20,15,650,1121555,20,1121535
8162,6,13,508,1041635,6,1041629
8163,15,6,649,841000,15,840985
8164,11,9,493,932648,11,932637
8165,11,-11,403,306933,11,306922
8166,19,12,714,1027407,19,1027388
8167,17,10,594,964484,17,964467
8168,18,2,394,713590,18,713572
8169,9,-1,252,599337,9,599328
8170,19,-9,913,373825,19,373806
8171,18,5,389,806659,18,806641
8172,11,13,908,1059954,11,1059943
8173,20,-3,561,558208,20,558188
8174,19,8,155,899159,19,899140
8175,11,-6,371,461994,11,461983
8176,6,-8,961,395886,6,395880
8177,18,14,175,1086815,18,1086797
8178,16,-8,275,399818,16,399802
8179,7,18,429,1195886,7,1195879
8180,19,12,863,1028570,19,1028551
8181,20,4,188,774586,20,774566
8182,19,19,56,1241182,19,1241163
8183,11,3,257,743796,11,743785
8184,7,9,459,916323,7,916316
8185,5,-13,844,236642,5,236637
8186,18,-14,567,213973,18,213955
8187,5,-11,974,302108,5,302103
8188,11,3,696,747178,11,747167
8189,13,-8,569,401866,13,401853
8190,14,-7,529,432335,14,432321
8191,11,-14,626,214439,11,214428
8192,8,5,663,795288,8,795280
8193,20,-15,498,181449,20,181429
8194,13,7,634,871660,13,871647
8195,18,-6,177,460522,18,460504
8196,5,-16,343,131259,5,131254
8197,5,-14,980,207866,5,207861
8198,17,-11,911,310857,17,310840
8199,12,-8,905,404322,12,404310
8200,15,4,772,778927,15,778912
8201,9,-13,750,234426,9,234417
8202,17,-20,71,23323,17,23306
8203,7,5,667,795398,7,795391
8204,14,7,745,872421,14,872407
8205,18,-3,188,555110,18,555092
8206,9,-5,360,476028,9,476019
8207,20,-7,259,430209,20,430189
8208,7,-12,492,260198,7,260191
8209,18,-1,312,619064,18,619046
8210,18,-6,552,463448,18,463430
8211,11,-9,227,368206,11,368195
8212,5,-10,881,331488,5,331483
8213,11,2,506,714423,11,714412
8214,10,16,881,1143400,10,1143390
8215,14,-4,240,523995,14,523981
8216,16,-3,553,558154,16,558138
8217,14,-9,493,370571,14,370557
8218,19,10,402,962893,19,962874
8219,12,-4,981,529476,12,529464
8220,18,17,123,1178765,18,1178747
8221,18,18,149,1210199,18,1210181
8222,8,-14,258,192443,8,192435
8223,15,8,116,898830,15,898815
8224,16,-19,934,61027,16,61011
8225,14,-4,666,527118,14,527104
8226,19,0,453,651523,19,651504
8227,14,-5,715,496250,14,496236
8228,9,-20,680,15031,9,15022
8229,19,-17,848,121818,19,121799
8230,16,-1,3,616522,16,616506
8231,7,-10,484,323177,7,323170
8232,19,-12,804,278375,19,278356
8233,18,4,61,773683,18,773665
8234,13,-20,184,24231,13,24218
8235,19,16,380,1149880,19,1149861
8236,10,-3,441,540248,10,540238
8237,8,-5,187,472145,8,472137
8238,16,19,679,1246257,16,1246241
8239,14,14,748,1091303,14,1091289
8240,11,-15,186,179105,11,179094
8241,9,17,814,1172805,9,1172796
8242,19,-2,178,586363,19,586344
8243,15,-16,562,151137,15,151122
8244,14,19,365,1243749,14,1243735
8245,13,18,81,1209567,13,1209554
8246,10,-1,818,611417,10,611407
8247,11,16,916,1153670,11,1153659
8248,14,19,527,1245155,14,1245141
8249,14,11,235,992491,14,992477
8250,11,0,365,650801,11,650790
8251,8,-8,651,389275,8,389267
8252,9,0,633,639121,9,639112
8253,20,-6,881,465740,20,465720
8254,12,-2,900,591986,12,591974
8255,19,-3,937,561304,19,561285
8256,13,14,363,1088247,13,1088234
8257,20,-19,704,59461,20,59441
8258,7,12,173,1002903,7,1002896
8259,8,-20,522,11190,8,11182
8260,17,14,510,1089438,17,1089421
8261,15,4,244,775039,15,775024
8262,16,-8,985,404913,16,404897
8263,14,-2,882,591911,14,591897
8264,13,9,405,931984,13,931971
8265,12,-6,220,460848,12,460836
8266,18,7,932,873654,18,873636
8267,19,3,163,743052,19,743033
8268,15,15,665,1121679,15,1121664
8269,13,18,700,1213996,13,1213983
8270,5,-17,669,107889,5,107884
8271,14,-20,376,25698,14,25684
8272,10,-7,535,417322,10,417312
8273,19,-8,51,398303,19,398284
8274,8,-15,497,166221,8,166213
8275,8,9,342,913936,8,913928
8276,5,15,891,1113373,5,1113368
8277,18,-17,489,119116,18,119098
8278,14,-4,815,528082,14,528068
8279,13,-5,536,495014,13,495001
8280,13,-16,15,146864,13,146851
8281,11,-5,358,493715,11,493704
8282,7,6,848,831400,7,831393
8283,15,12,181,1023367,15,1023352
8284,19,12,980,1029669,19,1029650
8285,14,1,674,685146,14,685132
8286,9,-4,3,499406,9,499397
8287,20,-2,992,592667,20,592647
8288,10,3,589,731334,10,731324
8289,7,17,732,1170895,7,1170888
8290,6,12,131,1001969,6,1001963
8291,19,-7,369,431152,19,431133
8292,7,-2,287,568925,7,568918
8293,9,-8,305,381842,9,381833
8294,12,-5,315,493404,12,493392
8295,7,-12,768,266139,7,266132
8296,11,4,554,777254,11,777243
8297,8,-16,255,129559,8,129551
8298,20,11,246,992610,20,992590
8299,18,-11,92,304384,18,304366
8300,11,0,437,651394,11,651383
8301,5,7,16,845089,5,845084
8302,14,-16,940,153835,14,153821
8303,9,-8,523,386353,9,386344
8304,16,-14,876,216336,16,216320
8305,11,11,466,994250,11,994239
8306,8,13,376,1038779,8,1038771
8307,9,17,530,1166646,9,1166637
8308,11,-19,355,56772,11,56761
8309,13,1,124,680802,13,680789
8310,10,12,673,1013863,10,1013853
8311,11,-16,287,149056,11,149045
8312,17,7,427,870200,17,870183
8313,16,19,484,1244748,16,1244732
8314,6,5,493,791850,6,791844
8315,18,4,573,777407,18,777389
8316,16,-14,970,217039,16,217023
8317,5,-9,953,364939,5,364934
8318,9,11,394,976949,9,976940
8319,20,10,19,959974,20,959954
8320,5,19,535,1229604,5,1229599
8321,8,-16,792,141036,8,141028
8322,15,-19,20,54039,15,54024
8323,12,-20,671,27952,12,27940
8324,19,-8,523,401521,19,401502
8325,7,-15,187,159357,7,159350
8326,5,-11,172,284838,5,284833
8327,20,9,170,930339,20,930319
8328,10,11,837,986321,10,986311
8329,19,-11,757,309595,19,309576
8330,7,-3,750,547210,7,547203
8331,17,5,869,810099,17,810082
8332,6,18,293,1193155,6,1193149
8333,13,7,988,874031,13,874018
8334,17,6,940,843247,17,843230
8335,15,-16,195,148373,15,148358
8336,17,15,420,1119741,17,1119724
8337,14,11,706,995852,14,995838
8338,17,-8,825,403770,17,403753
8339,7,0,358,632932,7,632925
8340,16,-19,134,55084,16,55068
8341,10,16,475,1135386,10,1135376
8342,17,-18,60,85646,17,85629
8343,19,7,692,872083,19,872064
8344,18,11,676,995633,18,995615
8345,7,-7,35,406865,7,406858
8346,10,-3,506,541809,10,541799
8347,9,14,683,1077342,9,1077333
8348,13,11,793,996585,13,996572
8349,7,9,514,917626,7,917619
8350,13,-7,913,435038,13,435025
8351,20,-19,191,55560,20,55540
8352,20,-11,623,308697,20,308677
8353,11,-3,317,556092,11,556081
8354,9,-4,998,520967,9,520958
8355,14,4,534,777125,14,777111
8356,16,-19,756,59915,16,59899
8357,19,-17,744,121164,19,121145
8358,17,-16,641,151715,17,151698
8359,12,-6,760,464949,12,464937
8360,18,-9,527,370860,18,370842
8361,20,-11,386,306820,20,306800
8362,11,-18,163,86492,11,86481
8363,8,-20,93,2053,8,2045
8364,9,8,217,879883,9,879874
8365,13,6,204,837255,13,837242
8366,20,18,761,1214467,20,1214447
8367,6,-14,188,190501,6,190495
8368,14,17,568,1182061,14,1182047
8369,19,7,995,874074,19,874055
8370,19,8,584,902539,19,902520
8371,15,-1,535,620825,15,620810
8372,11,5,175,805077,11,805066
8373,6,-10,988,333786,6,333780
8374,10,-16,160,127458,10,127448
8375,10,-5,653,482115,10,482105
8376,15,13,716,1058569,15,1058554
8377,11,-1,710,622054,11,622043
8378,20,7,663,871874,20,871854
8379,5,14,85,1063664,5,1063659
8380,19,17,103,1178563,19,1178544
8381,19,10,221,961510,19,961491
8382,15,15,140,1117857,15,1117842
8383,19,18,409,1212071,19,1212052
8384,9,5,56,782853,9,782844
8385,8,16,755,1140775,8,1140767
8386,6,8,491,885938,6,885932
8387,8,-19,459,41365,8,41357
8388,18,10,779,965865,18,965847
8389,18,16,716,1152222,18,1152204
8390,19,-11,489,307642,19,307623
8391,16,16,152,1148156,16,1148140
8392,11,-9,602,371349,11,371338
8393,10,-11,583,294122,10,294112
8394,14,12,849,1028457,14,1028443
8395,12,-20,750,28586,12,28574
8396,10,-3,51,531653,10,531643
8397,11,6,484,839651,11,839640
8398,13,-5,362,493740,13,493727
8399,9,-6,491,447395,9,447386
8400,20,-13,606,245534,20,245514
8401,19,-10,310,337308,19,337289
8402,7,4,987,772004,7,771997
8403,12,17,492,1181575,12,1181563
8404,5,13,973,1051565,5,1051560
8405,5,-1,807,611169,5,611164
8406,14,-17,750,121202,14,121188
8407,17,6,567,840371,17,840354
8408,7,10,299,943829,7,943822
8409,7,1,619,670718,7,670711
8410,15,7,163,868206,15,868191
8411,12,7,805,872824,12,872812
8412,8,10,240,942556,8,942548
8413,17,-16,799,152761,17,152744
8414,20,3,586,746211,20,746191
8415,14,-17,798,121528,14,121514
8416,18,-10,308,337272,18,337254
8417,19,3,371,744656,19,744637
8418,11,-1,495,620524,11,620513
8419,11,7,309,869251,11,869240
8420,16,-15,406,180758,16,180742
8421,16,1,511,683882,16,683866
8422,19,13,548,1057369,19,1057350
8423,17,-20,768,28723,17,28706
8424,10,-17,566,105700,10,105690
8425,20,19,766,1246981,20,1246961
8426,11,-6,186,460596,11,460585
8427,8,17,467,1165304,8,1165296
8428,18,-20,327,25391,18,25373
8429,7,-18,139,65465,7,65458
8430,12,-5,386,493860,12,493848
8431,9,2,681,702990,9,702981
8432,10,-1,736,609669,10,609659
8433,15,10,439,963183,15,963168
8434,11,14,63,1085930,11,1085919
8435,15,-16,194,148361,15,148346
8436,17,-17,47,115891,17,115874
8437,8,-7,175,409568,8,409560
8438,5,-5,529,479531,5,479526
8439,5,7,709,859768,5,859763
8440,20,-10,296,337188,20,337168
8441,16,2,637,715344,16,715328
8442,11,12,819,1028115,11,1028104
8443,19,-5,718,496292,19,496273
8444,8,-10,909,331973,8,331965
8445,20,0,689,653557,20,653537
8446,11,2,47,710851,11,710840
8447,18,-6,489,462926,18,462908
8448,8,17,413,1164082,8,1164074
8449,20,9,875,935557,20,935537
8450,18,-6,611,463810,18,463792
8451,12,-12,109,273314,12,273302
8452,5,-2,659,576773,5,576768
8453,6,5,174,785162,6,785156
8454,7,-4,41,500184,7,500177
8455,20,-4,573,526402,20,526382
8456,13,19,360,1243690,13,1243677
8457,17,2,519,714563,17,714546
8458,12,5,684,808795,12,808783
8459,16,-6,905,465975,16,465959
8460,16,-17,970,122598,16,122582
8461,12,8,695,903467,12,903455
8462,11,-12,714,277758,11,277747
8463,9,13,562,1042852,9,1042843
8464,13,6,806,842239,13,842226
8465,11,14,621,1090248,11,1090237
8466,5,-8,182,379418,5,379413
8467,7,2,848,706255,7,706248
8468,5,-8,340,382625,5,382620
8469,10,11,37,969264,10,969254
8470,14,-1,686,621838,14,621824
8471,7,-13,957,239123,7,239116
8472,15,-11,875,310588,15,310573
8473,11,2,721,716039,11,716028
8474,8,-7,487,416260,8,416252
8475,13,10,770,965782,13,965769
8476,5,-14,294,193108,5,193103
8477,18,10,565,964225,18,964207
8478,8,-7,416,414817,8,414809
8479,17,-14,139,210410,17,210393
8480,20,9,65,929533,20,929513
8481,16,-17,682,120625,16,120609
8482,12,-20,307,25222,12,25210
8483,11,-16,67,147298,11,147287
8484,10,6,311,819203,10,819193
8485,19,-7,997,435749,19,435730
8486,19,18,455,1212357,19,1212338
8487,20,-14,778,215621,20,215601
8488,12,12,363,1024748,12,1024736
8489,19,-19,511,57933,19,57914
8490,14,19,452,1244545,14,1244531
8491,13,14,477,1089143,13,1089130
8492,14,17,13,1177930,14,1177916
8493,5,-5,411,476929,5,476924
8494,13,10,377,962630,13,962617
8495,12,11,348,993399,12,993387
8496,8,-14,309,193382,8,193374
8497,19,-11,824,310151,19,310132
8498,12,-17,955,122508,12,122496
8499,20,16,628,1151538,20,1151518
8500,18,1,443,683305,18,683287
8501,9,4,292,756855,9,756846
8502,19,-4,840,528202,19,528183
8503,18,1,677,685153,18,685135
8504,7,-11,824,298771,7,298764
8505,14,-10,546,339134,14,339120
8506,16,-18,789,90992,16,90976
8507,17,13,761,1058918,17,1058901
8508,15,-12,962,279780,15,279765
8509,11,11,876,997220,11,997209
8510,18,-14,606,214291,18,214273
8511,19,-12,584,276794,19,276775
8512,14,-15,983,185242,14,185228
8513,16,6,905,842974,16,842958
8514,18,18,325,1211463,18,1211445
8515,16,14,598,1090053,16,1090037
8516,6,19,710,1233224,6,1233218
8517,19,-10,835,341357,19,341338
8518,10,1,709,672354,10,672344
8519,10,-4,261,505291,10,505281
8520,12,18,21,1209038,12,1209026
8521,13,-11,426,307160,13,307147
8522,15,9,713,934334,15,934319
8523,11,-13,195,242480,11,242469
8524,8,-11,501,292366,8,292358
8525,19,16,22,1147249,19,1147230
8526,15,13,117,1054092,15,1054077
8527,7,-4,602,512350,7,512343
8528,15,-6,868,465662,15,465647
8529,10,14,416,1071106,10,1071096
8530,16,13,919,1059984,16,1059968
8531,8,4,192,754708,8,754700
8532,5,-8,688,390196,5,390191
8533,10,13,164,1034136,10,1034126
8534,10,5,176,785230,10,785220
8535,5,13,990,1051847,5,1051842
8536,7,14,658,1076697,7,1076690
8537,18,-5,277,493075,18,493057
8538,8,15,742,1110274,8,1110266
8539,19,-11,904,310810,19,310791
8540,18,-10,688,340297,18,340279
8541,5,-7,757,421861,5,421856
8542,9,2,822,705734,9,705725
8543,10,-16,745,139991,10,139981
8544,10,11,609,981520,10,981510
8545,8,-5,935,488412,8,488404
8546,16,14,288,1087640,16,1087624
8547,8,5,279,787516,8,787508
8548,12,-8,654,402486,12,402474
8549,12,3,230,743620,12,743608
8550,13,18,52,1209306,13,1209293
8551,19,-6,601,463752,19,463733
8552,5,1,347,664789,5,664784
8553,20,-17,491,119149,20,119129
8554,11,-14,127,210263,11,210252
8555,8,2,886,707068,8,707060
8556,17,11,602,995186,17,995169
8557,5,4,907,770513,5,770508
8558,13,-15,547,181799,13,181786
8559,18,19,238,1242588,18,1242570
8560,18,-17,144,116532,18,116514
8561,18,-4,37,522322,18,522304
8562,6,-18,58,63647,6,63641
8563,5,-12,196,253681,5,253676
8564,17,-1,459,620206,17,620189
8565,18,-7,170,429591,18,429573
8566,13,-20,800,29012,13,28999
8567,15,-2,795,591101,15,591086
8568,5,-1,647,607818,5,607813
8569,14,3,22,741949,14,741935
8570,9,14,938,1082837,9,1082828
8571,18,-3,760,559855,18,559837
8572,16,4,692,778320,16,778304
8573,20,2,606,715106,20,715086
8574,19,9,398,931897,19,931878
8575,6,-14,481,197068,6,197062
8576,11,6,474,839560,11,839549
8577,18,3,605,746352,18,746334
8578,5,-6,679,451300,5,451295
8579,10,-18,472,72538,10,72528
8580,14,4,238,775012,14,774998
8581,11,-10,73,335735,11,335724
8582,18,18,773,1214568,18,1214550
8583,12,11,936,997656,12,997644
8584,14,6,192,837190,14,837176
8585,17,0,747,654035,17,654018
8586,16,5,841,809905,16,809889
8587,14,-5,566,495199,14,495185
8588,15,8,300,900327,15,900312
8589,19,11,138,991807,19,991788
8590,12,-16,483,150573,12,150561
8591,14,15,715,1122091,14,1122077
8592,5,-7,883,424718,5,424713
8593,15,-18,82,85836,15,85821
8594,16,-17,598,120008,16,119992
8595,16,4,663,778086,16,778070
8596,9,-16,938,144184,9,144175
8597,8,-19,816,49233,8,49225
8598,19,9,700,934216,19,934197
8599,10,-20,270,5940,10,5930
8600,10,-11,766,297580,10,297570
8601,9,-17,923,112995,9,112986
8602,12,-9,438,370047,12,370035
8603,6,-9,220,348272,6,348266
8604,6,-4,583,511983,6,511977
8605,15,-7,337,430902,15,430887
8606,20,2,742,716149,20,716129
8607,10,6,66,813605,10,813595
8608,15,16,973,1154091,15,1154076
8609,10,6,499,823617,10,823607
8610,8,-20,301,6750,8,6742
8611,11,-13,43,241375,11,241364
8612,13,17,339,1180505,13,1180492
8613,20,-2,224,586824,20,586804
8614,8,19,287,1223853,8,1223845
8615,7,17,633,1168840,7,1168833
8616,16,3,945,749030,16,749014
8617,15,14,224,1087166,15,1087151
8618,16,11,764,996369,16,996353
8619,5,17,943,1175480,5,1175475
8620,16,-1,476,620379,16,620363
8621,20,2,249,712455,20,712435
8622,13,10,836,966266,13,966253
8623,13,0,958,655578,13,655565
8624,20,-1,719,622140,20,622120
8625,18,-17,685,120652,18,120634
8626,11,-11,298,306066,11,306055
8627,13,-10,399,337933,13,337920
8628,14,-3,601,558521,14,558507
8629,18,-17,50,115905,18,115887
8630,10,6,54,813346,10,813336
8631,18,0,265,650150,18,650132
8632,15,-3,286,555807,15,555792
8633,20,13,187,1054580,20,1054560
8634,15,-19,543,58204,15,58189
8635,18,-7,634,432952,18,432934
8636,5,-1,867,612488,5,612483
8637,20,-7,373,431196,20,431176
8638,10,5,87,783452,10,783442
8639,18,-5,952,498035,18,498017
8640,9,-7,946,426069,9,426060
8641,19,-12,810,278426,19,278407
8642,11,-8,503,401339,11,401328
8643,10,-16,9,123974,10,123964
8644,10,12,220,1003923,10,1003913
8645,5,9,587,919198,5,919193
8646,15,4,539,777144,15,777129
8647,5,16,523,1136348,5,1136343
8648,16,-11,663,309010,16,308994
8649,16,5,733,809124,16,809108
8650,17,4,65,773723,17,773706
8651,11,-12,69,273052,11,273041
8652,16,1,231,681707,16,681691
8653,10,-5,897,487585,10,487575
8654,15,7,239,868698,15,868683
8655,15,2,414,713772,15,713757
8656,17,5,790,809522,17,809505
8657,15,0,608,652842,15,652827
8658,13,-10,220,336706,13,336693
8659,18,2,866,716966,18,716948
8660,7,11,980,989466,7,989459
8661,15,-8,507,401388,15,401373
8662,20,5,324,806154,20,806134
8663,6,-2,575,574956,6,574950
8664,15,-14,912,216625,15,216610
8665,20,16,575,1151157,20,1151137
8666,19,13,981,1060488,19,1060469
8667,12,-18,430,88505,12,88493
8668,14,0,715,653760,14,653746
8669,5,-20,167,3717,5,3712
8670,9,16,836,1142526,9,1142517
8671,13,-5,298,493281,13,493268
8672,15,-4,615,526711,15,526696
8673,16,12,757,1027652,16,1027636
8674,18,-4,666,527126,18,527108
8675,16,14,36,1085690,16,1085674
8676,10,-6,788,453751,10,453741
8677,9,-5,454,477748,9,477739
8678,20,-11,265,305823,20,305803
8679,19,-3,119,554660,19,554641
8680,19,-5,54,491245,19,491226
8681,10,-10,481,323146,10,323136
8682,13,-16,818,152911,13,152898
8683,12,-6,501,463009,12,462997
8684,13,9,91,929697,13,929684
8685,18,-14,509,213449,18,213431
8686,17,6,648,840986,17,840969
8687,19,-6,198,460692,19,460673
8688,15,-3,844,560516,15,560501
8689,8,7,360,852574,8,852566
8690,9,3,290,725208,9,725199
8691,20,11,129,991775,20,991755
8692,16,4,465,776593,16,776577
8693,11,1,998,687541,11,687530
8694,6,-6,571,449072,6,449066
8695,11,9,938,936077,11,936066
8696,19,17,809,1184027,19,1184008
8697,20,-3,521,557833,20,557813
8698,5,-4,265,505358,5,505353
8699,7,-8,560,387141,7,387134
8700,12,17,212,1179462,12,1179450
8701,13,-18,486,88893,13,88880
8702,6,-7,945,426031,6,426025
8703,12,-15,211,179251,12,179239
8704,17,19,100,1241569,17,1241552
8705,15,15,624,1121366,15,1121351
8706,12,17,805,1183960,12,1183948
8707,17,-15,868,184361,17,184344
8708,14,-7,379,431237,14,431223
8709,16,18,787,1214688,16,1214672
8710,14,-2,506,588955,14,588941
8711,9,-5,936,488420,9,488411
8712,19,7,595,871411,19,871392
8713,17,-16,147,148021,17,148004
8714,20,6,968,843482,20,843462
8715,12,-5,240,492764,12,492752
8716,10,4,525,761961,10,761951
8717,16,3,259,743817,16,743801
8718,8,-8,380,383335,8,383327
8719,20,-5,496,494697,20,494677
8720,14,-4,460,525555,14,525541
8721,11,11,117,991676,11,991665
8722,11,-16,372,149635,11,149624
8723,6,16,500,1135809,6,1135803
8724,9,-16,537,135697,9,135688
8725,19,-4,567,526361,19,526342
8726,17,12,956,1029451,17,1029434
8727,19,-14,483,213218,19,213199
8728,11,17,290,1180110,11,1180099
8729,6,-20,152,3375,6,3369
8730,11,-18,123,86147,11,86136
8731,9,-4,364,507527,9,507518
8732,14,12,62,1022504,14,1022490
8733,14,-2,782,591021,14,591007
8734,16,19,148,1241962,16,1241946
8735,20,-13,30,241307,20,241287
8736,18,-18,489,88902,18,88884
8737,9,-12,203,253815,9,253806
8738,13,-4,746,527633,13,527620
8739,9,-11,603,294509,9,294500
8740,5,-9,991,365396,5,365391
8741,17,-10,263,337021,17,337004
8742,9,-3,615,544199,9,544190
8743,15,-4,394,525188,15,525173
8744,19,15,128,1117771,19,1117752
8745,9,1,649,671333,9,671324
8746,14,3,5,741850,14,741836
8747,5,-5,31,468534,5,468529
8748,16,3,610,746388,16,746372
8749,10,-11,65,282537,10,282527
8750,8,-19,637,45519,8,45511
8751,15,-15,89,178469,15,178454
8752,7,-15,766,171796,7,171789
8753,9,6,301,819045,9,819036
8754,16,10,994,967400,16,967384
8755,16,5,1,803782,16,803766
8756,15,15,553,1120792,15,1120777
8757,16,8,567,902396,16,902380
8758,16,19,30,1240938,16,1240922
8759,5,9,315,913398,5,913393
8760,12,-5,352,493708,12,493696
8761,9,15,185,1098396,9,1098387
8762,11,1,15,679838,11,679827
8763,9,-17,995,114376,9,114367
8764,10,-18,500,73198,10,73188
8765,10,10,257,942883,10,942873
8766,16,-13,618,245646,16,245630
8767,5,12,491,1009657,5,1009652
8768,12,2,835,716724,12,716712
8769,12,-1,965,623870,12,623858
8770,9,-8,514,386116,9,386107
8771,6,-7,361,413743,6,413737
8772,15,-2,757,590778,15,590763
8773,9,-15,586,168053,9,168044
8774,15,6,413,839100,15,839085
8775,14,-18,89,85893,14,85879
8776,18,15,539,1120700,18,1120682
8777,15,-7,114,429110,15,429095
8778,13,8,985,905606,13,905593
8779,8,4,549,762394,8,762386
8780,12,8,280,900183,12,900171
8781,11,-3,21,553967,11,553956
8782,9,-13,164,221837,9,221828
8783,19,6,795,842126,19,842107
8784,17,-17,742,121137,17,121120
8785,18,-16,481,150564,18,150546
8786,9,-5,672,482534,9,482525
8787,7,-2,844,580861,7,580854
8788,15,2,44,710846,15,710831
8789,18,14,155,1086690,18,1086672
8790,18,16,114,1147865,18,1147847
8791,17,4,320,775491,17,775474
8792,10,18,120,1189441,10,1189431
8793,9,-2,975,583689,9,583680
8794,10,1,806,674516,10,674506
8795,17,-10,986,342524,17,342507
8796,11,-8,683,402724,11,402713
8797,8,-19,732,47635,8,47627
8798,17,-19,239,55907,17,55890
8799,19,16,632,1151615,19,1151596
8800,18,-6,800,465298,18,465280
8801,15,-14,757,215390,15,215375
8802,10,-12,81,251329,10,251319
8803,10,-7,428,415056,10,415046
8804,15,8,781,904153,15,904138
8805,10,11,694,983172,10,983162
8806,8,-8,842,393296,8,393288
8807,17,-15,450,181103,17,181086
8808,20,3,137,742875,20,742855
8809,6,-7,558,417857,6,417851
8810,8,12,458,1008892,8,1008884
8811,10,8,678,890124,10,890114
8812,20,-8,243,399624,20,399604
8813,15,-14,484,213226,15,213211
8814,5,19,364,1225694,5,1225689
8815,12,12,776,1027805,12,1027793
8816,18,-1,15,616618,18,616600
8817,9,16,377,1133194,9,1133185
8818,9,18,228,1191767,9,1191758
8819,10,-1,775,610516,10,610506
8820,11,13,99,1053947,11,1053936
8821,7,6,984,834369,7,834362
8822,5,13,509,1041689,5,1041684
8823,20,-5,676,495936,20,495916
8824,15,-6,350,461866,15,461851
8825,8,-6,502,447626,8,447618
8826,14,12,666,1027046,14,1027032
8827,18,18,569,1213083,18,1213065
8828,14,11,92,991530,14,991516
8829,12,11,354,993445,12,993433
8830,16,15,464,1120053,16,1120037
8831,18,10,785,965918,18,965900
8832,16,12,239,1023796,16,1023780
8833,17,12,534,1025954,17,1025937
8834,12,-6,493,462970,12,462958
8835,8,-8,767,391811,8,391803
8836,7,-9,72,345120,7,345113
8837,6,-8,453,384703,6,384697
8838,11,-20,277,24921,11,24910
8839,16,-19,740,59833,16,59817
8840,12,13,1000,1060636,12,1060624
8841,8,6,6,812233,8,812225
8842,9,-8,602,388072,9,388063
8843,11,4,740,778698,11,778687
8844,15,13,58,1053651,15,1053636
8845,16,1,632,684843,16,684827
8846,19,14,397,1088540,19,1088521
8847,11,16,119,1147891,11,1147880
8848,14,2,339,713165,14,713151
8849,6,1,711,672393,6,672387
8850,17,-5,952,498042,17,498025
8851,17,0,729,653904,17,653887
8852,14,7,695,872100,14,872086
8853,18,-8,198,399310,18,399292
8854,17,-12,372,275278,17,275261
8855,13,16,900,1153491,13,1153478
8856,17,11,2,990850,17,990833
8857,11,-8,90,398597,11,398586
8858,5,-4,708,514638,5,514633
8859,12,-2,71,585661,12,585649
8860,18,7,44,867375,18,867357
8861,6,-1,174,597496,6,597490
8862,8,11,785,985227,8,985219
8863,11,13,998,1060619,11,1060608
8864,9,16,909,1144022,9,1144013
8865,5,16,358,1132763,5,1132758
8866,6,-5,139,471066,6,471060
8867,6,8,473,885486,6,885480
8868,19,-16,85,147491,19,147472
8869,8,16,517,1136201,8,1136193
8870,20,15,530,1120626,20,1120606
8871,5,-4,551,511350,5,511345
8872,17,-5,663,495834,17,495817
8873,12,-16,360,149531,12,149519
8874,13,1,104,680640,13,680627
8875,11,13,714,1058543,11,1058532
8876,18,14,84,1086103,18,1086085
8877,10,7,280,850749,10,850739
8878,9,-10,32,313322,9,313313
8879,14,-11,238,305548,14,305534
8880,18,-20,927,29864,18,29846
8881,5,-11,571,293776,5,293771
8882,15,17,912,1184777,15,1184762
8883,5,1,102,659339,5,659334
8884,5,-10,549,324512,5,324507
8885,16,-5,495,494675,16,494659
8886,13,8,239,899924,13,899911
8887,6,-19,436,40888,6,40882
8888,16,-18,570,89376,16,89360
8889,19,3,845,748195,19,748176
8890,15,-1,204,618119,15,618104
8891,6,12,57,1000348,6,1000342
8892,12,-3,326,556150,12,556138
8893,9,19,990,1239377,9,1239368
8894,17,-2,937,592281,17,592264
8895,13,2,534,714635,13,714622
8896,12,3,89,742470,12,742458
8897,9,-3,134,533322,9,533313
8898,17,15,957,1123826,17,1123809
8899,6,-6,470,446854,6,446848
8900,11,-20,212,24435,11,24424
8901,20,-7,950,435354,20,435334
8902,7,16,746,1140623,7,1140616
8903,20,-9,883,373599,20,373579
8904,8,-1,150,597006,8,596998
8905,14,11,710,995889,14,995875
8906,20,4,411,776172,20,776152
8907,5,-20,137,3011,5,3006
8908,16,0,147,649316,16,649300
8909,9,10,925,957415,9,957406
8910,8,-15,749,171468,8,171460
8911,19,0,721,653832,19,653813
8912,15,-6,143,460210,15,460195
8913,6,0,257,630959,6,630953
8914,14,13,813,1059356,14,1059342
8915,11,-16,375,149655,11,149644
8916,12,-4,871,528550,12,528538
8917,5,-1,872,612574,5,612569
8918,11,3,180,743217,11,743206
8919,15,8,428,901366,15,901351
8920,11,1,699,685285,11,685274
8921,14,-20,373,25669,14,25655
8922,9,1,821,674802,9,674793
8923,9,10,301,943846,9,943837
8924,17,3,668,746881,17,746864
8925,8,5,670,795426,8,795418
8926,11,-3,258,555593,11,555582
8927,5,-4,533,511004,5,510999
8928,16,-8,873,404064,16,404048
8929,5,-20,454,9707,5,9702
8930,18,-3,422,556944,18,556926
8931,8,-6,8,437047,8,437039
8932,16,-12,777,278210,16,278194
8933,7,17,929,1175224,7,1175217
8934,17,-6,519,463181,17,463164
8935,11,7,231,868645,11,868634
8936,18,18,845,1215119,18,1215101
8937,20,3,123,742769,20,742749
8938,10,14,802,1079865,10,1079855
8939,10,11,486,978812,10,978802
8940,16,-10,930,342052,16,342036
8941,10,-8,889,394333,10,394323
8942,5,-11,981,302248,5,302243
8943,5,3,19,719214,5,719209
8944,10,-16,390,132333,10,132323
8945,17,-13,991,248509,17,248492
8946,7,-13,42,219255,7,219248
8947,17,-2,489,588831,17,588814
8948,7,-15,455,165222,7,165215
8949,8,-8,15,375664,8,375656
8950,10,-15,220,160000,10,159990
8951,9,-5,376,476288,9,476279
8952,8,-16,445,133825,8,133817
8953,13,-12,405,275482,13,275469
8954,17,3,302,744189,17,744172
8955,5,3,186,722890,5,722885
8956,13,-2,643,589951,13,589938
8957,20,14,936,1092780,20,1092760
8958,14,11,107,991630,14,991616
8959,12,-1,59,616983,12,616971
8960,5,8,944,895728,5,895723
8961,17,16,456,1150403,17,1150386
8962,5,-12,842,267773,5,267768
8963,8,4,825,768664,8,768656
8964,9,-16,5,123895,9,123886
8965,6,-8,886,394232,6,394226
8966,12,15,27,1116993,12,1116981
8967,12,1,537,684151,12,684139
8968,18,2,91,711239,18,711221
8969,14,8,129,898943,14,898929
8970,15,7,564,871160,15,871145
8971,12,-9,68,367137,12,367125
8972,6,-5,603,481158,6,481152
8973,18,-7,20,428446,18,428428
8974,7,-5,9,467955,7,467948
8975,9,-11,670,295939,9,295930
8976,18,-18,67,85723,18,85705
8977,9,-2,8,562900,9,562891
8978,14,-17,381,118297,14,118283
8979,17,-10,713,340432,17,340415
8980,7,5,3,781668,7,781661
8981,15,8,637,903025,15,903010
8982,20,15,122,1117723,20,1117703
8983,7,6,412,821690,7,821683
8984,13,7,78,867570,13,867557
8985,14,14,704,1090980,14,1090966
8986,12,-1,171,617828,12,617816
8987,6,-18,208,66983,6,66977
8988,19,14,293,1087701,19,1087682
8989,13,-14,444,212965,13,212952
8990,18,-2,864,591714,18,591696
8991,5,3,934,739119,5,739114
8992,17,18,787,1214695,17,1214678
8993,15,-5,312,493375,15,493360
8994,11,17,283,1180039,11,1180028
8995,20,-6,502,463029,20,463009
8996,13,-18,77,85822,13,85809
8997,13,-2,855,591639,13,591626
8998,19,19,717,1246581,19,1246562
8999,7,19,842,1236246,7,1236239
9000,16,8,967,905472,16,905456
9001,18,9,955,936199,18,936181
9002,11,-5,119,491850,11,491839
9003,13,-13,331,243494,13,243481
9004,9,-5,854,486508,9,486499
9005,15,0,360,650751,15,650736
9006,5,11,956,988898,5,988893
9007,19,16,467,1150469,19,1150450
9008,10,-14,506,197585,10,197575
9009,18,-7,147,429349,18,429331
9010,7,-19,603,44718,7,44711
9011,14,3,351,744543,14,744529
9012,7,19,412,1226927,7,1226920
9013,17,13,380,1056014,17,1055997
9014,8,18,703,1201463,8,1201455
9015,16,-10,591,339469,16,339453
9016,18,-1,982,624013,18,623995
9017,5,-10,707,327867,5,327862
9018,7,-15,607,168444,7,168437
9019,14,-7,156,429447,14,429433
9020,6,-10,828,330337,6,330331
9021,18,3,902,748595,18,748577
9022,12,-8,918,404388,12,404376
9023,13,12,802,1028006,13,1027993
9024,14,16,591,1151265,14,1151251
9025,11,-8,569,401867,11,401856
9026,12,-20,973,30188,12,30176
9027,6,-9,305,350228,6,350222
9028,16,11,805,996682,16,996666
9029,7,-8,632,388884,7,388877
9030,15,-13,71,241565,15,241550
9031,17,12,683,1027201,17,1027184
9032,14,12,849,1028461,14,1028447
9033,12,-8,436,400898,12,400886
9034,14,-17,704,120790,14,120776
9035,16,1,809,686145,16,686129
9036,20,15,885,1123236,20,1123216
9037,9,0,649,639527,9,639518
9038,13,-7,535,432389,13,432376
9039,13,-11,245,305605,13,305592
9040,11,5,17,803894,11,803883
9041,6,4,20,750897,6,750891
9042,17,11,475,994335,17,994318
9043,7,3,289,725190,7,725183
9044,13,6,575,840439,13,840426
9045,7,14,89,1063748,7,1063741
9046,18,8,134,898982,18,898964
9047,14,12,480,1025589,14,1025575
9048,12,-18,317,87714,12,87702
9049,6,11,890,987680,6,987674
9050,20,-20,999,30445,20,30425
9051,7,15,770,1110811,7,1110804
9052,20,10,217,961484,20,961464
9053,14,7,946,873731,14,873717
9054,5,-1,397,602666,5,602661
9055,14,0,88,648874,14,648860
9056,11,8,199,899510,11,899499
9057,5,5,814,798600,5,798595
9058,16,-9,701,371970,16,371954
9059,17,-13,74,241587,17,241570
9060,7,3,409,727558,7,727551
9061,16,-11,537,308057,16,308041
9062,20,-19,334,56600,20,56580
9063,20,-10,457,338435,20,338415
9064,5,-6,958,457194,5,457189
9065,8,-17,191,97435,8,97427
9066,19,19,427,1244375,19,1244356
9067,8,11,308,974927,8,974919
9068,14,0,269,650154,14,650140
9069,14,17,13,1177934,14,1177920
9070,7,-12,988,271147,7,271140
9071,5,-17,728,109104,5,109099
9072,11,-1,406,619800,11,619789
9073,12,-4,813,528069,12,528057
9074,12,-18,710,90402,12,90390
9075,7,6,964,833895,7,833888
9076,14,-5,653,495776,14,495762
9077,15,19,352,1243617,15,1243602
9078,13,-20,852,29379,13,29366
9079,12,-18,162,86492,12,86480
9080,17,12,79,1022612,17,1022595
9081,5,-6,805,454114,5,454109
9082,8,11,452,978073,8,978065
9083,5,-20,462,9832,5,9827
9084,20,6,369,838621,20,838601
9085,11,17,652,1182712,11,1182701
9086,20,-20,252,24699,20,24679
9087,6,19,756,1234246,6,1234240
9088,14,-10,444,338336,14,338322
9089,18,3,928,748886,18,748868
9090,12,-1,885,623357,12,623345
9091,11,12,831,1028246,11,1028235
9092,11,-1,461,620227,11,620216
9093,8,-12,292,255827,8,255819
9094,8,-15,163,158924,8,158916
9095,9,-11,83,282812,9,282803
9096,5,-12,791,266628,5,266623
9097,11,-18,693,90253,11,90242
9098,15,-9,698,371954,15,371939
9099,12,9,422,932095,12,932083
9100,6,-1,893,613106,6,613100
9101,11,-4,19,522169,11,522158
9102,10,-17,925,113032,10,113022
9103,8,-14,271,192704,8,192696
9104,20,-10,653,339969,20,339949
9105,12,-10,918,341966,12,341954
9106,13,16,791,1152748,13,1152735
9107,19,-15,211,179260,19,179241
9108,6,-14,487,197199,6,197193
9109,9,8,590,888096,9,888087
9110,16,8,438,901470,16,901454
9111,13,19,438,1244446,13,1244433
9112,7,-14,645,200894,7,200887
9113,13,0,611,652862,13,652849
9114,10,0,779,642414,10,642404
9115,17,19,74,1241360,17,1241343
9116,16,-18,145,86331,16,86315
9117,17,17,328,1180448,17,1180431
9118,12,2,583,714922,12,714910
9119,11,12,667,1027046,11,1027035
9120,13,-10,617,339673,13,339660
9121,15,-13,943,248137,15,248122
9122,19,17,576,1182088,19,1182069
9123,11,-3,778,560072,11,560061
9124,18,13,80,1053808,18,1053790
9125,6,-6,820,454424,6,454418
9126,9,5,276,787420,9,787411
9127,7,-6,49,437882,7,437875
9128,8,-14,217,191373,8,191365
9129,11,-5,891,497565,11,497554
9130,12,-18,658,90070,12,90058
9131,7,12,442,1008551,7,1008544
9132,6,3,696,733996,6,733990
9133,20,-3,747,559736,20,559716
9134,16,-5,74,491434,16,491418
9135,6,7,440,854266,6,854260
9136,16,4,206,774722,16,774706
9137,11,12,723,1027470,11,1027459
9138,20,7,686,872019,20,871999
9139,16,-6,111,459905,16,459889
9140,7,-6,708,452026,7,452019
9141,19,-12,52,272888,19,272869
9142,11,-1,341,619314,11,619303
9143,20,-2,137,586125,20,586105
9144,11,-5,584,495351,11,495340
9145,11,4,465,776594,11,776583
9146,15,2,593,715030,15,715015
9147,13,-13,731,246418,13,246405
9148,12,-17,315,117833,12,117821
9149,20,-16,607,151466,20,151446
9150,15,6,989,843657,15,843642
9151,10,-10,637,326409,10,326399
9152,17,-12,572,276743,17,276726
9153,18,-15,714,183077,18,183059
9154,9,-5,230,473032,9,473023
9155,5,-7,14,406364,5,406359
9156,20,19,74,1241370,20,1241350
9157,13,-15,267,179688,13,179675
9158,15,-11,374,306750,15,306735
9159,11,-3,742,559663,11,559652
9160,10,17,333,1162523,10,1162513
9161,12,7,267,868927,12,868915
9162,7,7,662,858787,7,858780
9163,6,1,823,674806,6,674800
9164,7,12,775,1015876,7,1015869
9165,18,-16,801,152776,18,152758
9166,19,-10,226,336740,19,336721
9167,6,17,436,1164536,6,1164530
9168,19,0,541,652304,19,652285
9169,17,-15,415,180840,17,180823
9170,14,-17,293,117660,14,117646
9171,16,19,636,1245955,16,1245939
9172,14,-9,780,372711,14,372697
9173,7,13,598,1043656,7,1043649
9174,13,-3,329,556190,13,556177
9175,15,-11,527,307934,15,307919
9176,18,-15,840,184061,18,184043
9177,16,5,533,807695,16,807679
9178,7,-14,346,194243,7,194236
9179,12,7,977,873944,12,873932
9180,11,-2,804,591157,11,591146
9181,18,-1,677,621765,18,621747
9182,13,-8,835,403822,13,403809
9183,14,7,260,868915,14,868901
9184,13,2,771,716301,13,716288
9185,8,-20,883,19607,8,19599
9186,14,-13,529,244927,14,244913
9187,7,6,885,832217,7,832210
9188,16,16,184,1148440,16,1148424
9189,14,-12,573,276753,14,276739
9190,15,17,202,1179393,15,1179378
9191,20,8,57,898306,20,898286
9192,12,17,977,1185262,12,1185250
9193,9,-7,805,422815,9,422806
9194,11,11,460,994198,11,994187
9195,10,-10,981,333611,10,333601
9196,11,16,505,1150687,11,1150676
9197,6,-5,847,486312,6,486306
9198,17,-4,997,529581,17,529564
9199,11,-7,179,429649,11,429638
9200,20,-12,3,272525,20,272505
9201,14,-9,92,367309,14,367295
9202,9,-1,220,598552,9,598543
9203,10,-8,725,390893,10,390883
9204,18,-5,792,496765,18,496747
9205,13,-11,533,308003,13,307990
9206,12,-16,892,153514,12,153502
9207,14,-11,252,305679,14,305665
9208,19,-7,648,433023,19,433004
9209,12,-4,325,524636,12,524624
9210,19,-16,292,149104,19,149085
9211,11,14,258,1087423,11,1087412
9212,16,-4,771,527804,16,527788
9213,6,13,130,1033486,6,1033480
9214,20,3,276,743977,20,743957
9215,8,-17,752,109591,8,109583
9216,6,7,819,862167,6,862161
9217,5,17,885,1174315,5,1174310
9218,15,-15,543,181769,15,181754
9219,12,-11,356,306608,12,306596
9220,9,8,302,881823,9,881814
9221,18,2,828,716668,18,716650
9222,12,-11,294,306013,12,306001
9223,10,16,34,1125885,10,1125875
9224,16,-7,540,432411,16,432395
9225,17,-18,435,88523,17,88506
9226,11,11,487,994412,11,994401
9227,7,-16,956,144523,7,144516
9228,7,-12,345,257131,7,257124
9229,18,-9,671,371742,18,371724
9230,8,12,478,1009328,8,1009320
9231,6,-15,992,176546,6,176540
9232,15,-17,699,120736,15,120721
9233,14,-2,687,590326,14,590312
9234,13,18,619,1213374,13,1213361
9235,10,-1,334,601361,10,601351
9236,17,11,7,990913,17,990896
9237,6,-3,638,544803,6,544797
9238,7,12,18,999454,7,999447
9239,12,-2,598,589601,12,589589
9240,10,-2,447,572282,10,572272
9241,8,-16,517,135279,8,135271
9242,7,19,903,1237599,7,1237592
9243,12,-7,641,432986,12,432974
9244,20,1,686,685204,20,685184
9245,6,-18,283,68638,6,68632
9246,10,-5,631,481683,10,481673
9247,13,1,947,687252,13,687239
9248,15,-9,360,369343,15,369328
9249,17,-7,888,434852,17,434835
9250,18,-16,902,153556,18,153538
9251,6,14,724,1078299,6,1078293
9252,12,12,207,1023540,12,1023528
9253,7,14,433,1071518,7,1071511
9254,13,-1,924,623633,13,623620
9255,18,5,763,809321,18,809303
9256,14,-8,375,400536,14,400522
9257,12,-10,345,337564,12,337552
9258,10,-13,57,219619,10,219609
9259,5,4,209,755134,5,755129
9260,12,13,89,1053883,12,1053871
9261,15,-11,545,308126,15,308111
9262,16,15,183,1118172,16,1118156
9263,9,19,96,1219589,9,1219580
9264,14,9,380,931816,14,931802
9265,5,-18,148,65682,5,65677
9266,11,12,979,1029657,11,1029646
9267,16,4,943,780191,16,780175
9268,8,-20,637,13925,8,13917
9269,17,12,341,1024616,17,1024599
9270,8,13,571,1043009,8,1043001
9271,17,-19,553,58353,17,58336
9272,13,16,895,1153454,13,1153441
9273,8,-14,969,207656,8,207648
9274,17,5,777,809408,17,809391
9275,18,-15,910,184665,18,184647
9276,20,-12,64,272992,20,272972
9277,17,2,771,716308,17,716291
9278,8,15,514,1105460,8,1105452
9279,11,1,962,687339,11,687328
9280,17,14,305,1087800,17,1087783
9281,10,-13,534,229639,10,229629
9282,20,-6,434,462469,20,462449
9283,11,15,271,1118801,11,1118790
9284,19,-6,432,462459,19,462440
9285,10,8,727,891272,10,891262
9286,11,-7,339,430921,11,430910
9287,11,-13,683,245977,11,245966
9288,18,12,398,1024980,18,1024962
9289,11,4,121,774112,11,774101
9290,18,14,982,1093148,18,1093130
9291,13,14,332,1088047,13,1088034
9292,17,-2,732,590616,17,590599
9293,10,-10,215,317306,10,317296
9294,11,11,347,993392,11,993381
9295,15,-11,182,305204,15,305189
9296,10,-8,11,375547,10,375537
9297,15,-6,227,460908,15,460893
9298,10,3,279,724904,10,724894
9299,8,7,272,850627,8,850619
9300,13,18,25,1209078,13,1209065
9301,18,-6,854,465601,18,465583
9302,17,-20,158,23948,17,23931
9303,5,-12,524,260993,5,260988
9304,10,8,304,881866,10,881856
9305,5,4,401,759277,5,759272
9306,18,-8,854,403922,18,403904
9307,19,-11,860,310460,19,310441
9308,9,7,951,864859,9,864850
9309,13,-5,741,496458,13,496445
9310,5,-20,473,10133,5,10128
9311,11,2,352,713251,11,713240
9312,20,-2,942,592320,20,592300
9313,10,12,464,1009065,10,1009055
9314,11,-18,315,87707,11,87696
9315,16,13,728,1058653,16,1058637
9316,18,-17,218,117076,18,117058
9317,9,-2,962,583426,9,583417
9318,17,-14,98,210090,17,210073
9319,10,14,110,1064306,10,1064296
9320,15,12,366,1024780,15,1024765
9321,12,8,635,903016,12,903004
9322,12,18,729,1214168,12,1214156
9323,12,1,546,684220,12,684208
9324,13,-3,718,559483,13,559470
9325,15,-10,604,339581,15,339566
9326,11,-12,125,273489,11,273478
9327,6,4,68,752093,6,752087
9328,13,-2,161,586252,13,586239
9329,19,16,126,1147930,19,1147911
9330,19,-19,619,58879,19,58860
9331,18,18,40,1209200,18,1209182
9332,11,13,341,1055741,11,1055730
9333,18,-7,383,431253,18,431235
9334,8,19,257,1223173,8,1223165
9335,14,-5,520,494880,14,494866
9336,12,8,85,898557,12,898545
9337,18,-13,917,247939,18,247921
9338,9,3,466,728799,9,728790
9339,7,14,925,1082418,7,1082411
9340,12,11,691,995733,12,995721
9341,12,2,815,716533,12,716521
9342,17,15,825,1122820,17,1122803
9343,16,-7,493,432018,16,432002
9344,18,13,778,1059047,18,1059029
9345,8,11,469,978457,8,978449
9346,5,18,421,1195731,5,1195726
9347,9,-18,494,73066,9,73057
9348,16,15,37,1117049,16,1117033
9349,8,14,883,1081634,8,1081626
9350,7,-20,843,18754,7,18747
9351,7,2,566,700586,7,700579
9352,18,13,472,1056728,18,1056710
9353,11,3,702,747178,11,747167
9354,6,-5,520,479263,6,479257
9355,8,-7,953,426183,8,426175
9356,9,12,528,1010395,9,1010386
9357,9,-19,883,50735,9,50726
9358,5,8,968,896207,5,896202
9359,14,0,899,655104,14,655090
9360,9,-2,941,583019,9,583010
9361,5,-16,60,125124,5,125119
9362,18,17,340,1180521,18,1180503
9363,8,7,979,865491,8,865483
9364,13,-17,733,121050,13,121037
9365,15,-13,882,247628,15,247613
9366,12,-11,987,311442,12,311430
9367,9,-3,320,537365,9,537356
9368,19,-9,340,369182,19,369163
9369,12,14,276,1087562,12,1087550
9370,12,13,802,1059276,12,1059264
9371,11,-1,916,623567,11,623556
9372,19,19,252,1242736,19,1242717
9373,18,-17,507,119294,18,119276
9374,10,17,59,1156607,10,1156597
9375,11,4,460,776553,11,776542
9376,20,-7,281,430419,20,430399
9377,5,11,651,982327,5,982322
9378,12,-20,115,23632,12,23620
9379,16,16,856,1153212,16,1153196
9380,19,-19,337,56647,19,56628
9381,17,-14,381,212514,17,212497
9382,18,17,793,1183836,18,1183818
9383,8,-4,756,515540,8,515532
9384,19,18,631,1213488,19,1213469
9385,15,10,246,961648,15,961633
9386,16,9,299,931141,16,931125
9387,20,-5,830,497029,20,497009
9388,5,18,864,1204968,5,1204963
9389,11,-6,166,460408,11,460397
9390,15,-5,677,495940,15,495925
9391,18,5,571,807934,18,807916
9392,10,-11,200,285454,10,285444
9393,10,-6,655,450828,10,450818
9394,8,4,110,752997,8,752989
9395,5,-2,485,573137,5,573132
9396,16,-8,67,398457,16,398441
9397,6,-13,982,239584,6,239578
9398,10,-12,339,256974,10,256964
9399,17,-11,356,306615,17,306598
9400,15,13,367,1055931,15,1055916
9401,17,12,363,1024755,17,1024738
9402,15,16,409,1150069,15,1150054
9403,16,17,797,1183905,16,1183889
9404,13,-11,330,306390,13,306377
9405,5,-4,328,506663,5,506658
9406,12,7,859,873194,12,873182
9407,5,12,459,1008916,5,1008911
9408,8,17,468,1165331,8,1165323
9409,7,6,613,826153,7,826146
9410,16,-14,598,214236,16,214220
9411,12,5,283,805933,12,805921
9412,9,5,213,786118,9,786109
9413,5,-17,333,100670,5,100665
9414,6,-10,105,314814,6,314808
9415,8,16,459,1135044,8,1135036
9416,8,-6,543,448545,8,448537
9417,5,15,841,1112317,5,1112312
9418,9,7,558,856627,9,856618
9419,9,-3,362,538335,9,538326
9420,9,-20,235,5245,9,5236
9421,18,11,906,997456,18,997438
9422,9,-9,752,360243,9,360234
9423,14,-5,532,494977,14,494963
9424,9,8,914,895025,9,895016
9425,10,-2,906,582190,10,582180
9426,14,6,13,835872,14,835858
9427,19,13,671,1058302,19,1058283
9428,6,19,200,1221906,6,1221900
9429,19,-9,450,370151,19,370132
9430,20,-1,984,624051,20,624031
9431,9,-11,946,301441,9,301432
9432,11,-13,938,248126,11,248115
9433,16,-14,912,216631,16,216615
9434,18,-12,702,277676,18,277658
9435,10,-18,858,80936,10,80926
9436,12,-7,583,432714,12,432702
9437,6,4,387,758979,6,758973
9438,6,-18,596,75214,6,75208
9439,19,-14,338,212057,19,212038
9440,17,-14,791,215700,17,215683
9441,5,2,326,695669,5,695664
9442,18,0,334,650541,18,650523
9443,9,-19,314,38278,9,38269
9444,9,-7,310,412572,9,412563
9445,17,12,832,1028266,17,1028249
9446,11,-2,733,590616,11,590605
9447,17,-15,97,178514,17,178497
9448,13,-18,828,91263,13,91250
9449,7,-3,239,535632,7,535625
9450,8,-10,657,326833,8,326825
9451,14,17,777,1183637,14,1183623
9452,10,15,58,1095729,10,1095719
9453,12,-10,160,336272,12,336260
9454,10,-13,283,224497,10,224487
9455,5,16,287,1131260,5,1131255
9456,8,-18,479,72733,8,72725
9457,14,14,269,1087505,14,1087491
9458,19,0,881,654938,19,654919
9459,10,-2,51,563965,10,563955
9460,18,12,944,1029371,18,1029353
9461,17,0,465,651641,17,651624
9462,7,13,369,1038638,7,1038631
9463,17,8,481,901734,17,901717
9464,11,11,325,993233,11,993222
9465,10,-8,298,381678,10,381668
9466,13,-7,281,430422,13,430409
9467,12,-1,437,620008,12,619996
9468,18,15,532,1120655,18,1120637
9469,13,-13,131,241953,13,241940
9470,17,6,405,839034,17,839017
9471,13,-16,407,149903,13,149890
9472,9,8,765,891998,9,891989
9473,13,1,533,684103,13,684090
9474,19,18,818,1214868,19,1214849
9475,13,12,238,1023791,13,1023778
9476,20,12,376,1024837,20,1024817
9477,8,1,479,667724,8,667716
9478,17,16,298,1149298,17,1149281
9479,5,9,385,914794,5,914789
9480,15,14,1000,1093339,15,1093324
9481,5,10,17,937834,5,937829
9482,11,8,883,904786,11,904775
9483,12,-3,774,560029,12,560017
9484,15,-9,351,369250,15,369235
9485,18,9,257,930834,18,930816
9486,15,-4,754,527656,15,527641
9487,16,-15,663,182736,16,182720
9488,16,13,150,1054301,16,1054285
9489,6,0,314,631926,6,631920
9490,17,-1,452,620142,17,620125
9491,13,-5,882,497500,13,497487
9492,15,-9,837,373152,15,373137
9493,12,-1,230,618391,12,618379
9494,19,-11,745,309513,19,309494
9495,16,10,385,962712,16,962696
9496,7,5,654,795066,7,795059
9497,11,12,103,1022786,11,1022775
9498,20,-7,804,434139,20,434119
9499,18,-13,175,242306,18,242288
9500,19,5,263,805781,19,805762
9501,13,18,957,1215999,13,1215986
9502,19,-11,335,306433,19,306414
9503,12,7,980,873976,12,873964
9504,7,-19,919,51252,7,51245
9505,10,12,390,1007494,10,1007484
9506,20,-10,73,335745,20,335725
9507,11,-17,508,119294,11,119283
9508,17,5,611,808285,17,808268
9509,17,3,672,746918,17,746901
9510,15,9,287,931030,15,931015
9511,13,4,98,774001,13,773988
9512,17,15,374,1119531,17,1119514
9513,6,-18,313,69377,6,69371
9514,5,4,710,765920,5,765915
9515,19,-2,922,592145,19,592126
9516,7,-16,186,128071,7,128064
9517,14,-17,898,122152,14,122138
9518,5,-4,754,515489,5,515484
9519,7,-16,384,132223,7,132216
9520,15,11,220,992395,15,992380
9521,9,6,41,813099,9,813090
9522,13,-6,965,466436,13,466423
9523,17,7,930,873622,17,873605
9524,13,1,865,686544,13,686531
9525,7,11,216,972764,7,972757
9526,15,-6,356,461899,15,461884
9527,17,11,700,995802,17,995785
9528,6,12,632,1012805,6,1012799
9529,6,-1,280,599988,6,599982
9530,14,-1,454,620164,14,620150
9531,11,15,914,1123473,11,1123462
9532,9,-9,517,355311,9,355302
9533,15,6,676,841197,15,841182
9534,14,17,357,1180632,14,1180618
9535,16,-20,984,30311,16,30295
9536,13,11,148,991902,13,991889
9537,18,-4,661,527095,18,527077
9538,9,15,505,1105163,9,1105154
9539,6,-20,932,20534,6,20528
9540,10,6,280,818594,10,818584
9541,7,9,674,920907,7,920900
9542,9,-2,573,574932,9,574923
9543,12,-14,629,214448,12,214436
9544,20,-17,360,118153,20,118133
9545,8,14,378,1070155,8,1070147
9546,16,-16,7,146758,16,146742
9547,7,10,628,951055,7,951048
9548,14,14,878,1092290,14,1092276
9549,15,-6,273,461304,15,461289
9550,11,-2,932,592213,11,592202
9551,5,-8,354,382864,5,382859
9552,6,-18,419,71377,6,71371
9553,8,7,628,858072,8,858064
9554,5,18,995,1207769,5,1207764
9555,19,-7,233,430035,19,430016
9556,9,-8,330,382438,9,382429
9557,11,1,255,681930,11,681919
9558,20,-11,450,307370,20,307350
9559,12,-10,413,338081,12,338069
9560,10,14,644,1076319,10,1076309
9561,9,-14,748,202925,9,202916
9562,9,-20,17,423,9,414
9563,8,7,555,856581,8,856573
9564,20,-11,524,307907,20,307887
9565,13,-8,562,401792,13,401779
9566,10,-11,280,287166,10,287156
9567,6,3,117,721362,6,721356
9568,20,-13,536,244991,20,244971
9569,17,-13,279,243164,17,243147
9570,11,2,877,717038,11,717027
9571,6,-13,123,221018,6,221012
9572,12,10,580,964352,12,964340
9573,14,0,639,653076,14,653062
9574,17,10,302,962072,17,962055
9575,5,-9,187,347536,5,347531
9576,11,17,936,1184903,11,1184892
9577,18,9,144,930129,18,930111
9578,8,11,49,969488,8,969480
9579,14,18,165,1210285,14,1210271
9580,8,-10,390,320962,8,320954
9581,11,4,995,780517,11,780506
9582,7,9,927,926422,7,926415
9583,17,-14,656,214640,17,214623
9584,20,-13,331,243504,20,243484
9585,18,8,259,900003,18,899985
9586,7,-7,168,409378,7,409371
9587,18,14,421,1088764,18,1088746
9588,20,-3,178,555022,20,555002
9589,18,-11,398,306902,18,306884
9590,16,19,614,1245748,16,1245732
9591,6,-1,991,615315,6,615309
9592,15,-11,936,310990,15,310975
9593,15,-7,138,429290,15,429275
9594,11,19,967,1248520,11,1248509
9595,12,14,495,1089312,12,1089300
9596,13,-14,49,209698,13,209685
9597,10,9,648,920437,10,920427
9598,9,17,824,1173017,9,1173008
9599,7,14,82,1063602,7,1063595
9600,20,-13,681,245967,20,245947
9601,8,-13,875,237320,8,237312
9602,9,-4,74,500978,9,500969
9603,12,-15,473,181264,12,181252
9604,15,14,508,1089428,15,1089413
9605,18,10,814,966190,18,966172
9606,10,-6,459,446570,10,446560
9607,17,9,681,934060,17,934043
9608,6,-14,76,188233,6,188227
9609,11,16,498,1150649,11,1150638
9610,7,5,444,790811,7,790804
9611,12,19,151,1241974,12,1241962
9612,13,-10,128,336056,13,336043
9613,14,-9,133,367538,14,367524
9614,18,-2,210,586673,18,586655
9615,9,-3,892,550352,9,550343
9616,20,5,942,810706,20,810686
9617,18,-3,331,556232,18,556214
9618,5,9,8,906893,5,906888
9619,9,-18,802,79732,9,79723
9620,19,-4,507,525940,19,525921
9621,6,-4,230,504606,6,504600
9622,19,10,34,960117,19,960098
9623,6,-15,529,166864,6,166858
9624,15,-3,117,554639,15,554624
9625,6,3,44,719750,6,719744
9626,15,-2,614,589755,15,589740
9627,10,-9,166,347112,10,347102
9628,13,-4,219,523794,13,523781
9629,19,-12,122,273451,19,273432
9630,10,-13,770,235087,10,235077
9631,13,-17,254,117339,13,117326
9632,14,-9,787,372779,14,372765
9633,14,19,682,1246298,14,1246284
9634,15,-18,56,85618,15,85603
9635,6,-14,616,200234,6,200228
9636,15,1,11,679813,15,679798
9637,7,-2,387,570899,7,570892
9638,19,8,976,905533,19,905514
9639,13,-11,910,310846,13,310833
9640,18,-5,45,491176,18,491158
9641,9,-17,86,95271,9,95262
9642,6,-15,726,170996,6,170990
9643,17,11,781,996507,17,996490
9644,6,16,765,1140958,6,1140952
9645,6,-9,529,355597,6,355591
9646,9,15,761,1110650,9,1110641
9647,20,-18,425,88482,20,88462
9648,14,13,921,1060032,14,1060018
9649,9,-19,811,49140,9,49131
9650,20,16,114,1147875,20,1147855
9651,6,0,296,631655,6,631649
9652,15,17,782,1183713,15,1183698
9653,19,19,471,1244670,19,1244651
9654,19,-7,238,430049,19,430030
9655,11,-3,378,556591,11,556580
9656,12,-14,940,216795,12,216783
9657,10,1,673,671829,10,671819
9658,9,1,564,669645,9,669636
9659,11,0,719,653799,11,653788
9660,13,-7,86,428882,13,428869
9661,14,8,487,901796,14,901782
9662,15,4,580,777458,15,777443
9663,15,-17,47,115896,15,115881
9664,11,6,612,840674,11,840663
9665,18,1,135,680918,18,680900
9666,12,-9,209,368012,12,368000
9667,16,6,173,837040,16,837024
9668,9,6,16,812555,9,812546
9669,11,-3,693,559283,11,559272
9670,15,8,228,899796,15,899781
9671,13,-16,220,148601,13,148588
9672,18,7,914,873548,18,873530
9673,17,-3,722,559528,17,559511
9674,5,7,802,861734,5,861729
9675,7,16,186,1129117,7,1129110
9676,12,-12,187,273842,12,273830
9677,9,-6,798,453963,9,453954
9678,16,-4,677,527199,16,527183
9679,11,-7,555,432507,11,432496
9680,19,13,167,1054426,19,1054407
9681,10,-6,156,440093,10,440083
9682,17,-10,969,342363,17,342346
9683,8,-5,307,474843,8,474835
9684,6,-17,466,103417,6,103411
9685,19,18,124,1209931,19,1209912
9686,8,0,194,629722,8,629714
9687,20,-14,454,213013,20,212993
9688,18,-8,765,403299,18,403281
9689,19,7,856,873177,19,873158
9690,10,17,633,1168850,10,1168840
9691,9,4,497,761259,9,761250
9692,16,16,768,1152521,16,1152505
9693,6,-5,429,477269,6,477263
9694,16,2,340,713170,16,713154
9695,8,-6,515,447963,8,447955
9696,14,7,360,869627,14,869613
9697,19,19,753,1246881,19,1246862
9698,18,1,120,680763,18,680745
9699,6,-2,454,572459,6,572453
9700,7,-8,248,380771,7,380764
9701,7,15,188,1098494,7,1098487
9702,5,0,93,627384,5,627379
9703,5,-16,757,140379,5,140374
9704,12,14,623,1090253,12,1090241
9705,17,16,309,1149362,17,1149345
9706,9,13,391,1039115,9,1039106
9707,14,15,312,1119076,14,1119062
9708,9,14,293,1068303,9,1068294
9709,9,-4,460,509418,9,509409
9710,7,2,915,707636,7,707629
9711,13,-20,470,26306,13,26293
9712,10,-18,848,80629,10,80619
9713,10,-3,965,552130,10,552120
9714,13,-5,760,496562,13,496549
9715,11,19,376,1243811,11,1243800
9716,8,-7,697,420647,8,420639
9717,18,8,324,900526,18,900508
9718,19,-19,114,54890,19,54871
9719,5,19,91,1219533,5,1219528
9720,18,-8,900,404309,18,404291
9721,11,12,80,1022616,11,1022605
9722,7,-14,592,199626,7,199619
9723,5,-17,895,112442,5,112437
9724,11,-13,494,244641,11,244630
9725,13,6,407,839041,13,839028
9726,12,18,607,1213278,12,1213266
9727,7,-8,497,385695,7,385688
9728,13,-12,803,278367,13,278354
9729,9,9,251,911986,9,911977
9730,6,-7,856,423992,6,423986
9731,13,0,510,652022,13,652009
9732,7,-1,762,610160,7,610153
9733,7,16,823,1142261,7,1142254
9734,8,-9,696,358931,8,358923
9735,14,10,627,964752,14,964738
9736,7,16,421,1134214,7,1134207
9737,7,0,819,643145,7,643138
9738,5,2,313,695343,5,695338
9739,15,18,906,1215549,15,1215534
9740,13,-17,185,116806,13,116793
9741,7,-2,9,562939,7,562932
9742,12,7,658,871830,12,871818
9743,20,9,632,933774,20,933754
9744,15,-18,658,90075,15,90060
9745,6,-12,708,264813,6,264807
9746,15,4,34,773513,15,773498
9747,15,10,93,960592,15,960577
9748,11,16,518,1150782,11,1150771
9749,9,0,654,639679,9,639670
9750,8,-20,287,6395,8,6387
9751,11,-19,135,55089,11,55078
9752,10,9,831,924412,10,924402
9753,18,-1,614,621330,18,621312
9754,6,16,525,1136372,6,1136366
9755,8,7,439,854227,8,854219
9756,9,-10,839,330612,9,330603
9757,13,-15,338,180218,13,180205
9758,6,-20,404,8775,6,8769
9759,20,18,108,1209847,20,1209827
9760,14,1,146,680993,14,680979
9761,8,-20,72,1582,8,1574
9762,11,13,580,1057677,11,1057666
9763,18,4,711,778494,18,778476
9764,12,3,605,746354,12,746342
9765,20,-5,874,497432,20,497412
9766,8,0,456,635301,8,635293
9767,15,-14,240,211277,15,211262
9768,10,-18,301,69060,10,69050
9769,13,5,856,809983,13,809970
9770,9,-10,195,316852,9,316843
9771,10,6,518,824099,10,824089
9772,14,6,970,843510,14,843496
9773,20,-13,646,245742,20,245722
9774,20,-15,510,181523,20,181503
9775,6,16,421,1134220,6,1134214
9776,10,-5,501,478840,10,478830
9777,13,16,174,1148331,13,1148318
9778,9,11,41,969299,9,969290
9779,9,-3,223,535155,9,535146
9780,9,18,568,1198844,9,1198835
9781,7,-16,125,126779,7,126772
9782,20,9,814,935084,20,935064
9783,17,-19,837,60434,17,60417
9784,11,-20,895,29695,11,29684
9785,13,0,853,654707,13,654694
9786,8,0,412,634262,8,634254
9787,7,6,884,832163,7,832156
9788,20,-1,789,622634,20,622614
9789,15,0,572,652579,15,652564
9790,16,-11,808,310014,16,309998
9791,18,2,221,712245,18,712227
9792,8,16,612,1138005,8,1137997
9793,17,-10,126,336041,17,336024
9794,9,-19,739,47852,9,47843
9795,19,-2,897,591979,19,591960
9796,19,-4,204,523682,19,523663
9797,16,19,89,1241512,16,1241496
9798,20,-18,165,86517,20,86497
9799,10,-6,83,438465,10,438455
9800,6,10,482,947721,6,947715
9801,19,-7,990,435632,19,435613
9802,9,-19,932,51499,9,51490
9803,9,4,713,766001,9,765992
9804,9,-19,839,49867,9,49858
9805,13,-5,468,494499,13,494486
9806,16,15,658,1121618,16,1121602
9807,16,7,359,869615,16,869599
9808,15,-20,16,8870,15,8855
9809,15,-19,335,56605,15,56590
9810,5,-17,378,101584,5,101579
9811,9,-10,643,326521,9,326512
9812,11,-3,408,556811,11,556800
9813,16,15,169,1118033,16,1118017
9814,10,11,26,969016,10,969006
9815,12,-12,468,275945,12,275933
9816,7,-17,109,95746,7,95739
9817,18,-4,781,527891,18,527873
9818,13,7,49,867412,13,867399
9819,17,14,760,1091418,17,1091401
9820,18,-13,962,248326,18,248308
9821,9,-2,529,573958,9,573949
9822,18,-8,606,402102,18,402084
9823,18,5,124,804688,18,804670
9824,14,-15,732,183239,14,183225
9825,6,-6,157,440128,6,440122
9826,9,-8,159,378876,9,378867
9827,11,-10,362,337650,11,337639
9828,10,14,793,1079687,10,1079677
9829,16,-18,419,88422,16,88406
9830,18,-13,681,245975,18,245957
9831,17,17,841,1184279,17,1184262
9832,13,3,297,744138,13,744125
9833,19,17,658,1182751,19,1182732
9834,12,13,869,1059733,12,1059721
9835,11,-17,751,121210,11,121199
9836,19,-20,450,26224,19,26205
9837,9,3,675,733377,9,733368
9838,10,-2,198,566968,10,566958
9839,20,5,79,804387,20,804367
9840,7,18,338,1194077,7,1194070
9841,13,-8,481,401174,13,401161
9842,11,-8,180,399186,11,399175
9843,7,11,767,984916,7,984909
9844,19,-15,368,180467,19,180448
9845,16,-2,400,588075,16,588059
9846,7,4,313,757252,7,757245
9847,20,3,372,744668,20,744648
9848,5,14,426,1071369,5,1071364
9849,6,16,741,1140550,6,1140544
9850,16,-6,110,459895,16,459879
9851,16,-13,861,247463,16,247447
9852,16,15,666,1121684,16,1121668
9853,12,-19,237,55892,12,55880
9854,20,15,732,1122222,20,1122202
9855,17,8,335,900613,17,900596
9856,20,1,134,680904,20,680884
9857,12,13,727,1058643,12,1058631
9858,13,3,91,742479,13,742466
9859,8,-1,925,613917,8,613909
9860,17,-1,823,622870,17,622853
9861,7,-13,615,231546,7,231539
9862,14,-2,482,588776,14,588762
9863,10,-20,538,11723,10,11713
9864,14,6,323,838272,14,838258
9865,20,17,768,1183552,20,1183532
9866,7,14,43,1062781,7,1062774
9867,20,4,961,780302,20,780282
9868,18,-16,493,150634,18,150616
9869,20,-10,903,341878,20,341858
9870,18,14,254,1087416,18,1087398
9871,16,7,433,870269,16,870253
9872,11,15,37,1117050,11,1117039
9873,9,-5,63,469222,9,469213
9874,14,-13,703,246165,14,246151
9875,10,-3,130,533237,10,533227
9876,20,0,182,649653,20,649633
9877,11,-5,162,492200,11,492189
9878,16,3,618,746468,16,746452
9879,10,-20,166,3703,10,3693
9880,16,10,400,962842,16,962826
9881,5,2,677,702911,5,702906
9882,7,9,610,919699,7,919692
9883,17,12,135,1023025,17,1023008
9884,14,-4,447,525497,14,525483
9885,6,13,84,1032554,6,1032548
9886,9,2,849,706273,9,706264
9887,17,-8,770,403328,17,403311
9888,13,13,641,1058090,13,1058077
9889,17,-2,638,589910,17,589893
9890,12,-20,400,25835,12,25823
9891,5,-16,138,127025,5,127020
9892,13,-15,995,185291,13,185278
9893,10,9,742,922315,10,922305
9894,16,-11,79,304277,16,304261
9895,14,-16,106,147705,14,147691
9896,12,5,307,806012,12,806000
9897,10,16,816,1142114,10,1142104
9898,5,-19,477,41794,5,41789
9899,19,10,488,963551,19,963532
9900,17,-2,75,585697,17,585680
9901,17,16,163,1148218,17,1148201
9902,20,-1,945,623761,20,623741
9903,9,17,470,1165397,9,1165388
9904,9,2,906,707448,9,707439
9905,12,12,573,1026235,12,1026223
9906,6,-9,662,358171,6,358165
9907,11,-7,975,435533,11,435522
9908,8,5,117,783976,8,783968
9909,18,11,431,994000,18,993982
9910,9,3,445,728394,9,728385
9911,9,-18,614,75576,9,75567
9912,17,-6,758,464938,17,464921
9913,19,-10,25,335320,19,335301
9914,9,12,949,1020001,9,1019992
9915,17,9,207,930599,17,930582
9916,10,10,712,952905,10,952895
9917,9,7,849,862777,9,862768
9918,11,14,416,1088704,11,1088693
9919,13,-11,635,308750,13,308737
9920,5,9,437,915894,5,915889
9921,7,15,401,1102900,7,1102893
9922,20,7,447,870372,20,870352
9923,12,-16,332,149367,12,149355
9924,10,-12,754,265851,10,265841
9925,6,-10,405,321397,6,321391
9926,11,0,902,655129,11,655118
9927,18,-16,782,152654,18,152636
9928,7,-7,598,418615,7,418608
9929,14,6,133,836771,14,836757
9930,19,-14,253,211400,19,211381
9931,17,-12,656,277355,17,277338
9932,11,-9,425,369920,11,369909
9933,16,12,423,1025135,16,1025119
9934,7,11,933,988592,7,988585
9935,6,9,984,927734,6,927728
9936,10,3,914,738614,10,738604
9937,16,-16,10,146791,16,146775
9938,16,-11,800,309943,16,309927
9939,12,-8,899,404293,12,404281
9940,11,-6,923,466122,11,466111
9941,5,-13,868,237111,5,237106
9942,9,12,516,1010090,9,1010081
9943,6,15,217,1099090,6,1099084
9944,20,2,358,713311,20,713291
9945,6,16,394,1133579,6,1133573
9946,15,3,84,742445,15,742430
9947,11,-20,839,29302,11,29291
9948,19,15,856,1123029,19,1123010
9949,18,1,251,681880,18,681862
9950,19,17,180,1179226,19,1179207
9951,11,-1,63,617021,11,617010
9952,20,3,93,742496,20,742476
9953,7,5,366,789144,7,789137
9954,17,1,974,687432,17,687415
9955,6,5,720,796622,6,796616
9956,6,-3,179,534222,6,534216
9957,11,14,835,1091977,11,1091966
9958,11,-18,652,90015,11,90004
9959,18,5,923,810522,18,810504
9960,5,6,254,817881,5,817876
9961,14,-12,262,274422,14,274408
9962,12,-2,26,585322,12,585310
9963,5,-12,903,269285,5,269280
9964,18,-20,20,12064,18,12046
9965,5,13,540,1042258,5,1042253
9966,20,-16,541,150991,20,150971
9967,11,14,617,1090213,11,1090202
9968,13,-20,226,24520,13,24507
9969,6,4,582,763120,6,763114
9970,15,-14,908,216574,15,216559
9971,19,8,135,898996,19,898977
9972,5,19,7,1217579,5,1217574
9973,10,-14,603,199903,10,199893
9974,8,-9,361,351529,8,351521
9975,7,8,563,887528,7,887521
9976,9,9,967,927368,9,927359
9977,6,-11,920,300818,6,300812
9978,20,14,458,1089044,20,1089024
9979,11,-14,845,216084,11,216073
9980,18,-1,14,616597,18,616579
9981,16,-4,129,523035,16,523019
9982,6,-1,280,599994,6,599988
9983,5,15,954,1114808,5,1114803
9984,10,-17,851,111473,10,111463
9985,14,-5,318,493453,14,493439
9986,12,8,914,905089,12,905077
9987,16,19,701,1246472,16,1246456
9988,20,10,598,964538,20,964518
9989,8,7,247,850094,8,850086
9990,9,8,611,888505,9,888496
9991,14,18,806,1214827,14,1214813
9992,7,3,637,732473,7,732466
9993,15,-6,915,466074,15,466059
9994,12,10,23,960008,12,959996
9995,8,16,821,1142221,8,1142213
9996,6,-15,775,171990,6,171984
9997,14,8,166,899258,14,899244
9998,6,-9,668,358248,6,358242
9999,15,7,301,869196,15,869181
10000,18,11,318,993175,18,993157
10001,19,11,849,997014,19,996995
10002,15,-8,446,400948,15,400933
10003,15,6,90,836414,15,836399
10004,13,13,250,1055035,13,1055022
10005,13,7,997,874095,13,874082
10006,15,-13,808,247055,15,247040
10007,13,8,410,901258,13,901245
10008,18,-9,309,368828,18,368810
10009,7,16,291,1131334,7,1131327
10010,7,-1,405,602844,7,602837
10011,5,-7,539,417416,5,417411
10012,13,6,512,839931,13,839918
10013,6,-9,34,344343,6,344337
10014,10,7,261,850409,10,850399
10015,6,-20,492,10528,6,10522
10016,13,9,218,930675,13,930662
10017,7,-2,753,578744,7,578737
10018,14,7,850,873136,14,873122
10019,11,-12,457,275808,11,275797
10020,18,-15,803,183743,18,183725
10021,16,10,178,961213,16,961197
10022,6,-14,628,200544,6,200538
10023,7,17,853,1173738,7,1173731
10024,7,-7,38,406921,7,406914
10025,9,-15,274,161256,9,161247
10026,16,0,23,648390,16,648374
10027,8,-9,565,356328,8,356320
10028,9,-15,430,164751,9,164742
10029,10,-2,817,580262,10,580252
10030,19,-9,324,368975,19,368956
10031,17,12,763,1027706,17,1027689
10032,12,-5,992,498288,12,498276
10033,10,-7,225,410585,10,410575
10034,7,-16,149,127243,7,127236
10035,12,6,92,836438,12,836426
10036,17,4,744,778734,17,778717
10037,10,9,315,913408,10,913398
10038,10,0,166,629057,10,629047
10039,18,18,997,1216284,18,1216266
10040,12,-10,133,336108,12,336096
10041,6,-2,502,573467,6,573461
10042,15,17,874,1184536,15,1184521
10043,16,-6,507,463072,16,463056
10044,11,-16,622,151616,11,151605
10045,18,-14,895,216462,18,216444
10046,14,-13,661,245837,14,245823
10047,12,-7,680,433234,12,433222
10048,17,-5,507,494759,17,494742
10049,12,-6,609,463776,12,463764
10050,19,-8,200,399322,19,399303
10051,7,-18,607,75411,7,75404
10052,11,-16,290,149080,11,149069
10053,15,8,963,905434,15,905419
10054,9,2,49,689677,9,689668
10055,5,-6,878,455514,5,455509
10056,17,10,389,962756,17,962739
10057,15,1,21,679928,15,679913
10058,5,14,564,1074377,5,1074372
10059,8,9,344,914001,8,913993
10060,19,-5,238,492748,19,492729
10061,17,0,519,652084,17,652067
10062,15,3,960,749200,15,749185
10063,10,-16,362,131697,10,131687
10064,10,-19,117,34133,10,34123
10065,20,-7,850,434529,20,434509
10066,9,-8,348,382756,9,382747
10067,9,19,881,1237149,9,1237140
10068,18,-7,906,435003,18,434985
10069,17,17,48,1178239,17,1178222
10070,7,-11,735,296994,7,296987
10071,19,-15,776,183564,19,183545
10072,14,11,572,994983,14,994969
10073,7,-19,570,44007,7,44000
10074,12,19,220,1242485,12,1242473
10075,17,19,264,1242847,17,1242830
10076,13,1,96,680553,13,680540
10077,19,14,860,1092141,19,1092122
10078,5,18,690,1201174,5,1201169
10079,20,-20,90,23440,20,23420
10080,18,-12,170,273758,18,273740
10081,7,-1,405,602851,7,602844
10082,19,8,442,901514,19,901495
10083,18,-20,228,24532,18,24514
10084,16,-20,129,23734,16,23718
10085,15,11,682,995692,15,995677
10086,8,8,582,887932,8,887924
10087,13,19,435,1244422,13,1244409
10088,15,-16,497,150661,15,150646
10089,16,4,630,777845,16,777829
10090,19,-4,535,526149,19,526130
10091,10,8,49,876103,10,876093
10092,8,-17,179,97185,8,97177
10093,13,-17,565,119778,13,119765
10094,18,14,519,1089504,18,1089486
10095,5,-2,277,568732,5,568727
10096,11,-5,29,491032,11,491021
10097,20,12,430,1025212,20,1025192
10098,8,6,965,833919,8,833911
10099,10,6,178,816050,10,816040
10100,9,-16,585,136725,9,136716
10101,19,19,457,1244588,19,1244569
10102,15,8,344,900697,15,900682
10103,12,1,349,682654,12,682642
10104,10,-5,953,488728,10,488718
10105,8,0,502,636242,8,636234
10106,19,-2,107,585941,19,585922
10107,18,7,487,870656,18,870638
10108,18,-9,323,368962,18,368944
10109,7,8,897,894657,7,894650
10110,18,13,152,1054316,18,1054298
10111,9,-11,792,298121,9,298112
10112,8,-14,1,186439,8,186431
10113,11,-10,192,336494,11,336483
10114,6,-7,186,409829,6,409823
10115,15,-10,118,335972,15,335957
10116,12,-17,435,118687,12,118675
10117,19,-11,307,306207,19,306188
10118,15,-4,73,522597,15,522582
10119,20,-15,225,179366,20,179346
10120,17,-16,278,149033,17,149016
10121,16,9,294,931061,16,931045
10122,8,5,737,797021,8,797013
10123,20,-17,887,122097,20,122077
10124,10,-16,710,139245,10,139235
10125,8,18,632,1200136,8,1200128
10126,17,5,260,805740,17,805723
10127,11,-11,977,311372,11,311361
10128,9,0,483,635849,9,635840
10129,9,-18,735,78249,9,78240
10130,7,4,836,768924,7,768917
10131,8,16,350,1132577,8,1132569
10132,20,-15,648,182613,20,182593
10133,19,-16,303,149165,19,149146
10134,9,-14,866,205336,9,205327
10135,8,5,433,790515,8,790507
10136,16,5,890,810238,16,810222
10137,6,1,63,658332,6,658326
10138,19,-17,926,122335,19,122316
10139,10,-7,640,419403,10,419393
10140,8,-12,323,256665,8,256657
10141,8,-1,455,603955,8,603947
10142,16,-9,754,372419,16,372403
10143,11,13,683,1058369,11,1058358
10144,7,11,88,970306,7,970299
10145,6,-9,596,356959,6,356953
10146,11,18,58,1209380,11,1209369
10147,11,15,31,1117007,11,1116996
10148,18,1,185,681350,18,681332
10149,11,-15,109,178583,11,178572
10150,12,7,370,869678,12,869666
10151,20,11,841,996962,20,996942
10152,5,-17,161,96792,5,96787
10153,13,7,786,872677,13,872664
10154,6,17,549,1167010,6,1167004
10155,18,-17,959,122543,18,122525
10156,8,-11,37,281829,8,281821
10157,18,-16,459,150435,18,150417
10158,10,13,442,1040289,10,1040279
10159,13,-10,360,337633,13,337620
10160,15,17,640,1182616,15,1182601
10161,20,-10,328,337391,20,337371
10162,17,17,29,1178074,17,1178057
10163,9,18,980,1207571,9,1207562
10164,16,-9,734,372169,16,372153
10165,5,-2,185,566682,5,566677
10166,6,2,631,702022,6,702016
10167,8,-18,928,82640,8,82632
10168,14,0,680,653474,14,653460
10169,16,-6,140,460155,16,460139
10170,19,-11,847,310322,19,310303
10171,6,-5,585,480717,6,480711
10172,7,11,736,984141,7,984134
10173,20,13,5,1053285,20,1053265
10174,10,-1,212,598311,10,598301
10175,6,2,595,701091,6,701085
10176,6,3,342,726346,6,726340
10177,14,19,496,1244839,14,1244825
10178,14,-6,657,464145,14,464131
10179,11,-17,487,119102,11,119091
10180,15,-10,732,340581,15,340566
10181,13,-10,656,340004,13,339991
10182,12,15,449,1119974,12,1119962
10183,18,-7,809,434182,18,434164
10184,6,-15,332,162624,6,162618
10185,11,19,933,1248256,11,1248245
10186,19,0,481,651775,19,651756
10187,15,18,813,1214847,15,1214832
10188,10,-14,900,206037,10,206027
10189,20,3,442,745159,20,745139
10190,19,-17,802,121571,19,121552
10191,20,-16,536,150923,20,150903
10192,14,-6,13,459232,14,459218
10193,18,10,572,964290,18,964272
10194,18,9,630,933752,18,933734
10195,7,19,517,1229260,7,1229253
10196,18,-20,239,24607,18,24589
10197,14,-15,964,185114,14,185100
10198,19,-3,178,555031,19,555012
10199,5,-7,44,407001,5,406996
10200,19,11,140,991836,19,991817
10201,15,18,227,1210804,15,1210789
10202,15,-6,821,465414,15,465399
10203,13,10,428,963106,13,963093
10204,12,16,119,1147893,12,1147881
10205,7,-2,641,576344,7,576337
10206,20,2,477,714244,20,714224
10207,6,7,199,848970,6,848964
10208,13,-17,820,121628,13,121615
10209,14,-8,601,402046,14,402032
10210,17,5,107,804574,17,804557
10211,20,10,206,961387,20,961367
10212,15,-13,534,244969,15,244954
10213,9,-12,679,264210,9,264201
10214,15,-20,55,23191,15,23176
10215,18,7,814,872890,18,872872
10216,15,-15,651,182652,15,182637
10217,14,-17,154,116612,14,116598
10218,14,-8,327,400198,14,400184
10219,5,-1,327,601148,5,601143
10220,14,-11,872,310539,14,310525
10221,11,18,717,1214068,11,1214057
10222,13,12,255,1023965,13,1023952
10223,10,14,925,1082428,10,1082418
10224,12,-13,784,246884,12,246872
10225,17,9,40,929342,17,929325
10226,7,-8,654,389391,7,389384
10227,5,-9,22,344112,5,344107
10228,8,0,543,637029,8,637021
10229,10,11,811,985860,10,985850
10230,19,19,724,1246675,19,1246656
10231,13,-14,793,215714,13,215701
10232,19,-16,402,149839,19,149820
10233,9,1,107,659399,9,659390
10234,10,16,480,1135497,10,1135487
10235,13,-1,430,619976,13,619963
10236,13,-5,778,496639,13,496626
10237,18,17,20,1177997,18,1177979
10238,19,-4,490,525753,19,525734
10239,20,9,503,932732,20,932712
10240,18,15,404,1119672,18,1119654
10241,11,11,406,993862,11,993851
10242,16,2,190,711998,16,711982
10243,9,-4,615,512669,9,512660
10244,12,2,28,710667,12,710655
10245,11,8,276,900133,11,900122
10246,7,-6,300,443339,7,443332
10247,20,6,341,838442,20,838422
10248,13,11,668,995575,13,995562
10249,14,1,758,685750,14,685736
10250,12,3,115,742690,12,742678
10251,15,-20,394,25797,15,25782
10252,9,5,422,790229,9,790220
10253,11,-17,689,120666,11,120655
10254,17,-14,326,211936,17,211919
10255,11,10,849,966320,11,966309
10256,11,3,322,744344,11,744333
10257,17,-4,128,523030,17,523013
10258,13,-14,921,216690,13,216677
10259,13,-14,109,210165,13,210152
10260,6,7,731,860258,6,860252
10261,12,14,376,1088369,12,1088357
10262,15,-13,910,247857,15,247842
10263,19,13,653,1058181,19,1058162
10264,6,-17,89,95376,6,95370
10265,17,17,426,1181075,17,1181058
10266,8,11,964,989043,8,989035
10267,12,5,19,803894,12,803882
10268,12,-6,778,465098,12,465086
10269,5,8,306,881933,5,881928
10270,15,16,324,1149458,15,1149443
10271,13,-20,947,29974,13,29961
10272,10,1,152,660526,10,660516
10273,19,-19,612,58802,19,58783
10274,17,-7,588,432740,17,432723
10275,12,-2,637,589894,12,589882
10276,13,19,411,1244172,13,1244159
10277,18,-20,751,28593,18,28575
10278,10,-2,996,584048,10,584038
10279,12,-9,654,371676,12,371664
10280,20,19,800,1247236,20,1247216
10281,10,14,469,1072249,10,1072239
10282,17,6,449,839349,17,839332
10283,12,6,651,841000,12,840988
10284,10,3,26,719384,10,719374
10285,15,17,737,1183370,15,1183355
10286,20,-1,611,621315,20,621295
10287,16,8,765,903998,16,903982
10288,8,12,906,1019080,8,1019072
10289,8,-19,106,33796,8,33788
10290,12,-17,209,116992,12,116980
10291,7,6,657,827114,7,827107
10292,13,-1,296,618887,13,618874
10293,6,0,894,644757,6,644751
10294,6,4,691,765464,6,765458
10295,13,-13,427,244138,13,244125
10296,17,-19,171,55388,17,55371
10297,6,-11,704,296404,6,296398
10298,10,-13,182,222243,10,222233
10299,8,-13,714,233592,8,233584
10300,6,-10,339,319920,6,319914
10301,6,3,676,733412,6,733406
10302,7,0,331,632338,7,632331
10303,12,-15,778,183583,12,183571
10304,20,-14,108,210162,20,210142
10305,14,7,406,870040,14,870026
10306,19,7,79,867589,19,867570
10307,16,-2,258,587057,16,587041
10308,8,7,79,846515,8,846507
10309,17,8,379,900928,17,900911
10310,11,-8,486,401204,11,401193
10311,15,-5,340,493660,15,493645
10312,14,-11,61,304151,14,304137
10313,15,-14,559,213818,15,213803
10314,5,14,204,1066206,5,1066201
10315,19,-14,951,216868,19,216849
10316,18,4,543,777196,18,777178
10317,19,18,649,1213643,19,1213624
10318,16,-15,573,182016,16,182000
10319,19,8,130,898951,19,898932
10320,14,-18,926,91936,14,91922
10321,17,5,43,804097,17,804080
10322,11,4,684,778262,11,778251
10323,20,0,677,653447,20,653427
10324,6,9,207,911151,6,911145
10325,14,-7,488,431982,14,431968
10326,11,1,316,682355,11,682344
10327,18,-8,445,400944,18,400926
10328,13,18,82,1209581,13,1209568
10329,6,18,755,1202610,6,1202604
10330,18,17,133,1178846,18,1178828
10331,17,4,565,777349,17,777332
10332,19,-10,530,338979,19,338960
10333,8,1,55,658259,8,658251
10334,20,-4,58,522482,20,522462
10335,6,-19,571,44022,6,44016
10336,10,8,651,889430,10,889420
10337,9,14,352,1069515,9,1069506
10338,10,0,436,634730,10,634720
10339,17,-1,308,619034,17,619017
10340,10,-12,814,267189,10,267179
10341,6,-15,264,161009,6,161003
10342,18,1,817,686199,18,686181
10343,8,9,253,912011,8,912003
10344,17,-20,311,25275,17,25258
10345,17,11,241,992555,17,992538
10346,6,19,174,1221371,6,1221365
10347,17,5,612,808295,17,808278
10348,9,-5,900,487601,9,487592
10349,11,7,642,871717,11,871706
10350,14,-18,531,89157,14,89143
10351,10,14,393,1070451,10,1070441
10352,12,7,988,874033,12,874021
10353,8,-13,508,229088,8,229080
10354,7,6,593,825689,7,825682
10355,9,-16,242,129356,9,129347
10356,19,-8,663,402597,19,402578
10357,12,-5,686,496018,12,496006
10358,13,9,672,934005,13,933992
10359,5,-17,626,106965,5,106960
10360,20,17,843,1184335,20,1184315
10361,14,5,862,810043,14,810029
10362,7,-1,627,607438,7,607431
10363,12,16,218,1148687,12,1148675
10364,16,5,954,810813,16,810797
10365,8,18,679,1200977,8,1200969
10366,11,0,647,653155,11,653144
10367,10,-15,261,160951,10,160941
10368,6,-9,909,364068,6,364062
10369,20,7,815,872909,20,872889
10370,9,-10,783,329310,9,329301
10371,5,-3,396,539124,5,539119
10372,11,6,196,837202,11,837191
10373,6,-20,949,20886,6,20880
10374,20,18,638,1213564,20,1213544
10375,11,-3,120,554663,11,554652
10376,19,15,394,1119643,19,1119624
10377,9,-5,82,469760,9,469751
10378,9,-10,20,313002,9,312993
10379,12,-5,326,493546,12,493534
10380,18,15,993,1124094,18,1124076
10381,15,5,670,808657,15,808642
10382,5,13,253,1035975,5,1035970
10383,10,4,511,761589,10,761579
10384,15,-2,446,588475,15,588460
10385,14,14,784,1091633,14,1091619
10386,12,15,823,1122805,12,1122793
10387,14,4,901,779923,14,779909
10388,11,-11,434,307244,11,307233
10389,5,17,303,1161816,5,1161811
10390,8,7,356,852511,8,852503
10391,9,-14,991,208107,9,208098
10392,8,18,480,1197011,8,1197003
10393,7,-8,50,376450,7,376443
10394,17,10,761,965675,17,965658
10395,12,19,830,1247476,12,1247464
10396,12,-6,215,460814,12,460802
10397,8,8,174,878872,8,878864
10398,16,-1,205,618145,16,618129
10399,10,-17,400,101953,10,101943
10400,9,-3,159,533797,9,533788
10401,13,1,836,686301,13,686288
10402,17,5,582,808035,17,808018
10403,6,13,765,1047191,6,1047185
10404,5,-9,478,354345,5,354340
10405,13,-11,929,310941,13,310928
10406,5,9,88,908563,5,908558
10407,20,6,615,840720,20,840700
10408,10,18,743,1202329,10,1202319
10409,5,15,58,1095734,5,1095729
10410,15,5,636,808446,15,808431
10411,8,-3,813,548604,8,548596
10412,17,-13,240,242818,17,242801
10413,18,17,604,1182357,18,1182339
10414,9,7,409,853626,9,853617
10415,16,5,447,807055,16,807039
10416,15,0,990,655835,15,655820
10417,11,-19,113,54881,11,54870
10418,10,15,712,1109621,10,1109611
10419,17,8,19,898052,17,898035
10420,18,6,961,843385,18,843367
10421,5,-5,790,484937,5,484932
10422,6,-12,202,253791,6,253785
10423,19,-20,249,24674,19,24655
10424,8,11,921,988403,8,988395
10425,19,19,685,1246324,19,1246305
10426,12,4,272,775164,12,775152
10427,6,1,140,660255,6,660249
10428,8,-17,385,101725,8,101717
10429,13,18,913,1215610,13,1215597
10430,10,-5,388,476497,10,476487
10431,19,-7,272,430334,19,430315
10432,15,7,334,869461,15,869446
10433,15,-19,2,53897,15,53882
10434,7,10,418,946456,7,946449
10435,13,-12,849,278811,13,278798
10436,7,-2,688,577466,7,577459
10437,5,14,533,1073711,5,1073706
10438,7,11,342,975741,7,975734
10439,13,3,178,743189,13,743176
10440,15,9,728,934391,15,934376
10441,11,-8,671,402654,11,402643
10442,17,-7,547,432454,17,432437
10443,7,-17,932,113119,7,113112
10444,15,-14,390,212615,15,212600
10445,5,-7,254,411169,5,411164
10446,20,-2,113,585982,20,585962
10447,9,19,394,1226440,9,1226431
10448,16,-3,706,559406,16,559390
10449,8,-2,33,563492,8,563484
10450,12,17,683,1182923,12,1182911
10451,12,-4,727,527525,12,527513
10452,14,8,894,904896,14,904882
10453,15,-17,408,118436,15,118421
10454,8,-2,276,568728,8,568720
10455,16,-3,189,555118,16,555102
10456,13,-15,67,178253,13,178240
10457,18,-11,865,310500,18,310482
10458,14,15,218,1118450,14,1118436
10459,13,17,836,1184230,13,1184217
10460,15,-19,801,60189,15,60174
10461,14,1,784,685961,14,685947
10462,16,4,510,776923,16,776907
10463,5,8,195,879374,5,879369
10464,9,-7,827,423277,9,423268
10465,11,4,361,775833,11,775822
10466,14,-6,161,460356,14,460342
10467,17,15,482,1120216,17,1120199
10468,9,-18,579,74901,9,74892
10469,9,-2,186,566717,9,566708
10470,15,0,788,654236,15,654221
10471,13,-13,662,245839,13,245826
10472,20,-20,777,28805,20,28785
10473,20,-2,715,590527,20,590507
10474,8,-19,454,41255,8,41247
10475,20,-8,906,404342,20,404322
10476,9,19,372,1225913,9,1225904
10477,11,-16,694,152005,11,151994
10478,15,0,743,653988,15,653973
10479,20,8,563,902347,20,902327
10480,15,-16,362,149552,15,149537
10481,8,5,554,793091,8,793083
10482,5,7,389,853196,5,853191
10483,16,6,790,842090,16,842074
10484,13,-12,693,277596,13,277583
10485,8,14,267,1067716,8,1067708
10486,14,-17,47,115900,14,115886
10487,7,5,152,784696,7,784689
10488,13,-3,235,555412,13,555399
10489,8,-16,664,138310,8,138302
10490,9,-11,617,294809,9,294800
10491,15,12,644,1026880,15,1026865
10492,20,-16,26,146936,20,146916
10493,11,-1,622,621373,11,621362
10494,5,18,319,1193651,5,1193646
10495,8,4,193,754755,8,754747
10496,7,-12,995,271327,7,271320
10497,7,-2,424,571784,7,571777
10498,17,7,177,868283,17,868266
10499,16,-12,362,275243,16,275227
10500,7,12,485,1009532,7,1009525
10501,11,-16,535,150908,11,150897
10502,10,5,488,791732,10,791722
10503,19,-3,123,554676,19,554657
10504,11,9,927,935985,11,935974
10505,12,0,358,650736,12,650724
10506,8,4,739,766722,8,766714
10507,8,-2,781,579374,8,579366
10508,17,-11,932,310970,17,310953
10509,10,-1,858,612269,10,612259
10510,14,-1,824,622873,14,622859
10511,10,7,211,849223,10,849213
10512,9,-16,10,124019,9,124010
10513,14,19,546,1245267,14,1245253
10514,14,-3,728,559566,14,559552
10515,5,-18,671,76791,5,76786
10516,18,-13,748,246558,18,246540
10517,6,5,323,788252,6,788246
10518,11,-20,513,26687,11,26676
10519,6,16,915,1144231,6,1144225
10520,14,14,684,1090845,14,1090831
10521,18,11,160,991979,18,991961
10522,10,18,149,1190108,10,1190098
10523,20,-19,550,58291,20,58271
10524,12,-20,303,25160,12,25148
10525,8,15,412,1103039,8,1103031
10526,17,-14,913,216647,17,216630
10527,15,5,268,805806,15,805791
10528,17,-13,320,243448,17,243431
10529,18,0,117,649148,18,649130
10530,14,0,158,649418,14,649404
10531,9,5,523,792495,9,792486
10532,11,-12,360,275224,11,275213
10533,14,-17,570,119794,14,119780
10534,6,-3,768,547638,6,547632
10535,20,-8,500,401321,20,401301
10536,17,3,785,747747,17,747730
10537,14,15,345,1119329,14,1119315
10538,12,-12,434,275638,12,275626
10539,7,7,759,860803,7,860796
10540,19,-4,495,525805,19,525786
10541,7,-10,236,317685,7,317678
10542,13,-16,902,153559,13,153546
10543,20,1,438,683268,20,683248
10544,7,-13,457,227880,7,227873
10545,14,4,443,776432,14,776418
10546,15,-8,565,401852,15,401837
10547,15,-6,638,464045,15,464030
10548,8,-3,216,535021,8,535013
10549,15,-18,236,87175,15,87160
10550,16,-9,208,368011,16,367995
10551,16,19,71,1241333,16,1241317
10552,10,3,575,731054,10,731044
10553,19,-17,297,117734,19,117715
10554,11,6,560,840265,11,840254
10555,19,10,767,965749,19,965730
10556,17,10,363,962554,17,962537
10557,17,-7,843,434458,17,434441
10558,7,-15,735,171216,7,171209
10559,14,1,654,685012,14,684998
10560,12,-8,503,401341,12,401329
10561,5,-17,101,95633,5,95628
10562,15,14,993,1093259,15,1093244
10563,13,-19,726,59640,13,59627
10564,12,-10,52,335540,12,335528
10565,17,11,274,992817,17,992800
10566,15,-17,107,116365,15,116350
10567,20,10,318,962259,20,962239
10568,19,-13,911,247875,19,247856
10569,20,-17,43,115875,20,115855
10570,11,-11,857,310438,11,310427
10571,5,-8,410,383907,5,383902
10572,20,11,384,993677,20,993657
10573,9,7,495,855441,9,855432
10574,10,-13,68,219803,10,219793
10575,19,8,401,901159,19,901140
10576,15,-10,338,337504,15,337489
10577,14,-17,430,118631,14,118617
10578,14,19,809,1247338,14,1247324
10579,11,-12,565,276691,11,276680
10580,9,14,572,1074531,9,1074522
10581,12,3,462,745287,12,745275
10582,20,19,247,1242692,20,1242672
10583,11,-17,513,119359,11,119348
10584,5,8,498,886096,5,886091
10585,18,0,31,648470,18,648452
10586,5,15,308,1101088,5,1101083
10587,12,-11,588,308418,12,308406
10588,13,9,967,936323,13,936310
10589,16,15,870,1123143,16,1123127
10590,17,-12,868,279006,17,278989
10591,6,2,623,701775,6,701769
10592,7,18,408,1195409,7,1195402
10593,9,-14,191,190586,9,190577
10594,16,-16,841,153049,16,153033
10595,14,-1,792,622655,14,622641
10596,9,-12,538,261275,9,261266
10597,12,-9,814,372995,12,372983
10598,14,5,707,808955,14,808941
10599,14,-3,531,558032,14,558018
10600,17,9,491,932637,17,932620
10601,18,-11,68,304228,18,304210
10602,6,-20,390,8456,6,8450
10603,14,-5,524,494925,14,494911
10604,12,19,736,1246767,12,1246755
10605,10,15,784,1111086,10,1111076
10606,9,18,885,1205441,9,1205432
10607,6,15,197,1098672,6,1098666
10608,8,-3,95,532399,8,532391
10609,15,-19,134,55089,15,55074
10610,20,16,251,1148902,20,1148882
10611,14,11,116,991667,14,991653
10612,11,15,474,1120119,11,1120108
10613,20,2,438,713909,20,713889
10614,18,6,582,840487,18,840469
10615,8,-4,924,519182,8,519174
10616,15,-18,414,88386,15,88371
10617,10,15,980,1115341,10,1115331
10618,6,-9,701,359040,6,359034
10619,18,-6,456,462637,18,462619
10620,15,-7,828,434298,15,434283
10621,8,-15,572,167756,8,167748
10622,18,11,361,993483,18,993465
10623,16,11,57,991302,16,991286
10624,7,-4,80,501105,7,501098
10625,5,-4,350,507214,5,507209
10626,14,19,694,1246404,14,1246390
10627,13,0,954,655536,13,655523
10628,15,-3,370,556520,15,556505
10629,15,7,744,872418,15,872403
10630,14,-17,680,120604,14,120590
10631,18,-16,777,152617,18,152599
10632,7,-5,339,475596,7,475589
10633,11,-3,875,560776,11,560765
10634,6,-5,636,481741,6,481735
10635,5,18,854,1204832,5,1204827
10636,8,12,168,1002810,8,1002802
10637,5,-10,105,314819,5,314814
10638,5,14,507,1073114,5,1073109
10639,10,-10,884,331573,10,331563
10640,13,3,502,745564,13,745551
10641,9,16,76,1126757,9,1126748
10642,12,15,675,1121721,12,1121709
10643,16,13,911,1059964,16,1059948
10644,18,19,604,1245670,18,1245652
10645,9,-16,770,140577,9,140568
10646,15,-6,545,463391,15,463376
10647,15,19,796,1247207,15,1247192
10648,9,3,361,726670,9,726661
10649,7,-13,895,237671,7,237664
10650,8,-4,882,518348,8,518340
10651,9,-8,548,386942,9,386933
10652,12,17,918,1184817,12,1184805
10653,16,-10,931,342067,16,342051
10654,6,-16,613,137342,6,137336
10655,18,-16,172,148152,18,148134
10656,5,-7,295,412228,5,412223
10657,8,-1,481,604610,8,604602
10658,17,-4,900,528840,17,528823
10659,6,10,888,956559,6,956553
10660,15,15,799,1122635,15,1122620
10661,18,11,913,997499,18,997481
10662,19,11,746,996188,19,996169
10663,14,7,376,869762,14,869748
10664,10,-2,726,578277,10,578267
10665,9,-6,444,446191,9,446182
10666,11,-18,474,88815,11,88804
10667,10,-2,601,575559,10,575549
10668,20,12,159,1023214,20,1023194
10669,19,10,632,964780,19,964761
10670,17,8,710,903597,17,903580
10671,18,12,791,1027943,18,1027925
10672,10,17,911,1174901,10,1174891
10673,17,1,747,685682,17,685665
10674,11,-7,768,433894,11,433883
10675,10,0,622,638842,10,638832
10676,7,-4,583,511990,7,511983
10677,8,8,435,884695,8,884687
10678,10,-16,314,130773,10,130763
10679,15,-6,635,464013,15,463998
10680,10,12,917,1019286,10,1019276
10681,16,6,913,843072,16,843056
10682,7,5,57,782866,7,782859
10683,11,-2,816,591276,11,591265
10684,10,19,982,1239215,10,1239205
10685,11,17,798,1183913,11,1183902
10686,17,-4,534,526141,17,526124
10687,7,-5,542,479751,7,479744
10688,5,-11,264,286843,5,286838
10689,18,-1,751,622347,18,622329
10690,11,-4,808,528033,11,528022
10691,14,-6,227,460912,14,460898
10692,8,-11,155,284544,8,284536
10693,9,11,595,981245,9,981236
10694,13,-11,13,303787,13,303774
10695,6,12,464,1009071,6,1009065
10696,6,-13,100,220618,6,220612
10697,7,8,867,893991,7,893984
10698,14,3,285,744055,14,744041
10699,18,-11,839,310258,18,310240
10700,12,3,669,746883,12,746871
10701,5,-16,483,134603,5,134598
10702,5,0,75,626871,5,626866
10703,11,12,720,1027437,11,1027426
10704,15,9,156,930213,15,930198
10705,8,17,914,1174946,8,1174938
10706,14,4,83,773841,14,773827
10707,13,-10,612,339649,13,339636
10708,11,3,67,742311,11,742300
10709,19,10,70,960369,19,960350
10710,6,7,293,851069,6,851063
10711,14,-3,146,554807,14,554793
10712,17,-7,933,435223,17,435206
10713,12,2,951,717571,12,717559
10714,15,1,328,682511,15,682496
10715,20,-19,234,55875,20,55855
10716,5,12,847,1017591,5,1017586
10717,18,-13,482,244529,18,244511
10718,17,-12,558,276635,17,276618
10719,16,-20,241,24620,16,24604
10720,13,2,692,715846,13,715833
10721,5,11,961,988963,5,988958
10722,13,1,883,686665,13,686652
10723,15,12,242,1023836,15,1023821
10724,6,-9,137,346469,6,346463
10725,6,-15,149,158634,6,158628
10726,11,12,643,1026871,11,1026860
10727,17,-11,111,304566,17,304549
10728,13,-13,882,247631,13,247618
10729,19,3,147,742925,19,742906
10730,5,-8,818,392892,5,392887
10731,18,-4,758,527681,18,527663
10732,7,-7,927,425638,7,425631
10733,10,6,443,822434,10,822424
10734,8,12,137,1002086,8,1002078
10735,13,-13,434,244200,13,244187
10736,6,11,72,970001,6,969995
10737,15,0,756,654072,15,654057
10738,19,-15,930,184852,19,184833
10739,10,2,549,700241,10,700231
10740,8,19,504,1228963,8,1228955
10741,13,7,858,873181,13,873168
10742,5,-8,714,390697,5,390692
10743,10,18,84,1188581,10,1188571
10744,20,17,771,1183577,20,1183557
10745,15,-11,959,311230,15,311215
10746,12,-17,199,116925,12,116913
10747,5,18,826,1204201,5,1204196
10748,12,12,559,1026137,12,1026125
10749,16,-14,620,214385,16,214369
10750,14,-7,609,432794,14,432780
10751,15,-9,248,368411,15,368396
10752,5,-6,436,446080,5,446075
10753,9,16,924,1144438,9,1144429
10754,17,-5,937,497919,17,497902
10755,10,16,878,1143322,10,1143312
10756,8,15,989,1115509,8,1115501
10757,6,-16,801,141205,6,141199
10758,16,-15,591,182122,16,182106
10759,7,16,605,1137859,7,1137852
10760,6,-5,527,479478,6,479472
10761,17,-9,32,366840,17,366823
10762,20,13,825,1059423,20,1059403
10763,18,1,998,687549,18,687531
10764,20,-13,396,243930,20,243910
10765,9,-11,302,287766,9,287757
10766,14,18,957,1216003,14,1215989
10767,16,9,672,934011,16,933995
10768,12,12,354,1024676,12,1024664
10769,9,-18,467,72487,9,72478
10770,5,2,616,701640,5,701635
10771,9,11,523,979657,9,979648
10772,7,-14,435,196184,7,196177
10773,10,-11,452,291232,10,291222
10774,15,0,382,650986,15,650971
10775,9,6,491,823510,9,823501
10776,5,0,869,644201,5,644196
10777,12,-5,580,495334,12,495322
10778,10,-13,983,239613,10,239603
10779,9,-19,361,39310,9,39301
10780,10,8,780,892408,10,892398
10781,6,18,859,1204881,6,1204875
10782,13,12,786,1027912,13,1027899
10783,16,-20,421,25953,16,25937
10784,20,16,807,1152921,20,1152901
10785,12,1,7,679795,12,679783
10786,8,-2,324,569696,8,569688
10787,13,19,123,1241782,13,1241769
10788,6,-16,520,135361,6,135355
10789,9,-20,587,12795,9,12786
10790,10,0,289,631528,10,631518
10791,17,17,166,1179117,17,1179100
10792,15,2,730,716087,15,716072
10793,6,-7,284,411940,6,411934
10794,8,4,786,767764,8,767756
10795,15,7,473,870539,15,870524
10796,14,-9,519,370784,14,370770
10797,17,-17,312,117833,17,117816
10798,18,-11,216,305412,18,305394
10799,13,10,749,965619,13,965606
10800,6,-13,652,232194,6,232188
10801,15,-6,326,461695,15,461680
10802,17,9,501,932709,17,932692
10803,13,4,75,773792,13,773779
10804,15,-5,256,492925,15,492910
10805,14,10,951,967146,14,967132
10806,5,14,352,1069520,5,1069515
10807,7,-19,400,40220,7,40213
10808,19,15,502,1120360,19,1120341
10809,12,-11,38,303925,12,303913
10810,18,5,509,807502,18,807484
10811,18,-13,199,242540,18,242522
10812,17,3,615,746425,17,746408
10813,13,-5,794,496778,13,496765
10814,17,9,476,932469,17,932452
10815,19,-18,926,91945,19,91926
10816,20,-4,940,529109,20,529089
10817,10,15,542,1106009,10,1105999
10818,17,-10,869,341611,17,341594
10819,11,-9,641,371604,11,371593
10820,8,-4,877,518225,8,518217
10821,5,-8,133,378230,5,378225
10822,5,-15,574,167868,5,167863
10823,6,-5,424,477150,6,477144
10824,15,11,513,994559,15,994544
10825,9,18,783,1203285,9,1203276
10826,14,15,867,1123122,14,1123108
10827,19,2,363,713345,19,713326
10828,7,-10,23,313056,7,313049
10829,20,7,764,872537,20,872517
10830,12,-1,286,618836,12,618824
10831,18,-6,358,461911,18,461893
10832,19,-19,615,58831,19,58812
10833,5,-11,201,285488,5,285483
10834,16,2,95,711307,16,711291
10835,15,18,127,1209940,15,1209925
10836,19,16,48,1147427,19,1147408
10837,6,11,413,977312,6,977306
10838,17,-8,936,404496,17,404479
10839,15,9,605,933526,15,933511
10840,16,-19,577,58583,16,58567
10841,10,3,619,732065,10,732055
10842,5,-17,341,100805,5,100800
10843,9,-14,398,195523,9,195514
10844,16,12,84,1022688,16,1022672
10845,12,1,149,681016,12,681004
10846,9,7,707,859745,9,859736
10847,20,-3,538,558075,20,558055
10848,8,6,229,817347,8,817339
10849,20,4,50,773610,20,773590
10850,12,16,213,1148665,12,1148653
10851,19,11,205,992284,19,992265
10852,18,-6,885,465816,18,465798
10853,13,0,91,648907,13,648894
10854,14,-19,715,59564,14,59550
10855,5,4,406,759405,5,759400
10856,19,0,470,651674,19,651655
10857,16,18,48,1209284,16,1209268
10858,12,4,493,776771,12,776759
10859,5,1,183,661149,5,661144
10860,10,-3,963,552076,10,552066
10861,16,-17,796,121508,16,121492
10862,10,16,592,1137618,10,1137608
10863,17,-4,416,525347,17,525330
10864,11,-2,593,589585,11,589574
10865,17,11,459,994191,17,994174
10866,16,16,156,1148188,16,1148172
10867,8,-9,462,353828,8,353820
10868,16,5,818,809753,16,809737
10869,10,-17,144,96448,10,96438
10870,10,17,784,1171994,10,1171984
10871,17,-16,910,153643,17,153626
10872,9,-12,806,266951,9,266942
10873,16,9,880,935617,16,935601
10874,17,16,487,1150588,17,1150571
10875,9,4,389,759012,9,759003
10876,11,-8,372,400503,11,400492
10877,16,-6,689,464411,16,464395
10878,12,-18,346,87930,12,87918
10879,20,-2,453,588566,20,588546
10880,12,6,673,841159,12,841147
10881,13,13,560,1057456,13,1057443
10882,7,-2,10,562950,7,562943
10883,19,-12,48,272817,19,272798
10884,19,-9,190,367894,19,367875
10885,14,10,621,964703,14,964689
10886,20,-5,729,496387,20,496367
10887,12,4,563,777333,12,777321
10888,8,0,528,636735,8,636727
10889,19,-8,307,400037,19,400018
10890,6,-14,527,197972,6,197966
10891,5,-15,810,172713,5,172708
10892,12,10,253,961723,12,961711
10893,20,-18,231,87125,20,87105
10894,20,7,564,871170,20,871150
10895,14,-7,658,433065,14,433051
10896,17,6,678,841208,17,841191
10897,16,-16,483,150579,16,150563
10898,12,7,474,870551,12,870539
10899,6,14,630,1075980,6,1075974
10900,11,-8,436,400899,11,400888
10901,9,1,626,670899,9,670890
10902,11,3,967,749261,11,749250
10903,19,-1,26,616715,19,616696
10904,10,-13,609,231416,10,231406
10905,15,-5,491,494658,15,494643
10906,8,-17,577,105976,8,105968
10907,11,4,174,774546,11,774535
10908,15,-9,873,373490,15,373475
10909,20,16,362,1149750,20,1149730
10910,19,-14,476,213187,19,213168
10911,8,5,215,786154,8,786146
10912,16,-1,421,619904,16,619888
10913,8,14,322,1068947,8,1068939
10914,16,-3,621,558745,16,558729
10915,16,15,575,1120963,16,1120947
10916,10,3,461,728694,10,728684
10917,11,-9,623,371478,11,371467
10918,12,-9,641,371606,12,371594
10919,12,14,751,1091332,12,1091320
10920,12,7,251,868826,12,868814
10921,16,5,686,808800,16,808784
10922,8,-1,692,608764,8,608756
10923,9,16,387,1133370,9,1133361
10924,12,-10,416,338101,12,338089
10925,18,-12,598,276871,18,276853
10926,15,0,609,652848,15,652833
10927,10,9,357,914280,10,914270
10928,20,1,475,683588,20,683568
10929,7,-12,426,258786,7,258779
10930,16,-12,114,273372,16,273356
10931,17,17,373,1180733,17,1180716
10932,12,10,872,966522,12,966510
10933,17,-2,929,592198,17,592181
10934,12,-1,929,623671,12,623659
10935,17,5,184,805175,17,805158
10936,15,-16,8,146776,15,146761
10937,19,12,164,1023240,19,1023221
10938,11,17,238,1179665,11,1179654
10939,12,-3,149,554823,12,554811
10940,15,6,452,839392,15,839377
10941,6,-3,43,531437,6,531431
10942,19,-7,221,429964,19,429945
10943,11,-16,972,154081,11,154070
10944,18,-14,138,210390,18,210372
10945,8,3,184,722811,8,722803
10946,7,17,158,1158516,7,1158509
10947,15,11,366,993543,15,993528
10948,5,-9,170,347175,5,347170
10949,9,14,545,1073956,9,1073947
10950,7,14,995,1084143,7,1084136
10951,10,18,51,1187787,10,1187777
10952,7,9,861,925043,7,925036
10953,10,12,875,1018291,10,1018281
10954,5,-10,58,313905,5,313900
10955,10,-12,396,258203,10,258193
10956,16,16,180,1148399,16,1148383
10957,19,5,814,809722,19,809703
10958,5,7,760,860868,5,860863
10959,10,-15,226,160172,10,160162
10960,17,10,526,963907,17,963890
10961,11,-11,820,310087,11,310076
10962,15,-2,482,588781,15,588766
10963,7,-14,843,204805,7,204798
10964,12,17,692,1183038,12,1183026
10965,5,14,21,1062245,5,1062240
10966,13,-11,722,309338,13,309325
10967,14,-8,87,398598,14,398584
10968,15,-1,147,617657,15,617642
10969,19,6,595,840596,19,840577
10970,20,1,321,682429,20,682409
10971,6,6,366,820446,6,820440
10972,14,15,5,1116786,14,1116772
10973,7,-3,428,539896,7,539889
10974,15,9,515,932837,15,932822
10975,5,-11,902,300528,5,300523
10976,9,7,726,860105,9,860096
10977,20,9,478,932496,20,932476
10978,11,-18,354,87999,11,87988
10979,19,-4,371,525003,19,524984
10980,13,-6,501,463012,13,462999
10981,9,0,740,641619,9,641610
10982,16,-8,857,403947,16,403931
10983,15,14,287,1087615,15,1087600
10984,19,-5,964,498129,19,498110
10985,14,6,350,838495,14,838481
10986,11,6,993,843695,11,843684
10987,5,1,859,675658,5,675653
10988,7,17,359,1163007,7,1163000
10989,7,18,253,1192374,7,1192367
10990,5,-12,657,263810,5,263805
10991,9,0,441,634856,9,634847
10992,14,5,0,803777,14,803763
10993,12,-10,923,342016,12,342004
10994,14,-18,732,90587,14,90573
10995,6,-15,831,173160,6,173154
10996,13,17,858,1184436,13,1184423
10997,14,9,285,931020,14,931006
10998,12,-1,502,620543,12,620531
10999,19,-9,423,369889,19,369870
11000,9,16,294,1131369,9,1131360
11001,15,19,3,1240664,15,1240649
11002,20,15,728,1122183,20,1122163
11003,13,18,573,1213105,13,1213092
11004,13,10,945,967098,13,967085
11005,7,-12,181,253325,7,253318
11006,17,19,938,1248296,17,1248279
11007,17,-7,208,429865,17,429848
11008,15,6,871,842715,15,842700
11009,13,-14,482,213203,13,213190
11010,14,-8,188,399243,14,399229
11011,9,0,557,637366,9,637357
11012,18,7,287,869072,18,869054
11013,10,1,417,666303,10,666293
11014,8,7,758,860788,8,860780
11015,8,9,211,911246,8,911238
11016,5,-1,759,610110,5,610105
11017,5,-5,227,472989,5,472984
11018,19,2,696,715862,19,715843
11019,15,12,924,1029166,15,1029151
11020,9,-9,768,360729,9,360720
11021,15,-15,131,178786,15,178771
11022,18,-10,586,339419,18,339401
11023,8,3,578,731177,8,731169
11024,17,2,453,714054,17,714037
11025,10,9,878,925362,10,925352
11026,19,-16,540,150978,19,150959
11027,10,-12,954,270394,10,270384
11028,19,-5,318,493462,19,493443
11029,20,-12,493,276151,20,276131
11030,9,-4,609,512516,9,512507
11031,16,17,609,1182392,16,1182376
11032,20,-5,259,492944,20,492924
11033,20,5,964,810930,20,810910
11034,20,3,75,742381,20,742361
11035,20,-7,392,431327,20,431307
11036,20,-11,597,308470,20,308450
11037,20,-11,569,308242,20,308222
11038,14,17,585,1182180,14,1182166
11039,17,-11,495,307694,17,307677
11040,8,0,661,639819,8,639811
11041,14,-2,94,585822,14,585808
11042,18,5,375,806531,18,806513
11043,20,7,382,869838,20,869818
11044,14,2,859,716888,14,716874
11045,9,4,781,767636,9,767627
11046,16,8,321,900478,16,900462
11047,10,18,492,1197247,10,1197237
11048,17,-11,261,305764,17,305747
11049,8,15,62,1095815,8,1095807
11050,9,6,785,829927,9,829918
11051,15,-8,301,399978,15,399963
11052,13,-18,752,90759,13,90746
11053,14,-3,577,558357,14,558343
11054,9,7,696,859532,9,859523
11055,20,-17,867,121928,20,121908
11056,19,14,889,1092404,19,1092385
11057,6,11,739,984213,6,984207
11058,7,6,569,825136,7,825129
11059,14,4,217,774841,14,774827
11060,9,-10,748,328695,9,328686
11061,16,-17,872,121957,16,121941
11062,17,-9,602,371356,17,371339
11063,18,-4,678,527220,18,527202
11064,16,13,120,1054109,16,1054093
11065,15,-10,325,337381,15,337366
11066,12,-13,176,242317,12,242305
11067,18,-16,301,149158,18,149140
11068,16,3,259,743823,16,743807
11069,6,-20,806,17918,6,17912
11070,12,-19,654,59127,12,59115
11071,6,-8,606,388188,6,388182
11072,7,-11,242,286304,7,286297
11073,9,-19,88,33333,9,33324
11074,6,-20,849,18877,6,18871
11075,7,-13,765,234871,7,234864
11076,17,-12,416,275570,17,275553
11077,15,17,780,1183685,15,1183670
11078,5,11,754,984597,5,984592
11079,6,-20,321,7163,6,7157
11080,17,-17,982,122696,17,122679
11081,19,18,323,1211429,19,1211410
11082,20,-4,894,528762,20,528742
11083,14,-5,846,497162,14,497148
11084,7,-14,361,194510,7,194503
11085,19,-11,266,305831,19,305812
11086,20,-1,518,620691,20,620671
11087,13,11,826,996823,13,996810
11088,8,-11,774,297826,8,297818
11089,13,-13,54,241485,13,241472
11090,9,12,262,1004990,9,1004981
11091,5,-16,897,143175,5,143170
11092,17,13,873,1059770,17,1059753
11093,5,10,838,955574,5,955569
11094,14,18,312,1211347,14,1211333
11095,9,-12,939,270005,9,269996
11096,9,-9,593,356926,9,356917
11097,11,8,98,898700,11,898689
11098,19,3,675,746987,19,746968
11099,5,-6,766,453247,5,453242
11100,11,-11,936,310991,11,310980
11101,13,19,578,1245535,13,1245522
11102,13,-14,960,216921,13,216908
11103,14,-1,583,621128,14,621114
11104,19,10,600,964559,19,964540
11105,9,-13,325,225259,9,225250
11106,15,-17,791,121476,15,121461
11107,10,10,233,942442,10,942432
11108,9,-19,215,36318,9,36309
11109,20,16,404,1150042,20,1150022
11110,17,-6,514,463146,17,463129
11111,15,-7,985,435606,15,435591
11112,20,3,743,747456,20,747436
11113,16,18,275,1211159,16,1211143
11114,14,-10,902,341860,14,341846
11115,20,-12,254,274382,20,274362
11116,10,7,263,850423,10,850413
11117,10,-5,325,475345,10,475335
11118,6,-3,840,549171,6,549165
11119,13,-13,859,247445,13,247432
11120,12,16,267,1149041,12,1149029
11121,13,15,805,1122657,13,1122644
11122,9,9,177,910524,9,910515
11123,20,-9,777,372687,20,372667
11124,16,-6,551,463428,16,463412
11125,19,9,399,931910,19,931891
11126,20,-1,434,620002,20,619982
11127,6,-9,633,357580,6,357574
11128,19,-5,871,497397,19,497378
11129,10,-9,354,351401,10,351391
11130,11,16,135,1148045,11,1148034
11131,12,18,145,1210150,12,1210138
11132,16,7,102,867752,16,867736
11133,20,17,278,1180004,20,1179984
11134,20,17,136,1178874,20,1178854
11135,15,0,99,649016,15,649001
11136,6,8,803,892787,6,892781
11137,14,-15,947,185008,14,184994
11138,14,8,724,903720,14,903706
11139,10,-13,469,228164,10,228154
11140,15,-3,769,559963,15,559948
11141,9,12,744,1015302,9,1015293
11142,17,-1,468,620309,17,620292
11143,5,10,375,945463,5,945458
11144,9,4,923,770867,9,770858
11145,10,-20,670,14786,10,14776
11146,13,6,699,841454,13,841441
11147,16,19,393,1243971,16,1243955
11148,20,2,749,716209,20,716189
11149,12,-19,425,57258,12,57246
11150,7,-12,201,253766,7,253759
11151,5,17,420,1164222,5,1164217
11152,10,-8,475,385099,10,385089
11153,10,-8,71,377007,10,376997
11154,16,-2,820,591328,16,591312
11155,15,-14,57,209737,15,209722
11156,18,5,46,804109,18,804091
11157,7,13,54,1031949,7,1031942
11158,11,15,994,1124099,11,1124088
11159,15,-12,687,277550,15,277535
11160,6,-15,598,168274,6,168268
11161,17,-10,745,340705,17,340688
11162,16,13,547,1057355,16,1057339
11163,18,-17,597,120000,18,119982
11164,9,-10,137,315687,9,315678
11165,18,-19,488,57699,18,57681
11166,20,-4,555,526289,20,526269
11167,5,-20,651,14282,5,14277
11168,6,18,134,1189723,6,1189717
11169,10,-7,589,418499,10,418489
11170,14,-10,390,337843,14,337829
11171,17,16,496,1150623,17,1150606
11172,20,12,320,1024458,20,1024438
11173,7,-14,623,200397,7,200390
11174,16,-19,525,58074,16,58058
11175,11,13,158,1054371,11,1054360
11176,7,-13,516,229320,7,229313
11177,9,-1,522,605407,9,605398
11178,14,-2,511,588999,14,588985
11179,20,-14,965,216991,20,216971
11180,5,-17,886,112218,5,112213
11181,20,13,992,1060540,20,1060520
11182,17,-2,449,588518,17,588501
11183,8,14,69,1063386,8,1063378
11184,14,-11,496,307722,14,307708
11185,10,-15,54,156477,10,156467
11186,11,9,764,934606,11,934595
11187,9,6,949,833572,9,833563
11188,19,-10,500,338780,19,338761
11189,9,11,821,985986,9,985977
11190,16,-18,88,85873,16,85857
11191,10,-5,649,482058,10,482048
11192,10,16,989,1145820,10,1145810
11193,9,13,750,1046812,9,1046803
11194,10,-12,734,265290,10,265280
11195,20,-6,615,463848,20,463828
11196,15,-7,503,432110,15,432095
11197,11,-10,659,340023,11,340012
11198,15,15,680,1121767,15,1121752
11199,6,18,410,1195463,6,1195457
11200,20,-18,157,86471,20,86451
11201,18,14,369,1088318,18,1088300
11202,6,18,516,1197843,6,1197837
11203,12,-9,638,371595,12,371583
11204,13,-3,739,559636,13,559623
11205,6,-18,403,71050,6,71044
11206,6,15,111,1096867,6,1096861
11207,20,8,394,901080,20,901060
11208,7,8,267,880971,7,880964
11209,5,17,661,1169492,5,1169487
11210,13,19,755,1246889,13,1246876
11211,18,11,767,996397,18,996379
11212,16,-13,27,241291,16,241275
11213,7,-5,565,480259,7,480252
11214,12,2,153,711737,12,711725
11215,20,12,841,1028393,20,1028373
11216,15,-1,484,620448,15,620433
11217,5,-19,514,42598,5,42593
11218,13,-3,484,557507,13,557494
11219,14,2,529,714595,14,714581
11220,9,3,49,719878,9,719869
11221,6,-17,267,99161,6,99155
11222,20,8,637,903035,20,903015
11223,14,-9,518,370755,14,370741
11224,19,-10,624,339710,19,339691
11225,20,12,528,1025912,20,1025892
11226,18,2,693,715853,18,715835
11227,11,18,435,1212255,11,1212244
11228,16,9,734,934440,16,934424
11229,8,9,257,912054,8,912046
11230,7,11,783,985215,7,985208
11231,5,-10,792,329483,5,329478
11232,6,18,436,1196077,6,1196071
11233,11,-20,427,25981,11,25970
11234,14,-20,832,29254,14,29240
11235,9,-4,472,509624,9,509615
11236,7,1,68,658492,7,658485
11237,16,2,304,712860,16,712844
11238,12,19,20,1240835,12,1240823
11239,13,0,103,649059,13,649046
11240,17,6,187,837154,17,837137
11241,5,5,30,782200,5,782195
11242,8,15,305,1101037,8,1101029
11243,14,3,788,747760,14,747746
11244,14,13,347,1055768,14,1055754
11245,9,15,344,1101864,9,1101855
11246,5,-5,295,474570,5,474565
11247,13,6,116,836655,13,836642
11248,20,18,988,1216215,20,1216195
11249,17,13,326,1055607,17,1055590
11250,8,3,485,729195,8,729187
11251,15,-13,538,245003,15,244988
11252,7,-2,747,578606,7,578599
11253,12,6,402,838990,12,838978
11254,19,13,431,1056444,19,1056425
11255,7,19,134,1220325,7,1220318
11256,17,6,835,842479,17,842462
11257,10,0,875,644282,10,644272
11258,20,17,540,1181892,20,1181872
11259,6,10,557,949387,6,949381
11260,10,-13,272,224248,10,224238
11261,6,2,247,693887,6,693881
11262,7,-6,878,455521,7,455514
11263,6,-6,6,436974,6,436968
11264,8,-9,883,363416,8,363408
11265,10,-11,268,286912,10,286902
11266,6,3,492,729352,6,729346
11267,20,19,103,1241604,20,1241584
11268,17,17,714,1183216,17,1183199
11269,6,-14,407,195695,6,195689
11270,11,12,431,1025214,11,1025203
11271,10,-7,308,412525,10,412515
11272,8,-14,870,205380,8,205372
11273,10,9,838,924602,10,924592
11274,19,-6,537,463323,19,463304
11275,9,13,928,1050591,9,1050582
11276,17,10,119,960822,17,960805
11277,5,-5,160,471545,5,471540
11278,13,8,400,901138,13,901125
11279,11,-16,639,151694,11,151683
11280,17,4,709,778467,17,778450
11281,19,9,766,934636,19,934617
11282,6,9,787,923339,6,923333
11283,14,-9,276,368583,14,368569
11284,16,12,41,1022394,16,1022378
11285,16,13,190,1054602,16,1054586
11286,16,2,918,717299,16,717283
11287,7,-5,1,467747,7,467740
11288,9,2,15,688839,9,688830
11289,20,18,888,1215484,20,1215464
11290,6,-11,696,296321,6,296315
11291,16,13,998,1060625,16,1060609
11292,10,-14,416,195943,10,195933
11293,15,11,853,997038,15,997023
11294,14,-18,9,85292,14,85278
11295,17,-4,173,523388,17,523371
11296,18,11,647,995433,18,995415
11297,11,12,164,1023241,11,1023230
11298,10,-7,315,412687,10,412677
11299,7,-16,260,129680,7,129673
11300,5,5,482,791627,5,791622
11301,5,15,227,1099396,5,1099391
11302,11,-8,963,404729,11,404718
11303,16,1,273,682068,16,682052
11304,20,7,754,872470,20,872450
11305,12,12,164,1023243,12,1023231
11306,10,-1,337,601450,10,601440
11307,7,-8,410,383914,7,383907
11308,13,14,872,1092240,13,1092227
11309,6,15,378,1102476,6,1102470
11310,9,17,370,1163252,9,1163243
11311,11,-3,884,560866,11,560855
11312,15,2,626,715240,15,715225
11313,9,-2,699,577792,9,577783
11314,6,6,252,817841,6,817835
11315,18,-2,212,586690,18,586672
11316,15,-10,178,336406,15,336391
11317,6,-12,591,262256,6,262250
11318,5,14,532,1073669,5,1073664
11319,9,-1,863,612402,9,612393
11320,12,9,483,932593,12,932581
11321,20,-13,936,248120,20,248100
11322,15,13,305,1055442,15,1055427
11323,13,-6,223,460866,13,460853
11324,5,-7,84,407614,5,407609
11325,8,-11,273,287007,8,286999
11326,16,7,314,869301,16,869285
11327,11,-1,237,618442,11,618431
11328,5,-12,515,260809,5,260804
11329,9,0,165,629040,9,629031
11330,8,-7,640,419411,8,419403
11331,5,-20,934,20580,5,20575
11332,8,9,964,927274,8,927266
11333,11,16,652,1151790,11,1151779
11334,12,-16,719,152194,12,152182
11335,12,-17,998,122747,12,122735
11336,9,-4,663,513697,9,513688
11337,16,-5,495,494681,16,494665
11338,12,6,67,836257,12,836245
11339,20,-9,71,367156,20,367136
11340,6,-20,471,10058,6,10052
11341,11,-8,741,403099,11,403088
11342,18,-10,963,342308,18,342290
11343,12,9,582,933345,12,933333
11344,19,-8,529,401564,19,401545
11345,12,-13,871,247531,12,247519
11346,19,-7,450,431719,19,431700
11347,14,-13,763,246682,14,246668
11348,19,-19,349,56722,19,56703
11349,14,14,596,1090031,14,1090017
11350,19,-6,792,465178,19,465159
11351,7,3,10,719030,7,719023
11352,6,-13,376,226228,6,226222
11353,8,0,625,638898,8,638890
11354,17,-1,677,621772,17,621755
11355,9,5,513,792220,9,792211
11356,14,-5,30,491045,14,491031
11357,6,-20,198,4664,6,4658
11358,11,18,7,1208967,11,1208956
11359,17,-15,930,184859,17,184842
11360,17,11,956,997712,17,997695
11361,20,7,513,870828,20,870808
11362,10,2,36,689372,10,689362
11363,19,13,385,1056067,19,1056048
11364,10,-16,790,141010,10,141000
11365,5,-16,765,140491,5,140486
11366,8,0,849,643782,8,643774
11367,20,16,704,1152113,20,1152093
11368,10,-18,121,65117,10,65107
11369,6,12,683,1014126,6,1014120
11370,12,12,933,1029234,12,1029222
11371,10,-6,182,440869,10,440859
11372,20,4,287,775259,20,775239
11373,14,-19,170,55373,14,55359
11374,16,14,495,1089318,16,1089302
11375,10,-10,251,318012,10,318002
11376,17,-6,206,460745,17,460728
11377,15,4,952,780272,15,780257
11378,17,-13,149,242109,17,242092
11379,10,1,452,667030,10,667020
11380,5,-9,33,344338,5,344333
11381,16,-17,757,121264,16,121248
11382,15,-16,87,147520,15,147505
11383,9,-10,835,330520,9,330511
11384,7,16,803,1141908,7,1141901
11385,15,3,742,747436,15,747421
11386,12,6,973,843535,12,843523
11387,14,-6,410,462277,14,462263
11388,8,-7,687,420343,8,420335
11389,13,5,731,809088,13,809075
11390,20,3,801,747887,20,747867
11391,13,-7,207,429849,13,429836
11392,5,11,319,975190,5,975185
11393,16,-13,956,248278,16,248262
11394,10,-17,63,94709,10,94699
11395,9,-7,17,406415,9,406406
11396,18,-1,586,621137,18,621119
11397,14,16,818,1152959,14,1152945
11398,6,-4,814,516729,6,516723
11399,6,7,82,846629,6,846623
11400,20,-14,510,213465,20,213445
11401,14,18,925,1215705,14,1215691
11402,15,2,356,713292,15,713277
11403,16,-19,168,55361,16,55345
11404,6,15,603,1107269,6,1107263
11405,20,10,118,960812,20,960792
11406,9,-1,883,612914,9,612905
11407,18,4,825,779360,18,779342
11408,18,14,125,1086441,18,1086423
11409,12,-18,599,89577,12,89565
11410,8,18,60,1188011,8,1188003
11411,6,14,659,1076708,6,1076702
11412,10,15,226,1099377,10,1099367
11413,9,-18,43,63267,9,63258
11414,7,9,978,927638,7,927631
11415,5,0,219,630225,5,630220
11416,9,2,929,707904,9,707895
11417,6,-1,230,598920,6,598914
11418,13,-9,62,367109,13,367096
11419,14,18,192,1210575,14,1210561
11420,20,-3,538,558085,20,558065
11421,18,2,350,713234,18,713216
11422,16,13,746,1058778,16,1058762
11423,18,-10,463,338488,18,338470
11424,5,11,618,981679,5,981674
11425,10,-14,5,186516,10,186506
11426,16,-2,37,585401,16,585385
11427,14,-20,655,27785,14,27771
11428,13,-16,218,148587,13,148574
11429,16,-2,976,592582,16,592566
11430,12,2,4,710513,12,710501
11431,16,17,26,1178050,16,1178034
11432,10,-4,263,505319,10,505309
11433,16,14,617,1090219,16,1090203
11434,14,-17,627,120173,14,120159
11435,16,-19,562,58414,16,58398
11436,20,-8,305,400022,20,400002
11437,14,6,762,841885,14,841871
11438,10,-6,578,449165,10,449155
11439,15,9,543,933015,15,933000
11440,13,-14,405,212711,13,212698
11441,11,9,79,929625,11,929614
11442,18,9,820,935128,18,935110
11443,20,19,496,1244849,20,1244829
11444,12,8,21,898065,12,898053
11445,17,16,134,1148040,17,1148023
11446,5,-16,981,145097,5,145092
11447,14,-15,86,178445,14,178431
11448,18,-5,926,497821,18,497803
11449,14,10,647,964934,14,964920
11450,5,9,40,907615,5,907610
11451,13,13,35,1053468,13,1053455
11452,5,11,567,980581,5,980576
11453,6,16,495,1135671,6,1135665
11454,13,-14,961,216929,13,216916
11455,12,17,455,1181347,12,1181335
11456,15,14,995,1093283,15,1093268
11457,9,11,262,973793,9,973784
11458,8,13,537,1042206,8,1042198
11459,9,-9,826,361978,9,361969
11460,8,-12,190,253520,8,253512
11461,20,-9,788,372791,20,372771
11462,18,8,629,902956,18,902938
11463,19,-12,51,272859,19,272840
11464,6,-16,156,127385,6,127379
11465,11,-13,483,244529,11,244518
11466,9,-11,643,295349,9,295340
11467,14,12,184,1023385,14,1023371
11468,7,-5,253,473612,7,473605
11469,8,-20,300,6723,8,6715
11470,15,9,466,932404,15,932389
11471,10,-14,478,197014,10,197004
11472,7,19,599,1230948,7,1230941
11473,16,-18,347,87937,16,87921
11474,6,10,39,938343,6,938337
11475,18,-9,135,367553,18,367535
11476,10,-3,812,548571,10,548561
11477,16,8,713,903640,16,903624
11478,7,17,965,1176060,7,1176053
11479,7,17,770,1171598,7,1171591
11480,9,-9,883,363425,9,363416
11481,5,-3,249,535869,5,535864
11482,6,6,645,826809,6,826803
11483,10,-2,280,568764,10,568754
11484,15,-5,846,497167,15,497152
11485,9,8,395,883848,9,883839
11486,17,9,814,935091,17,935074
11487,11,5,195,805291,11,805280
11488,10,4,216,755365,10,755355
11489,6,-9,637,357672,6,357666
11490,9,-1,497,604907,9,604898
11491,11,3,340,744454,11,744443
11492,8,-16,292,130347,8,130339
11493,11,-16,519,150837,11,150826
11494,10,15,286,1100664,10,1100654
11495,20,15,798,1122625,20,1122605
11496,13,-1,674,621738,13,621725
11497,7,2,904,707372,7,707365
11498,14,-8,147,398955,14,398941
11499,12,19,369,1243762,12,1243750
11500,12,7,640,871696,12,871684
11501,19,-1,564,621003,19,620984
11502,7,-9,433,353134,7,353127
11503,19,-7,141,429325,19,429306
11504,16,6,519,840011,16,839995
11505,17,3,952,749109,17,749092
11506,12,-14,616,214363,12,214351
11507,19,-20,625,27525,19,27506
11508,11,-7,810,434188,11,434177
11509,19,-20,686,28090,19,28071
11510,5,-18,763,78970,5,78965
11511,7,-3,305,537034,7,537027
11512,7,-10,824,330272,7,330265
11513,12,1,208,681520,12,681508
11514,8,-18,208,66991,8,66983
11515,19,4,572,777400,19,777381
11516,10,5,185,785510,10,785500
11517,20,-13,225,242693,20,242673
11518,7,-4,987,520716,7,520709
11519,5,11,590,981139,5,981134
11520,15,-6,373,462034,15,462019
11521,20,-2,859,591656,20,591636
11522,18,-20,595,27307,18,27289
11523,8,-17,748,109529,8,109521
11524,11,4,780,778981,11,778970
11525,8,-17,946,113423,8,113415
11526,20,13,6,1053294,20,1053274
11527,12,11,632,995342,12,995330
11528,17,-8,398,400742,17,400725
11529,12,-3,258,555595,12,555583
11530,7,-1,571,606333,7,606326
11531,7,-3,847,549325,7,549318
11532,18,14,636,1090388,18,1090370
11533,12,-7,825,434288,12,434276
11534,10,17,935,1175310,10,1175300
11535,7,-20,358,7872,7,7865
11536,17,5,246,805654,17,805637
11537,11,17,492,1181576,11,1181565
11538,9,-11,107,283431,9,283422
11539,10,-18,740,78379,10,78369
11540,11,17,220,1179483,11,1179472
11541,17,10,657,964990,17,964973
11542,10,3,65,720164,10,720154
11543,10,9,591,919318,10,919308
11544,18,-13,421,244061,18,244043
11545,15,-19,438,57381,15,57366
11546,16,6,702,841478,16,841462
11547,16,0,528,652194,16,652178
11548,12,17,386,1180781,12,1180769
11549,6,-12,482,260002,6,259996
11550,6,15,755,1110597,6,1110591
11551,13,17,836,1184233,13,1184220
11552,10,-12,268,255285,10,255275
11553,12,-10,433,338217,12,338205
11554,13,2,332,713085,13,713072
11555,6,-19,426,40683,6,40677
11556,7,1,428,666456,7,666449
11557,8,19,790,1235000,8,1234992
11558,12,12,618,1026619,12,1026607
11559,12,-9,560,371132,12,371120
11560,7,4,304,757092,7,757085
11561,11,3,86,742460,11,742449
11562,10,18,456,1196510,10,1196500
11563,19,-3,757,559828,19,559809
11564,6,3,896,738119,6,738113
11565,14,-18,992,92429,14,92415
11566,14,4,448,776458,14,776444
11567,9,-13,775,235239,9,235230
11568,14,8,922,905131,14,905117
11569,11,-8,923,404400,11,404389
11570,19,18,950,1215950,19,1215931
11571,6,-17,497,104175,6,104169
11572,17,-7,418,431478,17,431461
11573,19,-4,886,528719,19,528700
11574,6,-6,762,453198,6,453192
11575,15,12,122,1022930,15,1022915
11576,16,-13,704,246173,16,246157
11577,6,-18,772,79165,6,79159
11578,7,-16,401,132594,7,132587
11579,11,9,474,932453,11,932442
11580,20,17,542,1181909,20,1181889
11581,15,2,443,713988,15,713973
11582,17,7,213,868493,17,868476
11583,10,5,763,797528,10,797518
11584,6,19,917,1237840,6,1237834
11585,7,19,430,1227507,7,1227500
11586,7,10,946,957863,7,957856
11587,13,-7,477,431910,13,431897
11588,9,15,961,1114962,9,1114953
11589,11,12,307,1024383,11,1024372
11590,8,-10,14,312845,8,312837
11591,19,-13,537,244999,19,244980
11592,11,-17,141,116518,11,116507
11593,17,-7,843,434465,17,434448
11594,16,6,969,843492,16,843476
11595,14,-8,132,398818,14,398804
11596,17,13,792,1059189,17,1059172
11597,16,5,200,805347,16,805331
11598,19,7,838,873077,19,873058
11599,19,15,725,1122159,19,1122140
11600,19,-20,4,2500,19,2481
11601,14,6,391,838861,14,838847
11602,12,-8,870,404049,12,404037
11603,16,-11,317,306307,16,306291
11604,17,5,552,807808,17,807791
11605,15,19,139,1241882,15,1241867
11606,15,17,464,1181408,15,1181393
11607,7,11,110,970801,7,970794
11608,20,2,755,716257,20,716237
11609,10,-15,831,173170,10,173160
11610,12,8,876,904735,12,904723
11611,16,-16,718,152173,16,152157
11612,10,-12,740,265468,10,265458
11613,5,-20,101,2244,5,2239
11614,18,-2,831,591456,18,591438
11615,18,15,934,1123615,18,1123597
11616,20,-14,387,212585,20,212565
11617,8,-7,46,407033,8,407025
11618,6,-10,308,319182,6,319176
11619,9,-20,67,1425,9,1416
11620,11,14,53,1085821,11,1085810
11621,6,8,572,887769,6,887763
11622,18,-10,262,337010,18,336992
11623,6,-6,513,447914,6,447908
11624,11,18,848,1215156,11,1215145
11625,11,2,81,711151,11,711140
11626,7,-14,55,187741,7,187734
11627,8,2,942,708237,8,708229
11628,14,-5,501,494730,14,494716
11629,12,-11,245,305607,12,305595
11630,16,-10,809,341190,16,341174
11631,12,-5,584,495353,12,495341
11632,5,-16,463,134240,5,134235
11633,19,12,429,1025185,19,1025166
11634,14,13,375,1055980,14,1055966
11635,14,11,568,994942,14,994928
11636,9,-8,632,388893,9,388884
11637,11,-1,691,621877,11,621866
11638,6,18,173,1190564,6,1190558
11639,13,10,854,966356,13,966343
11640,7,-10,75,314337,7,314330
11641,19,15,112,1117619,19,1117600
11642,16,-18,780,90952,16,90936
11643,6,-2,239,567893,6,567887
11644,12,12,801,1027995,12,1027983
11645,7,-15,402,164078,7,164071
11646,15,-3,297,555939,15,555924
11647,11,-7,279,430385,11,430374
11648,6,11,864,986943,6,986937
11649,15,15,263,1118722,15,1118707
11650,10,7,741,860478,10,860468
11651,11,14,372,1088323,11,1088312
11652,10,16,924,1144448,10,1144438
11653,10,-15,113,157944,10,157934
11654,11,14,392,1088469,11,1088458
11655,11,1,484,683693,11,683682
11656,15,0,827,654538,15,654523
11657,12,11,44,991174,12,991162
11658,19,18,102,1209742,19,1209723
11659,18,14,55,1085842,18,1085824
11660,11,11,926,997633,11,997622
11661,6,-2,723,578243,6,578237
11662,10,18,964,1207161,10,1207151
11663,15,7,886,873371,15,873356
11664,12,0,591,652739,12,652727
11665,9,-3,473,541081,9,541072
11666,19,9,526,932919,19,932900
11667,14,-6,64,459566,14,459552
11668,15,15,612,1121260,15,1121245
11669,8,-3,957,551957,8,551949
11670,12,3,819,748000,12,747988
11671,9,8,916,895098,9,895089
11672,20,2,494,714330,20,714310
11673,14,-14,104,210136,14,210122
11674,19,-1,166,617803,19,617784
11675,12,1,873,686605,12,686593
11676,20,-19,871,60699,20,60679
11677,11,0,33,648490,11,648479
11678,5,-2,201,567040,5,567035
11679,13,-20,121,23673,13,23660
11680,18,-19,636,59010,18,58992
11681,6,18,851,1204755,6,1204749
11682,5,18,271,1192822,5,1192817
11683,17,-18,287,87462,17,87445
11684,16,-7,26,428501,16,428485
11685,8,-5,933,488386,8,488378
11686,19,0,562,652483,19,652464
11687,13,15,994,1124102,13,1124089
11688,13,-15,18,177957,13,177944
11689,18,2,287,712751,18,712733
11690,13,-16,998,154288,13,154275
11691,14,-15,901,184586,14,184572
11692,10,-16,521,135377,10,135367
11693,15,-7,901,434988,15,434973
11694,10,-8,295,381616,10,381606
11695,16,-1,3,616528,16,616512
11696,8,-9,876,363200,8,363192
11697,17,13,1000,1060643,17,1060626
11698,8,7,308,851387,8,851379
11699,13,13,784,1059100,13,1059087
11700,9,-15,485,165960,9,165951
11701,14,-17,276,117528,14,117514
11702,10,1,437,666652,10,666642
11703,9,-10,188,316692,9,316683
11704,13,-6,853,465579,13,465566
11705,17,-8,945,404564,17,404547
11706,12,-4,334,524683,12,524671
11707,11,6,333,838342,11,838331
11708,19,-1,595,621212,19,621193
11709,10,11,19,968849,10,968839
11710,16,-12,681,277516,16,277500
11711,18,12,606,1026508,18,1026490
11712,8,-3,251,535904,8,535896
11713,16,14,606,1090126,16,1090110
11714,11,-17,855,121851,11,121840
11715,14,14,396,1088508,14,1088494
11716,19,7,651,871769,19,871750
11717,10,-10,886,331589,10,331579
11718,16,9,22,929196,16,929180
11719,15,-6,735,464778,15,464763
11720,5,-14,965,207555,5,207550
11721,8,-6,693,451728,8,451720
11722,7,6,576,825330,7,825323
11723,5,0,587,638092,5,638087
11724,9,15,545,1106080,9,1106071
11725,17,7,792,872745,17,872728
11726,17,-16,489,150613,17,150596
11727,16,-3,954,561443,16,561427
11728,8,-2,253,568170,8,568162
11729,6,14,960,1083278,6,1083272
11730,9,6,857,831546,9,831537
11731,14,9,857,935419,14,935405
11732,12,-6,986,466614,12,466602
11733,14,12,714,1027411,14,1027397
11734,17,-19,738,59822,17,59805
11735,7,-11,22,281534,7,281527
11736,10,4,479,760897,10,760887
11737,19,12,833,1028279,19,1028260
11738,7,1,367,665257,7,665250
11739,8,-12,254,254995,8,254987
11740,20,16,552,1151020,20,1151000
11741,13,-10,256,336967,13,336954
11742,5,10,622,950932,5,950927
11743,18,0,943,655403,18,655385
11744,18,-13,874,247574,18,247556
11745,19,6,970,843519,19,843500
11746,20,13,180,1054533,20,1054513
11747,5,-14,235,191868,5,191863
11748,9,17,728,1170844,9,1170835
11749,7,6,63,813495,7,813488
11750,17,15,204,1118332,17,1118315
11751,18,-4,309,524490,18,524472
11752,10,-19,323,38547,10,38537
11753,11,1,477,683622,11,683611
11754,13,-20,161,23969,13,23956
11755,8,14,881,1081548,8,1081540
11756,8,13,908,1050155,8,1050147
11757,15,4,707,778417,15,778402
11758,19,9,663,933959,19,933940
11759,6,9,152,909924,6,909918
11760,11,2,15,710557,11,710546
11761,11,7,151,868127,11,868116
11762,14,4,350,775749,14,775735
11763,7,3,429,728015,7,728008
11764,20,-4,466,525582,20,525562
11765,18,-13,438,244210,18,244192
11766,9,13,449,1040400,9,1040391
11767,16,-10,44,335484,16,335468
11768,18,17,791,1183815,18,1183797
11769,5,-12,878,268619,5,268614
11770,19,3,807,747929,19,747910
11771,12,-1,209,618164,12,618152
11772,15,4,280,775206,15,775191
11773,12,7,890,873392,12,873380
11774,12,-1,283,618783,12,618771
11775,16,-9,791,372830,16,372814
11776,17,6,396,838931,17,838914
11777,9,-7,259,411263,9,411254
11778,5,3,682,733550,5,733545
11779,5,8,774,892245,5,892240
11780,8,-3,84,532209,8,532201
11781,12,19,837,1247549,12,1247537
11782,14,5,718,809017,14,809003
11783,9,12,171,1002888,9,1002879
11784,19,-1,652,621631,19,621612
11785,6,-10,784,329335,6,329329
11786,19,19,811,1247352,19,1247333
11787,18,12,48,1022429,18,1022411
11788,19,8,928,905172,19,905153
11789,16,12,373,1024811,16,1024795
11790,20,14,104,1086300,20,1086280
11791,10,6,398,821350,10,821340
11792,19,12,867,1028616,19,1028597
11793,9,-1,974,614860,9,614851
11794,10,15,22,1094930,10,1094920
11795,17,-10,374,337762,17,337745
11796,13,9,1000,936518,13,936505
11797,15,17,449,1181300,15,1181285
11798,18,17,427,1181098,18,1181080
11799,7,17,573,1167455,7,1167448
11800,20,13,573,1057583,20,1057563
11801,6,18,290,1193106,6,1193100
11802,8,17,271,1161077,8,1161069
11803,9,16,295,1131392,9,1131383
11804,5,-11,830,298908,5,298903
11805,17,-13,818,247104,17,247087
11806,8,-11,441,290964,8,290956
11807,13,14,19,1085511,13,1085498
11808,18,-12,323,274937,18,274919
11809,20,13,670,1058287,20,1058267
11810,8,-20,865,19213,8,19205
11811,10,-4,305,506120,10,506110
11812,12,-9,292,368719,12,368707
11813,19,-14,323,211904,19,211885
11814,8,-5,505,478936,8,478928
11815,19,-5,118,491835,19,491816
11816,9,-8,911,394836,9,394827
11817,10,9,32,907489,10,907479
11818,5,9,507,917451,5,917446
11819,11,14,661,1090620,11,1090609
11820,14,-14,443,212955,14,212941
11821,14,11,963,997735,14,997721
11822,6,-6,858,455151,6,455145
11823,6,15,887,1113287,6,1113281
11824,16,18,262,1211077,16,1211061
11825,6,17,851,1173683,6,1173677
11826,20,8,638,903048,20,903028
11827,7,15,171,1098100,7,1098093
11828,19,9,350,931574,19,931555
11829,14,0,192,649715,14,649701
11830,16,-7,475,431899,16,431883
11831,15,5,64,804288,15,804273
11832,17,2,865,716950,17,716933
11833,10,7,802,861744,10,861734
11834,16,13,735,1058708,16,1058692
11835,8,12,275,1005338,8,1005330
11836,14,-7,463,431809,14,431795
11837,16,15,325,1119182,16,1119166
11838,6,10,633,951162,6,951156
11839,16,-7,86,428888,16,428872
11840,8,-10,148,315895,8,315887
11841,17,-17,235,117187,17,117170
11842,14,-11,692,309184,14,309170
11843,13,13,188,1054589,13,1054576
11844,5,16,613,1138019,5,1138014
11845,17,14,372,1088330,17,1088313
11846,20,1,802,686098,20,686078
11847,13,-4,723,527476,13,527463
11848,5,2,868,706645,5,706640
11849,6,-4,782,516142,6,516136
11850,6,-2,226,567590,6,567584
11851,14,-2,363,587791,14,587777
11852,15,11,287,992960,15,992945
11853,15,-15,11,177904,15,177889
11854,15,-20,641,27660,15,27645
11855,5,-10,22,313050,5,313045
11856,20,9,499,932675,20,932655
11857,12,-2,496,588887,12,588875
11858,17,-2,582,589523,17,589506
11859,16,5,47,804121,16,804105
11860,5,3,558,730558,5,730553
11861,16,-14,16,209457,16,209441
11862,10,-4,627,512957,10,512947
11863,14,3,513,745623,14,745609
11864,17,-4,133,523078,17,523061
11865,10,-9,609,357195,10,357185
11866,11,-13,286,243217,11,243206
11867,18,-19,395,57085,18,57067
11868,11,3,953,749119,11,749108
11869,10,-1,685,608609,10,608599
11870,8,-11,739,297074,8,297066
11871,5,1,6,657121,5,657116
11872,9,6,931,833162,9,833153
11873,6,-6,186,440954,6,440948
11874,15,-9,637,371586,15,371571
11875,13,11,811,996753,13,996740
11876,12,-12,52,272890,12,272878
11877,9,-1,551,605980,9,605971
11878,7,-15,106,157722,7,157715
11879,13,-5,925,497803,13,497790
11880,16,19,734,1246748,16,1246732
11881,5,16,210,1129625,5,1129620
11882,9,5,52,782755,9,782746
11883,11,-10,26,335326,11,335315
11884,8,-4,371,507712,8,507704
11885,12,14,167,1086736,12,1086724
11886,12,8,592,902594,12,902582
11887,10,14,803,1079920,10,1079910
11888,7,14,588,1074862,7,1074855
11889,13,-17,772,121371,13,121358
11890,5,-13,211,222820,5,222815
11891,6,-8,633,388914,6,388908
11892,19,5,264,805789,19,805770
11893,8,7,958,865005,8,864997
11894,16,-16,54,147179,16,147163
11895,19,-3,999,561751,19,561732
11896,11,15,490,1120267,11,1120256
11897,15,-16,877,153432,15,153417
11898,15,10,820,966207,15,966192
11899,6,-12,344,257093,6,257087
11900,9,-8,605,388153,9,388144
11901,16,11,462,994212,16,994196
11902,8,-7,571,418100,8,418092
11903,8,15,846,1112445,8,1112437
11904,20,16,674,1151937,20,1151917
11905,19,19,575,1245503,19,1245484
11906,20,-14,896,216480,20,216460
11907,10,18,185,1190978,10,1190968
11908,16,14,639,1090412,16,1090396
11909,10,15,314,1101228,10,1101218
11910,19,-6,794,465191,19,465172
11911,14,14,608,1090148,14,1090134
11912,8,-1,868,612505,8,612497
11913,10,-17,718,108891,10,108881
11914,10,-16,805,141307,10,141297
11915,14,-17,678,120602,14,120588
11916,9,12,136,1002044,9,1002035
11917,17,19,801,1247276,17,1247259
11918,8,-15,363,163270,8,163262
11919,11,-2,0,585127,11,585116
11920,18,-2,792,591084,18,591066
11921,13,-13,39,241341,13,241328
11922,10,12,117,1001693,10,1001683
11923,11,-6,136,460121,11,460110
11924,6,-19,120,34216,6,34210
11925,14,9,703,934257,14,934243
11926,12,18,615,1213358,12,1213346
11927,13,2,630,715287,13,715274
11928,10,-1,758,610081,10,610071
11929,8,-5,763,484463,8,484455
11930,13,4,853,779650,13,779637
11931,10,-17,72,94910,10,94900
11932,15,3,768,747641,15,747626
11933,11,15,986,1124028,11,1124017
11934,9,12,603,1012106,9,1012097
11935,10,-2,636,576229,10,576219
11936,11,-15,207,179221,11,179210
11937,20,-12,534,276510,20,276490
11938,9,-12,294,255864,9,255855
11939,10,14,0,1061662,10,1061652
11940,5,14,451,1071845,5,1071840
11941,18,-7,998,435756,18,435738
11942,12,4,839,779499,12,779487
11943,11,11,864,997111,11,997100
11944,15,-7,10,428329,15,428314
11945,8,5,610,794283,8,794275
11946,12,1,435,683244,12,683232
11947,8,-8,995,396669,8,396661
11948,13,-8,375,400539,13,400526
11949,10,-12,632,263142,10,263132
11950,13,3,132,742822,13,742809
11951,7,11,312,975039,7,975032
11952,16,-7,846,434498,16,434482
11953,6,9,57,907984,6,907978
11954,5,-12,417,258712,5,258707
11955,8,5,949,801744,8,801736
11956,15,0,114,649133,15,649118
11957,7,-11,222,285850,7,285843
11958,14,12,581,1026310,14,1026296
11959,19,-13,70,241559,19,241540
11960,20,-18,524,89121,20,89101
11961,19,-1,878,623297,19,623278
11962,10,-14,366,194686,10,194676
11963,18,17,254,1179798,18,1179780
11964,17,15,120,1117705,17,1117688
11965,8,-5,790,484945,8,484937
11966,6,5,300,787846,6,787840
11967,14,-10,125,336026,14,336012
11968,18,-11,54,304079,18,304061
11969,10,-13,377,226246,10,226236
11970,11,-8,319,400132,11,400121
11971,17,-1,962,623848,17,623831
11972,19,13,190,1054611,19,1054592
11973,13,13,188,1054592,13,1054579
11974,5,-4,840,517239,5,517234
11975,6,-4,474,509648,6,509642
11976,20,5,257,805715,20,805695
11977,12,13,63,1053676,12,1053664
11978,5,17,837,1173309,5,1173304
11979,14,11,592,995138,14,995124
11980,7,-12,568,261807,7,261800
11981,8,-11,734,296978,8,296970
11982,5,18,723,1201732,5,1201727
11983,18,9,595,933499,18,933481
11984,20,-10,443,338327,20,338307
11985,19,-3,115,554615,19,554596
11986,19,7,249,868826,19,868807
11987,6,-1,227,598811,6,598805
11988,5,-9,601,357025,5,357020
11989,18,-2,680,590245,18,590227
11990,10,14,674,1077116,10,1077106
11991,18,13,652,1058160,18,1058142
11992,17,-1,553,620935,17,620918
11993,6,-13,50,219440,6,219434
11994,11,-19,59,54289,11,54278
11995,19,-12,323,274946,19,274927
11996,13,7,956,873774,13,873761
11997,6,-14,954,207179,6,207173
11998,13,19,838,1247561,13,1247548
11999,20,19,397,1244045,20,1244025
12000,6,-4,47,500277,6,500271
12001,6,-11,524,292806,6,292800
12002,14,-14,292,211681,14,211667
12003,5,12,269,1005163,5,1005158
12004,12,-19,744,59871,12,59859
12005,15,7,224,868574,15,868559
12006,16,2,440,713940,16,713924
12007,15,-18,808,91149,15,91134
12008,6,19,483,1228512,6,1228506
12009,16,16,890,1153417,16,1153401
12010,9,-16,900,143266,9,143257
12011,18,0,737,653950,18,653932
12012,15,-13,851,247347,15,247332
12013,5,-20,719,15772,5,15767
12014,16,1,858,686484,16,686468
12015,13,-8,384,400582,13,400569
12016,14,2,229,712305,14,712291
12017,11,-8,744,403149,11,403138
12018,6,0,339,632593,6,632587
12019,18,-7,448,431699,18,431681
12020,17,-9,352,369269,17,369252
12021,17,-12,440,275712,17,275695
12022,14,8,572,902454,14,902440
12023,9,-12,552,261511,9,261502
12024,14,-20,828,29225,14,29211
12025,18,5,871,810125,18,810107
12026,16,-13,216,242602,16,242586
12027,7,1,711,672400,7,672393
12028,7,-7,710,420920,7,420913
12029,12,-6,809,465334,12,465322
12030,17,17,111,1178635,17,1178618
12031,7,-15,540,167036,7,167029
12032,7,-19,43,32408,7,32401
12033,7,8,525,886778,7,886771
12034,14,-6,510,463092,14,463078
12035,10,12,709,1014666,10,1014656
12036,17,-7,845,434486,17,434469
12037,17,5,253,805681,17,805664
12038,15,-5,105,491734,15,491719
12039,17,-15,319,180080,17,180063
12040,12,8,823,904366,12,904354
12041,8,18,329,1193834,8,1193826
12042,20,5,446,807035,20,807015
12043,7,13,240,1035797,7,1035790
12044,8,-9,99,345735,8,345727
12045,20,5,441,806965,20,806945
12046,5,5,510,792133,5,792128
12047,6,-5,476,478298,6,478292
12048,11,-2,939,592298,11,592287
12049,8,7,258,850338,8,850330
12050,6,13,474,1040865,6,1040859
12051,14,19,645,1246025,14,1246011
12052,7,-4,566,511609,7,511602
12053,12,-8,230,399546,12,399534
12054,12,-7,167,429550,12,429538
12055,11,1,444,683313,11,683302
12056,16,-14,173,210631,16,210615
12057,19,14,991,1093233,19,1093214
12058,10,-18,329,69620,10,69610
12059,16,-18,216,86937,16,86921
12060,10,5,421,790211,10,790201
12061,20,-17,423,118574,20,118554
12062,15,18,605,1213253,15,1213238
12063,5,-11,269,286936,5,286931
12064,7,5,449,790989,7,790982
12065,8,-13,763,234805,8,234797
12066,5,-8,726,390946,5,390941
12067,12,-7,823,434271,12,434259
12068,20,-7,25,428496,20,428476
12069,13,-5,877,497487,13,497474
12070,17,14,401,1088570,17,1088553
12071,9,-6,870,455322,9,455313
12072,20,11,3,990876,20,990856
12073,11,10,166,961152,11,961141
12074,12,-20,962,30066,12,30054
12075,19,-12,73,273078,19,273059
12076,17,6,292,837983,17,837966
12077,15,19,968,1248532,15,1248517
12078,6,0,606,638466,6,638460
12079,12,16,61,1147530,12,1147518
12080,20,-5,928,497839,20,497819
12081,7,-3,437,540129,7,540122
12082,16,9,578,933328,16,933312
12083,7,0,786,642533,7,642526
12084,17,-8,864,404021,17,404004
12085,13,-1,617,621362,13,621349
12086,8,-11,513,292601,8,292593
12087,15,-10,292,337142,15,337127
12088,12,12,458,1025400,12,1025388
12089,5,-6,766,453252,5,453247
12090,12,2,930,717374,12,717362
12091,9,8,503,886245,9,886236
12092,12,-18,975,92326,12,92314
12093,14,-18,55,85614,14,85600
12094,13,-7,731,433615,13,433602
12095,17,-20,202,24418,17,24401
12096,13,18,237,1210880,13,1210867
12097,18,-16,567,151181,18,151163
12098,14,-7,681,433246,14,433232
12099,6,-17,82,95180,6,95174
12100,10,-15,632,169040,10,169030
12101,9,18,7,1186691,9,1186682
12102,9,12,941,1019844,9,1019835
12103,10,8,970,896265,10,896255
12104,15,-15,872,184379,15,184364
12105,16,-16,593,151368,16,151352
12106,7,-3,205,534799,7,534792
12107,20,-8,114,398679,20,398659
12108,17,-17,299,117759,17,117742
12109,19,-10,29,335373,19,335354
12110,8,17,181,1159063,8,1159055
12111,12,-7,889,434866,12,434854
12112,17,-1,399,619739,17,619722
12113,7,12,697,1014390,7,1014383
12114,9,3,727,734637,9,734628
12115,13,0,788,654239,13,654226
12116,19,-8,274,399810,19,399791
12117,12,-4,197,523595,12,523583
12118,6,15,526,1105668,6,1105662
12119,12,17,740,1183399,12,1183387
12120,17,-14,424,212855,17,212838
12121,9,10,308,944026,9,944017
12122,18,-5,731,496400,18,496382
12123,18,-5,264,492966,18,492948
12124,20,-19,335,56615,20,56595
12125,17,17,637,1182585,17,1182568
12126,8,9,524,917824,8,917816
12127,19,-18,166,86532,19,86513
12128,8,-9,595,356944,8,356936
12129,7,10,796,954782,7,954775
12130,18,0,375,650922,18,650904
12131,9,11,584,981011,9,981002
12132,5,15,179,1098292,5,1098287
12133,8,-16,341,131231,8,131223
12134,15,19,891,1248005,15,1247990
12135,20,12,153,1023131,20,1023111
12136,16,-19,30,54107,16,54091
12137,11,-17,784,121434,11,121423
12138,18,5,424,806843,18,806825
12139,15,-6,110,459900,15,459885
12140,5,-11,224,285890,5,285885
12141,18,8,837,904457,18,904439
12142,11,0,170,649523,11,649512
12143,16,-14,968,217027,16,217011
12144,11,-18,382,88158,11,88147
12145,9,8,37,875861,9,875852
12146,16,7,639,871695,16,871679
12147,19,9,545,933030,19,933011
12148,19,-8,428,400871,19,400852
12149,13,-10,865,341581,13,341568
12150,19,-14,170,210598,19,210579
12151,6,15,158,1097812,6,1097806
12152,18,6,135,836798,18,836780
12153,17,-3,43,554107,17,554090
12154,7,-5,867,486806,7,486799
12155,12,5,155,804905,12,804893
12156,6,15,98,1096551,6,1096545
12157,17,-13,535,244982,17,244965
12158,6,16,206,1129536,6,1129530
12159,14,9,825,935142,14,935128
12160,18,-2,414,588195,18,588177
12161,13,-5,734,496412,13,496399
12162,20,9,536,932971,20,932951
12163,16,16,165,1148257,16,1148241
12164,12,9,523,932877,12,932865
12165,14,16,88,1147708,14,1147694
12166,12,-8,943,404552,12,404540
12167,14,-15,910,184669,14,184655
12168,16,-16,845,153099,16,153083
12169,8,17,647,1169133,8,1169125
12170,7,-2,165,566227,7,566220
12171,12,-15,869,184362,12,184350
12172,10,-15,818,172906,10,172896
12173,17,5,606,808229,17,808212
12174,6,10,336,944625,6,944619
12175,6,6,609,826054,6,826048
12176,13,-7,155,429434,13,429421
12177,19,19,755,1246898,19,1246879
12178,15,-12,262,274427,15,274412
12179,15,14,353,1088167,15,1088152
12180,19,13,199,1054719,19,1054700
12181,16,1,540,684171,16,684155
12182,12,8,802,904289,12,904277
12183,17,9,307,931240,17,931223
12184,6,-10,817,330092,6,330086
12185,15,-4,209,523728,15,523713
12186,7,-16,81,125637,7,125630
12187,15,-4,148,523184,15,523169
12188,14,-5,728,496361,14,496347
12189,19,17,73,1178421,19,1178402
12190,15,-10,179,336410,15,336395
12191,16,14,418,1088721,16,1088705
12192,15,-15,220,179311,15,179296
12193,14,10,476,963459,14,963445
12194,10,-17,216,98059,10,98049
12195,7,8,936,895552,7,895545
12196,6,10,814,955165,6,955159
12197,6,-6,287,443094,6,443088
12198,20,-18,170,86566,20,86546
12199,6,10,846,955677,6,955671
12200,11,-5,798,496784,11,496773
12201,16,-9,244,368362,16,368346
12202,19,11,749,996235,19,996216
12203,13,-3,255,555571,13,555558
12204,6,-17,702,108527,6,108521
12205,18,7,538,870995,18,870977
12206,15,6,809,842284,15,842269
12207,15,-14,146,210430,15,210415
12208,17,-7,290,430513,17,430496
12209,17,15,744,1122320,17,1122303
12210,11,-17,585,119935,11,119924
12211,15,-18,14,85311,15,85296
12212,13,-20,724,28343,13,28330
12213,17,14,941,1092830,17,1092813
12214,11,-15,11,177905,11,177894
12215,10,-2,130,565641,10,565631
12216,11,18,462,1212389,11,1212378
12217,18,19,535,1245178,18,1245160
12218,17,-16,55,147185,17,147168
12219,19,16,432,1150251,19,1150232
12220,9,11,96,970524,9,970515
12221,20,4,226,774907,20,774887
12222,6,-13,740,234149,6,234143
12223,18,17,417,1181020,18,1181002
12224,5,-7,900,425163,5,425158
12225,15,-19,996,61411,15,61396
12226,5,10,361,945170,5,945165
12227,10,-3,255,535974,10,535964
12228,14,-8,553,401750,14,401736
12229,20,-16,858,153217,20,153197
12230,14,1,512,683902,14,683888
12231,9,4,561,762640,9,762631
12232,6,11,356,976008,6,976002
12233,19,12,425,1025142,19,1025123
12234,19,6,860,842614,19,842595
12235,15,12,722,1027457,15,1027442
12236,6,-13,741,234180,6,234174
12237,5,-8,885,394207,5,394202
12238,7,17,307,1161961,7,1161954
12239,14,-5,594,495428,14,495414
12240,10,10,447,947088,10,947078
12241,11,6,395,838925,11,838914
12242,20,-13,74,241597,20,241577
12243,11,-5,286,493163,11,493152
12244,13,-4,151,523217,13,523204
12245,8,17,497,1165946,8,1165938
12246,10,-10,873,331248,10,331238
12247,13,10,351,962441,13,962428
12248,19,3,635,746628,19,746609
12249,18,-3,830,560425,18,560407
12250,16,-7,542,432430,16,432414
12251,7,3,914,738621,7,738614
12252,20,-12,529,276474,20,276454
12253,20,17,621,1182464,20,1182444
12254,7,-1,635,607565,7,607558
12255,10,0,835,643472,10,643462
12256,10,4,564,762745,10,762735
12257,9,8,469,885429,9,885420
12258,19,13,890,1059882,19,1059863
12259,5,5,140,784474,5,784469
12260,6,-12,866,268447,6,268441
12261,15,18,327,1211477,15,1211462
12262,18,19,379,1243835,18,1243817
12263,8,-3,231,535344,8,535336
12264,8,16,67,1126590,8,1126582
12265,9,19,556,1230048,9,1230039
12266,18,8,209,899639,18,899621
12267,12,14,106,1086317,12,1086305
12268,20,-2,880,591876,20,591856
12269,10,12,306,1005918,10,1005908
12270,9,-4,205,503980,9,503971
12271,7,-16,12,124099,7,124092
12272,8,-17,483,103792,8,103784
12273,19,-9,867,373443,19,373424
12274,11,10,322,962271,11,962260
12275,18,-3,157,554868,18,554850
12276,19,17,339,1180514,19,1180495
12277,18,-10,212,336642,18,336624
12278,19,-2,743,590701,19,590682
12279,5,12,850,1017706,5,1017701
12280,12,-3,856,560606,12,560594
12281,11,12,607,1026517,11,1026506
12282,19,15,992,1124063,19,1124044
12283,17,8,325,900543,17,900526
12284,7,-15,288,161554,7,161547
12285,8,7,251,850200,8,850192
12286,19,11,857,997070,19,997051
12287,15,4,548,777218,15,777203
12288,8,14,467,1072214,8,1072206
12289,14,2,697,715871,14,715857
12290,14,8,733,903790,14,903776
12291,12,-14,211,210957,12,210945
12292,14,-4,438,525427,14,525413
12293,14,7,254,868865,14,868851
12294,11,-20,67,23283,11,23272
12295,7,-17,908,112732,7,112725
12296,15,-9,470,370339,15,370324
12297,11,1,370,682831,11,682820
12298,7,7,332,851977,7,851970
12299,9,15,305,1101046,9,1101037
12300,14,-1,717,622108,14,622094
12301,6,9,8,906899,6,906893
12302,13,11,84,991485,13,991472
12303,13,-9,945,374046,13,374033
12304,15,-19,624,58928,15,58913
12305,5,-14,188,190506,5,190501
12306,13,0,347,650660,13,650647
12307,19,-9,946,374054,19,374035
12308,18,-10,470,338594,18,338576
12309,14,-13,31,241324,14,241310
12310,15,-19,244,55966,15,55951
12311,6,1,63,658338,6,658332
12312,5,-14,976,207815,5,207810
12313,15,5,870,810104,15,810089
12314,18,2,237,712344,18,712326
12315,11,-14,607,214299,11,214288
12316,14,0,647,653159,14,653145
12317,8,-14,143,189598,8,189590
12318,5,6,395,821251,5,821246
12319,9,18,128,1189595,9,1189586
12320,10,14,946,1083019,10,1083009
12321,19,-8,116,398702,19,398683
12322,19,14,996,1093300,19,1093281
12323,13,-18,730,90575,13,90562
12324,8,-10,320,319472,8,319464
12325,5,18,30,1187195,5,1187190
12326,7,-7,430,415086,7,415079
12327,18,16,278,1149129,18,1149111
12328,20,8,551,902299,20,902279
12329,12,-9,253,368430,12,368418
12330,14,-3,760,559859,14,559845
12331,7,13,714,1046004,7,1045997
12332,10,-3,592,543737,10,543727
12333,19,15,710,1122040,19,1122021
12334,6,2,864,706573,6,706567
12335,5,16,232,1130191,5,1130186
12336,14,4,190,774608,14,774594
12337,8,12,305,1005889,8,1005881
12338,19,18,295,1211259,19,1211240
12339,15,-17,225,117112,15,117097
12340,7,10,654,951675,7,951668
12341,7,-7,759,421911,7,421904
12342,10,14,466,1072187,10,1072177
12343,5,18,210,1191436,5,1191431
12344,8,-6,907,456139,8,456131
12345,20,-1,192,617979,20,617959
12346,9,8,670,889865,9,889856
12347,18,0,584,652689,18,652671
12348,6,-15,292,161684,6,161678
12349,15,-1,976,623962,15,623947
12350,10,0,467,635513,10,635503
12351,7,13,345,1038205,7,1038198
12352,9,-17,820,110846,9,110837
12353,8,-1,65,595123,8,595115
12354,10,10,19,937905,10,937895
12355,7,0,82,627023,7,627016
12356,16,8,482,901739,16,901723
12357,13,12,369,1024799,13,1024786
12358,20,-3,333,556258,20,556238
12359,8,18,31,1187230,8,1187222
12360,8,-6,546,448654,8,448646
12361,9,7,392,853240,9,853231
12362,9,-12,525,261011,9,261002
12363,15,11,281,992901,15,992886
12364,13,5,282,805914,13,805901
12365,11,-19,680,59292,11,59281
12366,16,-17,78,116090,16,116074
12367,19,-2,969,592513,19,592494
12368,9,-13,30,219029,9,219020
12369,15,-10,403,337969,15,337954
12370,15,11,544,994767,15,994752
12371,10,-13,339,225502,10,225492
12372,9,10,472,947589,9,947580
12373,10,18,445,1196261,10,1196251
12374,19,9,556,933144,19,933125
12375,5,12,959,1020254,5,1020249
12376,18,13,354,1055842,18,1055824
12377,13,-13,703,246168,13,246155
12378,6,4,381,758876,6,758870
12379,12,-14,202,210863,12,210851
12380,16,3,872,748391,16,748375
12381,12,2,50,710895,12,710883
12382,19,-8,605,402094,19,402075
12383,20,-11,901,310790,20,310770
12384,10,4,685,765347,10,765337
12385,9,19,235,1222684,9,1222675
12386,12,14,255,1087417,12,1087405
12387,15,-11,458,307422,15,307407
12388,10,8,129,877834,10,877824
12389,10,-16,923,143810,10,143800
12390,13,5,188,805207,13,805194
12391,9,1,851,675501,9,675492
12392,5,-17,466,103422,5,103417
12393,16,15,646,1121509,16,1121493
12394,14,4,601,777668,14,777654
12395,10,-8,672,389846,10,389836
12396,13,-12,812,278447,13,278434
12397,18,-8,237,399581,18,399563
12398,15,-10,755,340783,15,340768
12399,6,-12,693,264480,6,264474
12400,14,17,393,1180867,14,1180853
12401,10,2,206,693081,10,693071
12402,16,16,233,1148768,16,1148752
12403,7,2,14,688812,7,688805
12404,19,19,187,1242236,19,1242217
12405,12,-4,247,524047,12,524035
12406,8,4,189,754634,8,754626
12407,13,9,70,929579,13,929566
12408,13,-8,921,404400,13,404387
12409,13,18,444,1212284,13,1212271
12410,13,-7,556,432509,13,432496
12411,14,3,886,748477,14,748463
12412,7,-13,838,236492,7,236485
12413,14,-14,586,214131,14,214117
12414,18,-13,952,248238,18,248220
12415,8,-1,42,594743,8,594735
12416,6,6,862,831678,6,831672
12417,6,-3,71,532032,6,532026
12418,16,3,293,744111,16,744095
12419,15,0,82,648817,15,648802
12420,13,-6,936,466224,13,466211
12421,11,7,562,871152,11,871141
12422,8,-5,917,487996,8,487988
12423,11,-13,141,242039,11,242028
12424,15,1,644,684928,15,684913
12425,14,-6,927,466153,14,466139
12426,12,4,410,776160,12,776148
12427,13,-5,926,497824,13,497811
12428,17,-11,345,306486,17,306469
12429,5,9,151,909909,5,909904
12430,7,-11,657,295598,7,295591
12431,13,13,859,1059667,13,1059654
12432,14,-12,64,272996,14,272982
12433,18,-11,227,305480,18,305462
12434,9,-4,185,503474,9,503465
12435,10,-18,572,74715,10,74705
12436,16,-20,805,29063,16,29047
12437,9,-9,473,354208,9,354199
12438,6,-4,450,509236,6,509230
12439,14,-8,148,398969,14,398955
12440,10,-15,240,160492,10,160482
12441,13,-8,229,399526,13,399513
12442,10,15,252,1099937,10,1099927
12443,17,-2,463,588608,17,588591
12444,5,-13,295,224750,5,224745
12445,17,3,174,743149,17,743132
12446,14,-3,416,556868,14,556854
12447,9,16,449,1134881,9,1134872
12448,17,-19,758,59929,17,59912
12449,5,-20,205,4791,5,4786
12450,15,14,156,1086707,15,1086692
12451,11,-16,37,146997,11,146986
12452,8,15,477,1104495,8,1104487
12453,6,3,749,735046,6,735040
12454,19,7,541,871018,19,870999
12455,14,12,385,1024863,14,1024849
12456,18,8,629,902964,18,902946
12457,16,-18,90,85900,16,85884
12458,17,-9,421,369869,17,369852
12459,12,-6,751,464895,12,464883
12460,6,-5,616,481355,6,481349
12461,14,-8,657,402525,14,402511
12462,6,-15,982,176376,6,176370
12463,6,18,560,1198674,6,1198668
12464,10,-1,224,598708,10,598698
12465,11,5,596,808125,11,808114
12466,10,-20,190,4479,10,4469
12467,17,1,912,686959,17,686942
12468,7,13,870,1049465,7,1049458
12469,6,-12,717,265014,6,265008
12470,7,0,99,627586,7,627579
12471,12,-9,390,369611,12,369599
12472,10,-13,999,239970,10,239960
12473,17,16,904,1153548,17,1153531
12474,10,-10,435,322052,10,322042
12475,5,-6,501,447602,5,447597
12476,19,1,847,686410,19,686391
12477,6,1,65,658392,6,658386
12478,15,-3,639,558906,15,558891
12479,15,15,282,1118868,15,1118853
12480,9,7,595,857426,9,857417
12481,7,8,610,888477,7,888470
12482,16,10,555,964092,16,964076
12483,17,-11,781,309842,17,309825
12484,17,5,731,809095,17,809078
12485,7,2,567,700602,7,700595
12486,17,13,941,1060217,17,1060200
12487,16,18,412,1212092,16,1212076
12488,17,8,375,900884,17,900867
12489,12,-12,597,276859,12,276847
12490,18,-19,568,58483,18,58465
12491,16,1,909,686926,16,686910
12492,10,-3,706,546349,10,546339
12493,15,9,711,934314,15,934299
12494,12,-16,175,148167,12,148155
12495,9,-16,499,134927,9,134918
12496,18,-12,644,277239,18,277221
12497,7,-3,145,533521,7,533514
12498,18,-5,534,494999,18,494981
12499,6,8,724,891208,6,891202
12500,7,-4,166,503008,7,503001
12501,7,2,831,705915,7,705908
12502,10,13,50,1031832,10,1031822
12503,13,6,82,836327,13,836314
12504,11,-19,975,61282,11,61271
12505,8,-20,598,13083,8,13075
12506,6,17,45,1156335,6,1156329
12507,10,4,703,765694,10,765684
12508,19,1,136,680936,19,680917
12509,13,-7,525,432301,13,432288
12510,9,-9,333,350898,9,350889
12511,13,14,150,1086633,13,1086620
12512,9,5,928,801181,9,801172
12513,19,1,35,680073,19,680054
12514,12,-13,993,248515,12,248503
12515,13,-12,111,273346,13,273333
12516,15,-2,566,589378,15,589363
12517,14,-9,289,368694,14,368680
12518,16,10,756,965648,16,965632
12519,18,-16,982,154152,18,154134
12520,9,15,148,1097689,9,1097680
12521,20,-20,213,24446,20,24426
12522,18,7,607,871507,18,871489
12523,10,-11,74,282696,10,282686
12524,6,-10,129,315433,6,315427
12525,7,8,341,882685,7,882678
12526,11,-4,766,527768,11,527757
12527,20,6,703,841490,20,841470
12528,9,17,355,1162944,9,1162935
12529,13,-4,454,525520,13,525507
12530,6,-14,131,189294,6,189288
12531,11,1,685,685183,11,685172
12532,20,-20,722,28334,20,28314
12533,11,19,233,1242560,11,1242549
12534,14,-7,558,432518,14,432504
12535,19,-1,825,622885,19,622866
12536,7,14,381,1070237,7,1070230
12537,11,-18,352,87968,11,87957
12538,6,13,975,1051614,6,1051608
12539,17,4,163,774458,17,774441
12540,6,1,152,660532,6,660526
12541,5,10,703,952674,5,952669
12542,8,-4,982,520552,8,520544
12543,16,2,749,716215,16,716199
12544,10,17,896,1174614,10,1174604
12545,7,-12,674,264114,7,264107
12546,8,-20,96,2127,8,2119
12547,9,5,425,790313,9,790304
12548,10,3,397,727349,10,727339
12549,17,0,610,652860,17,652843
12550,19,0,135,649265,19,649246
12551,18,0,412,651217,18,651199
12552,11,17,82,1178468,11,1178457
12553,7,-12,497,260344,7,260337
12554,14,-3,318,556102,14,556088
12555,8,0,605,638433,8,638425
12556,18,19,782,1247105,18,1247087
12557,20,7,907,873484,20,873464
12558,20,-17,211,117024,20,117004
12559,17,4,821,779295,17,779278
12560,16,12,841,1028399,16,1028383
12561,8,0,959,646217,8,646209
12562,5,-15,89,157322,5,157317
12563,20,-17,812,121609,20,121589
12564,18,0,829,654554,18,654536
12565,13,18,347,1211626,13,1211613
12566,7,16,27,1125751,7,1125744
12567,12,-7,468,431850,12,431838
12568,16,-19,551,58327,16,58311
12569,9,8,240,880493,9,880484
12570,19,11,142,991858,19,991839
12571,19,17,656,1182743,19,1182724
12572,10,9,604,919552,10,919542
12573,6,-18,592,75155,6,75149
12574,12,9,892,935665,12,935653
12575,11,-5,832,497053,11,497042
12576,12,12,867,1028618,12,1028606
12577,12,12,77,1022590,12,1022578
12578,20,-14,975,217098,20,217078
12579,8,-15,347,162951,8,162943
12580,15,7,739,872400,15,872385
12581,5,-5,386,476468,5,476463
12582,16,9,862,935455,16,935439
12583,11,-3,211,555249,11,555238
12584,19,-1,282,618762,19,618743
12585,9,7,159,848229,9,848220
12586,17,-20,254,24720,17,24703
12587,8,-5,837,486101,8,486093
12588,13,-16,925,153725,13,153712
12589,8,9,904,925933,8,925925
12590,11,19,493,1244821,11,1244810
12591,11,10,709,965335,11,965324
12592,18,14,783,1091621,18,1091603
12593,5,11,583,980967,5,980962
12594,6,-11,52,282168,6,282162
12595,15,-13,768,246735,15,246720
12596,17,-11,744,309490,17,309473
12597,12,-12,306,274794,12,274782
12598,9,15,426,1103425,9,1103416
12599,9,-10,719,328078,9,328069
12600,13,-17,663,120482,13,120469
12601,11,-10,577,339364,11,339353
12602,13,7,653,871793,13,871780
12603,17,9,554,933119,17,933102
12604,11,13,996,1060586,11,1060575
12605,15,-16,900,153546,15,153531
12606,8,10,659,951758,8,951750
12607,19,-16,332,149376,19,149357
12608,18,8,760,903955,18,903937
12609,9,-5,462,478003,9,477994
12610,6,18,111,1189220,6,1189214
12611,20,10,994,967410,20,967390
12612,17,-6,629,463958,17,463941
12613,8,12,629,1012747,8,1012739
12614,19,-7,968,435475,19,435456
12615,15,9,279,930974,15,930959
12616,14,-15,691,182878,14,182864
12617,15,-19,619,58884,15,58869
12618,16,-14,283,211640,16,211624
12619,11,9,42,929367,11,929356
12620,14,-6,225,460885,14,460871
12621,8,-18,947,82965,8,82957
12622,13,-18,234,87148,13,87135
12623,8,19,906,1237706,8,1237698
12624,17,-14,154,210491,17,210474
12625,12,13,277,1055228,12,1055216
12626,15,3,352,744551,15,744536
12627,19,1,888,686723,19,686704
12628,7,-4,991,520784,7,520777
12629,17,10,550,964067,17,964050
12630,14,-17,775,121390,14,121376
12631,7,-17,995,114383,7,114376
12632,9,-15,496,166214,9,166205
12633,7,-1,828,611626,7,611619
12634,15,-4,648,526950,15,526935
12635,10,12,608,1012238,10,1012228
12636,15,-14,511,213482,15,213467
12637,6,-14,78,188285,6,188279
12638,8,3,920,738782,8,738774
12639,13,-4,231,523895,13,523882
12640,20,8,863,904673,20,904653
12641,17,2,952,717578,17,717561
12642,14,-20,605,27405,14,27391
12643,18,9,772,934722,18,934704
12644,14,14,947,1092887,14,1092873
12645,8,-1,684,608600,8,608592
12646,14,4,468,776622,14,776608
12647,12,10,191,961304,12,961292
12648,5,16,729,1140233,5,1140228
12649,6,3,86,720650,6,720644
12650,13,9,512,932817,13,932804
12651,7,10,532,948857,7,948850
12652,5,-13,723,233826,5,233821
12653,11,-6,370,461985,11,461974
12654,9,7,74,846386,9,846377
12655,15,-19,735,59807,15,59792
12656,12,-11,152,304932,12,304920
12657,14,-14,288,211649,14,211635
12658,15,-9,710,372033,15,372018
12659,15,-3,687,559265,15,559250
12660,18,-3,291,555869,18,555851
12661,16,-8,429,400876,16,400860
12662,7,0,538,636957,7,636950
12663,5,18,511,1197728,5,1197723
12664,6,-18,655,76446,6,76440
12665,15,-19,141,55133,15,55118
12666,5,-19,88,33338,5,33333
12667,13,-2,550,589262,13,589249
12668,10,1,626,670909,10,670899
12669,9,-13,899,237724,9,237715
12670,19,8,587,902563,19,902544
12671,10,5,439,790630,10,790620
12672,19,5,176,805091,19,805072
12673,5,-8,634,388943,5,388938
12674,11,-15,217,179290,11,179279
12675,10,-6,332,443949,10,443939
12676,18,12,691,1027277,18,1027259
12677,17,-12,105,273282,17,273265
12678,13,-20,636,27611,13,27598
12679,15,19,783,1247121,15,1247106
12680,16,3,348,744513,16,744497
12681,12,-10,174,336389,12,336377
12682,11,12,788,1027921,11,1027910
12683,10,16,396,1133622,10,1133612
12684,18,7,515,870834,18,870816
12685,11,8,505,901978,11,901967
12686,11,8,357,900774,11,900763
12687,5,-5,912,487886,5,487881
12688,12,8,800,904281,12,904269
12689,9,18,493,1197265,9,1197256
12690,12,-13,763,246684,12,246672
12691,15,-2,317,587499,15,587484
12692,12,-7,982,435579,12,435567
12693,14,-19,691,59378,14,59364
12694,5,1,209,661762,5,661757
12695,10,-18,70,63953,10,63943
12696,16,-15,59,178224,16,178208
12697,13,-19,144,55147,13,55134
12698,15,-10,759,340826,15,340811
12699,16,-5,58,491264,16,491248
12700,6,-2,792,579628,6,579622
12701,10,2,605,701356,10,701346
12702,8,-2,734,578378,8,578370
12703,20,-6,907,465998,20,465978
12704,8,4,448,760266,8,760258
12705,13,-12,728,277818,13,277805
12706,18,18,504,1212639,18,1212621
12707,12,8,520,902112,12,902100
12708,20,19,690,1246360,20,1246340
12709,12,-5,196,492397,12,492385
12710,6,1,790,674139,6,674133
12711,18,7,940,873692,18,873674
12712,16,-8,674,402670,16,402654
12713,11,-7,217,429929,11,429918
12714,11,-5,680,495962,11,495951
12715,19,1,533,684112,19,684093
12716,16,10,541,963985,16,963969
12717,20,14,930,1092717,20,1092697
12718,13,-8,189,399245,13,399232
12719,6,16,239,1130310,6,1130304
12720,6,6,968,834067,6,834061
12721,14,2,401,713673,14,713659
12722,16,9,10,929110,16,929094
12723,18,-8,645,402406,18,402388
12724,15,18,486,1212534,15,1212519
12725,7,12,221,1003966,7,1003959
12726,15,-1,966,623874,15,623859
12727,11,2,916,717282,11,717271
12728,10,-15,749,171478,10,171468
12729,6,-11,549,293379,6,293373
12730,6,-18,728,78084,6,78078
12731,18,-17,451,118817,18,118799
12732,19,17,707,1183143,19,1183124
12733,6,-1,490,604749,6,604743
12734,17,12,231,1023740,17,1023723
12735,5,14,223,1066687,5,1066682
12736,18,6,501,839817,18,839799
12737,16,-5,421,494109,16,494093
12738,12,-1,398,619730,12,619718
12739,18,15,17,1116910,18,1116892
12740,11,4,267,775121,11,775110
12741,11,3,681,747013,11,747002
12742,17,13,919,1059991,17,1059974
12743,17,19,81,1241437,17,1241420
12744,9,16,659,1139025,9,1139016
12745,17,16,284,1149190,17,1149173
12746,6,-19,562,43751,6,43745
12747,20,8,563,902357,20,902337
12748,13,18,305,1211296,13,1211283
12749,17,17,806,1183966,17,1183949
12750,19,-3,424,557002,19,556983
12751,13,2,609,715115,13,715102
12752,10,11,694,983182,10,983172
12753,12,1,276,682070,12,682058
12754,19,-20,172,24074,19,24055
12755,20,-12,502,276274,20,276254
12756,20,-14,715,215103,20,215083
12757,13,-4,917,528955,13,528942
12758,10,8,925,895236,10,895226
12759,8,3,340,726312,8,726304
12760,17,7,757,872480,17,872463
12761,15,-19,965,61245,15,61230
12762,8,-11,751,297328,8,297320
12763,10,-11,951,301643,10,301633
12764,11,0,470,651675,11,651664
12765,10,-3,341,537925,10,537915
12766,7,-8,724,390864,7,390857
12767,16,11,760,996330,16,996314
12768,16,17,330,1180466,16,1180450
12769,11,8,334,900598,11,900587
12770,11,-10,748,340718,11,340707
12771,11,12,49,1022429,11,1022418
12772,7,-6,602,449792,7,449785
12773,8,-3,920,551080,8,551072
12774,12,-1,106,617370,12,617358
12775,17,-13,599,245439,17,245422
12776,12,14,424,1088797,12,1088785
12777,16,4,671,778138,16,778122
12778,10,-4,765,515750,10,515740
12779,13,-6,687,464391,13,464378
12780,5,-3,647,545010,5,545005
12781,11,-5,92,491633,11,491622
12782,7,-2,963,583442,7,583435
12783,8,-16,295,130420,8,130412
12784,19,-13,97,241736,19,241717
12785,6,4,156,753948,6,753942
12786,10,8,526,886793,10,886783
12787,10,-13,907,237926,10,237916
12788,20,-4,124,522989,20,522969
12789,12,-7,6,428304,12,428292
12790,12,-18,317,87716,12,87704
12791,10,16,139,1128040,10,1128030
12792,16,-6,651,464121,16,464105
12793,7,18,397,1195187,7,1195180
12794,8,-8,13,375592,8,375584
12795,16,12,940,1029318,16,1029302
12796,14,-12,409,275518,14,275504
12797,17,0,656,653273,17,653256
12798,5,16,634,1138527,5,1138522
12799,6,2,923,707782,6,707776
12800,14,-14,193,210795,14,210781
12801,8,-17,806,110671,8,110663
12802,18,-13,845,247324,18,247306
12803,6,-2,695,577675,6,577669
12804,7,13,994,1051969,7,1051962
12805,19,0,298,650325,19,650306
12806,10,-8,89,377307,10,377297
12807,14,2,948,717532,14,717518
12808,15,12,338,1024608,15,1024593
12809,16,-5,288,493181,16,493165
12810,15,-4,944,529152,15,529137
12811,7,10,709,952817,7,952810
12812,10,-17,922,112980,10,112970
12813,15,15,709,1122024,15,1122009
12814,14,15,259,1118684,14,1118670
12815,9,-14,718,202410,9,202401
12816,5,-10,286,318696,5,318691
12817,15,-4,544,526229,15,526214
12818,7,4,20,750904,7,750897
12819,9,0,879,644359,9,644350
12820,17,2,377,713462,17,713445
12821,5,-13,193,222543,5,222538
12822,20,15,760,1122431,20,1122411
12823,9,11,329,975470,9,975461
12824,9,5,539,792805,9,792796
12825,16,-14,365,212276,16,212260
12826,5,16,289,1131273,5,1131268
12827,14,-19,219,55802,14,55788
12828,12,7,309,869253,12,869241
12829,7,16,551,1136830,7,1136823
12830,9,-19,257,37164,9,37155
12831,15,11,370,993576,15,993561
12832,15,-15,911,184702,15,184687
12833,14,17,144,1178921,14,1178907
12834,6,-17,734,109240,6,109234
12835,17,-13,318,243420,17,243403
12836,9,-15,162,158883,9,158874
12837,19,-13,313,243377,19,243358
12838,7,19,788,1234944,7,1234937
12839,6,-15,893,174393,6,174387
12840,11,15,531,1120638,11,1120627
12841,13,11,140,991839,13,991826
12842,19,2,398,713624,19,713605
12843,9,-1,985,615202,9,615193
12844,20,-16,830,152992,20,152972
12845,18,5,899,810326,18,810308
12846,10,1,599,670256,10,670246
12847,9,-20,908,20110,9,20101
12848,19,17,891,1184644,19,1184625
12849,20,3,169,743105,20,743085
12850,19,1,502,683820,19,683801
12851,9,2,313,695352,9,695343
12852,11,-8,277,399832,11,399821
12853,6,15,777,1110914,6,1110908
12854,15,16,138,1148078,15,1148063
12855,20,1,783,685953,20,685933
12856,6,13,365,1038565,6,1038559
12857,20,2,850,716841,20,716821
12858,5,19,808,1235384,5,1235379
12859,16,9,39,929326,16,929310
12860,20,13,567,1057490,20,1057470
12861,9,14,844,1080754,9,1080745
12862,20,2,281,712636,20,712616
12863,9,-18,873,81265,9,81256
12864,20,-8,318,400127,20,400107
12865,20,17,441,1181220,20,1181200
12866,8,-20,771,16967,8,16959
12867,17,13,953,1060312,17,1060295
12868,7,-1,952,614497,7,614490
12869,15,12,731,1027534,15,1027519
12870,19,-5,117,491825,19,491806
12871,6,-3,863,549678,6,549672
12872,14,14,653,1090566,14,1090552
12873,20,-14,636,214521,20,214501
12874,5,18,272,1192836,5,1192831
12875,20,-16,507,150744,20,150724
12876,13,17,319,1180357,13,1180344
12877,11,18,700,1213997,11,1213986
12878,13,-20,718,28262,13,28249
12879,12,-10,827,341304,12,341292
12880,10,-17,544,105205,10,105195
12881,13,-7,722,433560,13,433547
12882,8,-20,464,9897,8,9889
12883,15,3,886,748482,15,748467
12884,17,-6,809,465341,17,465324
12885,10,17,423,1164284,10,1164274
12886,8,7,502,855530,8,855522
12887,17,10,674,965116,17,965099
12888,20,-12,562,276668,20,276648
12889,16,-3,202,555209,16,555193
12890,12,-13,758,246642,12,246630
12891,6,13,104,1032939,6,1032933
12892,15,6,945,843289,15,843274
12893,15,-3,595,558494,15,558479
12894,16,17,163,1179089,16,1179073
12895,19,-2,197,586559,19,586540
12896,14,-10,247,336875,14,336861
12897,5,-19,534,43078,5,43073
12898,11,9,788,934869,11,934858
12899,8,-17,982,114196,8,114188
12900,10,5,212,786110,10,786100
12901,9,3,752,735097,9,735088
12902,13,-10,51,335519,13,335506
12903,19,13,157,1054361,19,1054342
12904,19,-9,257,368462,19,368443
12905,9,-1,775,610525,9,610516
12906,9,-14,515,197760,9,197751
12907,12,-5,931,497885,12,497873
12908,12,-6,363,461953,12,461941
12909,7,9,408,915255,7,915248
12910,19,-17,238,117219,19,117200
12911,10,-12,952,270316,10,270306
12912,12,1,569,684373,12,684361
12913,6,-12,209,253954,6,253948
12914,15,-7,664,433086,15,433071
12915,12,-4,775,527821,12,527809
12916,15,-14,353,212143,15,212128
12917,14,-17,701,120756,14,120742
12918,9,19,437,1227662,9,1227653
12919,9,1,508,668357,9,668348
12920,13,-2,264,587117,13,587104
12921,17,11,905,997449,17,997432
12922,16,-1,710,622060,16,622044
12923,19,-3,271,555706,19,555687
12924,5,19,815,1235537,5,1235532
12925,6,-17,840,111278,6,111272
12926,16,8,50,898257,16,898241
12927,5,-14,619,200303,5,200298
12928,15,-9,818,373017,15,373002
12929,16,19,118,1241744,16,1241728
12930,11,-18,489,88903,11,88892
12931,11,15,785,1122523,11,1122512
12932,5,-20,353,7777,5,7772
12933,7,15,216,1099065,7,1099058
12934,6,11,826,986081,6,986075
12935,13,-5,27,491023,13,491010
12936,9,0,219,630234,9,630225
12937,5,18,222,1191627,5,1191622
12938,14,18,159,1210246,14,1210232
12939,7,17,626,1168680,7,1168673
12940,6,-7,426,415000,6,414994
12941,19,-6,301,461516,19,461497
12942,20,16,829,1153079,20,1153059
12943,19,15,958,1123834,19,1123815
12944,18,13,937,1060186,18,1060168
12945,18,-10,154,336234,18,336216
12946,16,8,906,905049,16,905033
12947,11,19,437,1244444,11,1244433
12948,9,12,273,1005312,9,1005303
12949,15,12,518,1025818,15,1025803
12950,5,-20,18,435,5,430
12951,13,3,662,746840,13,746827
12952,10,-16,572,136448,10,136438
12953,7,-18,948,83001,7,82994
12954,19,16,642,1151716,19,1151697
12955,11,-20,455,26247,11,26236
12956,12,19,57,1241185,12,1241173
12957,7,9,168,910340,7,910333
12958,5,-9,650,357936,5,357931
12959,16,5,990,811054,16,811038
12960,16,0,79,648785,16,648769
12961,8,-16,919,143729,8,143721
12962,6,9,586,919124,6,919118
12963,12,-7,320,430777,12,430765
12964,13,16,11,1147165,13,1147152
12965,9,-3,441,540257,9,540248
12966,17,-9,633,371538,17,371521
12967,16,3,628,746558,16,746542
12968,20,-11,500,307749,20,307729
12969,10,-18,548,74224,10,74214
12970,6,-9,130,346326,6,346320
12971,15,0,87,648871,15,648856
12972,7,7,238,849849,7,849842
12973,12,-16,958,153973,12,153961
12974,5,6,101,814350,5,814345
12975,20,-3,355,556383,20,556363
12976,20,12,26,1022282,20,1022262
12977,18,18,666,1213790,18,1213772
12978,8,14,998,1084271,8,1084263
12979,12,-1,787,622619,12,622607
12980,7,14,710,1077945,7,1077938
12981,19,6,131,836737,19,836718
12982,7,-15,394,163904,7,163897
12983,16,-17,250,117316,16,117300
12984,19,-11,39,303945,19,303926
12985,20,9,198,930521,20,930501
12986,16,15,459,1120030,16,1120014
12987,10,-14,812,204313,10,204303
12988,14,5,554,807810,14,807796
12989,6,5,1000,802761,6,802755
12990,16,14,118,1086407,16,1086391
12991,7,-9,259,349266,7,349259
12992,15,13,290,1055338,15,1055323
12993,15,15,39,1117092,15,1117077
12994,10,-12,253,254958,10,254948
12995,12,-18,497,88930,12,88918
12996,10,6,646,826836,10,826826
12997,10,19,540,1229696,10,1229686
12998,13,3,577,746162,13,746149
12999,10,-13,615,231556,10,231546
13000,6,-12,193,253549,6,253543
13001,8,-16,4,123855,8,123847
13002,13,12,251,1023909,13,1023896
13003,13,-12,469,275953,13,275940
13004,6,-12,626,263016,6,263010
13005,5,-3,780,547967,5,547962
13006,19,16,282,1149185,19,1149166
13007,8,19,349,1225339,8,1225331
13008,7,-5,346,475711,7,475704
13009,12,12,727,1027514,12,1027502
13010,19,17,965,1185165,19,1185146
13011,6,1,26,657620,6,657614
13012,6,1,642,671209,6,671203
13013,19,18,772,1214561,19,1214542
13014,18,-5,658,495803,18,495785
13015,19,-12,987,279997,19,279978
13016,18,6,434,839230,18,839212
13017,20,-5,511,494806,20,494786
13018,12,19,696,1246440,12,1246428
13019,16,-15,814,183859,16,183843
13020,11,1,116,680716,11,680705
13021,19,-7,217,429938,19,429919
13022,18,10,512,963802,18,963784
13023,18,-10,722,340497,18,340479
13024,13,2,560,714803,13,714790
13025,14,7,577,871283,14,871269
13026,11,-7,831,434319,11,434308
13027,8,12,937,1019711,8,1019703
13028,7,14,536,1073791,7,1073784
13029,16,6,958,843366,16,843350
13030,5,-15,149,158639,5,158634
13031,14,18,958,1216018,14,1216004
13032,10,-6,642,450617,10,450607
13033,19,12,771,1027781,19,1027762
13034,17,-15,95,178500,17,178483
13035,7,-16,420,133044,7,133037
13036,12,13,68,1053737,12,1053725
13037,10,11,528,979795,10,979785
13038,17,-17,203,116943,17,116926
13039,8,10,375,945471,8,945463
13040,10,14,764,1079081,10,1079071
13041,9,-11,793,298129,9,298120
13042,16,-8,589,401954,16,401938
13043,19,14,279,1087587,19,1087568
13044,7,1,285,663382,7,663375
13045,8,11,617,981669,8,981661
13046,19,11,516,994599,19,994580
13047,14,-11,906,310830,14,310816
13048,17,-4,411,525310,17,525293
13049,13,13,327,1055625,13,1055612
13050,5,-11,394,289853,5,289848
13051,15,-16,702,152083,15,152068
13052,5,-10,471,322974,5,322969
13053,6,10,376,945486,6,945480
13054,8,1,990,678474,8,678466
13055,9,-19,915,51186,9,51177
13056,16,7,582,871309,16,871293
13057,8,8,453,885073,8,885065
13058,11,-6,804,465305,11,465294
13059,15,-14,388,212599,15,212584
13060,18,7,386,869867,18,869849
13061,10,-2,200,567003,10,566993
13062,8,-12,216,254130,8,254122
13063,8,-3,446,540416,8,540408
13064,16,0,955,655541,16,655525
13065,10,8,862,893885,10,893875
13066,14,-14,179,210679,14,210665
13067,13,-4,640,526916,13,526903
13068,13,11,979,997891,13,997878
13069,10,15,899,1113577,10,1113567
13070,17,10,378,962636,17,962619
13071,13,0,576,652618,13,652605
13072,17,-16,190,148320,17,148303
13073,9,-11,894,300258,9,300249
13074,6,-16,821,141634,6,141628
13075,20,-6,506,463062,20,463042
13076,11,7,845,873113,11,873102
13077,19,17,780,1183694,19,1183675
13078,9,19,902,1237573,9,1237564
13079,8,-2,924,582589,8,582581
13080,20,-8,655,402495,20,402475
13081,19,-19,361,56810,19,56791
13082,6,9,249,911949,6,911943
13083,5,-7,278,411745,5,411740
13084,7,-13,659,232304,7,232297
13085,8,-16,74,125435,8,125427
13086,5,-18,807,79859,5,79854
13087,17,8,927,905161,17,905144
13088,20,13,928,1060114,20,1060094
13089,8,-6,836,454656,8,454648
13090,14,-17,350,118089,14,118075
13091,19,17,897,1184693,19,1184674
13092,19,-15,997,185369,19,185350
13093,5,-7,894,425049,5,425044
13094,15,-16,345,149425,15,149410
13095,9,-5,348,475773,9,475764
13096,8,-11,788,298083,8,298075
13097,20,12,976,1029634,20,1029614
13098,18,-1,14,616605,18,616587
13099,20,-10,686,340280,20,340260
13100,6,17,200,1159508,6,1159502
13101,18,12,917,1029090,18,1029072
13102,16,-2,909,592084,16,592068
13103,8,-13,838,236500,8,236492
13104,13,-12,77,273090,13,273077
13105,9,13,392,1039133,9,1039124
13106,17,-9,870,373466,17,373449
13107,8,5,548,792997,8,792989
13108,20,15,497,1120293,20,1120273
13109,8,-9,207,347960,8,347952
13110,7,8,185,879058,7,879051
13111,11,0,212,649839,11,649828
13112,6,-3,617,544263,6,544257
13113,20,10,463,963382,20,963362
13114,9,-12,854,268180,9,268171
13115,12,7,664,871881,12,871869
13116,20,10,462,963362,20,963342
13117,18,9,278,930970,18,930952
13118,8,-10,143,315798,8,315790
13119,11,4,600,777642,11,777631
13120,11,-17,872,121958,11,121947
13121,20,-16,539,150966,20,150946
13122,17,3,849,748231,17,748214
13123,18,9,46,929417,18,929399
13124,16,-20,434,26088,16,26072
13125,8,-12,414,258646,8,258638
13126,17,-17,436,118698,17,118681
13127,9,-8,760,391642,9,391633
13128,20,-11,954,311176,20,311156
13129,5,-19,422,40555,5,40550
13130,5,-13,925,238354,5,238349
13131,9,-16,439,133654,9,133645
13132,13,12,248,1023878,13,1023865
13133,18,15,158,1117946,18,1117928
13134,11,-12,242,274293,11,274282
13135,15,11,627,995323,15,995308
13136,11,-2,759,590813,11,590802
13137,17,8,507,901995,17,901978
13138,8,-14,8,186574,8,186566
13139,7,5,585,793733,7,793726
13140,14,17,951,1185012,14,1184998
13141,15,0,311,650378,15,650363
13142,18,-14,380,212499,18,212481
13143,10,-14,194,190693,10,190683
13144,15,9,860,935448,15,935433
13145,18,-19,812,60226,18,60208
13146,11,-5,881,497496,11,497485
13147,17,-12,496,276204,17,276187
13148,15,-20,584,27254,15,27239
13149,5,-10,605,325728,5,325723
13150,10,7,109,847190,10,847180
13151,10,-1,233,599015,10,599005
13152,8,0,138,628449,8,628441
13153,18,6,867,842681,18,842663
13154,6,-12,833,267604,6,267598
13155,14,-4,435,525426,14,525412
13156,7,8,16,875494,7,875487
13157,20,-20,162,23992,20,23972
13158,14,10,326,962278,14,962264
13159,17,18,342,1211593,17,1211576
13160,16,4,506,776887,16,776871
13161,12,-19,63,54329,12,54317
13162,15,0,256,650084,15,650069
13163,16,-3,688,559270,16,559254
13164,20,-1,87,617229,20,617209
13165,18,-10,197,336524,18,336506
13166,15,-6,769,464988,15,464973
13167,17,-18,500,88948,17,88931
13168,12,-8,882,404100,12,404088
13169,14,11,751,996239,14,996225
13170,15,-7,993,435667,15,435652
13171,15,-14,896,216485,15,216470
13172,9,-15,107,157745,9,157736
13173,13,-1,821,622853,13,622840
13174,8,-12,607,262594,8,262586
13175,5,-5,26,468372,5,468367
13176,10,-2,734,578388,10,578378
13177,11,-11,192,305257,11,305246
13178,9,-4,858,517728,9,517719
13179,13,9,895,935690,13,935677
13180,12,9,83,929648,12,929636
13181,17,-6,680,464297,17,464280
13182,8,-3,14,530897,8,530889
13183,15,-3,385,556647,15,556632
13184,13,-4,232,523900,13,523887
13185,8,13,994,1051977,8,1051969
13186,18,-9,645,371628,18,371610
13187,6,9,612,919742,6,919736
13188,6,10,618,950858,6,950852
13189,12,19,272,1242928,12,1242916
13190,10,-1,968,614738,10,614728
13191,13,10,281,961935,13,961922
13192,12,16,279,1149155,12,1149143
13193,19,12,217,1023667,19,1023648
13194,17,0,217,649881,17,649864
13195,10,-5,312,474964,10,474954
13196,19,-12,810,278435,19,278416
13197,15,11,541,994753,15,994738
13198,8,-5,872,487004,8,486996
13199,17,-17,834,121745,17,121728
13200,5,-20,487,10432,5,10427
13201,16,-4,341,524729,16,524713
13202,12,-8,812,403688,12,403676
13203,6,-1,934,614145,6,614139
13204,19,4,451,776484,19,776465
13205,12,5,415,806771,12,806759
13206,12,-4,282,524259,12,524247
13207,17,8,991,905652,17,905635
13208,11,7,618,871552,11,871541
13209,12,5,867,810070,12,810058
13210,8,1,225,662127,8,662119
13211,13,-12,809,278415,13,278402
13212,13,5,851,809952,13,809939
13213,10,-6,332,443959,10,443949
13214,9,-10,393,321081,9,321072
13215,5,-11,997,302620,5,302615
13216,9,7,919,864259,9,864250
13217,13,-8,789,403519,13,403506
13218,12,6,788,842068,12,842056
13219,19,-14,805,215843,19,215824
13220,7,-9,193,347659,7,347652
13221,7,-8,376,383264,7,383257
13222,13,15,171,1118066,13,1118053
13223,11,-3,832,560439,11,560428
13224,12,6,296,838041,12,838029
13225,16,-6,714,464577,16,464561
13226,16,13,39,1053511,16,1053495
13227,16,16,967,1154036,16,1154020
13228,8,-3,873,549919,8,549911
13229,13,-9,397,369668,13,369655
13230,18,11,146,991896,18,991878
13231,16,-10,234,336782,16,336766
13232,13,-17,941,122410,13,122397
13233,18,4,325,775557,18,775539
13234,8,-13,814,235976,8,235968
13235,9,-5,811,485482,9,485473
13236,5,-6,888,455755,5,455750
13237,17,-15,442,181045,17,181028
13238,14,17,994,1185427,14,1185413
13239,16,8,991,905658,16,905642
13240,15,11,290,992982,15,992967
13241,12,-17,136,116477,12,116465
13242,20,19,31,1240966,20,1240946
13243,12,-9,286,368667,12,368655
13244,8,-19,273,37478,8,37470
13245,16,-12,255,274389,16,274373
13246,16,0,459,651596,16,651580
13247,15,-12,276,274573,15,274558
13248,19,17,690,1183017,19,1182998
13249,13,-8,517,401460,13,401447
13250,14,19,941,1248353,14,1248339
13251,13,10,126,960873,13,960860
13252,6,-11,622,294923,6,294917
13253,15,-9,475,370402,15,370387
13254,6,4,629,764232,6,764226
13255,15,-13,612,245582,15,245567
13256,12,-11,416,307060,12,307048
13257,10,6,311,819213,10,819203
13258,11,-16,390,149746,11,149735
13259,12,6,230,837486,12,837474
13260,5,-10,96,314665,5,314660
13261,10,-4,228,504567,10,504557
13262,12,17,586,1182189,12,1182177
13263,17,14,941,1092837,17,1092820
13264,12,-3,442,557139,12,557127
13265,20,-9,474,370389,20,370369
13266,13,-5,861,497283,13,497270
13267,11,12,691,1027278,11,1027267
13268,11,14,249,1087382,11,1087371
13269,19,5,186,805198,19,805179
13270,11,-19,155,55302,11,55291
13271,10,-4,245,504989,10,504979
13272,15,10,881,966561,15,966546
13273,15,-15,957,185073,15,185058
13274,8,12,64,1000480,8,1000472
13275,10,-12,450,259270,10,259260
13276,8,-4,975,520400,8,520392
13277,16,-4,875,528627,16,528611
13278,5,15,743,1110288,5,1110283
13279,16,-6,999,466716,16,466700
13280,14,9,341,931504,14,931490
13281,11,-17,267,117446,11,117435
13282,16,19,206,1242397,16,1242381
13283,18,-11,181,305200,18,305182
13284,14,1,209,681539,14,681525
13285,8,-4,827,516925,8,516917
13286,18,-18,298,87554,18,87536
13287,8,15,173,1098154,8,1098146
13288,16,12,903,1028950,16,1028934
13289,7,-5,277,474143,7,474136
13290,12,11,465,994245,12,994233
13291,10,18,872,1205146,10,1205136
13292,13,5,926,810581,13,810568
13293,12,-5,906,497679,12,497667
13294,12,-4,685,527262,12,527250
13295,10,7,735,860375,10,860365
13296,13,9,143,930122,13,930109
13297,5,4,631,764283,5,764278
13298,5,-7,304,412389,5,412384
13299,9,10,752,953626,9,953617
13300,20,18,398,1211982,20,1211962
13301,5,-1,105,596061,5,596056
13302,6,-17,110,95751,6,95745
13303,13,-15,318,180072,13,180059
13304,10,-10,324,319567,10,319557
13305,7,1,422,666341,7,666334
13306,9,-20,762,16744,9,16735
13307,14,-12,124,273478,14,273464
13308,12,-12,575,276762,12,276750
13309,10,1,575,669915,10,669905
13310,12,13,956,1060336,12,1060324
13311,11,-13,46,241400,11,241389
13312,16,-3,525,557967,16,557951
13313,6,-8,977,396363,6,396357
13314,14,-10,215,336658,14,336644
13315,14,1,401,683039,14,683025
13316,13,13,578,1057655,13,1057642
13317,5,-10,12,312786,5,312781
13318,20,-13,168,242257,20,242237
13319,8,-16,718,139432,8,139424
13320,15,5,394,806670,15,806655
13321,11,12,976,1029635,11,1029624
13322,17,-16,813,152884,17,152867
13323,11,5,540,807724,11,807713
13324,12,-18,170,86568,12,86556
13325,10,5,883,800216,10,800206
13326,6,16,641,1138704,6,1138698
13327,6,12,254,1004696,6,1004690
13328,18,10,617,964675,18,964657
13329,5,9,895,925733,5,925728
13330,5,-12,860,268277,5,268272
13331,6,1,215,661924,6,661918
13332,5,15,906,1113687,5,1113682
13333,19,-13,566,245222,19,245203
13334,18,-13,953,248255,18,248237
13335,15,16,726,1152290,15,1152275
13336,14,-2,65,585647,14,585633
13337,7,-9,443,353459,7,353452
13338,6,-14,572,199059,6,199053
13339,20,13,887,1059864,20,1059844
13340,17,18,774,1214579,17,1214562
13341,12,-10,245,336844,12,336832
13342,15,-3,218,555302,15,555287
13343,11,-9,108,367374,11,367363
13344,14,-20,756,28630,14,28616
13345,10,-19,355,39206,10,39196
13346,15,6,22,835987,15,835972
13347,5,11,192,972351,5,972346
13348,8,1,964,677951,8,677943
13349,5,-3,578,543484,5,543479
13350,5,-20,68,1449,5,1444
13351,15,-2,538,589156,15,589141
13352,13,-20,782,28841,13,28828
13353,18,14,822,1091896,18,1091878
13354,17,2,603,715094,17,715077
13355,19,-8,193,399263,19,399244
13356,20,-2,907,592055,20,592035
13357,10,7,163,848290,10,848280
13358,17,6,103,836520,17,836503
13359,19,-5,947,497980,19,497961
13360,18,-17,497,119220,18,119202
13361,19,-3,19,553949,19,553930
13362,15,-8,787,403497,15,403482
13363,11,14,142,1086572,11,1086561
13364,8,-12,344,257101,8,257093
13365,15,-2,551,589276,15,589261
13366,13,-7,39,428621,13,428608
13367,8,4,668,764973,8,764965
13368,9,-14,965,207564,9,207555
13369,12,-3,603,558528,12,558516
13370,9,13,643,1044576,9,1044567
13371,13,5,211,805409,13,805396
13372,8,9,905,925990,8,925982
13373,15,0,113,649119,15,649104
13374,17,0,882,654961,17,654944
13375,16,3,571,746065,16,746049
13376,16,12,65,1022530,16,1022514
13377,9,8,130,877858,9,877849
13378,20,-11,576,308313,20,308293
13379,16,4,640,777911,16,777895
13380,11,-13,773,246799,11,246788
13381,10,-18,274,68473,10,68463
13382,6,13,899,1050032,6,1050026
13383,19,-6,175,460487,19,460468
13384,10,2,318,695429,10,695419
13385,5,-20,99,2199,5,2194
13386,5,1,916,676945,5,676940
13387,19,15,677,1121746,19,1121727
13388,8,-7,278,411753,8,411745
13389,7,-12,762,266023,7,266016
13390,12,19,201,1242342,12,1242330
13391,16,-11,652,308915,16,308899
13392,17,-8,465,401078,17,401061
13393,9,-14,437,196227,9,196218
13394,8,-17,406,102073,8,102065
13395,5,8,982,896541,5,896536
13396,20,-15,993,185281,20,185261
13397,11,4,877,779795,11,779784
13398,18,1,861,686520,18,686502
13399,7,-19,469,41641,7,41634
13400,15,-5,522,494908,15,494893
13401,18,-16,4,146739,18,146721
13402,8,8,397,883888,8,883880
13403,19,1,519,683949,19,683930
13404,7,14,149,1065181,7,1065174
13405,10,13,870,1049475,10,1049465
13406,20,9,708,934286,20,934266
13407,8,-11,351,288900,8,288892
13408,13,14,413,1088682,13,1088669
13409,12,6,577,840449,12,840437
13410,16,3,912,748708,16,748692
13411,7,10,441,947010,7,947003
13412,12,0,882,654963,12,654951
13413,18,-19,156,55310,18,55292
13414,10,-18,935,82773,10,82763
13415,14,4,468,776626,14,776612
13416,9,-20,196,4601,9,4592
13417,7,10,377,945518,7,945511
13418,19,-9,317,368924,19,368905
13419,7,-5,960,488868,7,488861
13420,16,-1,896,623410,16,623394
13421,18,-19,724,59632,18,59614
13422,18,-7,795,434038,18,434020
13423,11,-15,716,183106,11,183095
13424,8,-11,78,282769,8,282761
13425,11,-2,235,586896,11,586885
13426,17,16,990,1154194,17,1154177
13427,20,-3,178,555041,20,555021
13428,8,-3,278,536388,8,536380
13429,19,12,484,1025631,19,1025612
13430,8,15,420,1103196,8,1103188
13431,14,-16,599,151420,14,151406
13432,15,-12,268,274508,15,274493
13433,18,0,494,651920,18,651902
13434,16,19,122,1241773,16,1241757
13435,5,-17,186,97306,5,97301
13436,15,-13,930,248053,15,248038
13437,5,8,896,894615,5,894610
13438,15,9,172,930352,15,930337
13439,13,11,449,994102,13,994089
13440,11,-9,675,371754,11,371743
13441,5,-12,558,261615,5,261610
13442,6,19,0,1217328,6,1217322
13443,18,14,669,1090668,18,1090650
13444,8,6,155,815508,8,815500
13445,11,-8,320,400152,11,400141
13446,6,14,742,1078649,6,1078643
13447,19,0,456,651584,19,651565
13448,9,-16,530,135560,9,135551
13449,13,19,256,1242773,13,1242760
13450,5,10,689,952403,5,952398
13451,16,-10,349,337585,16,337569
13452,9,10,565,949613,9,949604
13453,16,6,942,843255,16,843239
13454,15,-12,819,278515,15,278500
13455,8,0,664,639887,8,639879
13456,7,-1,901,613343,7,613336
13457,11,19,299,1243164,11,1243153
13458,20,-13,379,243827,20,243807
13459,5,-11,805,298377,5,298372
13460,16,-19,955,61178,16,61162
13461,19,-11,111,304575,19,304556
13462,16,-6,379,462071,16,462055
13463,16,2,809,716524,16,716508
13464,18,-18,971,92277,18,92259
13465,14,-18,393,88240,14,88226
13466,19,-17,35,115810,19,115791
13467,13,-12,501,276258,13,276245
13468,14,9,622,933696,14,933682
13469,7,-16,456,134024,7,134017
13470,13,7,780,872641,13,872628
13471,13,-12,234,274218,13,274205
13472,7,14,942,1082933,7,1082926
13473,13,4,319,775475,13,775462
13474,20,-20,433,26066,20,26046
13475,16,-7,471,431878,16,431862
13476,8,-6,60,438075,8,438067
13477,14,14,28,1085585,14,1085571
13478,7,14,962,1083333,7,1083326
13479,7,-20,21,528,7,521
13480,13,-9,868,373453,13,373440
13481,15,10,457,963303,15,963288
13482,5,18,468,1196771,5,1196766
13483,11,19,513,1244998,11,1244987
13484,6,-17,485,103845,6,103839
13485,14,9,384,931825,14,931811
13486,12,11,457,994171,12,994159
13487,5,9,213,911305,5,911300
13488,19,0,322,650412,19,650393
13489,16,16,800,1152855,16,1152839
13490,9,-5,558,480069,9,480060
13491,7,19,923,1237955,7,1237948
13492,14,-17,519,119411,14,119397
13493,16,13,168,1054436,16,1054420
13494,17,-1,76,617157,17,617140
13495,10,19,221,1222435,10,1222425
13496,13,10,233,961576,13,961563
13497,10,-1,182,597614,10,597604
13498,14,7,325,869400,14,869386
13499,19,3,922,748812,19,748793
13500,15,-3,746,559710,15,559695
13501,12,-16,903,153568,12,153556
13502,11,-20,331,25429,11,25418
13503,11,-16,504,150733,11,150722
13504,11,5,698,808885,11,808874
13505,15,-14,371,212407,15,212392
13506,10,-2,928,582680,10,582670
13507,19,-19,201,55651,19,55632
13508,19,11,568,994951,19,994932
13509,11,13,333,1055691,11,1055680
13510,13,12,676,1027148,13,1027135
13511,7,10,426,946643,7,946636
13512,9,3,646,732711,9,732702
13513,18,13,287,1055308,18,1055290
13514,6,-7,191,409877,6,409871
13515,13,-10,697,340356,13,340343
13516,20,0,97,648996,20,648976
13517,14,-8,535,401620,14,401606
13518,20,17,148,1178961,20,1178941
13519,8,-14,486,197174,8,197166
13520,13,0,577,652620,13,652607
13521,14,-7,0,428254,14,428240
13522,9,19,779,1234741,9,1234732
13523,15,-5,808,496862,15,496847
13524,15,-6,109,459881,15,459866
13525,10,13,27,1031346,10,1031336
13526,9,12,876,1018309,9,1018300
13527,18,2,735,716103,18,716085
13528,8,19,744,1234005,8,1233997
13529,5,-2,547,574329,5,574324
13530,8,6,24,812803,8,812795
13531,14,4,738,778692,14,778678
13532,5,14,621,1075724,5,1075719
13533,16,-10,388,337829,16,337813
13534,18,-11,722,309346,18,309328
13535,11,11,907,997462,11,997451
13536,11,-18,13,85300,11,85289
13537,16,5,849,809943,16,809927
13538,19,-8,839,403849,19,403830
13539,9,3,663,733068,9,733059
13540,6,1,210,661803,6,661797
13541,16,-13,758,246648,16,246632
13542,8,17,956,1175777,8,1175769
13543,16,0,862,654766,16,654750
13544,17,15,910,1123409,17,1123392
13545,13,14,59,1085879,13,1085866
13546,14,12,977,1029645,14,1029631
13547,20,12,928,1029201,20,1029181
13548,14,-10,670,340144,14,340130
13549,16,-6,150,460265,16,460249
13550,5,-6,565,449014,5,449009
13551,14,-14,999,217300,14,217286
13552,10,-19,564,43867,10,43857
13553,9,-2,41,563702,9,563693
13554,19,5,764,809336,19,809317
13555,7,-18,589,75110,7,75103
13556,12,14,592,1089980,12,1089968
13557,13,-20,686,28093,13,28080
13558,12,9,821,935129,12,935117
13559,8,-12,807,266973,8,266965
13560,14,7,936,873678,14,873664
13561,7,11,26,969023,7,969016
13562,11,-2,33,585366,11,585355
13563,11,16,801,1152861,11,1152850
13564,13,-6,25,459350,13,459337
13565,10,13,642,1044558,10,1044548
13566,11,17,737,1183371,11,1183360
13567,18,0,58,648677,18,648659
13568,8,-6,278,442883,8,442875
13569,18,-14,853,216172,18,216154
13570,15,13,925,1060106,15,1060091
13571,20,-18,443,88571,20,88551
13572,6,8,526,886799,6,886793
13573,14,6,804,842201,14,842187
13574,13,4,743,778718,13,778705
13575,5,-7,782,422404,5,422399
13576,5,-9,287,349852,5,349847
13577,20,-8,536,401636,20,401616
13578,13,10,733,965519,13,965506
13579,7,16,166,1128609,7,1128602
13580,15,18,152,1210217,15,1210202
13581,7,-15,14,155607,7,155600
13582,6,-19,426,40689,6,40683
13583,15,8,428,901371,15,901356
13584,9,15,843,1112373,9,1112364
13585,8,-4,652,513430,8,513422
13586,9,-9,943,364758,9,364749
13587,5,15,671,1108673,5,1108668
13588,5,19,620,1231367,5,1231362
13589,14,2,748,716194,14,716180
13590,17,7,583,871317,17,871300
13591,14,2,732,716094,14,716080
13592,15,-17,656,120432,15,120417
13593,11,-1,220,618271,11,618260
13594,5,1,790,674144,5,674139
13595,18,-4,750,527649,18,527631
13596,12,14,767,1091465,12,1091453
13597,7,-14,278,192858,7,192851
13598,15,4,162,774438,15,774423
13599,8,-12,486,260036,8,260028
13600,13,-14,708,215039,13,215026
13601,20,-9,8,366707,20,366687
13602,18,7,123,867910,18,867892
13603,10,17,964,1176024,10,1176014
13604,13,4,206,774725,13,774712
13605,18,-18,122,86141,18,86123
13606,6,-3,201,534707,6,534701
13607,11,-16,766,152526,11,152515
13608,16,6,593,840570,16,840554
13609,16,-15,327,180129,16,180113
13610,17,-17,483,119082,17,119065
13611,20,-8,765,403309,20,403289
13612,20,14,228,1087199,20,1087179
13613,15,14,679,1090778,15,1090763
13614,8,6,196,816444,8,816436
13615,8,9,881,925417,8,925409
13616,5,-12,16,249913,5,249908
13617,8,-17,882,112127,8,112119
13618,16,-12,80,273120,16,273104
13619,13,-2,119,586015,13,586002
13620,10,8,664,889679,10,889669
13621,5,-14,196,190736,5,190731
13622,19,-11,513,307837,19,307818
13623,20,11,362,993512,20,993492
13624,15,5,22,803902,15,803887
13625,12,-1,446,620105,12,620093
13626,19,-13,624,245695,19,245676
13627,14,-17,219,117088,14,117074
13628,10,18,471,1196813,10,1196803
13629,8,9,597,919447,8,919439
13630,18,-7,881,434768,18,434750
13631,7,9,508,917487,7,917480
13632,13,-18,966,92230,13,92217
13633,7,9,583,919060,7,919053
13634,18,0,713,653755,18,653737
13635,12,3,538,745758,12,745746
13636,10,14,872,1081360,10,1081350
13637,14,-15,501,181472,14,181458
13638,7,-17,603,106530,7,106523
13639,10,-11,316,288115,10,288105
13640,13,-8,777,403414,13,403401
13641,5,-5,685,482824,5,482819
13642,16,1,5,679781,16,679765
13643,16,-9,44,366934,16,366918
13644,5,-13,995,239849,5,239844
13645,5,12,963,1020373,5,1020368
13646,11,-10,656,340005,11,339994
13647,10,-13,578,230694,10,230684
13648,6,-12,625,262978,6,262972
13649,15,9,627,933728,15,933713
13650,16,12,29,1022301,16,1022285
13651,20,4,704,778387,20,778367
13652,13,-8,65,398435,13,398422
13653,20,13,812,1059343,20,1059323
13654,5,11,130,971226,5,971221
13655,12,-3,282,555768,12,555756
13656,18,5,787,809509,18,809491
13657,12,7,905,873472,12,873460
13658,20,-4,616,526729,20,526709
13659,8,16,474,1135341,8,1135333
13660,19,-2,343,587674,19,587655
13661,19,15,419,1119729,19,1119710
13662,18,-15,821,183925,18,183907
13663,8,6,274,818408,8,818400
13664,19,12,831,1028255,19,1028236
13665,13,10,832,966245,13,966232
13666,9,-17,940,113261,9,113252
13667,5,-9,660,358106,5,358101
13668,8,10,43,938433,8,938425
13669,11,18,817,1214859,11,1214848
13670,8,-11,333,288448,8,288440
13671,12,-2,489,588833,12,588821
13672,9,4,939,771131,9,771122
13673,8,17,865,1174024,8,1174016
13674,12,-5,915,497744,12,497732
13675,18,-12,84,273143,18,273125
13676,8,19,974,1239095,8,1239087
13677,16,13,731,1058688,16,1058672
13678,16,16,610,1151413,16,1151397
13679,13,-8,251,399675,13,399662
13680,13,2,957,717627,13,717614
13681,16,5,511,807512,16,807496
13682,14,-13,211,242569,14,242555
13683,16,19,473,1244691,16,1244675
13684,19,-11,996,311496,19,311477
13685,14,13,109,1054036,14,1054022
13686,20,-12,993,280056,20,280036
13687,17,16,935,1153799,17,1153782
13688,8,11,396,976985,8,976977
13689,16,-17,967,122578,16,122562
13690,11,-5,787,496707,11,496696
13691,6,-12,430,258899,6,258893
13692,7,-6,420,445765,7,445758
13693,15,11,815,996772,15,996757
13694,13,-14,362,212227,13,212214
13695,17,13,565,1057482,17,1057465
13696,15,9,321,931352,15,931337
13697,6,-15,635,169111,6,169105
13698,17,-12,111,273353,17,273336
13699,16,15,492,1120271,16,1120255
13700,14,-9,274,368577,14,368563
13701,18,-17,495,119206,18,119188
13702,16,12,623,1026670,16,1026654
13703,5,-3,990,552599,5,552594
13704,8,14,808,1080090,8,1080082
13705,15,-11,54,304084,15,304069
13706,17,-4,358,524927,17,524910
13707,20,1,25,679981,20,679961
13708,15,9,757,934553,15,934538
13709,16,3,358,744572,16,744556
13710,17,-18,890,91680,17,91663
13711,11,10,561,964172,11,964161
13712,15,-16,95,147597,15,147582
13713,17,-9,973,374155,17,374138
13714,15,-9,179,367822,15,367807
13715,9,2,958,708717,9,708708
13716,20,11,433,994026,20,994006
13717,6,18,214,1191479,6,1191473
13718,13,1,482,683665,13,683652
13719,17,-14,670,214768,17,214751
13720,14,2,426,713851,14,713837
13721,13,-19,957,61216,13,61203
13722,16,-19,431,57303,16,57287
13723,15,-2,877,591838,15,591823
13724,9,1,510,668419,9,668410
13725,14,-2,263,587107,14,587093
13726,15,-1,435,620006,15,619991
13727,5,18,882,1205324,5,1205319
13728,7,-2,252,568153,7,568146
13729,14,17,768,1183556,14,1183542
13730,11,16,595,1151296,11,1151285
13731,11,16,389,1149916,11,1149905
13732,13,-9,5,366649,13,366636
13733,15,-19,46,54223,15,54208
13734,20,2,137,711638,20,711618
13735,16,19,83,1241457,16,1241441
13736,11,12,686,1027237,11,1027226
13737,14,-8,424,400821,14,400807
13738,13,-15,186,179108,13,179095
13739,11,-20,551,27000,11,26989
13740,9,10,534,948889,9,948880
13741,14,9,172,930356,14,930342
13742,6,12,210,1003718,6,1003712
13743,9,7,744,860523,9,860514
13744,13,19,281,1242992,13,1242979
13745,12,3,594,746260,12,746248
13746,18,8,561,902337,18,902319
13747,13,-15,561,181910,13,181897
13748,8,18,762,1202792,8,1202784
13749,14,15,329,1119196,14,1119182
13750,11,-2,917,592120,11,592109
13751,13,-4,797,527973,13,527960
13752,10,-20,287,6405,10,6395
13753,9,-13,564,230349,9,230340
13754,15,14,125,1086446,15,1086431
13755,14,13,119,1054101,14,1054087
13756,14,-9,371,369427,14,369413
13757,10,11,653,982378,10,982368
13758,6,16,474,1135347,6,1135341
13759,8,-2,995,583999,8,583991
13760,16,13,670,1058293,16,1058277
13761,10,18,901,1205821,10,1205811
13762,12,-20,665,27923,12,27911
13763,9,-17,842,111310,9,111301
13764,9,-16,435,133505,9,133496
13765,16,-1,611,621321,16,621305
13766,18,-12,147,273621,18,273603
13767,11,-15,19,177964,11,177953
13768,19,-15,354,180355,19,180336
13769,6,-4,672,513877,6,513871
13770,9,4,252,756128,9,756119
13771,11,-2,800,591136,11,591125
13772,20,-7,253,430159,20,430139
13773,10,-12,532,261140,10,261130
13774,15,14,318,1087896,15,1087881
13775,7,11,51,969585,7,969578
13776,6,19,405,1226710,6,1226704
13777,10,7,757,860769,10,860759
13778,16,-18,798,91048,16,91032
13779,16,-5,416,494092,16,494076
13780,18,9,965,936312,18,936294
13781,7,14,723,1078287,7,1078280
13782,7,4,710,765927,7,765920
13783,17,-2,290,587319,17,587302
13784,17,19,68,1241298,17,1241281
13785,6,-7,540,417450,6,417444
13786,7,-16,793,141049,7,141042
13787,14,-13,672,245866,14,245852
13788,10,17,373,1163328,10,1163318
13789,18,-14,433,212886,18,212868
13790,20,-4,888,528740,20,528720
13791,9,-15,583,167957,9,167948
13792,7,6,202,816598,7,816591
13793,13,-7,144,429333,13,429320
13794,18,19,609,1245712,18,1245694
13795,10,-12,583,262130,10,262120
13796,12,18,501,1212603,12,1212591
13797,12,18,769,1214514,12,1214502
13798,17,2,373,713430,17,713413
13799,6,11,223,972921,6,972915
13800,11,12,510,1025770,11,1025759
13801,16,10,917,966910,16,966894
13802,8,-7,577,418297,8,418289
13803,18,12,92,1022737,18,1022719
13804,6,11,327,975408,6,975402
13805,17,13,844,1059550,17,1059533
13806,19,-17,701,120765,19,120746
13807,15,0,730,653917,15,653902
13808,15,14,885,1092383,15,1092368
13809,10,1,74,658621,10,658611
13810,17,-11,332,306415,17,306398
13811,18,5,418,806803,18,806785
13812,12,-14,411,212781,12,212769
13813,18,14,680,1090798,18,1090780
13814,15,19,306,1243221,15,1243206
13815,18,-7,900,434976,18,434958
13816,13,-20,726,28364,13,28351
13817,8,13,847,1048970,8,1048962
13818,20,-2,227,586849,20,586829
13819,10,-6,575,449103,10,449093
13820,19,5,473,807278,19,807259
13821,15,18,545,1212950,15,1212935
13822,20,-13,977,248398,20,248378
13823,18,9,828,935200,18,935182
13824,16,10,844,966287,16,966271
13825,18,-20,934,29901,18,29883
13826,7,8,870,894047,7,894040
13827,10,-5,619,481414,10,481404
13828,5,-9,6,343859,5,343854
13829,12,-2,686,590285,12,590273
13830,5,-16,178,127817,5,127812
13831,5,13,956,1051222,5,1051217
13832,19,14,712,1091055,19,1091036
13833,7,-2,935,582860,7,582853
13834,19,9,216,930634,19,930615
13835,7,19,672,1232387,7,1232380
13836,7,-9,524,355491,7,355484
13837,5,-11,881,300056,5,300051
13838,9,3,405,727511,9,727502
13839,18,-18,311,87683,18,87665
13840,12,4,38,773549,12,773537
13841,10,9,587,919208,10,919198
13842,8,14,646,1076395,8,1076387
13843,9,-12,842,267782,9,267773
13844,12,6,726,841673,12,841661
13845,7,8,775,892268,7,892261
13846,18,-9,391,369626,18,369608
13847,11,-16,704,152087,11,152076
13848,15,14,329,1088031,15,1088016
13849,7,2,585,700891,7,700884
13850,19,7,292,869114,19,869095
13851,16,17,240,1179681,16,1179665
13852,11,17,677,1182887,11,1182876
13853,12,4,900,779905,12,779893
13854,7,-5,801,485218,7,485211
13855,18,11,698,995768,18,995750
13856,11,15,780,1122520,11,1122509
13857,11,2,796,716415,11,716404
13858,10,3,799,736026,10,736016
13859,15,16,429,1150232,15,1150217
13860,15,-9,97,367339,15,367324
13861,5,11,99,970599,5,970594
13862,15,2,245,712418,15,712403
13863,6,17,409,1163967,6,1163961
13864,20,-2,240,586959,20,586939
13865,5,-8,95,377391,5,377386
13866,11,18,156,1210228,11,1210217
13867,10,-3,315,537251,10,537241
13868,6,-17,426,102477,6,102471
13869,7,-18,835,80445,7,80438
13870,7,-14,536,198109,7,198102
13871,17,15,842,1122923,17,1122906
13872,7,-9,150,346790,7,346783
13873,20,-20,688,28117,20,28097
13874,15,-10,384,337816,15,337801
13875,12,11,644,995422,12,995410
13876,7,1,70,658517,7,658510
13877,13,-17,66,115973,13,115960
13878,15,-11,707,309255,15,309240
13879,16,-7,935,435238,16,435222
13880,7,-16,470,134376,7,134369
13881,20,1,218,681609,20,681589
13882,10,16,138,1128031,10,1128021
13883,11,-14,907,216563,11,216552
13884,7,7,13,845053,7,845046
13885,16,12,58,1022494,16,1022478
13886,20,11,64,991357,20,991337
13887,10,5,21,782028,10,782018
13888,16,-5,121,491874,16,491858
13889,6,0,815,643097,6,643091
13890,15,4,870,779743,15,779728
13891,12,-6,308,461545,12,461533
13892,19,-14,166,210555,19,210536
13893,15,-3,792,560150,15,560135
13894,11,-2,379,587905,11,587894
13895,18,-19,572,58533,18,58515
13896,10,-2,177,566434,10,566424
13897,20,19,397,1244055,20,1244035
13898,19,-15,316,180055,19,180036
13899,16,5,940,810691,16,810675
13900,17,17,213,1179468,17,1179451
13901,17,4,709,778474,17,778457
13902,20,-19,62,54324,20,54304
13903,19,0,921,655262,19,655243
13904,5,11,594,981224,5,981219
13905,7,19,496,1228783,7,1228776
13906,13,3,717,747307,13,747294
13907,7,-17,544,105212,7,105205
13908,10,7,804,861809,10,861799
13909,11,5,428,806873,11,806862
13910,19,14,983,1093156,19,1093137
13911,16,11,913,997505,16,997489
13912,16,15,3,1116747,16,1116731
13913,6,10,166,941172,6,941166
13914,19,-8,787,403506,19,403487
13915,7,10,65,938902,7,938895
13916,12,13,659,1058226,12,1058214
13917,13,-15,716,183109,13,183096
13918,14,-20,174,24096,14,24082
13919,16,3,673,746940,16,746924
13920,8,-10,193,316810,8,316802
13921,16,-4,559,526319,16,526303
13922,6,18,167,1190439,6,1190433
13923,6,-1,122,596441,6,596435
13924,17,-7,372,431166,17,431149
13925,8,5,290,787766,8,787758
13926,10,7,253,850248,10,850238
13927,18,-8,164,399064,18,399046
13928,14,-16,299,149145,14,149131
13929,13,-15,104,178576,13,178563
13930,19,15,342,1119299,19,1119280
13931,18,17,205,1179426,18,1179408
13932,18,-11,769,309715,18,309697
13933,15,17,243,1179711,15,1179696
13934,17,4,15,773367,17,773350
13935,6,-12,305,256260,6,256254
13936,19,1,923,687071,19,687052
13937,15,18,738,1214246,15,1214231
13938,8,-4,766,515796,8,515788
13939,14,12,184,1023389,14,1023375
13940,14,14,998,1093327,14,1093313
13941,9,15,819,1111770,9,1111761
13942,13,5,239,805601,13,805588
13943,12,12,140,1023046,12,1023034
13944,7,-8,671,389827,7,389820
13945,19,-17,429,118619,19,118600
13946,20,7,879,873354,20,873334
13947,9,-13,703,233286,9,233277
13948,20,-11,428,307181,20,307161
13949,5,14,905,1082054,5,1082049
13950,14,-17,537,119514,14,119500
13951,15,1,647,684937,15,684922
13952,6,-10,130,315488,6,315482
13953,5,-16,557,136124,5,136119
13954,17,0,370,650859,17,650842
13955,14,-3,837,560476,14,560462
13956,12,-12,145,273591,12,273579
13957,11,-18,915,91879,11,91868
13958,14,16,777,1152618,14,1152604
13959,13,3,350,744531,13,744518
13960,11,-12,475,276001,11,275990
13961,16,-10,40,335468,16,335452
13962,16,1,711,685332,16,685316
13963,12,-4,849,528301,12,528289
13964,12,13,997,1060603,12,1060591
13965,12,0,304,650360,12,650348
13966,8,-7,434,415208,8,415200
13967,19,-3,525,557976,19,557957
13968,6,5,822,798817,6,798811
13969,6,6,525,824280,6,824274
13970,12,-9,820,373044,12,373032
13971,12,15,591,1121081,12,1121069
13972,19,-7,532,432350,19,432331
13973,6,5,467,791300,6,791294
13974,15,6,83,836353,15,836338
13975,16,-13,701,246136,16,246120
13976,5,13,341,1038153,5,1038148
13977,9,17,639,1168975,9,1168966
13978,16,11,669,995589,16,995573
13979,18,-17,237,117211,18,117193
13980,13,6,864,842668,13,842655
13981,13,-20,230,24535,13,24522
13982,17,6,105,836539,17,836522
13983,6,10,609,950621,6,950615
13984,20,-11,295,306042,20,306022
13985,9,1,436,666643,9,666634
13986,5,-5,587,480763,5,480758
13987,10,2,518,699657,10,699647
13988,5,1,387,665665,5,665660
13989,10,2,396,697158,10,697148
13990,8,-12,599,262499,8,262491
13991,14,-19,317,56415,14,56401
13992,19,-2,838,591519,19,591500
13993,13,-13,308,243344,13,243331
13994,20,-1,210,618173,20,618153
13995,11,11,940,997664,11,997653
13996,16,19,679,1246263,16,1246247
13997,17,-4,742,527618,17,527601
13998,18,13,725,1058616,18,1058598
13999,13,-2,654,590052,13,590039
14000,9,-14,965,207573,9,207564
14001,9,2,529,699828,9,699819
14002,18,19,972,1248574,18,1248556
14003,13,-12,592,276831,13,276818
14004,15,5,607,808237,15,808222
14005,12,-8,452,401015,12,401003
14006,7,11,540,980015,7,980008
14007,16,18,636,1213531,16,1213515
14008,6,1,669,671759,6,671753
14009,15,-10,634,339813,15,339798
14010,6,16,587,1137463,6,1137457
14011,13,-13,759,246654,13,246641
14012,10,12,666,1013634,10,1013624
14013,5,17,538,1166778,5,1166773
14014,13,14,497,1089345,13,1089332
14015,18,7,439,870307,18,870289
14016,19,-15,360,180384,19,180365
14017,19,-7,8,428311,19,428292
14018,11,18,100,1209731,11,1209720
14019,11,-8,475,401127,11,401116
14020,18,-10,241,336829,18,336811
14021,5,1,427,666445,5,666440
14022,12,13,455,1056633,12,1056621
14023,16,-16,446,150315,16,150299
14024,10,11,377,976488,10,976478
14025,9,11,708,983509,9,983500
14026,8,-15,959,175955,8,175947
14027,8,-5,366,476156,8,476148
14028,17,5,921,810493,17,810476
14029,8,-17,881,112093,8,112085
14030,10,-19,933,51535,10,51525
14031,20,16,973,1154101,20,1154081
14032,18,12,617,1026603,18,1026585
14033,7,4,802,768070,7,768063
14034,12,18,717,1214070,12,1214058
14035,7,-17,628,107036,7,107029
14036,16,-10,937,342153,16,342137
14037,5,-8,636,388976,5,388971
14038,6,1,836,675087,6,675081
14039,9,-6,961,457248,9,457239
14040,7,13,903,1050070,7,1050063
14041,13,-5,854,497257,13,497244
14042,16,14,545,1089723,16,1089707
14043,20,13,245,1055018,20,1054998
14044,13,11,949,997685,13,997672
14045,6,-3,397,539169,6,539163
14046,18,-20,840,29330,18,29312
14047,16,-9,302,368786,16,368770
14048,17,18,327,1211484,17,1211467
14049,11,-3,309,556023,11,556012
14050,19,16,106,1147825,19,1147806
14051,20,2,646,715407,20,715387
14052,9,-3,473,541090,9,541081
14053,9,-14,629,200569,9,200560
14054,10,-2,313,569501,10,569491
14055,19,-10,798,341109,19,341090
14056,6,16,619,1138148,6,1138142
14057,15,18,887,1215468,15,1215453
14058,7,-6,281,442946,7,442939
14059,5,0,352,632824,5,632819
14060,20,-10,608,339617,20,339597
14061,10,-7,796,422591,10,422581
14062,11,18,739,1214256,11,1214245
14063,17,18,189,1210546,17,1210529
14064,14,-8,536,401640,14,401626
14065,17,19,951,1248405,17,1248388
14066,6,-5,955,488768,6,488762
14067,6,-6,46,437831,6,437825
14068,20,13,748,1058786,20,1058766
14069,20,4,473,776669,20,776649
14070,13,5,522,807607,13,807594
14071,17,18,62,1209446,17,1209429
14072,14,6,705,841496,14,841482
14073,15,18,936,1215806,15,1215791
14074,11,-12,90,273193,11,273182
14075,8,-10,907,331947,8,331939
14076,13,1,321,682432,13,682419
14077,11,10,798,966090,11,966079
14078,18,15,815,1122755,18,1122737
14079,11,-19,276,56149,11,56138
14080,15,1,991,687491,15,687476
14081,13,-3,800,560212,13,560199
14082,5,13,736,1046532,5,1046527
14083,12,15,823,1122807,12,1122795
14084,18,-15,541,181738,18,181720
14085,7,4,731,766476,7,766469
14086,20,12,469,1025482,20,1025462
14087,10,-1,375,602241,10,602231
14088,9,7,456,854587,9,854578
14089,15,-9,358,369335,15,369320
14090,7,9,531,917996,7,917989
14091,20,-6,212,460799,20,460779
14092,14,13,231,1054923,14,1054909
14093,17,6,378,838714,17,838697
14094,8,-11,248,286459,8,286451
14095,14,16,908,1153586,14,1153572
14096,15,-10,186,336452,15,336437
14097,16,9,623,933704,16,933688
14098,9,-9,475,354255,9,354246
14099,5,4,238,755878,5,755873
14100,18,7,42,867354,18,867336
14101,7,-1,73,595381,7,595374
14102,12,14,759,1091399,12,1091387
14103,18,18,750,1214415,18,1214397
14104,7,16,375,1133132,7,1133125
14105,13,-4,668,527141,13,527128
14106,6,-3,217,535036,6,535030
14107,17,12,821,1028154,17,1028137
14108,14,-12,640,277200,14,277186
14109,8,14,93,1063859,8,1063851
14110,16,2,30,710689,16,710673
14111,18,-6,188,460617,18,460599
14112,16,-9,229,368235,16,368219
14113,5,17,829,1173154,5,1173149
14114,19,-11,675,309084,19,309065
14115,12,-18,852,91382,12,91370
14116,13,-20,478,26367,13,26354
14117,18,14,919,1092590,18,1092572
14118,10,4,998,772267,10,772257
14119,5,10,747,953562,5,953557
14120,5,-14,872,205419,5,205414
14121,20,-1,125,617506,20,617486
14122,19,-17,83,116179,19,116160
14123,18,-16,144,147993,18,147975
14124,15,14,419,1088747,15,1088732
14125,10,-12,654,263720,10,263710
14126,16,-8,50,398268,16,398252
14127,5,17,860,1173891,5,1173886
14128,18,-20,951,29991,18,29973
14129,8,-10,229,317549,8,317541
14130,10,6,834,831125,10,831115
14131,11,17,340,1180522,11,1180511
14132,10,2,753,704517,10,704507
14133,10,-2,774,579230,10,579220
14134,13,3,495,745517,13,745504
14135,15,-18,360,88021,15,88006
14136,20,6,978,843570,20,843550
14137,20,-4,178,523429,20,523409
14138,17,-3,988,561673,17,561656
14139,7,15,540,1105981,7,1105974
14140,15,7,606,871500,15,871485
14141,14,-15,155,178945,14,178931
14142,10,1,712,672425,10,672415
14143,19,19,30,1240947,19,1240928
14144,5,-2,431,571937,5,571932
14145,14,-12,51,272863,14,272849
14146,5,-16,280,130125,5,130120
14147,12,-12,203,273931,12,273919
14148,19,2,134,711623,19,711604
14149,7,-3,139,533411,7,533404
14150,11,18,927,1215738,11,1215727
14151,6,-8,821,392921,6,392915
14152,17,-19,319,56453,17,56436
14153,20,14,249,1087392,20,1087372
14154,12,2,624,715226,12,715214
14155,19,-10,28,335355,19,335336
14156,16,10,246,961654,16,961638
14157,11,9,716,934345,11,934334
14158,5,5,741,797115,5,797110
14159,9,-15,696,170218,9,170209
14160,18,17,153,1178970,18,1178952
14161,17,-9,426,369930,17,369913
14162,5,-17,304,100063,5,100058
14163,7,7,756,860727,7,860720
14164,11,-1,309,619037,11,619026
14165,5,19,382,1226121,5,1226116
14166,5,-1,198,597939,5,597934
14167,10,-1,408,602903,10,602893
14168,14,6,194,837199,14,837185
14169,15,-9,684,371828,15,371813
14170,12,7,543,871049,12,871037
14171,10,18,335,1194002,10,1193992
14172,13,-5,873,497418,13,497405
14173,13,7,286,869060,13,869047
14174,9,0,593,638210,9,638201
14175,19,-17,858,121874,19,121855
14176,15,18,478,1212507,15,1212492
14177,9,16,309,1131714,9,1131705
14178,20,-1,504,620558,20,620538
14179,14,19,634,1245914,14,1245900
14180,20,17,599,1182305,20,1182285
14181,16,9,946,936140,16,936124
14182,6,-16,630,137681,6,137675
14183,15,1,495,683795,15,683780
14184,16,13,61,1053670,16,1053654
14185,5,4,730,766465,5,766460
14186,5,-3,176,534147,5,534142
14187,11,4,738,778693,11,778682
14188,11,3,701,747178,11,747167
14189,15,-7,562,432531,15,432516
14190,11,-9,138,367579,11,367568
14191,19,18,102,1209751,19,1209732
14192,8,-8,140,378396,8,378388
14193,13,9,182,930407,13,930394
14194,19,-19,721,59617,19,59598
14195,17,-7,884,434816,17,434799
14196,7,13,112,1033095,7,1033088
14197,19,-1,15,616627,19,616608
14198,16,-11,303,306157,16,306141
14199,5,-11,635,295134,5,295129
14200,10,-1,118,596363,10,596353
14201,15,19,709,1246518,15,1246503
14202,10,-15,247,160697,10,160687
14203,10,-2,642,576379,10,576369
14204,10,-7,491,416342,10,416332
14205,7,1,841,675213,7,675206
14206,15,1,489,683709,15,683694
14207,18,6,786,842060,18,842042
14208,19,-2,541,589188,19,589169
14209,9,12,187,1003251,9,1003242
14210,11,-15,294,179917,11,179906
14211,16,19,532,1245173,16,1245157
14212,18,-1,386,619652,18,619634
14213,6,0,775,642318,6,642312
14214,15,1,969,687409,15,687394
14215,19,-10,809,341199,19,341180
14216,17,-18,675,90175,17,90158
14217,7,-17,929,113085,7,113078
14218,13,15,720,1122136,13,1122123
14219,16,19,849,1247614,16,1247598
14220,14,14,793,1091668,14,1091654
14221,13,7,602,871478,13,871465
14222,15,-6,142,460201,15,460186
14223,10,12,312,1006043,10,1006033
14224,14,-7,401,431393,14,431379
14225,20,-6,312,461585,20,461565
14226,14,6,577,840453,14,840439
14227,11,-16,16,146894,11,146883
14228,13,8,872,904723,13,904710
14229,17,-3,860,560659,17,560642
14230,14,-9,867,373447,14,373433
14231,8,-12,63,250926,8,250918
14232,15,-16,856,153182,15,153167
14233,15,4,729,778632,15,778617
14234,19,-4,22,522215,19,522196
14235,6,-2,521,573851,6,573845
14236,18,9,923,935980,18,935962
14237,15,0,453,651528,15,651513
14238,8,7,453,854523,8,854515
14239,15,10,278,961915,15,961900
14240,13,-4,296,524367,13,524354
14241,20,-15,754,183391,20,183371
14242,12,2,917,717294,12,717282
14243,19,-4,895,528780,19,528761
14244,10,-3,309,537111,10,537101
14245,13,10,440,963185,13,963172
14246,7,-7,386,414242,7,414235
14247,5,-18,24,62924,5,62919
14248,15,-18,526,89134,15,89119
14249,5,-7,762,421981,5,421976
14250,6,-7,747,421664,6,421658
14251,9,14,570,1074460,9,1074451
14252,6,15,318,1101280,6,1101274
14253,18,-9,528,370880,18,370862
14254,9,-6,616,450027,9,450018
14255,6,18,809,1203823,6,1203817
14256,14,14,923,1092637,14,1092623
14257,11,-4,403,525249,11,525238
14258,13,1,108,680662,13,680649
14259,16,12,136,1023030,16,1023014
14260,20,10,909,966793,20,966773
14261,17,-15,724,183187,17,183170
14262,9,6,535,824436,9,824427
14263,11,-16,523,150853,11,150842
14264,13,4,737,778680,13,778667
14265,6,-18,344,69917,6,69911
14266,10,-13,334,225396,10,225386
14267,12,19,123,1241784,12,1241772
14268,13,8,914,905092,13,905079
14269,12,12,196,1023426,12,1023414
14270,20,-19,99,54719,20,54699
14271,6,-19,59,32694,6,32688
14272,18,-8,546,401700,18,401682
14273,10,5,111,783884,10,783874
14274,17,3,149,742966,17,742949
14275,8,14,319,1068834,8,1068826
14276,18,12,659,1026940,18,1026922
14277,11,-9,708,372009,11,371998
14278,9,-1,827,611595,9,611586
14279,14,-20,295,25105,14,25091
14280,7,-18,831,80362,7,80355
14281,13,-5,353,493712,13,493699
14282,12,-3,632,558857,12,558845
14283,17,-13,948,248195,17,248178
14284,15,13,795,1059206,15,1059191
14285,8,10,1000,958827,8,958819
14286,19,3,46,742167,19,742148
14287,14,-5,660,495809,14,495795
14288,18,-9,845,373242,18,373224
14289,12,-20,237,24576,12,24564
14290,19,2,543,714691,19,714672
14291,14,-19,23,54050,14,54036
14292,6,-18,320,69474,6,69468
14293,14,-3,876,560788,14,560774
14294,11,-14,599,214248,11,214237
14295,20,-19,68,54401,20,54381
14296,13,-8,424,400824,13,400811
14297,13,-14,955,216890,13,216877
14298,19,-10,17,335274,19,335255
14299,11,-13,631,245708,11,245697
14300,20,-8,813,403722,20,403702
14301,14,14,79,1086053,14,1086039
14302,11,-10,631,339751,11,339740
14303,11,2,250,712457,11,712446
14304,18,-13,13,241132,18,241114
14305,19,-2,144,586182,19,586163
14306,7,-15,16,155661,7,155654
14307,18,-5,530,494975,18,494957
14308,18,-7,688,433286,18,433268
14309,7,10,443,947025,7,947018
14310,15,-3,434,557060,15,557045
14311,10,-13,380,226320,10,226310
14312,9,17,779,1171886,9,1171877
14313,8,16,965,1145361,8,1145353
14314,16,-14,998,217277,16,217261
14315,16,-12,843,278738,16,278722
14316,5,14,859,1081059,5,1081054
14317,12,5,373,806525,12,806513
14318,6,14,635,1076106,6,1076100
14319,12,9,808,935025,12,935013
14320,17,16,268,1149058,17,1149041
14321,11,3,80,742420,11,742409
14322,12,-8,750,403194,12,403182
14323,19,-20,791,28950,19,28931
14324,8,-8,388,383480,8,383472
14325,19,-16,442,150276,19,150257
14326,14,18,68,1209490,14,1209476
14327,12,6,955,843345,12,843333
14328,16,-1,947,623773,16,623757
14329,18,-14,777,215612,18,215594
14330,6,-8,332,382482,6,382476
14331,19,6,737,841741,19,841722
14332,7,-8,596,387946,7,387939
14333,13,-11,505,307793,13,307780
14334,19,-14,785,215669,19,215650
14335,11,3,29,741993,11,741982
14336,19,-18,104,86032,19,86013
14337,11,13,728,1058654,11,1058643
14338,14,-9,949,374070,14,374056
14339,20,14,764,1091458,20,1091438
14340,5,17,540,1166851,5,1166846
14341,14,15,282,1118872,14,1118858
14342,17,18,285,1211203,17,1211186
14343,19,15,894,1123303,19,1123284
14344,8,0,40,626144,8,626136
14345,14,-5,17,490898,14,490884
14346,8,-12,429,258855,8,258847
14347,5,-18,729,78098,5,78093
14348,8,14,401,1070678,8,1070670
14349,10,-8,770,391852,10,391842
14350,20,1,425,683171,20,683151
14351,17,16,64,1147539,17,1147522
14352,17,-15,549,181845,17,181828
14353,19,17,505,1181674,19,1181655
14354,13,-5,982,498252,13,498239
14355,11,-1,802,622726,11,622715
14356,7,-12,650,263618,7,263611
14357,11,-5,786,496707,11,496696
14358,10,-3,675,545707,10,545697
14359,6,-19,420,40517,6,40511
14360,17,0,799,654387,17,654370
14361,16,-1,617,621368,16,621352
14362,11,4,564,777343,11,777332
14363,19,-8,890,404189,19,404170
14364,9,3,787,735686,9,735677
14365,6,-5,885,487290,6,487284
14366,10,-7,286,411982,10,411972
14367,17,-20,405,25891,17,25874
14368,12,-15,66,178245,12,178233
14369,20,-9,393,369644,20,369624
14370,10,-18,667,76716,10,76706
14371,12,-8,670,402642,12,402630
14372,16,9,796,934958,16,934942
14373,11,-18,154,86434,11,86423
14374,14,-2,762,590827,14,590813
14375,14,6,247,837601,14,837587
14376,11,12,154,1023161,11,1023150
14377,17,-13,167,242248,17,242231
14378,16,-12,910,279425,16,279409
14379,20,-14,370,212390,20,212370
14380,6,19,976,1239119,6,1239113
14381,18,-4,205,523702,18,523684
14382,9,-17,913,112842,9,112833
14383,11,8,207,899608,11,899597
14384,11,4,722,778565,11,778554
14385,17,-15,197,179160,17,179143
14386,10,7,852,862846,10,862836
14387,10,-6,205,441335,10,441325
14388,12,16,570,1151130,12,1151118
14389,11,1,521,683971,11,683960
14390,7,2,335,695829,7,695822
14391,8,7,89,846757,8,846749
14392,14,-6,551,463432,14,463418
14393,18,7,472,870533,18,870515
14394,17,-13,225,242700,17,242683
14395,11,-5,836,497089,11,497078
14396,14,-7,459,431779,14,431765
14397,6,-12,299,256105,6,256099
14398,11,13,569,1057524,11,1057513
14399,15,18,950,1215955,15,1215940
14400,20,17,481,1181525,20,1181505
14401,6,2,375,696781,6,696775
14402,17,14,106,1086324,17,1086307
14403,15,6,103,836525,15,836510
14404,8,-17,441,102781,8,102773
14405,17,-7,162,429505,17,429488
14406,20,5,782,809462,20,809442
14407,9,-12,968,270711,9,270702
14408,7,19,156,1220931,7,1220924
14409,18,-1,784,622603,18,622585
14410,10,-4,815,516770,10,516760
14411,8,9,626,920087,8,920079
14412,17,0,162,649446,17,649429
14413,8,1,893,676420,8,676412
14414,20,-7,832,434336,20,434316
14415,15,16,723,1152253,15,1152238
14416,5,7,757,860774,5,860769
14417,7,-7,858,424059,7,424052
14418,15,0,63,648698,15,648683
14419,13,-4,146,523139,13,523126
14420,18,-12,773,278187,18,278169
14421,20,1,760,685780,20,685760
14422,14,-2,493,588864,14,588850
14423,14,2,272,712582,14,712568
14424,10,-15,955,175836,10,175826
14425,10,-8,168,379045,10,379035
14426,16,4,409,776159,16,776143
14427,15,-19,919,60923,15,60908
14428,12,-12,326,274968,12,274956
14429,6,7,849,862783,6,862777
14430,5,-9,984,365312,5,365307
14431,16,7,188,868363,16,868347
14432,5,1,997,678610,5,678605
14433,14,-16,930,153785,14,153771
14434,19,-19,858,60601,19,60582
14435,6,9,676,920959,6,920953
14436,7,-12,627,263064,7,263057
14437,15,-3,703,559376,15,559361
14438,6,15,832,1112111,6,1112105
14439,11,-13,447,244273,11,244262
14440,6,15,398,1102866,6,1102860
14441,17,3,891,748521,17,748504
14442,12,-8,82,398582,12,398570
14443,6,-18,148,65688,6,65682
14444,10,-13,472,228269,10,228259
14445,13,-20,127,23712,13,23699
14446,5,-13,98,220521,5,220516
14447,7,-10,468,322886,7,322879
14448,14,8,164,899244,14,899230
14449,15,15,454,1120011,15,1119996
14450,16,0,479,651758,16,651742
14451,13,-3,983,561643,13,561630
14452,19,12,262,1024040,19,1024021
14453,17,3,174,743156,17,743139
14454,14,2,905,717220,14,717206
14455,11,-11,10,303779,11,303768
14456,6,-14,222,191502,6,191496
14457,7,-12,984,271089,7,271082
14458,9,-1,711,609236,9,609227
14459,19,10,549,964040,19,964021
14460,7,17,726,1170763,7,1170756
14461,16,-3,155,554848,16,554832
14462,8,-15,374,163505,8,163497
14463,5,9,954,926965,5,926960
14464,12,1,186,681351,12,681339
14465,7,-3,143,533516,7,533509
14466,18,-9,438,370055,18,370037
14467,7,17,301,1161793,7,1161786
14468,15,12,70,1022567,15,1022552
14469,6,0,135,628382,6,628376
14470,5,11,961,988968,5,988963
14471,6,-1,124,596481,6,596475
14472,20,3,673,746950,20,746930
14473,10,4,15,750810,10,750800
14474,11,15,366,1119440,11,1119429
14475,5,-2,326,569761,5,569756
14476,6,-10,688,327540,6,327534
14477,19,9,217,930653,19,930634
14478,18,-1,639,621508,18,621490
14479,5,13,675,1045274,5,1045269
14480,7,8,89,876928,7,876921
14481,9,2,702,703471,9,703462
14482,18,-8,717,402967,18,402949
14483,17,-8,553,401757,17,401740
14484,7,2,783,704951,7,704944
14485,11,16,717,1152223,11,1152212
14486,6,8,979,896489,6,896483
14487,11,-17,989,122714,11,122703
14488,12,-16,587,151312,12,151300
14489,12,12,520,1025839,12,1025827
14490,15,13,152,1054321,15,1054306
14491,13,-19,394,57074,13,57061
14492,17,-11,493,307672,17,307655
14493,5,-20,109,2377,5,2372
14494,7,-17,701,108506,7,108499
14495,5,4,265,756311,5,756306
14496,15,2,975,717720,15,717705
14497,20,17,766,1183538,20,1183518
14498,6,6,372,820693,6,820687
14499,9,-18,810,79933,9,79924
14500,7,-15,914,174891,7,174884
14501,7,3,352,726529,7,726522
14502,13,-1,658,621652,13,621639
14503,12,-8,631,402292,12,402280
14504,10,-15,853,173620,10,173610
14505,19,2,649,715442,19,715423
14506,16,12,920,1029140,16,1029124
14507,18,-18,450,88641,18,88623
14508,9,-13,396,226651,9,226642
14509,19,-12,136,273566,19,273547
14510,20,-3,879,560814,20,560794
14511,18,14,972,1093043,18,1093025
14512,9,-7,328,413012,9,413003
14513,17,-5,241,492784,17,492767
14514,5,-16,642,137922,5,137917
14515,6,-19,727,47468,6,47462
14516,20,1,765,685834,20,685814
14517,12,-18,989,92406,12,92394
14518,16,9,344,931537,16,931521
14519,13,17,194,1179346,13,1179333
14520,11,14,460,1089043,11,1089032
14521,13,4,357,775795,13,775782
14522,15,14,240,1087295,15,1087280
14523,11,9,806,935025,11,935014
14524,8,7,992,865793,8,865785
14525,19,-11,638,308803,19,308784
14526,18,-19,553,58361,18,58343
14527,11,-12,790,278294,11,278283
14528,8,14,520,1073428,8,1073420
14529,20,-9,338,369153,20,369133
14530,14,13,304,1055424,14,1055410
14531,14,-18,686,90216,14,90202
14532,20,3,458,745261,20,745241
14533,11,1,525,684016,11,684005
14534,13,18,220,1210750,13,1210737
14535,14,3,459,745270,14,745256
14536,20,15,524,1120572,20,1120552
14537,16,-9,436,370022,16,370006
14538,12,-1,869,623186,12,623174
14539,12,7,47,867390,12,867378
14540,16,10,728,965485,16,965469
14541,16,7,907,873490,16,873474
14542,5,-11,652,295477,5,295472
14543,5,-9,208,347974,5,347969
14544,13,-17,495,119209,13,119196
14545,13,18,719,1214079,13,1214066
14546,17,6,27,836030,17,836013
14547,14,-20,846,29359,14,29345
14548,6,-18,427,71561,6,71555
14549,8,13,399,1039334,8,1039326
14550,6,-14,87,188467,6,188461
14551,20,15,747,1122361,20,1122341
14552,11,2,908,717253,11,717242
14553,17,-3,727,559558,17,559541
14554,13,1,227,681690,13,681677
14555,20,-2,151,586204,20,586184
14556,13,13,933,1060157,13,1060144
14557,12,4,931,780125,12,780113
14558,18,-8,325,400187,18,400169
14559,19,4,899,779894,19,779875
14560,10,-13,174,222029,10,222019
14561,13,8,202,899571,13,899558
14562,9,8,839,893446,9,893437
14563,15,3,723,747332,15,747317
14564,12,12,13,1022181,12,1022169
14565,8,18,136,1189779,8,1189771
14566,15,-5,517,494857,15,494842
14567,8,14,838,1080640,8,1080632
14568,7,-2,194,566915,7,566908
14569,20,14,715,1091120,20,1091100
14570,6,17,520,1166468,6,1166462
14571,18,8,45,898203,18,898185
14572,11,-13,676,245897,11,245886
14573,15,7,464,870472,15,870457
14574,14,-3,56,554179,14,554165
14575,8,-7,586,418443,8,418435
14576,13,-2,544,589204,13,589191
14577,19,6,41,836127,19,836108
14578,5,2,744,704301,5,704296
14579,19,10,114,960771,19,960752
14580,11,18,448,1212318,11,1212307
14581,11,6,750,841795,11,841784
14582,14,-17,934,122376,14,122362
14583,14,14,648,1090497,14,1090483
14584,11,0,44,648591,11,648580
14585,14,12,42,1022409,14,1022395
14586,14,-16,650,151769,14,151755
14587,15,17,455,1181352,15,1181337
14588,12,-16,461,150461,12,150449
14589,8,14,913,1082159,8,1082151
14590,6,-10,948,332825,6,332819
14591,11,11,365,993531,11,993520
14592,15,8,971,905495,15,905480
14593,8,-17,110,95759,8,95751
14594,16,4,870,779749,16,779733
14595,7,-7,403,414657,7,414650
14596,6,8,344,882767,6,882761
14597,19,-19,480,57649,19,57630
14598,6,-12,360,257470,6,257464
14599,13,0,260,650118,13,650105
14600,16,-2,530,589118,16,589102
14601,17,11,829,996829,17,996812
14602,6,13,147,1033776,6,1033770
14603,13,-6,69,459586,13,459573
14604,20,6,884,842818,20,842798
14605,8,15,607,1107340,8,1107332
14606,14,3,62,742294,14,742280
14607,9,-14,135,189414,9,189405
14608,20,-5,222,492614,20,492594
14609,6,-15,212,159798,6,159792
14610,17,-4,524,526088,17,526071
14611,16,-3,857,560631,16,560615
14612,14,-6,510,463096,14,463082
14613,16,14,231,1087224,16,1087208
14614,12,-6,418,462344,12,462332
14615,12,0,419,651300,12,651288
14616,11,8,424,901347,11,901336
14617,13,6,29,836040,13,836027
14618,10,17,202,1159532,10,1159522
14619,8,-1,473,604398,8,604390
14620,10,19,294,1224023,10,1224013
14621,15,-9,898,373695,15,373680
14622,17,19,22,1240880,17,1240863
14623,15,-12,40,272790,15,272775
14624,18,8,773,904077,18,904059
14625,5,18,63,1188154,5,1188149
14626,8,7,219,849416,8,849408
14627,10,-18,587,75057,10,75047
14628,16,1,314,682340,16,682324
14629,6,8,253,880719,6,880713
14630,8,14,293,1068311,8,1068303
14631,19,-18,203,86876,19,86857
14632,18,12,646,1026886,18,1026868
14633,6,9,916,926221,6,926215
14634,18,-4,277,524236,18,524218
14635,6,8,363,883115,6,883109
14636,11,-18,854,91395,11,91384
14637,8,-10,773,329096,8,329088
14638,18,7,947,873742,18,873724
14639,15,16,677,1151965,15,1151950
14640,20,14,541,1089685,20,1089665
14641,6,18,811,1203862,6,1203856
14642,14,-3,468,557363,14,557349
14643,17,-12,708,277728,17,277711
14644,7,-18,284,68659,7,68652
14645,12,12,631,1026706,12,1026694
14646,9,-12,381,257876,9,257867
14647,16,15,526,1120593,16,1120577
14648,6,6,164,815738,6,815732
14649,14,14,174,1086800,14,1086786
14650,19,4,781,778999,19,778980
14651,9,0,915,645206,9,645197
14652,18,4,950,780269,18,780251
14653,18,-4,477,525653,18,525635
14654,10,10,706,952777,10,952767
14655,7,11,676,982813,7,982806
14656,7,-16,639,137848,7,137841
14657,10,-6,719,452254,10,452244
14658,6,-20,626,13649,6,13643
14659,6,12,381,1007325,6,1007319
14660,20,-5,231,492675,20,492655
14661,6,5,565,793269,6,793263
14662,19,8,775,904101,19,904082
14663,16,12,557,1026111,16,1026095
14664,20,-20,198,24388,20,24368
14665,11,17,896,1184673,11,1184662
14666,15,-8,763,403290,15,403275
14667,15,-14,317,211848,15,211833
14668,17,-4,810,528062,17,528045
14669,11,16,691,1152021,11,1152010
14670,19,-8,806,403644,19,403625
14671,14,3,980,749362,14,749348
14672,12,16,730,1152315,12,1152303
14673,17,-8,883,404114,17,404097
14674,9,2,358,696437,9,696428
14675,9,-20,915,20230,9,20221
14676,7,11,660,982530,7,982523
14677,14,-7,529,432339,14,432325
14678,10,-6,94,438761,10,438751
14679,20,-12,32,272731,20,272711
14680,8,18,476,1196933,8,1196925
14681,13,9,429,932142,13,932129
14682,11,13,782,1059077,11,1059066
14683,11,-9,266,368530,11,368519
14684,19,-18,797,91041,19,91022
14685,17,-15,743,183313,17,183296
14686,19,16,547,1150961,19,1150942
14687,20,8,274,900096,20,900076
14688,18,17,410,1180964,18,1180946
14689,20,-14,57,209747,20,209727
14690,18,-18,749,90734,18,90716
14691,5,-11,539,293187,5,293182
14692,19,15,284,1118905,19,1118886
14693,17,9,249,930819,17,930802
14694,13,-13,453,244300,13,244287
14695,13,-7,923,435134,13,435121
14696,14,9,498,932659,14,932645
14697,15,3,721,747316,15,747301
14698,9,-20,462,9841,9,9832
14699,18,10,297,962046,18,962028
14700,15,17,939,1184922,15,1184907
14701,7,-12,415,258659,7,258652
14702,13,18,906,1215552,13,1215539
14703,18,14,443,1088913,18,1088895
14704,11,-15,208,179236,11,179225
14705,17,14,613,1090177,17,1090160
14706,9,1,2,657030,9,657021
14707,8,-20,176,3993,8,3985
14708,7,-15,857,173683,7,173676
14709,9,18,952,1206924,9,1206915
14710,17,-12,655,277342,17,277325
14711,9,15,112,1096902,9,1096893
14712,5,4,802,768075,5,768070
14713,9,-9,686,358631,9,358622
14714,17,-18,734,90604,17,90587
14715,14,15,970,1123936,14,1123922
14716,5,5,158,784817,5,784812
14717,9,6,357,820321,9,820312
14718,5,11,110,970806,5,970801
14719,15,-16,861,153254,15,153239
14720,7,-3,747,547153,7,547146
14721,11,-1,95,617296,11,617285
14722,14,11,210,992295,14,992281
14723,13,14,8,1085420,13,1085407
14724,10,14,803,1079930,10,1079920
14725,5,-17,540,105067,5,105062
14726,5,9,236,911694,5,911689
14727,17,-19,637,59019,17,59002
14728,11,2,543,714692,11,714681
14729,20,3,268,743909,20,743889
14730,9,-20,270,5949,9,5940
14731,12,-7,570,432594,12,432582
14732,7,16,928,1144550,7,1144543
14733,19,14,943,1092858,19,1092839
14734,15,-19,193,55568,15,55553
14735,14,-12,882,279109,14,279095
14736,7,3,27,719400,7,719393
14737,8,-17,798,110490,8,110482
14738,6,-10,807,329902,6,329896
14739,10,2,727,703958,10,703948
14740,18,2,610,715137,18,715119
14741,13,18,846,1215121,13,1215108
14742,19,5,151,804886,19,804867
14743,13,-6,871,465671,13,465658
14744,17,-16,296,149144,17,149127
14745,20,-17,356,118116,20,118096
14746,9,4,80,752323,9,752314
14747,19,-19,886,60772,19,60753
14748,16,8,83,898533,16,898517
14749,5,-1,939,614213,5,614208
14750,6,6,873,831946,6,831940
14751,19,10,15,959941,19,959922
14752,16,-13,895,247704,16,247688
14753,15,19,594,1245608,15,1245593
14754,5,-19,25,32054,5,32049
14755,13,-7,937,435249,13,435236
14756,7,-16,227,129033,7,129026
14757,6,-19,591,44450,6,44444
14758,6,-15,132,158337,6,158331
14759,12,12,790,1027934,12,1027922
14760,18,-5,713,496239,18,496221
14761,8,16,903,1143874,8,1143866
14762,7,9,672,920862,7,920855
14763,20,3,285,744065,20,744045
14764,14,-17,93,116265,14,116251
14765,7,6,416,821772,7,821765
14766,20,3,481,745431,20,745411
14767,13,6,574,840425,13,840412
14768,6,7,854,862860,6,862854
14769,20,1,260,681970,20,681950
14770,9,-3,358,538224,9,538215
14771,17,5,998,811112,17,811095
14772,11,4,923,780068,11,780057
14773,12,19,325,1243379,12,1243367
14774,8,-5,102,470347,8,470339
14775,20,10,18,959954,20,959934
14776,19,0,561,652475,19,652456
14777,18,-5,592,495412,18,495394
14778,14,16,44,1147390,14,1147376
14779,7,-15,27,155953,7,155946
14780,15,8,694,903445,15,903430
14781,20,8,108,898781,20,898761
14782,6,-11,804,298343,6,298337
14783,13,19,557,1245327,13,1245314
14784,19,-10,55,335561,19,335542
14785,16,7,721,872240,16,872224
14786,7,-5,800,485183,7,485176
14787,19,-9,377,369486,19,369467
14788,11,5,467,807243,11,807232
14789,6,1,93,659064,6,659058
14790,17,-17,598,120015,17,119998
14791,17,-13,156,242159,17,242142
14792,11,-8,240,399595,11,399584
14793,5,17,948,1175603,5,1175598
14794,6,1,225,662133,6,662127
14795,8,10,15,937803,8,937795
14796,15,15,658,1121623,15,1121608
14797,5,16,280,1131123,5,1131118
14798,16,-3,550,558130,16,558114
14799,20,19,929,1248249,20,1248229
14800,18,16,630,1151572,18,1151554
14801,15,14,545,1089728,15,1089713
14802,11,10,645,964905,11,964894
14803,15,6,956,843349,15,843334
14804,17,8,48,898247,17,898230
14805,11,9,212,930614,11,930603
14806,13,4,869,779731,13,779718
14807,7,8,479,885611,7,885604
14808,13,15,541,1120703,13,1120690
14809,13,5,859,809997,13,809984
14810,8,-6,764,453224,8,453216
14811,6,11,457,978176,6,978170
14812,17,-4,369,524979,17,524962
14813,20,-17,752,121219,20,121199
14814,17,0,33,648497,17,648480
14815,19,11,659,995518,19,995499
14816,16,9,394,931881,16,931865
14817,7,-5,260,473801,7,473794
14818,15,13,52,1053616,15,1053601
14819,18,10,181,961235,18,961217
14820,6,16,526,1136387,6,1136381
14821,17,-12,235,274226,17,274209
14822,7,5,14,781897,7,781890
14823,7,-5,350,475826,7,475819
14824,10,-14,257,192426,10,192416
14825,17,14,501,1089389,17,1089372
14826,8,10,38,938328,8,938320
14827,17,3,39,742111,17,742094
14828,19,4,142,774287,19,774268
14829,17,-20,972,30149,17,30132
14830,8,-15,352,163041,8,163033
14831,15,2,722,716047,15,716032
14832,20,-15,844,184112,20,184092
14833,13,-19,65,54355,13,54342
14834,11,10,269,961862,11,961851
14835,12,-15,324,180120,12,180108
14836,7,11,407,977243,7,977236
14837,17,-7,296,430563,17,430546
14838,15,19,126,1241808,15,1241793
14839,5,-9,81,345380,5,345375
14840,18,14,22,1085543,18,1085525
14841,10,5,676,795578,10,795568
14842,20,-4,952,529200,20,529180
14843,9,19,402,1226639,9,1226630
14844,20,-6,874,465711,20,465691
14845,16,10,541,963991,16,963975
14846,11,-4,978,529449,11,529438
14847,8,-9,977,365252,8,365244
14848,7,-3,629,544546,7,544539
14849,15,9,280,930978,15,930963
14850,13,14,904,1092525,13,1092512
14851,20,1,635,684871,20,684851
14852,5,-15,583,167962,5,167957
14853,9,-5,407,476833,9,476824
14854,19,1,426,683185,19,683166
14855,17,-11,866,310512,17,310495
14856,7,1,738,673064,7,673057
14857,9,8,499,886175,9,886166
14858,15,-9,887,373613,15,373598
14859,18,-20,327,25399,18,25381
14860,18,14,529,1089586,18,1089568
14861,9,-18,227,67402,9,67393
14862,9,-9,903,363938,9,363929
14863,8,-12,620,262923,8,262915
14864,13,9,536,932974,13,932961
14865,9,-9,326,350724,9,350715
14866,14,6,306,838097,14,838083
14867,12,14,367,1088304,12,1088292
14868,13,-17,368,118218,13,118205
14869,18,18,611,1213327,18,1213309
14870,16,-20,405,25897,16,25881
14871,12,4,224,774878,12,774866
14872,18,9,294,931069,18,931051
14873,8,-12,902,269255,8,269247
14874,19,-9,770,372642,19,372623
14875,19,1,21,679937,19,679918
14876,15,-12,130,273512,15,273497
14877,10,14,944,1082981,10,1082971
14878,8,-6,958,457202,8,457194
14879,13,-10,418,338127,13,338114
14880,8,11,738,984198,8,984190
14881,13,-15,161,178963,13,178950
14882,15,-18,586,89501,15,89486
14883,18,1,453,683428,18,683410
14884,5,6,205,816675,5,816670
14885,14,6,711,841533,14,841519
14886,6,6,782,829828,6,829822
14887,17,-9,914,373841,17,373824
14888,13,13,636,1058052,13,1058039
14889,18,-2,609,589710,18,589692
14890,16,12,953,1029430,16,1029414
14891,8,-14,602,199861,8,199853
14892,12,-17,119,116423,12,116411
14893,12,1,432,683215,12,683203
14894,13,12,738,1027547,13,1027534
14895,7,-1,499,604930,7,604923
14896,18,9,244,930786,18,930768
14897,16,8,29,898087,16,898071
14898,17,15,260,1118693,17,1118676
14899,20,3,419,745015,20,744995
14900,11,2,127,711564,11,711553
14901,5,19,160,1221038,5,1221033
14902,17,-10,428,338189,17,338172
14903,18,-14,90,210035,18,210017
14904,12,19,1000,1248795,12,1248783
14905,20,4,290,775290,20,775270
14906,11,1,307,682267,11,682256
14907,13,-10,847,341448,13,341435
14908,19,17,186,1179302,19,1179283
14909,17,9,126,930000,17,929983
14910,11,-1,950,623811,11,623800
14911,5,18,95,1188818,5,1188813
14912,20,-15,808,183804,20,183784
14913,17,-15,965,185128,17,185111
14914,6,-17,964,113772,6,113766
14915,18,1,79,680366,18,680348
14916,7,-2,829,580549,7,580542
14917,16,-14,549,213713,16,213697
14918,10,10,86,939386,10,939376
14919,14,-18,173,86627,14,86613
14920,20,-7,281,430432,20,430412
14921,9,-7,181,409706,9,409697
14922,20,-16,503,150713,20,150693
14923,13,17,228,1179548,13,1179535
14924,19,-10,121,336000,19,335981
14925,10,13,769,1047273,10,1047263
14926,6,9,549,918328,6,918322
14927,8,10,832,955457,8,955449
14928,8,12,230,1004132,8,1004124
14929,16,-18,260,87324,16,87308
14930,11,3,296,744136,11,744125
14931,17,-14,751,215309,17,215292
14932,7,-6,844,454788,7,454781
14933,18,17,970,1185205,18,1185187
14934,14,3,23,741958,14,741944
14935,8,-17,558,105499,8,105491
14936,19,-20,6,4090,19,4071
14937,19,-20,769,28738,19,28719
14938,11,-12,247,274312,11,274301
14939,11,-10,929,342047,11,342036
14940,19,-18,304,87595,19,87576
14941,18,-14,849,216143,18,216125
14942,8,-11,143,284275,8,284267
14943,19,12,828,1028207,19,1028188
14944,11,-19,402,57139,11,57128
14945,16,-19,693,59397,16,59381
14946,10,-8,765,391779,10,391769
14947,11,-20,934,29902,11,29891
14948,7,-7,43,406981,7,406974
14949,12,9,707,934272,12,934260
14950,10,-10,526,323940,10,323930
14951,20,8,488,901830,20,901810
14952,6,-14,900,206043,6,206037
14953,20,-6,273,461314,20,461294
14954,15,11,446,994089,15,994074
14955,18,-1,966,623882,18,623864
14956,17,-3,863,560681,17,560664
14957,8,-17,210,97888,8,97880
14958,16,6,904,842969,16,842953
14959,12,-1,211,618180,12,618168
14960,13,-2,585,589530,13,589517
14961,12,-15,157,178964,12,178952
14962,8,16,859,1142944,8,1142936
14963,9,-16,725,139611,9,139602
14964,15,-16,715,152143,15,152128
14965,13,1,125,680810,13,680797
14966,6,-2,22,563241,6,563235
14967,17,-19,136,55105,17,55088
14968,15,5,179,805139,15,805124
14969,16,4,223,774875,16,774859
14970,16,16,344,1149615,16,1149599
14971,15,-19,706,59493,15,59478
14972,12,0,387,651011,12,650999
14973,9,-10,11,312762,9,312753
14974,6,7,333,851992,6,851986
14975,12,-7,991,435644,12,435632
14976,8,5,314,788103,8,788095
14977,5,19,335,1225086,5,1225081
14978,17,8,497,901897,17,901880
14979,14,16,222,1148711,14,1148697
14980,17,-1,455,620184,17,620167
14981,5,-18,705,77529,5,77524
14982,13,-8,172,399141,13,399128
14983,12,0,879,654892,12,654880
14984,7,-12,92,251560,7,251553
14985,11,-18,305,87601,11,87590
14986,16,-20,943,29953,16,29937
14987,19,-5,949,498015,19,497996
14988,20,-9,844,373234,20,373214
14989,10,6,863,831715,10,831705
14990,9,-16,453,133970,9,133961
14991,12,-4,638,526878,12,526866
14992,14,-20,279,24931,14,24917
14993,5,12,395,1007600,5,1007595
14994,20,9,890,935641,20,935621
14995,11,-5,592,495413,11,495402
14996,6,10,538,948973,6,948967
14997,9,10,204,941848,9,941839
14998,7,-16,308,130636,7,130629
14999,11,8,209,899640,11,899629
15000,13,15,252,1118658,13,1118645
15001,6,3,472,728929,6,728923
15002,19,9,787,934861,19,934842
15003,6,15,878,1113118,6,1113112
15004,13,19,543,1245257,13,1245244
15005,14,15,945,1123701,14,1123687
15006,17,12,913,1029043,17,1029026
15007,17,13,147,1054280,17,1054263
15008,5,-17,208,97830,5,97825
15009,11,-15,460,181141,11,181130
15010,9,-15,526,166756,9,166747
15011,9,1,290,663466,9,663457
15012,6,-18,770,79091,6,79085
15013,17,-2,980,592608,17,592591
15014,5,15,168,1097997,5,1097992
15015,9,13,356,1038450,9,1038441
15016,7,16,380,1133261,7,1133254
15017,13,17,981,1185318,13,1185305
15018,20,-11,793,309896,20,309876
15019,19,-5,454,494357,19,494338
15020,10,14,223,1066697,10,1066687
15021,13,-17,456,118883,13,118870
15022,9,-19,346,39027,9,39018
15023,8,10,217,942153,8,942145
15024,10,-13,985,239673,10,239663
15025,12,9,700,934218,12,934206
15026,18,-20,287,25034,18,25016
15027,9,-3,225,535204,9,535195
15028,8,17,23,1155742,8,1155734
15029,15,1,279,682089,15,682074
15030,14,10,686,965212,14,965198
15031,11,18,585,1213158,11,1213147
15032,16,-6,250,461099,16,461083
15033,14,3,936,748936,14,748922
15034,19,14,899,1092509,19,1092490
15035,5,-6,977,457622,5,457617
15036,13,18,663,1213768,13,1213755
15037,8,8,954,895891,8,895883
15038,14,-12,824,278555,14,278541
15039,18,7,119,867864,18,867846
15040,6,-10,848,330767,6,330761
15041,18,-10,499,338766,18,338748
15042,13,-19,917,60901,13,60888
15043,17,-3,671,559144,17,559127
15044,7,-7,493,416387,7,416380
15045,10,1,571,669805,10,669795
15046,20,-8,549,401746,20,401726
15047,20,12,356,1024694,20,1024674
15048,17,-6,799,465272,17,465255
15049,8,17,624,1168613,8,1168605
15050,16,-10,441,338303,16,338287
15051,12,18,478,1212509,12,1212497
15052,8,-15,475,165729,8,165721
15053,8,1,839,675148,8,675140
15054,15,16,315,1149407,15,1149392
15055,7,-2,600,575500,7,575493
15056,11,-9,741,372295,11,372284
15057,20,4,600,777652,20,777632
15058,18,13,609,1057890,18,1057872
15059,19,-6,451,462581,19,462562
15060,19,-10,583,339399,19,339380
15061,15,-3,907,561045,15,561030
15062,15,-15,647,182597,15,182582
15063,19,8,249,899961,19,899942
15064,20,17,958,1185079,20,1185059
15065,16,-16,227,148665,16,148649
15066,13,19,863,1247773,13,1247760
15067,9,-4,241,504893,9,504884
15068,11,18,743,1214318,11,1214307
15069,5,-16,529,135552,5,135547
15070,15,-11,912,310870,15,310855
15071,7,-4,775,515978,7,515971
15072,6,1,790,674150,6,674144
15073,14,5,681,808758,14,808744
15074,6,19,356,1225480,6,1225474
15075,20,-3,344,556315,20,556295
15076,12,-18,430,88507,12,88495
15077,16,15,683,1121771,16,1121755
15078,18,0,517,652079,18,652061
15079,12,0,695,653610,12,653598
15080,13,9,403,931974,13,931961
15081,8,0,93,627392,8,627384
15082,5,19,685,1232668,5,1232663
15083,6,13,764,1047186,6,1047180
15084,7,16,308,1131676,7,1131669
15085,13,-5,637,495690,13,495677
15086,17,1,60,680232,17,680215
15087,20,11,240,992539,20,992519
15088,8,-11,746,297279,8,297271
15089,8,18,908,1205950,8,1205942
15090,11,-19,153,55279,11,55268
15091,17,-20,48,23144,17,23127
15092,6,-5,792,485029,6,485023
15093,12,19,309,1243259,12,1243247
15094,9,13,34,1031486,9,1031477
15095,6,0,360,633003,6,632997
15096,15,4,521,777042,15,777027
15097,6,11,990,989648,6,989642
15098,8,15,533,1105869,8,1105861
15099,15,-9,776,372672,15,372657
15100,9,15,537,1105927,9,1105918
15101,5,-18,656,76482,5,76477
15102,17,-14,95,210067,17,210050
15103,8,-19,344,38953,8,38945
15104,19,1,889,686731,19,686712
15105,18,-3,48,554169,18,554151
15106,20,-7,300,430574,20,430554
15107,15,8,245,899955,15,899940
15108,20,15,109,1117605,20,1117585
15109,17,-16,65,147273,17,147256
15110,11,-16,96,147605,11,147594
15111,9,9,981,927691,9,927682
15112,14,12,436,1025260,14,1025246
15113,8,-20,123,2705,8,2697
15114,8,4,352,758133,8,758125
15115,6,-17,59,94668,6,94662
15116,17,2,888,717107,17,717090
15117,20,6,927,843141,20,843121
15118,7,-11,733,296961,7,296954
15119,16,18,37,1209172,16,1209156
15120,7,2,343,696035,7,696028
15121,12,-11,960,311238,12,311226
15122,8,15,475,1104471,8,1104463
15123,15,17,17,1177976,15,1177961
15124,13,2,75,711137,13,711124
15125,13,7,660,871858,13,871845
15126,8,1,961,677906,8,677898
15127,15,-17,615,120107,15,120092
15128,20,17,170,1179165,20,1179145
15129,19,10,921,966935,19,966916
15130,5,12,425,1008156,5,1008151
15131,15,19,676,1246241,15,1246226
15132,16,4,638,777892,16,777876
15133,7,-7,409,414759,7,414752
15134,13,-1,398,619733,13,619720
15135,13,12,702,1027352,13,1027339
15136,9,-6,10,437081,9,437072
15137,18,-14,180,210686,18,210668
15138,8,15,521,1105577,8,1105569
15139,10,-8,920,394983,10,394973
15140,11,-19,766,59978,11,59967
15141,11,6,80,836306,11,836295
15142,8,11,354,975985,8,975977
15143,17,-9,153,367688,17,367671
15144,16,-14,652,214601,16,214585
15145,17,13,591,1057739,17,1057722
15146,13,18,520,1212796,13,1212783
15147,16,-9,840,373173,16,373157
15148,12,-17,809,121597,12,121585
15149,16,-12,698,277636,16,277620
15150,6,-16,850,142224,6,142218
15151,16,-9,728,372129,16,372113
15152,10,7,875,863391,10,863381
15153,6,-14,419,195988,6,195982
15154,13,10,371,962624,13,962611
15155,8,-19,539,43214,8,43206
15156,5,-10,694,327650,5,327645
15157,9,-3,219,535093,9,535084
15158,8,-6,395,445221,8,445213
15159,20,-1,356,619470,20,619450
15160,11,1,311,682288,11,682277
15161,13,-19,968,61267,13,61254
15162,10,2,974,709006,10,708996
15163,12,0,693,653591,12,653579
15164,16,14,652,1090543,16,1090527
15165,11,16,932,1153766,11,1153755
15166,20,2,630,715297,20,715277
15167,17,6,670,841149,17,841132
15168,6,-1,763,610195,6,610189
15169,16,-10,107,335897,16,335881
15170,15,6,65,836241,15,836226
15171,20,-12,895,279222,20,279202
15172,8,18,482,1197055,8,1197047
15173,9,6,890,832305,9,832296
15174,10,12,146,1002271,10,1002261
15175,6,1,867,675865,6,675859
15176,10,-17,252,98798,10,98788
15177,6,-14,589,199555,6,199549
15178,9,-20,787,17305,9,17296
15179,18,19,178,1242169,18,1242151
15180,13,-1,675,621749,13,621736
15181,14,-14,115,210200,14,210186
15182,12,11,262,992703,12,992691
15183,14,-17,289,117641,14,117627
15184,12,-10,761,340826,12,340814
15185,17,8,549,902271,17,902254
15186,11,10,688,965227,11,965216
15187,7,-15,349,162996,7,162989
15188,10,0,563,637466,10,637456
15189,10,4,268,756358,10,756348
15190,17,-1,646,621529,17,621512
15191,10,15,730,1110035,10,1110025
15192,11,-15,25,177985,11,177974
15193,6,-3,897,550492,6,550486
15194,7,6,228,817320,7,817313
15195,20,-6,253,461136,20,461116
15196,19,-20,23,13640,19,13621
15197,19,14,856,1092089,19,1092070
15198,11,14,787,1091658,11,1091647
15199,15,19,635,1245933,15,1245918
15200,15,11,975,997880,15,997865
15201,15,-10,208,336602,15,336587
15202,12,-2,46,585496,12,585484
15203,15,1,123,680793,15,680778
15204,14,16,935,1153803,14,1153789
15205,15,-15,564,181933,15,181918
15206,7,-14,640,200840,7,200833
15207,10,-1,38,594604,10,594594
15208,7,12,585,1011660,7,1011653
15209,8,11,517,979533,8,979525
15210,20,7,779,872636,20,872616
15211,7,8,605,888395,7,888388
15212,5,15,695,1109241,5,1109236
15213,8,-8,129,378099,8,378091
15214,18,7,655,871817,18,871799
15215,5,17,707,1170361,5,1170356
15216,9,-19,427,40713,9,40704
15217,6,-7,264,411401,6,411395
15218,7,1,351,664885,7,664878
15219,5,5,423,790273,5,790268
15220,11,-9,212,368049,11,368038
15221,12,2,404,713709,12,713697
15222,20,5,173,805044,20,805024
15223,6,-6,141,439720,6,439714
15224,13,9,69,929559,13,929546
15225,8,-19,536,43112,8,43104
15226,19,-5,61,491297,19,491278
15227,15,-3,756,559820,15,559805
15228,5,-16,513,135199,5,135194
15229,8,-17,449,103013,8,103005
15230,13,-9,841,373191,13,373178
15231,10,4,397,759174,10,759164
15232,18,8,138,899024,18,899006
15233,15,-10,604,339586,15,339571
15234,14,-20,680,28031,14,28017
15235,10,-10,197,316905,10,316895
15236,17,-5,728,496368,17,496351
15237,15,-14,78,209924,15,209909
15238,10,17,490,1165806,10,1165796
15239,6,3,545,730237,6,730231
15240,7,-9,602,357051,7,357044
15241,7,11,849,986662,7,986655
15242,17,-9,287,368683,17,368666
15243,14,-18,296,87536,14,87522
15244,12,-18,651,89999,12,89987
15245,18,-17,788,121469,18,121451
15246,16,0,536,652263,16,652247
15247,12,5,536,807704,12,807692
15248,20,-14,964,216972,20,216952
15249,6,0,221,630274,6,630268
15250,17,-20,504,26627,17,26610
15251,5,13,120,1033306,5,1033301
15252,8,1,847,675401,8,675393
15253,9,10,936,957665,9,957656
15254,6,-2,802,579868,6,579862
15255,18,3,280,744009,18,743991
15256,7,14,995,1084160,7,1084153
15257,11,-10,910,341902,11,341891
15258,6,-16,859,142474,6,142468
15259,12,10,828,966242,12,966230
15260,17,-8,290,399925,17,399908
15261,7,7,699,859605,7,859598
15262,16,-11,686,309160,16,309144
15263,19,19,42,1241027,19,1241008
15264,12,-19,947,61142,12,61130
15265,16,-12,788,278280,16,278264
15266,8,14,352,1069528,8,1069520
15267,18,14,709,1091028,18,1091010
15268,12,-11,502,307765,12,307753
15269,6,2,532,699887,6,699881
15270,20,-4,651,527002,20,526982
15271,20,-4,789,527939,20,527919
15272,17,-4,135,523090,17,523073
15273,15,2,348,713208,15,713193
15274,8,7,67,846259,8,846251
15275,15,-5,205,492447,15,492432
15276,14,3,946,749046,14,749032
15277,8,18,785,1203348,8,1203340
15278,7,14,635,1076113,7,1076106
15279,10,-9,225,348389,10,348379
15280,5,-5,41,468766,5,468761
15281,6,-6,425,445883,6,445877
15282,18,-10,26,335334,18,335316
15283,7,17,719,1170612,7,1170605
15284,8,-16,872,142801,8,142793
15285,7,14,152,1065230,7,1065223
15286,5,2,587,700894,5,700889
15287,18,-3,831,560433,18,560415
15288,8,-6,502,447644,8,447636
15289,19,13,120,1054118,19,1054099
15290,17,-18,872,91553,17,91536
15291,18,-7,532,432358,18,432340
15292,16,9,239,930757,16,930741
15293,6,9,97,908759,6,908753
15294,9,10,251,942742,9,942733
15295,8,-4,671,513872,8,513864
15296,16,-1,327,619165,16,619149
15297,15,8,707,903564,15,903549
15298,9,-17,426,102486,9,102477
15299,14,-20,74,23339,14,23325
15300,18,-18,414,88394,18,88376
15301,15,18,399,1211996,15,1211981
15302,16,11,458,994176,16,994160
15303,6,5,329,788373,6,788367
15304,10,-9,688,358704,10,358694
15305,5,12,528,1010410,5,1010405
15306,16,9,169,930310,16,930294
15307,11,6,538,840110,11,840099
15308,17,-6,151,460272,17,460255
15309,7,4,193,754762,7,754755
15310,11,-1,241,618466,11,618455
15311,17,-20,807,29095,17,29078
15312,9,-2,827,580478,9,580469
15313,15,4,467,776603,15,776588
15314,13,2,226,712289,13,712276
15315,7,-1,332,601285,7,601278
15316,11,-5,978,498213,11,498202
15317,13,-20,947,29977,13,29964
15318,18,-8,132,398826,18,398808
15319,7,5,220,786293,7,786286
15320,20,15,434,1119851,20,1119831
15321,16,-8,934,404458,16,404442
15322,6,3,857,737334,6,737328
15323,9,-10,337,319876,9,319867
15324,14,-13,860,247458,14,247444
15325,14,11,910,997482,14,997468
15326,14,-5,773,496638,14,496624
15327,16,-3,733,559600,16,559584
15328,11,4,549,777239,11,777228
15329,8,10,787,954477,8,954469
15330,15,-14,915,216653,15,216638
15331,17,-5,409,494017,17,494000
15332,8,-20,906,20083,8,20075
15333,5,10,742,953460,5,953455
15334,14,19,67,1241286,14,1241272
15335,13,-7,254,430166,13,430153
15336,15,-10,189,336475,15,336460
15337,17,-17,791,121483,17,121466
15338,9,-20,419,8961,9,8952
15339,17,11,451,994113,17,994096
15340,11,11,874,997204,11,997193
15341,12,6,164,836981,12,836969
15342,16,18,869,1215286,16,1215270
15343,10,16,473,1135305,10,1135295
15344,5,8,613,888546,5,888541
15345,15,0,77,648772,15,648757
15346,14,-18,956,92181,14,92167
15347,12,-15,713,183068,12,183056
15348,16,0,163,649455,16,649439
15349,15,-3,875,560781,15,560766
15350,11,15,387,1119604,11,1119593
15351,12,9,161,930252,12,930240
15352,13,-17,777,121396,13,121383
15353,10,-3,461,540788,10,540778
15354,8,1,351,664893,8,664885
15355,7,7,131,847599,7,847592
15356,17,-20,537,26872,17,26855
15357,17,10,396,962800,17,962783
15358,18,2,371,713404,18,713386
15359,15,-17,680,120609,15,120594
15360,5,19,52,1218538,5,1218533
15361,5,-14,394,195430,5,195425
15362,7,-11,94,283101,7,283094
15363,20,9,853,935403,20,935383
15364,14,17,263,1179860,14,1179846
15365,7,9,798,923710,7,923703
15366,12,-4,182,523479,12,523467
15367,14,6,698,841432,14,841418
15368,16,17,430,1181135,16,1181119
15369,20,-12,98,273240,20,273220
15370,13,-6,737,464781,13,464768
15371,8,-5,684,482762,8,482754
15372,11,12,802,1028007,11,1027996
15373,11,14,873,1092250,11,1092239
15374,15,19,391,1243960,15,1243945
15375,7,-2,852,581022,7,581015
15376,15,-3,855,560605,15,560590
15377,12,16,790,1152740,12,1152728
15378,15,-6,551,463437,15,463422
15379,11,-17,277,117533,11,117522
15380,11,-16,891,153504,11,153493
15381,7,-2,369,570474,7,570467
15382,15,8,471,901658,15,901643
15383,13,7,611,871514,13,871501
15384,18,-17,180,116781,18,116763
15385,18,9,885,935632,18,935614
15386,11,-13,637,245724,11,245713
15387,13,-19,339,56656,13,56643
15388,16,5,139,804796,16,804780
15389,8,-12,277,255519,8,255511
15390,7,-16,384,132230,7,132223
15391,18,13,992,1060548,18,1060530
15392,11,17,615,1182424,11,1182413
15393,17,-3,663,559070,17,559053
15394,16,-18,144,86307,16,86291
15395,7,-14,876,205528,7,205521
15396,10,-13,839,236519,10,236509
15397,20,5,867,810080,20,810060
15398,13,-8,59,398372,13,398359
15399,12,4,897,779878,12,779866
15400,17,-3,720,559495,17,559478
15401,14,0,896,655078,14,655064
15402,12,12,868,1028619,12,1028607
15403,16,-11,667,309044,16,309028
15404,19,10,244,961642,19,961623
15405,18,-12,641,277215,18,277197
15406,12,10,622,964713,12,964701
15407,15,-4,844,528237,15,528222
15408,15,12,177,1023332,15,1023317
15409,13,-3,671,559147,13,559134
15410,5,-20,924,20368,5,20363
15411,17,-4,765,527762,17,527745
15412,14,-11,719,309301,14,309287
15413,15,-1,511,620608,15,620593
15414,20,4,147,774323,20,774303
15415,6,16,431,1134484,6,1134478
15416,7,12,908,1019107,7,1019100
15417,13,3,309,744270,13,744257
15418,7,-13,996,239912,7,239905
15419,10,18,698,1201344,10,1201334
15420,13,-8,460,401038,13,401025
15421,16,12,442,1025290,16,1025274
15422,5,-8,306,381856,5,381851
15423,19,-8,185,399221,19,399202
15424,18,12,64,1022525,18,1022507
15425,6,17,200,1159514,6,1159508
15426,5,-1,432,603389,5,603384
15427,8,-4,996,520890,8,520882
15428,12,-9,658,371685,12,371673
15429,16,-1,685,621823,16,621807
15430,10,10,280,943452,10,943442
15431,6,3,690,733782,6,733776
15432,8,-19,56,32627,8,32619
15433,14,6,435,839249,14,839235
15434,12,8,707,903566,12,903554
15435,10,-11,402,290033,10,290023
15436,14,12,335,1024588,14,1024574
15437,7,14,625,1075817,7,1075810
15438,20,19,890,1247996,20,1247976
15439,15,19,177,1242150,15,1242135
15440,20,9,272,930908,20,930888
15441,12,-2,61,585596,12,585584
15442,5,-10,3,312550,5,312545
15443,17,14,133,1086510,17,1086493
15444,10,-3,215,534984,10,534974
15445,18,-10,799,341137,18,341119
15446,13,5,657,808557,13,808544
15447,13,19,580,1245543,13,1245530
15448,8,8,736,891487,8,891479
15449,17,-19,313,56402,17,56385
15450,18,10,510,963778,18,963760
15451,12,7,339,869496,12,869484
15452,10,-16,14,124204,10,124194
15453,18,-11,452,307399,18,307381
15454,5,-3,775,547849,5,547844
15455,11,5,93,804483,11,804472
15456,5,15,46,1095440,5,1095435
15457,17,-9,663,371719,17,371702
15458,8,7,802,861752,8,861744
15459,12,-12,291,274655,12,274643
15460,18,-18,174,86646,18,86628
15461,19,-11,757,309604,19,309585
15462,8,12,893,1018686,8,1018678
15463,12,-20,989,30352,12,30340
15464,20,12,747,1027629,20,1027609
15465,15,18,852,1215191,15,1215176
15466,20,2,935,717414,20,717394
15467,20,-14,330,211991,20,211971
15468,20,18,127,1209950,20,1209930
15469,5,14,976,1083646,5,1083641
15470,6,-13,894,237665,6,237659
15471,8,-2,674,577114,8,577106
15472,12,-15,709,183053,12,183041
15473,5,15,853,1112631,5,1112626
15474,8,-6,956,457131,8,457123
15475,20,16,212,1148651,20,1148631
15476,15,14,325,1087989,15,1087974
15477,9,-14,229,191727,9,191718
15478,13,-5,683,495976,13,495963
15479,16,-18,647,89953,16,89937
15480,10,16,522,1136344,10,1136334
15481,10,8,742,891563,10,891553
15482,6,10,870,956228,6,956222
15483,7,4,787,767770,7,767763
15484,16,5,422,806822,16,806806
15485,20,5,609,808253,20,808233
15486,20,7,101,867747,20,867727
15487,14,-9,76,367217,14,367203
15488,7,-20,228,5160,7,5153
15489,20,-6,986,466624,20,466604
15490,5,-12,222,254363,5,254358
15491,18,16,306,1149337,18,1149319
15492,5,-17,127,96071,5,96066
15493,10,16,501,1135823,10,1135813
15494,13,-3,369,556506,13,556493
15495,10,5,305,787900,10,787890
15496,13,15,619,1121328,13,1121315
15497,15,-5,288,493186,15,493171
15498,8,3,397,727357,8,727349
15499,19,-11,353,306579,19,306560
15500,14,6,185,837145,14,837131
15501,5,14,955,1083194,5,1083189
15502,7,7,189,848773,7,848766
15503,6,-6,914,456299,6,456293
15504,9,-3,799,548270,9,548261
15505,13,-12,823,278552,13,278539
15506,7,3,425,727927,7,727920
15507,10,6,777,829697,10,829687
15508,8,-20,112,2439,8,2431
15509,16,-1,836,622966,16,622950
15510,13,-15,515,181555,13,181542
15511,8,16,224,1129991,8,1129983
15512,11,-1,981,623989,11,623978
15513,17,11,725,996051,17,996034
15514,20,-15,860,184301,20,184281
15515,20,-11,44,303954,20,303934
15516,17,18,874,1215322,17,1215305
15517,18,13,685,1058387,18,1058369
15518,5,-7,966,426467,5,426462
15519,10,-18,303,69120,10,69110
15520,10,18,791,1203544,10,1203534
15521,15,-2,681,590251,15,590236
15522,11,-3,840,560496,11,560485
15523,7,8,312,882066,7,882059
15524,18,-14,830,215973,18,215955
15525,12,-2,900,591988,12,591976
15526,18,-16,917,153677,18,153659
15527,14,19,595,1245625,14,1245611
15528,11,-5,844,497136,11,497125
15529,5,13,309,1037331,5,1037326
15530,15,11,188,992149,15,992134
15531,16,4,719,778546,16,778530
15532,8,4,766,767307,8,767299
15533,11,-9,889,373623,11,373612
15534,15,1,333,682545,15,682530
15535,14,-10,455,338423,14,338409
15536,17,-5,948,498006,17,497989
15537,10,-20,119,2654,10,2644
15538,11,-12,331,275003,11,274992
15539,11,-16,467,150479,11,150468
15540,6,7,470,854875,6,854869
15541,12,-4,940,529111,12,529099
15542,10,-5,131,470926,10,470916
15543,11,-11,51,304023,11,304012
15544,6,-3,62,531791,6,531785
15545,12,1,52,680190,12,680178
15546,10,-12,775,266251,10,266241
15547,8,-9,919,364292,8,364284
15548,13,-20,737,28450,13,28437
15549,15,-17,12,115650,15,115635
15550,11,11,541,994754,11,994743
15551,17,-18,492,88913,17,88896
15552,8,10,752,953634,8,953626
15553,16,-19,184,55502,16,55486
15554,17,-1,867,623186,17,623169
15555,9,6,333,819810,9,819801
15556,6,-13,588,230940,6,230934
15557,6,-4,375,507770,6,507764
15558,7,-14,269,192660,7,192653
15559,13,0,714,653757,13,653744
15560,6,-12,975,270884,6,270878
15561,19,0,341,650633,19,650614
15562,13,1,229,681691,13,681678
15563,17,9,336,931483,17,931466
15564,7,-12,982,271059,7,271052
15565,19,16,623,1151500,19,1151481
15566,16,-3,163,554927,16,554911
15567,19,11,56,991294,19,991275
15568,18,-15,425,180938,18,180920
15569,18,2,231,712323,18,712305
15570,5,-2,661,576831,5,576826
15571,14,17,884,1184574,14,1184560
15572,15,2,533,714627,15,714612
15573,16,4,668,778124,16,778108
15574,15,7,919,873574,15,873559
15575,8,-1,848,612060,8,612052
15576,16,-8,788,403511,16,403495
15577,18,8,53,898270,18,898252
15578,8,-9,146,346687,8,346679
15579,14,-2,217,586765,14,586751
15580,7,-1,744,609802,7,609795
15581,7,-1,736,609676,7,609669
15582,7,5,122,784096,7,784089
15583,9,-6,70,438251,9,438242
15584,9,6,593,825708,9,825699
15585,8,10,284,943506,8,943498
15586,5,-6,422,445804,5,445799
15587,19,11,507,994529,19,994510
15588,17,-10,825,341304,17,341287
15589,11,-13,851,247348,11,247337
15590,11,-13,125,241913,11,241902
15591,19,19,800,1247245,19,1247226
15592,11,-8,460,401039,11,401028
15593,14,-13,780,246851,14,246837
15594,9,-1,551,605989,9,605980
15595,12,7,78,867572,12,867560
15596,16,8,206,899607,16,899591
15597,13,-2,42,585444,13,585431
15598,15,13,744,1058761,15,1058746
15599,13,10,636,964832,13,964819
15600,18,-17,890,122125,18,122107
15601,8,8,722,891156,8,891148
15602,13,-13,356,243651,13,243638
15603,5,-10,146,315841,5,315836
15604,12,-16,909,153619,12,153607
15605,18,-16,2,146722,18,146704
15606,16,-7,360,431077,16,431061
15607,5,-18,181,66449,5,66444
15608,10,6,511,823926,10,823916
15609,20,11,396,993786,20,993766
15610,14,-17,765,121311,14,121297
15611,12,3,297,744140,12,744128
15612,9,18,889,1205600,9,1205591
15613,9,-6,731,452534,9,452525
15614,6,15,88,1096323,6,1096317
15615,11,2,171,711889,11,711878
15616,8,-1,52,594919,8,594911
15617,6,-2,79,564516,6,564510
15618,11,-5,558,495148,11,495137
15619,5,-20,613,13379,5,13374
15620,20,10,950,967130,20,967110
15621,10,-9,548,356020,10,356010
15622,20,4,539,777154,20,777134
15623,20,-13,464,244361,20,244341
15624,9,-9,174,347257,9,347248
15625,8,14,155,1065334,8,1065326
15626,9,-9,723,359502,9,359493
15627,17,13,208,1054768,17,1054751
15628,13,11,361,993486,13,993473
15629,8,-4,833,517034,8,517026
15630,9,-11,331,288422,9,288413
15631,9,-16,980,145066,9,145057
15632,11,-9,403,369686,11,369675
15633,13,15,441,1119908,13,1119895
15634,14,15,461,1120044,14,1120030
15635,18,-9,870,373474,18,373456
15636,20,-4,253,524096,20,524076
15637,10,-17,611,106679,10,106669
15638,13,-16,189,148299,13,148286
15639,18,-17,545,119591,18,119573
15640,5,17,943,1175485,5,1175480
15641,18,-5,41,491165,18,491147
15642,12,0,237,650005,12,649993
15643,6,5,370,789260,6,789254
15644,16,2,899,717179,16,717163
15645,15,5,342,806293,15,806278
15646,5,2,460,698451,5,698446
15647,6,-3,723,546700,6,546694
15648,7,-16,608,137246,7,137239
15649,19,-10,225,336717,19,336698
15650,11,-7,32,428577,11,428566
15651,14,11,2,990854,14,990840
15652,11,18,473,1212454,11,1212443
15653,9,7,508,855686,9,855677
15654,20,8,57,898316,20,898296
15655,7,-10,308,319189,7,319182
15656,18,-14,668,214735,18,214717
15657,20,0,568,652531,20,652511
15658,18,12,984,1029710,18,1029692
15659,20,-7,886,434841,20,434821
15660,18,5,923,810530,18,810512
15661,13,12,537,1025980,13,1025967
15662,5,16,172,1128716,5,1128711
15663,9,0,225,630347,9,630338
15664,18,11,721,996012,18,995994
15665,5,-10,937,332606,5,332601
15666,5,5,970,802124,5,802119
15667,8,12,779,1015979,8,1015971
15668,16,-10,42,335472,16,335456
15669,10,16,161,1128428,10,1128418
15670,6,-18,874,81286,6,81280
15671,13,9,533,932952,13,932939
15672,13,-9,327,368999,13,368986
15673,14,-20,580,27201,14,27187
15674,20,-18,447,88612,20,88592
15675,5,-6,182,440874,5,440869
15676,14,-17,615,120111,14,120097
15677,17,8,390,901064,17,901047
15678,8,-20,651,14290,8,14282
15679,14,7,842,873100,14,873086
15680,6,-1,279,599944,6,599938
15681,10,19,856,1236615,10,1236605
15682,7,13,555,1042673,7,1042666
15683,9,9,141,909761,9,909752
15684,12,-19,433,57335,12,57323
15685,9,0,819,643154,9,643145
15686,11,15,746,1122335,11,1122324
15687,19,-2,606,589688,19,589669
15688,8,0,997,647096,8,647088
15689,7,9,830,924373,7,924366
15690,14,-16,177,148217,14,148203
15691,13,-9,726,372096,13,372083
15692,16,-7,264,430259,16,430243
15693,15,-12,861,278949,15,278934
15694,5,-7,965,426411,5,426406
15695,18,-1,343,619334,18,619316
15696,13,16,735,1152334,13,1152321
15697,15,4,883,779815,15,779800
15698,13,11,533,994705,13,994692
15699,15,-13,836,247243,15,247228
15700,12,-7,488,431984,12,431972
15701,8,-5,819,485639,8,485631
15702,17,18,103,1209759,17,1209742
15703,10,-3,104,532638,10,532628
15704,10,-18,392,70848,10,70838
15705,15,17,788,1183765,15,1183750
15706,10,13,15,1031124,10,1031114
15707,8,-1,503,604969,8,604961
15708,10,13,382,1038919,10,1038909
15709,6,-17,732,109196,6,109190
15710,9,-16,693,138867,9,138858
15711,7,-9,895,363706,7,363699
15712,12,-11,350,306537,12,306525
15713,14,15,814,1122748,14,1122734
15714,18,-17,187,116818,18,116800
15715,18,14,267,1087487,18,1087469
15716,13,16,213,1148668,13,1148655
15717,11,-14,625,214426,11,214415
15718,20,12,705,1027375,20,1027355
15719,19,-11,921,310910,19,310891
15720,19,-4,358,524936,19,524917
15721,8,-8,531,386519,8,386511
15722,13,3,558,745927,13,745914
15723,6,14,561,1074327,6,1074321
15724,6,-9,849,362474,6,362468
15725,8,-3,568,543280,8,543272
15726,8,-10,167,316258,8,316250
15727,20,-16,849,153142,20,153122
15728,16,6,345,838472,16,838456
15729,7,-15,22,155803,7,155796
15730,12,13,345,1055758,12,1055746
15731,6,12,912,1019181,6,1019175
15732,17,13,322,1055558,17,1055541
15733,7,2,267,694390,7,694383
15734,6,18,610,1199594,6,1199588
15735,15,16,2,1147119,15,1147104
15736,9,18,313,1193505,9,1193496
15737,20,-6,909,466022,20,466002
15738,12,19,139,1241884,12,1241872
15739,11,13,394,1056139,11,1056128
15740,15,11,682,995697,15,995682
15741,7,-5,845,486250,7,486243
15742,20,-18,175,86670,20,86650
15743,13,1,617,684694,13,684681
15744,11,-11,881,310643,11,310632
15745,16,18,242,1210909,16,1210893
15746,11,8,829,904412,11,904401
15747,18,0,521,652122,18,652104
15748,11,17,334,1180481,11,1180470
15749,10,-9,165,347083,10,347073
15750,10,13,229,1035581,10,1035571
15751,14,-18,286,87456,14,87442
15752,9,6,401,821399,9,821390
15753,19,3,889,748505,19,748486
15754,20,-5,904,497667,20,497647
15755,7,-15,171,159024,7,159017
15756,5,5,240,786668,5,786663
15757,12,-18,265,87357,12,87345
15758,18,-3,344,556323,18,556305
15759,15,12,948,1029381,15,1029366
15760,13,-7,824,434287,13,434274
15761,14,3,25,741964,14,741950
15762,5,19,615,1231257,5,1231252
15763,18,-10,872,341623,18,341605
15764,10,-5,92,470119,10,470109
15765,10,4,450,760312,10,760302
15766,17,1,433,683244,17,683227
15767,9,7,718,859931,9,859922
15768,11,5,306,806007,11,805996
15769,19,14,125,1086455,19,1086436
15770,7,-2,232,567690,7,567683
15771,13,7,630,871619,13,871606
15772,10,-17,527,104772,10,104762
15773,8,19,581,1230636,8,1230628
15774,5,-8,123,377956,5,377951
15775,12,-16,503,150715,12,150703
15776,16,1,852,686434,16,686418
15777,18,-2,225,586837,18,586819
15778,16,-4,490,525759,16,525743
15779,17,8,744,903844,17,903827
15780,20,12,102,1022782,20,1022762
15781,14,5,410,806754,14,806740
15782,17,10,849,966327,17,966310
15783,15,-2,907,592060,15,592045
15784,15,-13,678,245918,15,245903
15785,17,4,806,779174,17,779157
15786,13,0,322,650415,13,650402
15787,10,6,173,815941,10,815931
15788,11,14,261,1087467,11,1087456
15789,18,-20,790,28909,18,28891
15790,6,-18,88,64409,6,64403
15791,10,-11,276,287074,10,287064
15792,6,1,716,672555,6,672549
15793,17,-16,522,150846,17,150829
15794,11,-11,400,306921,11,306910
15795,14,1,894,686772,14,686758
15796,16,8,267,900046,16,900030
15797,15,-13,145,242074,15,242059
15798,16,0,418,651299,16,651283
15799,18,-12,265,274488,18,274470
15800,5,-8,545,386823,5,386818
15801,8,-3,200,534672,8,534664
15802,18,15,149,1117927,18,1117909
15803,16,16,858,1153229,16,1153213
15804,15,-2,843,591542,15,591527
15805,14,15,842,1122927,14,1122913
15806,8,9,262,912111,8,912103
15807,19,-8,827,403791,19,403772
15808,10,14,324,1068995,10,1068985
15809,5,-2,939,582961,5,582956
15810,17,-16,45,147089,17,147072
15811,8,-12,595,262359,8,262351
15812,20,-8,731,403063,20,403043
15813,19,2,248,712439,19,712420
15814,9,-4,400,508317,9,508308
15815,10,-5,905,487740,10,487730
15816,8,-17,825,110960,8,110952
15817,12,-18,491,88905,12,88893
15818,9,3,716,734382,9,734373
15819,5,-5,255,473655,5,473650
15820,15,-15,24,177984,15,177969
15821,13,4,54,773646,13,773633
15822,8,6,168,815809,8,815801
15823,7,-14,372,194894,7,194887
15824,6,9,545,918260,6,918254
15825,19,4,290,775299,19,775280
15826,20,-2,469,588670,20,588650
15827,7,-16,887,142992,7,142985
15828,20,4,808,779208,20,779188
15829,7,10,486,947854,7,947847
15830,9,9,285,912624,9,912615
15831,6,9,703,921549,6,921543
15832,9,1,846,675351,9,675342
15833,10,-1,903,613421,10,613411
15834,8,-2,253,568178,8,568170
15835,20,-1,306,619000,20,618980
15836,10,-8,566,387349,10,387339
15837,6,-20,854,18954,6,18948
15838,14,19,732,1246721,14,1246707
15839,14,-5,284,493142,14,493128
15840,10,9,489,917042,10,917032
15841,9,5,694,796022,9,796013
15842,19,14,854,1092057,19,1092038
15843,19,-10,892,341799,19,341780
15844,11,6,840,842521,11,842510
15845,17,-10,470,338601,17,338584
15846,18,6,100,836494,18,836476
15847,15,11,993,997991,15,997976
15848,16,16,701,1152079,16,1152063
15849,13,-8,520,401472,13,401459
15850,12,-11,434,307246,12,307234
15851,6,19,507,1229051,6,1229045
15852,7,-13,362,225942,7,225935
15853,17,-2,628,589849,17,589832
15854,6,-11,295,287513,6,287507
15855,10,-10,273,318426,10,318416
15856,15,-7,377,431217,15,431202
15857,11,18,81,1209568,11,1209557
15858,6,19,296,1224092,6,1224086
15859,17,16,923,1153732,17,1153715
15860,12,14,576,1089901,12,1089889
15861,13,3,30,742005,13,741992
15862,14,-12,917,279448,14,279434
15863,18,0,326,650464,18,650446
15864,6,10,490,947909,6,947903
15865,17,11,417,993909,17,993892
15866,8,18,294,1193181,8,1193173
15867,5,1,236,662368,5,662363
15868,12,8,18,898046,12,898034
15869,16,-9,116,367457,16,367441
15870,15,2,446,713995,15,713980
15871,9,6,812,830618,9,830609
15872,9,0,92,627340,9,627331
15873,11,14,716,1091126,11,1091115
15874,20,-6,836,465471,20,465451
15875,12,3,822,748014,12,748002
15876,13,8,686,903423,13,903410
15877,8,11,663,982582,8,982574
15878,7,-14,26,187049,7,187042
15879,15,-14,331,211998,15,211983
15880,9,0,813,643075,9,643066
15881,19,3,981,749392,19,749373
15882,16,-18,995,92444,16,92428
15883,18,-5,478,494589,18,494571
15884,17,-7,772,433930,17,433913
15885,14,11,428,993979,14,993965
15886,11,-19,71,54420,11,54409
15887,8,12,111,1001520,8,1001512
15888,14,-17,755,121239,14,121225
15889,13,15,987,1124038,13,1124025
15890,15,4,41,773558,15,773543
15891,9,10,494,947968,9,947959
15892,14,11,14,990963,14,990949
15893,17,-11,343,306474,17,306457
15894,9,-16,687,138730,9,138721
15895,17,-12,966,279829,17,279812
15896,8,11,487,978839,8,978831
15897,10,-19,692,46703,10,46693
15898,9,-13,42,219264,9,219255
15899,6,-7,329,413024,6,413018
15900,9,-9,364,351594,9,351585
15901,5,16,28,1125765,5,1125760
15902,15,6,396,838936,15,838921
15903,8,-19,568,43956,8,43948
15904,5,-14,485,197139,5,197134
15905,10,-16,546,135918,10,135908
15906,11,4,109,774053,11,774042
15907,15,8,46,898217,15,898202
15908,6,-9,905,363977,6,363971
15909,20,15,826,1122829,20,1122809
15910,13,-13,313,243380,13,243367
15911,19,-3,20,553967,19,553948
15912,16,-4,279,524253,16,524237
15913,12,16,461,1150417,12,1150405
15914,6,-2,25,563305,6,563299
15915,9,-15,867,173909,9,173900
15916,17,-5,106,491740,17,491723
15917,11,-19,574,58545,11,58534
15918,18,-15,367,180456,18,180438
15919,20,-4,272,524193,20,524173
15920,19,10,987,967360,19,967341
15921,18,-7,336,430891,18,430873
15922,17,-18,633,89834,17,89817
15923,11,-6,314,461609,11,461598
15924,9,-10,656,326811,9,326802
15925,16,-17,52,115909,16,115893
15926,10,0,288,631493,10,631483
15927,20,5,517,807582,20,807562
15928,10,-4,749,515424,10,515414
15929,7,-11,964,301907,7,301900
15930,14,4,11,773358,14,773344
15931,18,-10,567,339307,18,339289
15932,19,11,139,991820,19,991801
15933,15,-19,534,58143,15,58128
15934,6,-15,933,175255,6,175249
15935,12,15,509,1120447,12,1120435
15936,17,17,266,1179905,17,1179888
15937,9,-3,944,551620,9,551611
15938,17,4,461,776571,17,776554
15939,19,5,238,805594,19,805575
15940,5,12,244,1004452,5,1004447
15941,9,-4,594,512232,9,512223
15942,7,-19,158,35205,7,35198
15943,12,13,69,1053746,12,1053734
15944,10,-10,121,315223,10,315213
15945,19,10,317,962231,19,962212
15946,19,-19,184,55511,19,55492
15947,14,-3,45,554117,14,554103
15948,20,19,396,1244024,20,1244004
15949,11,1,677,685154,11,685143
15950,14,17,858,1184440,14,1184426
15951,13,-19,489,57710,13,57697
15952,20,-5,429,494162,20,494142
15953,18,-1,264,618608,18,618590
15954,5,12,601,1012046,5,1012041
15955,12,-14,395,212631,12,212619
15956,10,-3,832,548960,10,548950
15957,8,-8,514,386124,8,386116
15958,14,-20,170,24048,14,24034
15959,6,3,488,729274,6,729268
15960,15,14,571,1089878,15,1089863
15961,9,-12,509,260665,9,260656
15962,6,19,948,1238491,6,1238485
15963,19,-3,422,556953,19,556934
15964,11,-10,83,335804,11,335793
15965,5,12,847,1017596,5,1017591
15966,8,8,288,881504,8,881496
15967,12,-13,458,244325,12,244313
15968,20,5,938,810673,20,810653
15969,13,-2,686,590288,13,590275
15970,5,14,122,1064564,5,1064559
15971,13,11,75,991428,13,991415
15972,20,13,958,1060354,20,1060334
15973,11,17,515,1181763,11,1181752
15974,5,0,15,625504,5,625499
15975,5,8,419,884398,5,884393
15976,12,-2,455,588579,12,588567
15977,11,18,140,1210091,11,1210080
15978,19,-4,910,528923,19,528904
15979,13,-3,532,558037,13,558024
15980,8,0,148,628669,8,628661
15981,14,17,660,1182777,14,1182763
15982,20,12,641,1026830,20,1026810
15983,18,-15,798,183684,18,183666
15984,14,18,335,1211555,14,1211541
15985,13,7,374,869725,13,869712
15986,15,7,718,872225,15,872210
15987,11,-14,69,209824,11,209813
15988,10,-2,880,581707,10,581697
15989,10,-9,890,363601,10,363591
15990,12,-20,73,23324,12,23312
15991,18,-20,976,30233,18,30215
15992,6,-13,868,237117,6,237111
15993,16,17,238,1179671,16,1179655
15994,7,-9,637,357689,7,357682
15995,14,-11,472,307523,14,307509
15996,14,-9,2,366649,14,366635
15997,14,-14,440,212932,14,212918
15998,6,2,485,698967,6,698961
15999,12,-16,668,151811,12,151799
16000,14,8,846,904536,14,904522
16001,15,-8,140,398878,15,398863
16002,16,-20,724,28349,16,28333
16003,19,-3,744,559697,19,559678
16004,5,-12,9,249790,5,249785
16005,17,2,421,713808,17,713791
16006,11,-2,444,588458,11,588447
16007,8,-15,642,169347,8,169339
16008,19,-6,912,466063,19,466044
16009,13,-20,607,27415,13,27402
16010,7,-17,12,93793,7,93786
16011,12,5,22,803904,12,803892
16012,10,0,195,629765,10,629755
16013,13,5,952,810797,13,810784
16014,18,15,263,1118730,18,1118712
16015,18,16,889,1153403,18,1153385
16016,19,-15,401,180693,19,180674
16017,9,0,925,645469,9,645460
16018,15,15,699,1121924,15,1121909
16019,12,2,334,713093,12,713081
16020,7,17,313,1162045,7,1162038
16021,8,11,478,978625,8,978617
16022,17,-17,461,118937,17,118920
16023,15,0,10,648268,15,648253
16024,17,-14,990,217203,17,217186
16025,11,-20,19,11334,11,11323
16026,14,-17,165,116693,14,116679
16027,20,-4,382,525071,20,525051
16028,9,-16,895,143132,9,143123
16029,5,-5,583,480657,5,480652
16030,6,-3,172,534076,6,534070
16031,14,6,176,837065,14,837051
16032,19,16,865,1153250,19,1153231
16033,17,6,383,838755,17,838738
16034,5,-15,752,171528,5,171523
16035,11,13,633,1058036,11,1058025
16036,16,9,453,932310,16,932294
16037,14,16,704,1152117,14,1152103
16038,17,4,235,774986,17,774969
16039,10,7,612,857749,10,857739
16040,15,13,853,1059616,15,1059601
16041,20,-19,438,57391,20,57371
16042,5,18,751,1202547,5,1202542
16043,15,-7,65,428767,15,428752
16044,8,-18,500,73216,8,73208
16045,16,15,528,1120597,16,1120581
16046,7,18,269,1192741,7,1192734
16047,13,-19,69,54409,13,54396
16048,17,6,10,835825,17,835808
16049,12,17,639,1182601,12,1182589
16050,7,12,880,1018381,7,1018374
16051,19,-15,247,179570,19,179551
16052,11,-12,992,280038,11,280027
16053,10,-1,352,601791,10,601781
16054,18,-14,751,215317,18,215299
16055,6,5,568,793324,6,793318
16056,6,10,490,947915,6,947909
16057,17,-8,954,404662,17,404645
16058,13,-3,357,556398,13,556385
16059,7,18,707,1201534,7,1201527
16060,13,-17,628,120184,13,120171
16061,20,-14,90,210045,20,210025
16062,12,-19,447,57408,12,57396
16063,16,-8,156,399018,16,399002
16064,17,-15,319,180087,17,180070
16065,5,15,270,1100335,5,1100330
16066,18,3,988,749428,18,749410
16067,14,1,294,682176,14,682162
16068,13,-4,316,524551,13,524538
16069,11,10,401,962867,11,962856
16070,15,1,729,685527,15,685512
16071,10,-7,867,424246,10,424236
16072,19,-9,718,372062,19,372043
16073,13,-4,498,525818,13,525805
16074,16,-2,251,587029,16,587013
16075,19,18,649,1213652,19,1213633
16076,13,17,802,1183925,13,1183912
16077,16,11,50,991221,16,991205
16078,18,-7,198,429764,18,429746
16079,7,-15,72,156883,7,156876
16080,15,-20,467,26301,15,26286
16081,15,-7,395,431340,15,431325
16082,14,12,476,1025534,14,1025520
16083,7,14,821,1080333,7,1080326
16084,9,12,609,1012265,9,1012256
16085,15,10,272,961874,15,961859
16086,17,19,370,1243787,17,1243770
16087,17,-3,423,556974,17,556957
16088,13,19,275,1242962,13,1242949
16089,11,-16,544,150999,11,150988
16090,5,-20,962,21153,5,21148
16091,15,-20,484,26406,15,26391
16092,17,-17,296,117710,17,117693
16093,20,-11,104,304512,20,304492
16094,20,-5,463,494479,20,494459
16095,12,-15,724,183189,12,183177
16096,12,-2,51,585529,12,585517
16097,16,-11,770,309735,16,309719
16098,11,12,901,1028916,11,1028905
16099,5,-19,986,52616,5,52611
16100,16,17,836,1184239,16,1184223
16101,15,6,523,840058,15,840043
16102,9,-5,936,488429,9,488420
16103,8,-17,346,100926,8,100918
16104,14,4,573,777411,14,777397
16105,17,18,6,1208952,17,1208935
16106,17,8,170,899306,17,899289
16107,20,-11,376,306773,20,306753
16108,17,10,492,963567,17,963550
16109,18,2,955,717616,18,717598
16110,10,6,614,826162,10,826152
16111,16,-18,238,87189,16,87173
16112,14,16,715,1152215,14,1152201
16113,13,-2,236,586913,13,586900
16114,15,11,359,993462,15,993447
16115,6,17,806,1172631,6,1172625
16116,14,-3,629,558813,14,558799
16117,12,12,698,1027317,12,1027305
16118,14,-19,224,55816,14,55802
16119,9,-12,90,251506,9,251497
16120,14,-6,667,464232,14,464218
16121,9,13,114,1033163,9,1033154
16122,17,-20,412,25921,17,25904
16123,14,-9,285,368666,14,368652
16124,19,-15,734,183265,19,183246
16125,12,14,159,1086737,12,1086725
16126,14,8,708,903581,14,903567
16127,13,18,179,1210398,13,1210385
16128,13,-16,229,148683,13,148670
16129,18,-16,315,149270,18,149252
16130,12,-20,293,25080,12,25068
16131,19,-3,243,555471,19,555452
16132,16,-13,548,245057,16,245041
16133,11,12,189,1023400,11,1023389
16134,12,8,666,903222,12,903210
16135,20,-3,380,556617,20,556597
16136,14,-20,462,26269,14,26255
16137,12,-20,634,27588,12,27576
16138,12,-20,471,26314,12,26302
16139,7,9,435,915799,7,915792
16140,7,13,869,1049430,7,1049423
16141,15,-2,193,586513,15,586498
16142,7,14,867,1081238,7,1081231
16143,18,-3,94,554433,18,554415
16144,12,16,346,1149625,12,1149613
16145,8,-15,26,155927,8,155919
16146,16,1,900,686822,16,686806
16147,16,-9,8,366713,16,366697
16148,18,14,105,1086316,18,1086298
16149,8,-4,24,499813,8,499805
16150,16,-15,126,178731,16,178715
16151,18,5,466,807227,18,807209
16152,15,7,268,868939,15,868924
16153,17,7,784,872670,17,872653
16154,7,-11,168,284777,7,284770
16155,11,-11,607,308582,11,308571
16156,12,6,795,842128,12,842116
16157,12,17,993,1185423,12,1185411
16158,7,-19,95,33502,7,33495
16159,17,10,768,965755,17,965738
16160,6,13,90,1032666,6,1032660
16161,14,-19,677,59250,14,59236
16162,6,0,431,634667,6,634661
16163,9,1,847,675410,9,675401
16164,6,10,865,956137,6,956131
16165,11,-14,585,214111,11,214100
16166,17,1,582,684481,17,684464
16167,14,-18,469,88796,14,88782
16168,20,4,61,773693,20,773673
16169,16,-14,299,211728,16,211712
16170,6,-19,746,47991,6,47985
16171,15,14,89,1086135,15,1086120
16172,14,-9,791,372834,14,372820
16173,10,16,378,1133203,10,1133193
16174,10,18,791,1203554,10,1203544
16175,15,-13,236,242767,15,242752
16176,18,-13,426,244122,18,244104
16177,14,19,601,1245661,14,1245647
16178,18,13,39,1053519,18,1053501
16179,17,3,831,748058,17,748041
16180,11,5,637,808449,11,808438
16181,12,-3,478,557447,12,557435
16182,16,9,550,933065,16,933049
16183,8,-1,601,606981,8,606973
16184,5,-14,588,199514,5,199509
16185,6,-15,615,168635,6,168629
16186,12,-11,249,305656,12,305644
16187,13,-3,487,557565,13,557552
16188,16,17,721,1183274,16,1183258
16189,17,7,503,870742,17,870725
16190,16,15,197,1118280,16,1118264
16191,18,3,202,743452,18,743434
16192,7,-14,666,201313,7,201306
16193,8,-11,981,302256,8,302248
16194,5,-17,160,96788,5,96783
16195,9,4,485,761004,9,760995
16196,7,9,84,908493,7,908486
16197,16,11,399,993825,16,993809
16198,20,16,180,1148409,20,1148389
16199,14,18,719,1214083,14,1214069
16200,19,-19,492,57756,19,57737
16201,16,-7,82,428862,16,428846
16202,9,-8,920,394992,9,394983
16203,20,12,478,1025561,20,1025541
16204,9,3,955,739579,9,739570
16205,5,-1,727,609496,5,609491
16206,15,-20,657,27802,15,27787
16207,7,-16,561,136217,7,136210
16208,14,-1,931,623681,14,623667
16209,9,8,521,886708,9,886699
16210,6,-9,850,362499,6,362493
16211,20,0,348,650669,20,650649
16212,16,-20,73,23330,16,23314
16213,17,18,317,1211390,17,1211373
16214,6,-11,239,286220,6,286214
16215,5,13,203,1035085,5,1035080
16216,9,15,245,1099770,9,1099761
16217,18,3,74,742370,18,742352
16218,12,-16,218,148589,12,148577
16219,20,5,199,805334,20,805314
16220,12,9,197,930506,12,930494
16221,14,14,807,1091779,14,1091765
16222,18,-20,975,30222,18,30204
16223,20,-9,385,369549,20,369529
16224,12,-6,78,459621,12,459609
16225,10,-18,63,63752,10,63742
16226,13,-12,666,277435,13,277422
16227,5,-1,602,606995,5,606990
16228,11,1,270,682060,11,682049
16229,9,-16,385,132248,9,132239
16230,14,13,680,1058345,14,1058331
16231,10,11,881,987504,10,987494
16232,15,-19,684,59329,15,59314
16233,10,-5,378,476306,10,476296
16234,15,13,173,1054478,15,1054463
16235,19,5,962,810915,19,810896
16236,17,0,564,652494,17,652477
16237,15,18,555,1213023,15,1213008
16238,19,0,338,650574,19,650555
16239,14,17,309,1180302,14,1180288
16240,16,18,349,1211635,16,1211619
16241,12,6,885,842831,12,842819
16242,8,-4,941,519622,8,519614
16243,19,-12,35,272762,19,272743
16244,9,-2,913,582360,9,582351
16245,14,1,248,681833,14,681819
16246,19,-1,878,623306,19,623287
16247,14,-14,523,213563,14,213549
16248,8,15,762,1110657,8,1110649
16249,15,13,531,1057125,15,1057110
16250,14,-3,259,555607,14,555593
16251,6,-16,899,143230,6,143224
16252,15,4,224,774883,15,774868
16253,12,-4,61,522500,12,522488
16254,15,-4,508,525951,15,525936
16255,5,17,181,1159068,5,1159063
16256,9,-14,925,206623,9,206614
16257,12,18,179,1210400,12,1210388
16258,20,12,557,1026121,20,1026101
16259,9,-18,898,81880,9,81871
16260,11,11,251,992634,11,992623
16261,10,10,998,958775,10,958765
16262,16,-17,354,118108,16,118092
16263,9,-7,244,410973,9,410964
16264,5,-8,237,380553,5,380548
16265,20,3,789,747787,20,747767
16266,11,-20,272,24855,11,24844
16267,9,15,239,1099575,9,1099566
16268,17,2,860,716898,17,716881
16269,6,-9,176,347304,6,347298
16270,13,8,282,900217,13,900204
16271,7,-19,612,44899,7,44892
16272,11,-13,772,246780,11,246769
16273,5,15,936,1114377,5,1114372
16274,5,2,278,694572,5,694567
16275,9,-17,390,101812,9,101803
16276,13,-8,464,401072,13,401059
16277,19,-20,176,24137,19,24118
16278,12,18,611,1213329,12,1213317
16279,12,1,983,687479,12,687467
16280,20,0,202,649785,20,649765
16281,11,-18,419,88423,11,88412
16282,19,10,496,963600,19,963581
16283,19,0,58,648686,19,648667
16284,20,1,311,682298,20,682278
16285,16,-9,460,370209,16,370193
16286,10,14,275,1067920,10,1067910
16287,10,-18,812,79961,10,79951
16288,7,-14,352,194358,7,194351
16289,9,1,730,672878,9,672869
16290,15,12,463,1025448,15,1025433
16291,19,-10,660,340049,19,340030
16292,7,0,671,640011,7,640004
16293,10,8,739,891524,10,891514
16294,18,0,978,655785,18,655767
16295,16,-12,222,274143,16,274127
16296,6,-19,318,38353,6,38347
16297,9,-6,206,441370,9,441361
16298,16,14,649,1090523,16,1090507
16299,19,4,34,773522,19,773503
16300,16,9,708,934292,16,934276
16301,11,-14,252,211381,11,211370
16302,16,-11,363,306643,16,306627
16303,20,6,424,839168,20,839148
16304,9,-19,818,49285,9,49276
16305,6,-3,317,537304,6,537298
16306,20,-7,899,434969,20,434949
16307,16,15,224,1118491,16,1118475
16308,13,-2,216,586741,13,586728
16309,11,6,503,839847,11,839836
16310,12,3,636,746637,12,746625
16311,11,9,890,935642,11,935631
16312,18,-10,99,335866,18,335848
16313,14,-3,193,555123,14,555109
16314,15,-20,34,19346,15,19331
16315,20,2,977,717735,20,717715
16316,9,8,665,889714,9,889705
16317,14,9,6,929078,14,929064
16318,16,-10,401,337943,16,337927
16319,17,-15,154,178940,17,178923
16320,20,-9,606,371404,20,371384
16321,14,-16,470,150515,14,150501
16322,7,-7,678,420153,7,420146
16323,11,6,5,835758,11,835747
16324,11,-14,935,216741,11,216730
16325,11,13,178,1054506,11,1054495
16326,14,-15,275,179770,14,179756
16327,10,-19,521,42804,10,42794
16328,17,-2,769,590877,17,590860
16329,13,8,993,905673,13,905660
16330,20,10,410,962954,20,962934
16331,16,16,120,1147898,16,1147882
16332,5,18,435,1196052,5,1196047
16333,5,-9,295,350012,5,350007
16334,16,-1,912,623528,16,623512
16335,9,7,929,864416,9,864407
16336,6,-4,488,509902,6,509896
16337,6,8,375,883323,6,883317
16338,8,16,365,1132909,8,1132901
16339,18,7,934,873666,18,873648
16340,20,-3,275,555718,20,555698
16341,13,10,782,965906,13,965893
16342,5,19,481,1228498,5,1228493
16343,17,18,275,1211166,17,1211149
16344,12,3,846,748206,12,748194
16345,20,-19,873,60712,20,60692
16346,8,-19,496,42185,8,42177
16347,17,7,251,868833,17,868816
16348,8,-11,932,301103,8,301095
16349,20,16,966,1154031,20,1154011
16350,15,-14,344,212064,15,212049
16351,10,-3,414,539548,10,539538
16352,17,-19,838,60446,17,60429
16353,18,11,903,997427,18,997409
16354,13,-6,156,460323,13,460310
16355,18,-12,61,272969,18,272951
16356,18,3,460,745277,18,745259
16357,18,-12,118,273413,18,273395
16358,13,15,324,1119152,13,1119139
16359,16,19,985,1248669,16,1248653
16360,8,2,110,690953,8,690945
16361,16,3,427,745060,16,745044
16362,18,0,934,655341,18,655323
16363,19,19,620,1245849,19,1245830
16364,7,2,533,699921,7,699914
16365,9,-20,860,19028,9,19019
16366,8,-16,544,135853,8,135845
16367,20,-19,246,55982,20,55962
16368,11,-2,585,589531,11,589520
16369,12,-19,930,61004,12,60992
16370,5,1,260,662899,5,662894
16371,20,3,748,747484,20,747464
16372,10,-13,410,226837,10,226827
16373,20,13,576,1057615,20,1057595
16374,15,-17,152,116601,15,116586
16375,17,-18,905,91781,17,91764
16376,16,14,857,1092099,16,1092083
16377,15,-10,248,336880,15,336865
16378,12,-13,416,244030,12,244018
16379,20,9,399,931920,20,931900
16380,5,4,707,765819,5,765814
16381,12,7,416,870120,12,870108
16382,6,14,50,1062923,6,1062917
16383,13,12,239,1023799,13,1023786
16384,11,6,126,836721,11,836710
16385,16,16,86,1147696,16,1147680
16386,15,12,977,1029650,15,1029635
16387,18,-5,969,498197,18,498179
16388,7,14,826,1080441,7,1080434
16389,8,-8,662,389598,8,389590
16390,15,-17,635,120254,15,120239
16391,17,2,338,713145,17,713128
16392,19,19,608,1245705,19,1245686
16393,7,-6,97,438800,7,438793
16394,5,-12,709,264853,5,264848
16395,17,-19,112,54873,17,54856
16396,11,-6,169,460426,11,460415
16397,12,3,328,744371,12,744359
16398,18,14,338,1088087,18,1088069
16399,10,-16,986,145200,10,145190
16400,20,-9,756,372454,20,372434
16401,6,-8,224,380290,6,380284
16402,18,-7,259,430217,18,430199
16403,12,11,448,994098,12,994086
16404,15,-16,701,152058,15,152043
16405,12,-11,582,308387,12,308375
16406,13,-16,327,149363,13,149350
16407,7,-1,763,610202,7,610195
16408,11,-10,904,341878,11,341867
16409,11,4,110,774070,11,774059
16410,15,-13,358,243661,15,243646
16411,10,-4,142,502467,10,502457
16412,12,11,540,994739,12,994727
16413,13,-15,421,180882,13,180869
16414,12,17,199,1179377,12,1179365
16415,12,-6,695,464483,12,464471
16416,10,15,240,1099604,10,1099594
16417,19,-7,675,433176,19,433157
16418,18,13,934,1060171,18,1060153
16419,17,16,756,1152448,17,1152431
16420,18,0,925,655308,18,655290
16421,9,7,747,860561,9,860552
16422,7,9,938,926673,7,926666
16423,6,-13,431,227388,6,227382
16424,16,-17,508,119300,16,119284
16425,11,-12,270,274523,11,274512
16426,11,11,502,994493,11,994482
16427,14,-7,520,432279,14,432265
16428,9,19,224,1222513,9,1222504
16429,16,1,481,683656,16,683640
16430,7,10,351,944933,7,944926
16431,15,10,727,965468,15,965453
16432,10,11,822,986005,10,985995
16433,6,3,707,734199,6,734193
16434,13,-10,520,338905,13,338892
16435,15,13,941,1060222,15,1060207
16436,5,10,330,944507,5,944502
16437,5,-7,980,426787,5,426782
16438,12,-8,548,401737,12,401725
16439,10,-3,677,545806,10,545796
16440,7,-10,833,330444,7,330437
16441,11,-6,551,463438,11,463427
16442,6,13,841,1048842,6,1048836
16443,6,-11,318,288157,6,288151
16444,8,10,89,939488,8,939480
16445,11,-13,722,246335,11,246324
16446,16,-6,45,459458,16,459442
16447,11,17,952,1185018,11,1185007
16448,15,4,358,775808,15,775793
16449,10,12,792,1016265,10,1016255
16450,20,-20,784,28856,20,28836
16451,11,-15,871,184375,11,184364
16452,15,7,205,868454,15,868439
16453,8,-14,38,187344,8,187336
16454,8,16,594,1137682,8,1137674
16455,12,0,295,650285,12,650273
16456,20,5,530,807641,20,807621
16457,12,1,595,684528,12,684516
16458,9,-8,630,388743,9,388734
16459,11,10,525,963901,11,963890
16460,17,-1,587,621154,17,621137
16461,6,-4,252,505173,6,505167
16462,7,11,283,974335,7,974328
16463,18,-5,981,498240,18,498222
16464,18,-2,861,591685,18,591667
16465,6,-15,32,156018,6,156012
16466,13,-14,954,216879,13,216866
16467,19,-4,649,526966,19,526947
16468,20,11,185,992120,20,992100
16469,15,17,500,1181632,15,1181617
16470,17,16,628,1151545,17,1151528
16471,15,3,549,745863,15,745848
16472,14,6,271,837830,14,837816
16473,8,-1,886,612967,8,612959
16474,19,-19,901,60826,19,60807
16475,15,14,878,1092295,15,1092280
16476,7,-12,9,249797,7,249790
16477,15,-20,405,25902,15,25887
16478,15,11,489,994416,15,994401
16479,19,3,12,741904,19,741885
16480,20,1,559,684309,20,684289
16481,20,-4,952,529210,20,529190
16482,11,0,444,651452,11,651441
16483,19,6,27,836039,19,836020
16484,7,19,865,1236831,7,1236824
16485,18,12,0,1022105,18,1022087
16486,19,-16,615,151568,19,151549
16487,18,-12,158,273695,18,273677
16488,12,-10,987,342537,12,342525
16489,16,2,964,717684,16,717668
16490,5,-5,431,477301,5,477296
16491,18,4,962,780318,18,780300
16492,14,13,606,1057856,14,1057842
16493,6,0,760,642038,6,642032
16494,18,2,884,717078,18,717060
16495,8,-8,262,381015,8,381007
16496,12,-5,41,491167,12,491155
16497,15,-18,230,87116,15,87101
16498,10,-20,738,16223,10,16213
16499,9,6,81,813843,9,813834
16500,11,18,774,1214580,11,1214569
16501,11,14,141,1086572,11,1086561
16502,13,7,309,869256,13,869243
16503,5,3,407,727534,5,727529
16504,20,-9,178,367804,20,367784
16505,6,-16,127,126842,6,126836
16506,9,-1,784,610708,9,610699
16507,19,9,359,931671,19,931652
16508,6,1,256,662801,6,662795
16509,16,-15,617,182306,16,182290
16510,17,-16,80,147459,17,147442
16511,20,2,531,714607,20,714587
16512,7,18,479,1197004,7,1196997
16513,14,-4,778,527858,14,527844
16514,6,-4,982,520558,6,520552
16515,13,8,909,905061,13,905048
16516,18,-17,225,117120,18,117102
16517,10,-13,436,227495,10,227485
16518,13,-15,943,184966,13,184953
16519,6,-14,435,196190,6,196184
16520,7,-14,362,194556,7,194549
16521,19,16,207,1148619,19,1148600
16522,5,13,130,1033491,5,1033486
16523,9,-1,115,596265,9,596256
16524,6,4,557,762594,6,762588
16525,20,-12,754,278039,20,278019
16526,15,10,999,967423,15,967408
16527,9,-12,779,266354,9,266345
16528,5,-16,978,145003,5,144998
16529,9,6,440,822377,9,822368
16530,8,18,240,1192065,8,1192057
16531,20,-1,460,620218,20,620198
16532,10,-11,349,288797,10,288787
16533,5,-15,898,174482,5,174477
16534,16,-10,947,342208,16,342192
16535,9,10,64,938856,9,938847
16536,16,5,706,808943,16,808927
16537,17,-18,923,91902,17,91885
16538,5,-9,308,350306,5,350301
16539,10,13,41,1031634,10,1031624
16540,8,9,843,924736,8,924728
16541,10,6,801,830330,10,830320
16542,18,3,438,745123,18,745105
16543,8,16,669,1139230,8,1139222
16544,16,-6,446,462530,16,462514
16545,5,5,912,800785,5,800780
16546,12,-14,621,214394,12,214382
16547,19,-17,731,121043,19,121024
16548,7,-17,629,107082,7,107075
16549,5,4,531,762113,5,762108
16550,8,17,849,1173641,8,1173633
16551,5,-2,937,582903,5,582898
16552,11,-15,790,183611,11,183600
16553,17,-11,902,310799,17,310782
16554,7,10,969,958233,7,958226
16555,18,18,775,1214596,18,1214578
16556,16,7,50,867417,16,867401
16557,7,-19,955,51984,7,51977
16558,10,-16,626,137613,10,137603
16559,5,16,207,1129578,5,1129573
16560,16,-9,23,366772,16,366756
16561,16,2,362,713335,16,713319
16562,16,-18,833,91279,16,91263
16563,20,7,796,872756,20,872736
16564,11,9,299,931142,11,931131
16565,18,6,890,842866,18,842848
16566,15,12,321,1024462,15,1024447
16567,16,-7,770,433917,16,433901
16568,8,-7,764,422042,8,422034
16569,9,-19,292,37870,9,37861
16570,6,11,150,971571,6,971565
16571,10,-10,728,328293,10,328283
16572,13,-7,401,431396,13,431383
16573,12,-8,712,402914,12,402902
16574,20,17,78,1178461,20,1178441
16575,13,-13,84,241643,13,241630
16576,13,-7,279,430388,13,430375
16577,19,-3,619,558720,19,558701
16578,10,-8,757,391561,10,391551
16579,10,-6,5,436954,10,436944
16580,13,-16,240,148726,13,148713
16581,11,19,517,1245041,11,1245030
16582,9,1,473,667514,9,667505
16583,7,-2,567,574812,7,574805
16584,11,-20,783,28847,11,28836
16585,11,10,16,959941,11,959930
16586,17,-19,400,57130,17,57113
16587,11,-9,938,374016,11,374005
16588,5,19,548,1229872,5,1229867
16589,8,19,813,1235514,8,1235506
16590,20,-5,312,493385,20,493365
16591,19,17,236,1179616,19,1179597
16592,10,18,385,1194992,10,1194982
16593,9,0,717,641103,9,641094
16594,19,17,323,1180389,19,1180370
16595,15,14,230,1087211,15,1087196
16596,10,19,196,1221832,10,1221822
16597,12,-18,83,85849,12,85837
16598,11,17,148,1178962,11,1178951
16599,17,15,265,1118743,17,1118726
16600,6,-14,903,206111,6,206105
16601,8,-8,203,379812,8,379804
16602,14,3,665,746858,14,746844
16603,8,17,571,1167392,8,1167384
16604,9,-1,787,610764,9,610755
16605,6,-18,63,63758,6,63752
16606,9,-7,536,417366,9,417357
16607,11,-11,153,304952,11,304941
16608,12,-17,743,121151,12,121139
16609,15,-6,282,461385,15,461370
16610,13,14,603,1090107,13,1090094
16611,12,17,910,1184765,12,1184753
16612,12,-16,867,153350,12,153338
16613,6,-15,136,158405,6,158399
16614,8,-1,613,607165,8,607157
16615,19,10,223,961539,19,961520
16616,13,-17,627,120176,13,120163
16617,11,2,812,716528,11,716517
16618,14,-3,413,556849,14,556835
16619,12,-18,381,88157,12,88145
16620,18,-10,734,340602,18,340584
16621,11,12,230,1023733,11,1023722
16622,13,19,967,1248523,13,1248510
16623,10,-14,387,195271,10,195261
16624,6,10,201,941781,6,941775
16625,5,-2,24,563275,5,563270
16626,14,-1,316,619099,14,619085
16627,10,16,449,1134891,10,1134881
16628,12,10,786,965919,12,965907
16629,18,-11,244,305593,18,305575
16630,12,-7,492,432013,12,432001
16631,13,6,830,842436,13,842423
16632,12,1,83,680410,12,680398
16633,10,-4,909,518937,10,518927
16634,8,11,710,983565,8,983557
16635,17,15,911,1123428,17,1123411
16636,15,-14,440,212937,15,212922
16637,15,-1,746,622301,15,622286
16638,11,-3,408,556812,11,556801
16639,19,10,141,960979,19,960960
16640,11,-19,565,58463,11,58452
16641,12,7,854,873155,12,873143
16642,20,-18,525,89130,20,89110
16643,15,10,938,967038,15,967023
16644,19,-11,222,305447,19,305428
16645,18,-20,591,27290,18,27272
16646,20,-8,219,399480,20,399460
16647,13,-16,847,153119,13,153106
16648,8,-13,617,231599,8,231591
16649,15,6,6,835775,15,835760
16650,10,-18,998,84164,10,84154
16651,5,4,989,772095,5,772090
16652,10,8,540,887011,10,887001
16653,20,0,210,649824,20,649804
16654,7,-14,739,202747,7,202740
16655,17,-19,546,58245,17,58228
16656,14,-8,243,399628,14,399614
16657,15,-1,31,616766,15,616751
16658,14,13,804,1059305,14,1059291
16659,18,13,323,1055567,18,1055549
16660,18,-19,709,59519,18,59501
16661,17,-7,911,435034,17,435017
16662,19,10,725,965445,19,965426
16663,17,-15,499,181458,17,181441
16664,12,9,1,929069,12,929057
16665,18,12,269,1024117,18,1024099
16666,16,18,64,1209472,16,1209456
16667,15,1,32,680028,15,680013
16668,15,-16,317,149280,15,149265
16669,13,-8,94,398614,13,398601
16670,12,18,74,1209526,12,1209514
16671,15,-3,530,558005,15,557990
16672,12,-7,175,429629,12,429617
16673,8,-7,622,419047,8,419039
16674,16,0,795,654318,16,654302
16675,17,3,370,744638,17,744621
16676,18,15,435,1119864,18,1119846
16677,13,4,347,775719,13,775706
16678,16,-13,293,243257,16,243241
16679,5,-4,27,499865,5,499860
16680,6,0,183,629532,6,629526
16681,6,-17,492,104034,6,104028
16682,17,-4,438,525434,17,525417
16683,5,-20,427,9106,5,9101
16684,8,13,968,1051435,8,1051427
16685,11,-19,667,59179,11,59168
16686,5,16,429,1134462,5,1134457
16687,5,-11,891,300228,5,300223
16688,11,4,154,774365,11,774354
16689,9,-2,546,574305,9,574296
16690,6,-7,185,409764,6,409758
16691,5,-8,954,395754,5,395749
16692,5,-7,570,418083,5,418078
16693,6,-19,185,35674,6,35668
16694,8,17,238,1160352,8,1160344
16695,13,-8,166,399075,13,399062
16696,19,10,877,966546,19,966527
16697,19,-10,978,342456,19,342437
16698,20,-10,83,335814,20,335794
16699,9,-5,19,468179,9,468170
16700,17,7,871,873311,17,873294
16701,8,-12,240,254692,8,254684
16702,10,-9,462,353838,10,353828
16703,19,19,715,1246566,19,1246547
16704,11,-16,608,151487,11,151476
16705,15,-4,970,529408,15,529393
16706,17,14,87,1086117,17,1086100
16707,5,-12,323,256690,5,256685
16708,13,3,904,748611,13,748598
16709,12,-6,771,465021,12,465009
16710,20,6,230,837496,20,837476
16711,13,-2,800,591139,13,591126
16712,12,-19,195,55585,12,55573
16713,8,18,270,1192766,8,1192758
16714,15,2,176,711913,15,711898
16715,19,-20,821,29170,19,29151
16716,9,3,859,737421,9,737412
16717,18,19,619,1245828,18,1245810
16718,8,4,185,754555,8,754547
16719,9,-9,976,365245,9,365236
16720,13,6,447,839327,13,839314
16721,13,4,551,777252,13,777239
16722,5,2,56,689823,5,689818
16723,11,8,596,902631,11,902620
16724,19,-1,964,623869,19,623850
16725,11,-6,646,464096,11,464085
16726,20,-5,441,494282,20,494262
16727,15,3,889,748510,15,748495
16728,16,8,443,901529,16,901513
16729,5,-2,78,564501,5,564496
16730,6,-2,15,563071,6,563065
16731,5,-13,748,234355,5,234350
16732,6,-3,673,545649,6,545643
16733,11,18,118,1209908,11,1209897
16734,15,-20,90,23445,15,23430
16735,6,10,555,949307,6,949301
16736,12,-5,174,492288,12,492276
16737,14,-5,791,496755,14,496741
16738,10,15,851,1112590,10,1112580
16739,17,-13,245,242835,17,242818
16740,7,-14,945,207034,7,207027
16741,18,5,781,809450,18,809432
16742,17,-20,370,25648,17,25631
16743,14,-7,756,433766,14,433752
16744,8,-2,364,570412,8,570404
16745,18,-1,12,616574,18,616556
16746,7,7,214,849321,7,849314
16747,6,14,866,1081192,6,1081186
16748,18,-11,948,311100,18,311082
16749,16,9,25,929221,16,929205
16750,10,15,228,1099415,10,1099405
16751,17,1,807,686123,17,686106
16752,17,-3,975,561578,17,561561
16753,18,-4,558,526303,18,526285
16754,8,13,681,1045411,8,1045403
16755,5,-13,41,219229,5,219224
16756,7,1,327,664400,7,664393
16757,17,-3,1000,561771,17,561754
16758,6,18,457,1196557,6,1196551
16759,7,1,825,674847,7,674840
16760,18,-9,566,371171,18,371153
16761,17,9,83,929655,17,929638
16762,5,2,400,697227,5,697222
16763,13,16,903,1153533,13,1153520
16764,17,9,177,930377,17,930360
16765,10,-6,28,437489,10,437479
16766,5,-8,47,376389,5,376384
16767,10,-7,599,418662,10,418652
16768,14,-2,810,591208,14,591194
16769,20,-5,461,494457,20,494437
16770,8,11,770,984966,8,984958
16771,20,10,129,960889,20,960869
16772,17,9,690,934134,17,934117
16773,16,-8,147,398961,16,398945
16774,5,2,131,691446,5,691441
16775,9,-14,86,188432,9,188423
16776,10,8,770,892120,10,892110
16777,18,5,989,811046,18,811028
16778,16,9,223,930708,16,930692
16779,17,-19,467,57539,17,57522
16780,19,19,609,1245721,19,1245702
16781,7,9,837,924573,7,924566
16782,9,-18,754,78777,9,78768
16783,10,-10,619,326026,10,326016
16784,14,-17,21,115709,14,115695
16785,9,12,989,1020909,9,1020900
16786,14,11,930,997641,14,997627
16787,10,3,910,738472,10,738462
16788,15,19,647,1246055,15,1246040
16789,14,19,602,1245664,14,1245650
16790,8,-19,377,39637,8,39629
16791,20,2,106,711380,20,711360
16792,16,4,42,773570,16,773554
16793,7,-2,532,574023,7,574016
16794,15,2,957,717632,15,717617
16795,19,4,591,777569,19,777550
16796,16,-18,962,92211,16,92195
16797,12,-18,380,88156,12,88144
16798,13,-15,454,181110,13,181097
16799,8,15,122,1097172,8,1097164
16800,17,17,225,1179523,17,1179506
16801,11,-2,366,587813,11,587802
16802,10,-2,885,581814,10,581804
16803,8,18,170,1190524,8,1190516
16804,5,17,709,1170394,5,1170389
16805,17,-14,491,213305,17,213288
16806,11,-7,746,433687,11,433676
16807,11,-4,371,525004,11,524993
16808,12,-15,710,183054,12,183042
16809,18,2,242,712395,18,712377
16810,16,16,634,1151632,16,1151616
16811,14,11,390,993741,14,993727
16812,13,-4,828,528117,13,528104
16813,20,11,787,996548,20,996528
16814,7,-16,356,131565,7,131558
16815,11,18,335,1211556,11,1211545
16816,5,-14,969,207661,5,207656
16817,8,-20,70,1529,8,1521
16818,13,-15,302,179971,13,179958
16819,20,14,591,1089966,20,1089946
16820,16,19,182,1242188,16,1242172
16821,20,9,401,931973,20,931953
16822,7,16,663,1139119,7,1139112
16823,20,-3,472,557412,20,557392
16824,9,-15,757,171587,9,171578
16825,20,3,640,746668,20,746648
16826,19,-20,828,29234,19,29215
16827,5,13,617,1044085,5,1044080
16828,20,-13,137,241989,20,241969
16829,10,-16,459,134119,10,134109
16830,10,-20,84,1897,10,1887
16831,17,13,490,1056820,17,1056803
16832,19,9,161,930261,19,930242
16833,8,-2,107,565124,8,565116
16834,7,-7,354,413567,7,413560
16835,20,16,763,1152500,20,1152480
16836,19,10,229,961570,19,961551
16837,13,-16,532,150900,13,150887
16838,12,17,244,1179712,12,1179700
16839,18,8,942,905275,18,905257
16840,8,-2,384,570838,8,570830
16841,11,-20,190,24322,11,24311
16842,5,-20,509,10952,5,10947
16843,6,10,571,949738,6,949732
16844,12,13,861,1059677,12,1059665
16845,17,2,901,717189,17,717172
16846,14,-3,101,554492,14,554478
16847,9,11,884,987545,9,987536
16848,10,3,759,735249,10,735239
16849,16,14,684,1090851,16,1090835
16850,7,15,21,1094896,7,1094889
16851,16,13,406,1056267,16,1056251
16852,8,-16,936,144171,8,144163
16853,13,-2,133,586108,13,586095
16854,9,9,341,913910,9,913901
16855,19,-14,511,213491,19,213472
16856,10,-2,826,580454,10,580444
16857,10,3,898,738170,10,738160
16858,14,12,767,1027738,14,1027724
16859,10,-1,301,600557,10,600547
16860,5,5,485,791687,5,791682
16861,5,-13,562,230269,5,230264
16862,19,-14,512,213504,19,213485
16863,9,-15,219,159964,9,159955
16864,17,-16,922,153703,17,153686
16865,15,7,913,873541,15,873526
16866,14,-17,463,118950,14,118936
16867,19,-10,225,336726,19,336707
16868,9,-20,324,7256,9,7247
16869,16,8,756,903904,16,903888
16870,20,19,304,1243198,20,1243178
16871,8,-6,523,448098,8,448090
16872,5,-4,633,513068,5,513063
16873,19,17,428,1181109,19,1181090
16874,7,1,870,675925,7,675918
16875,11,12,859,1028514,11,1028503
16876,7,3,929,739018,7,739011
16877,5,12,947,1019974,5,1019969
16878,15,15,971,1123940,15,1123925
16879,6,-13,67,219777,6,219771
16880,5,11,347,975841,5,975836
16881,5,-13,326,225273,5,225268
16882,7,12,706,1014591,7,1014584
16883,14,-16,159,148096,14,148082
16884,11,13,150,1054302,11,1054291
16885,10,-10,331,319678,10,319668
16886,5,-5,492,478666,5,478661
16887,19,14,525,1089550,19,1089531
16888,11,10,647,964935,11,964924
16889,12,7,891,873400,12,873388
16890,8,-17,385,101733,8,101725
16891,16,-15,801,183695,16,183679
16892,11,-14,310,211784,11,211773
16893,9,11,899,987901,9,987892
16894,17,-10,972,342418,17,342401
16895,16,-15,616,182284,16,182268
16896,13,3,484,745437,13,745424
16897,11,-4,553,526272,11,526261
16898,6,5,539,792811,6,792805
16899,11,-16,891,153505,11,153494
16900,12,-3,889,560903,12,560891
16901,18,-19,869,60690,18,60672
16902,18,-12,651,277304,18,277286
16903,11,17,599,1182306,11,1182295
16904,20,-7,239,430062,20,430042
16905,16,6,134,836791,16,836775
16906,10,-8,765,391789,10,391779
16907,7,-9,704,359079,7,359072
16908,5,-4,75,501002,5,500997
16909,18,3,513,745631,18,745613
16910,17,0,577,652627,17,652610
16911,6,10,654,951681,6,951675
16912,9,-5,179,472013,9,472004
16913,8,-5,362,476068,8,476060
16914,11,-4,513,526003,11,525992
16915,9,-8,588,387724,9,387715
16916,20,-5,322,493499,20,493479
16917,6,5,79,783259,6,783253
16918,12,-1,773,622500,12,622488
16919,15,0,717,653800,15,653785
16920,11,6,23,835998,11,835987
16921,18,-19,310,56386,18,56368
16922,13,-12,8,272567,13,272554
16923,18,8,316,900454,18,900436
16924,16,6,468,839542,16,839526
16925,11,18,614,1213350,11,1213339
16926,19,-8,526,401553,19,401534
16927,10,10,501,948117,10,948107
16928,14,-1,606,621282,14,621268
16929,10,-4,27,499875,10,499865
16930,7,-8,191,379587,7,379580
16931,9,-9,54,344800,9,344791
16932,9,7,561,856693,9,856684
16933,14,3,399,744877,14,744863
16934,12,-3,869,560744,12,560732
16935,14,4,216,774838,14,774824
16936,5,-20,31,713,5,708
16937,11,-11,980,311381,11,311370
16938,16,11,320,993194,16,993178
16939,18,14,798,1091692,18,1091674
16940,14,18,96,1209687,14,1209673
16941,12,13,539,1057249,12,1057237
16942,9,1,870,675934,9,675925
16943,7,16,689,1139551,7,1139544
16944,6,12,463,1009046,6,1009040
16945,10,-10,648,326591,10,326581
16946,9,6,26,812834,9,812825
16947,18,-3,637,558883,18,558865
16948,10,4,681,765288,10,765278
16949,13,0,14,648289,13,648276
16950,8,-2,899,582018,8,582010
16951,12,-4,220,523804,12,523792
16952,19,15,350,1119370,19,1119351
16953,19,10,145,960998,19,960979
16954,16,-3,940,561323,16,561307
16955,12,1,595,684530,12,684518
16956,13,14,358,1088218,13,1088205
16957,16,7,373,869699,16,869683
16958,12,11,648,995452,12,995440
16959,8,8,763,891952,8,891944
16960,16,-8,131,398808,16,398792
16961,12,-19,786,60087,12,60075
16962,15,19,184,1242198,15,1242183
16963,7,8,860,893816,7,893809
16964,20,3,494,745500,20,745480
16965,17,-8,34,398163,17,398146
16966,13,-12,488,276097,13,276084
16967,9,-18,229,67514,9,67505
16968,11,13,630,1058038,11,1058027
16969,6,-17,620,106847,6,106841
16970,18,-11,999,311507,18,311489
16971,5,-15,190,159385,5,159380
16972,15,11,537,994718,15,994703
16973,15,-18,91,85930,15,85915
16974,18,2,319,712958,18,712940
16975,18,12,124,1022956,18,1022938
16976,5,-6,178,440737,5,440732
16977,11,10,527,963909,11,963898
16978,15,17,795,1183854,15,1183839
16979,12,12,633,1026730,12,1026718
16980,19,5,581,808027,19,808008
16981,19,0,663,653325,19,653306
16982,20,-7,623,432882,20,432862
16983,11,15,604,1121208,11,1121197
16984,9,3,190,722973,9,722964
16985,7,-14,223,191528,7,191521
16986,16,13,951,1060295,16,1060279
16987,18,11,343,993360,18,993342
16988,13,-2,803,591150,13,591137
16989,12,-20,997,30419,12,30407
16990,17,6,473,839548,17,839531
16991,12,1,960,687338,12,687326
16992,16,-2,15,585237,16,585221
16993,19,-1,408,619820,19,619801
16994,14,2,954,717603,14,717589
16995,15,13,617,1057956,15,1057941
16996,7,8,740,891530,7,891523
16997,13,-18,873,91566,13,91553
16998,15,-7,14,428398,15,428383
16999,12,16,180,1148411,12,1148399
17000,6,-1,895,613146,6,613140
17001,14,0,793,654292,14,654278
17002,18,9,217,930661,18,930643
17003,6,11,171,971955,6,971949
17004,6,11,547,980181,6,980175
17005,9,4,847,769324,9,769315
17006,7,-5,424,477157,7,477150
17007,12,9,814,935093,12,935081
17008,5,17,318,1162175,5,1162170
17009,6,-4,188,503512,6,503506
17010,13,15,585,1121023,13,1121010
17011,19,15,591,1121090,19,1121071
17012,10,-2,642,576389,10,576379
17013,20,15,842,1122937,20,1122917
17014,17,6,836,842498,17,842481
17015,15,9,462,932378,15,932363
17016,5,-19,303,38081,5,38076
17017,10,-10,381,320786,10,320776
17018,9,5,77,783205,9,783196
17019,5,13,682,1045440,5,1045435
17020,8,-2,759,578963,8,578955
17021,6,-9,132,346350,6,346344
17022,5,4,882,769991,5,769986
17023,16,15,467,1120094,16,1120078
17024,8,-20,537,11674,8,11666
17025,6,18,841,1204552,6,1204546
17026,13,9,9,929105,13,929092
17027,20,-20,574,27177,20,27157
17028,18,17,723,1183299,18,1183281
17029,15,-17,837,121770,15,121755
17030,10,-13,643,232013,10,232003
17031,15,16,23,1147256,15,1147241
17032,17,3,633,746617,17,746600
17033,10,19,280,1223691,10,1223681
17034,18,10,623,964732,18,964714
17035,6,-11,255,286611,6,286605
17036,15,-9,161,367726,15,367711
17037,6,19,716,1233389,6,1233383
17038,10,-5,286,474363,10,474353
17039,12,-7,709,433460,12,433448
17040,6,-20,479,10268,6,10262
17041,10,12,538,1010664,10,1010654
17042,8,12,682,1014082,8,1014074
17043,5,-5,894,487491,5,487486
17044,18,-16,848,153126,18,153108
17045,13,-11,87,304364,13,304351
17046,5,12,366,1007109,5,1007104
17047,16,-7,598,432776,16,432760
17048,8,8,758,891837,8,891829
17049,12,9,593,933471,12,933459
17050,11,-17,257,117365,11,117354
17051,6,11,210,972657,6,972651
17052,8,4,773,767466,8,767458
17053,17,2,875,717019,17,717002
17054,15,-17,952,122498,15,122483
17055,16,-3,933,561246,16,561230
17056,17,16,545,1150943,17,1150926
17057,16,10,171,961184,16,961168
17058,19,-17,905,122208,19,122189
17059,15,16,57,1147497,15,1147482
17060,8,-7,759,421919,8,421911
17061,9,-4,134,502336,9,502327
17062,14,-7,703,433428,14,433414
17063,20,-7,356,431040,20,431020
17064,18,-1,710,622068,18,622050
17065,15,-3,479,557451,15,557436
17066,12,3,914,748729,12,748717
17067,19,-9,756,372463,19,372444
17068,5,4,339,757815,5,757810
17069,6,-18,86,64356,6,64350
17070,6,18,212,1191465,6,1191459
17071,18,-10,914,341927,18,341909
17072,6,19,153,1220843,6,1220837
17073,5,3,225,723674,5,723669
17074,18,-19,83,54551,18,54533
17075,10,13,925,1050545,10,1050535
17076,7,-4,187,503507,7,503500
17077,15,9,504,932742,15,932727
17078,15,-12,648,277269,15,277254
17079,19,-9,458,370195,19,370176
17080,10,18,925,1206278,10,1206268
17081,5,3,136,721780,5,721775
17082,19,-1,304,618991,19,618972
17083,5,1,70,658522,5,658517
17084,18,5,596,808133,18,808115
17085,7,11,757,984631,7,984624
17086,17,15,68,1117272,17,1117255
17087,5,8,222,880009,5,880004
17088,7,19,3,1217465,7,1217458
17089,19,17,818,1184080,19,1184061
17090,12,-1,385,619637,12,619625
17091,12,11,807,996718,12,996706
17092,16,-4,866,528473,16,528457
17093,12,19,248,1242705,12,1242693
17094,6,4,115,753079,6,753073
17095,20,19,651,1246067,20,1246047
17096,8,-17,603,106538,8,106530
17097,12,-8,289,399905,12,399893
17098,8,11,799,985559,8,985551
17099,20,-2,833,591474,20,591454
17100,10,19,816,1235570,10,1235560
17101,19,16,14,1147182,19,1147163
17102,17,-1,538,620839,17,620822
17103,17,-10,16,335260,17,335243
17104,16,4,937,780152,16,780136
17105,12,15,276,1118827,12,1118815
17106,18,-12,105,273290,18,273272
17107,19,-6,808,465330,19,465311
17108,19,16,951,1153857,19,1153838
17109,10,-1,156,597133,10,597123
17110,14,-17,211,117028,14,117014
17111,5,-5,42,468806,5,468801
17112,20,-3,522,557850,20,557830
17113,16,-7,44,428649,16,428633
17114,19,-6,691,464444,19,464425
17115,5,9,352,914150,5,914145
17116,16,-10,176,336393,16,336377
17117,7,7,439,854244,7,854237
17118,19,8,486,901793,19,901774
17119,5,18,951,1206896,5,1206891
17120,19,-6,498,463001,19,462982
17121,14,-5,291,493211,14,493197
17122,9,4,842,769130,9,769121
17123,9,-16,428,133269,9,133260
17124,8,4,970,771713,8,771705
17125,14,-9,187,367873,14,367859
17126,10,6,860,831617,10,831607
17127,13,-5,298,493284,13,493271
17128,17,-6,160,460349,17,460332
17129,11,-7,418,431479,11,431468
17130,12,2,691,715811,12,715799
17131,12,-5,781,496668,12,496656
17132,10,5,88,783461,10,783451
17133,17,-7,692,433316,17,433299
17134,16,18,511,1212716,16,1212700
17135,7,4,736,766607,7,766600
17136,8,19,544,1229827,8,1229819
17137,19,10,257,961755,19,961736
17138,9,-1,49,594851,9,594842
17139,7,2,809,705471,7,705464
17140,14,-2,15,585241,14,585227
17141,18,-5,691,496078,18,496060
17142,6,-20,738,16229,6,16223
17143,5,-16,404,132703,5,132698
17144,11,-5,750,496518,11,496507
17145,10,19,51,1218495,10,1218485
17146,10,-3,872,549894,10,549884
17147,13,-12,878,279047,13,279034
17148,9,-16,89,125875,9,125866
17149,13,-19,554,58369,13,58356
17150,12,16,819,1152982,12,1152970
17151,12,1,450,683371,12,683359
17152,15,-13,241,242827,15,242812
17153,17,-6,18,459266,17,459249
17154,12,6,831,842464,12,842452
17155,20,12,209,1023568,20,1023548
17156,6,-20,960,21110,6,21104
17157,10,9,769,922915,10,922905
17158,10,12,494,1009724,10,1009714
17159,12,6,421,839137,12,839125
17160,12,5,791,809526,12,809514
17161,10,-16,566,136332,10,136322
17162,10,15,264,1100182,10,1100172
17163,14,8,226,899767,14,899753
17164,19,-20,802,29031,19,29012
17165,11,-5,86,491552,11,491541
17166,12,4,895,779865,12,779853
17167,6,3,715,734374,6,734368
17168,16,4,573,777417,16,777401
17169,5,-18,958,83298,5,83293
17170,7,-13,318,225092,7,225085
17171,7,16,680,1139419,7,1139412
17172,12,2,936,717424,12,717412
17173,13,-10,864,341571,13,341558
17174,13,-2,770,590889,13,590876
17175,8,-17,157,96746,8,96738
17176,16,10,293,962010,16,961994
17177,11,-17,900,122176,11,122165
17178,5,0,791,642651,5,642646
17179,19,-17,490,119131,19,119112
17180,6,-18,964,83415,6,83409
17181,10,2,168,692253,10,692243
17182,14,14,94,1086207,14,1086193
17183,13,-8,437,400910,13,400897
17184,18,-16,65,147281,18,147263
17185,5,-1,98,595937,5,595932
17186,10,7,153,848024,10,848014
17187,5,-13,611,231434,5,231429
17188,16,16,970,1154078,16,1154062
17189,10,2,84,690381,10,690371
17190,12,0,436,651374,12,651362
17191,15,-3,428,557008,15,556993
17192,18,12,704,1027366,18,1027348
17193,20,-15,906,184628,20,184608
17194,6,-6,368,444597,6,444591
17195,12,-12,450,275749,12,275737
17196,16,18,968,1216101,16,1216085
17197,16,14,965,1092971,16,1092955
17198,8,5,887,800280,8,800272
17199,6,-20,170,3809,6,3803
17200,18,9,212,930622,18,930604
17201,10,-4,611,512579,10,512569
17202,8,-5,49,468946,8,468938
17203,12,16,806,1152905,12,1152893
17204,7,11,642,982106,7,982099
17205,8,4,612,763898,8,763890
17206,18,-10,251,336919,18,336901
17207,20,4,782,779013,20,778993
17208,5,15,82,1096181,5,1096176
17209,11,-2,655,590064,11,590053
17210,8,-1,614,607204,8,607196
17211,14,-7,31,428571,14,428557
17212,12,19,413,1244205,12,1244193
17213,9,11,857,986849,9,986840
17214,6,-20,139,3041,6,3035
17215,19,8,357,900783,19,900764
17216,10,16,322,1131988,10,1131978
17217,8,4,11,750752,8,750744
17218,10,-2,116,565360,10,565350
17219,13,13,119,1054104,13,1054091
17220,9,16,587,1137472,9,1137463
17221,8,15,321,1101319,8,1101311
17222,10,13,977,1051632,10,1051622
17223,10,7,26,845283,10,845273
17224,11,-4,934,529052,11,529041
17225,7,-20,561,12254,7,12247
17226,15,-4,42,522352,15,522337
17227,12,-7,356,431042,12,431030
17228,19,18,382,1211870,19,1211851
17229,5,-7,227,410654,5,410649
17230,7,8,621,888746,7,888739
17231,15,-10,757,340795,15,340780
17232,11,18,595,1213184,11,1213173
17233,8,-9,555,356179,8,356171
17234,12,-13,746,246544,12,246532
17235,6,-18,247,67903,6,67897
17236,5,-8,404,383840,5,383835
17237,20,14,65,1085978,20,1085958
17238,20,14,83,1086073,20,1086053
17239,14,10,824,966239,14,966225
17240,19,13,232,1054940,19,1054921
17241,16,4,165,774468,16,774452
17242,13,9,597,933502,13,933489
17243,6,-9,179,347394,6,347388
17244,10,2,485,698977,10,698967
17245,5,4,624,764138,5,764133
17246,6,-16,646,138034,6,138028
17247,16,4,457,776520,16,776504
17248,18,10,917,966918,18,966900
17249,18,-15,854,184243,18,184225
17250,14,5,211,805413,14,805399
17251,18,0,34,648523,18,648505
17252,19,-7,303,430604,19,430585
17253,19,-10,996,342697,19,342678
17254,15,-20,366,25622,15,25607
17255,12,-15,262,179648,12,179636
17256,14,10,225,961541,14,961527
17257,15,-13,30,241312,15,241297
17258,17,-4,898,528810,17,528793
17259,7,-3,521,542136,7,542129
17260,15,-18,864,91475,15,91460
17261,8,3,956,739608,8,739600
17262,11,-6,635,464014,11,464003
17263,11,11,414,993885,11,993874
17264,14,10,97,960655,14,960641
17265,12,13,63,1053678,12,1053666
17266,5,11,638,982055,5,982050
17267,14,-17,377,118273,14,118259
17268,8,-10,482,323163,8,323155
17269,16,-2,101,585877,16,585861
17270,12,10,268,961853,12,961841
17271,16,11,100,991581,16,991565
17272,10,-16,147,127190,10,127180
17273,6,-7,204,410170,6,410164
17274,5,3,972,740116,5,740111
17275,9,-7,755,421802,9,421793
17276,20,-7,973,435515,20,435495
17277,5,0,607,638488,5,638483
17278,5,-17,528,104812,5,104807
17279,10,3,836,736818,10,736808
17280,16,8,838,904491,16,904475
17281,17,-3,77,554323,17,554306
17282,9,15,101,1096655,9,1096646
17283,15,13,832,1059471,15,1059456
17284,10,-15,15,155655,10,155645
17285,8,7,311,851498,8,851490
17286,19,-19,421,57228,19,57209
17287,20,-9,309,368838,20,368818
17288,12,18,415,1212108,12,1212096
17289,9,-15,893,174402,9,174393
17290,18,-17,724,120985,18,120967
17291,20,9,455,932337,20,932317
17292,10,1,605,670447,10,670437
17293,15,10,462,963367,15,963352
17294,6,-7,876,424477,6,424471
17295,11,11,290,992983,11,992972
17296,20,-1,528,620785,20,620765
17297,17,-16,825,152964,17,152947
17298,7,-13,688,232858,7,232851
17299,12,12,714,1027413,12,1027401
17300,6,0,4,625247,6,625241
17301,5,-1,386,602443,5,602438
17302,15,-15,843,184099,15,184084
17303,15,-3,457,557302,15,557287
17304,9,8,780,892417,9,892408
17305,8,5,374,789346,8,789338
17306,18,19,996,1248755,18,1248737
17307,9,-11,81,282795,9,282786
17308,14,-19,97,54688,14,54674
17309,6,9,213,911311,6,911305
17310,9,2,174,692400,9,692391
17311,13,-12,888,279162,13,279149
17312,11,8,732,903761,11,903750
17313,8,9,0,906719,8,906711
17314,19,-17,14,115683,19,115664
17315,10,-18,729,78108,10,78098
17316,5,-4,666,513759,5,513754
17317,6,-13,707,233399,6,233393
17318,7,16,434,1134570,7,1134563
17319,19,8,303,900351,19,900332
17320,16,12,337,1024603,16,1024587
17321,14,7,383,869841,14,869827
17322,12,11,448,994100,12,994088
17323,11,6,149,836894,11,836883
17324,14,-16,451,150369,14,150355
17325,15,-14,808,215855,15,215840
17326,7,1,780,673956,7,673949
17327,19,16,990,1154203,19,1154184
17328,12,-9,901,373751,12,373739
17329,7,-8,335,382549,7,382542
17330,7,0,416,634410,7,634403
17331,12,11,398,993820,12,993808
17332,11,-17,423,118575,11,118564
17333,14,7,386,869871,14,869857
17334,8,-13,494,228757,8,228749
17335,6,8,308,881976,6,881970
17336,6,12,118,1001708,6,1001702
17337,13,-2,270,587151,13,587138
17338,15,4,977,780398,15,780383
17339,16,-20,749,28568,16,28552
17340,10,-17,876,112010,10,112000
17341,18,18,533,1212892,18,1212874
17342,19,19,192,1242278,19,1242259
17343,8,1,945,677519,8,677511
17344,7,-12,529,261090,7,261083
17345,14,1,738,685599,14,685585
17346,5,8,580,887892,5,887887
17347,13,15,93,1117469,13,1117456
17348,5,-13,143,221407,5,221402
17349,20,2,115,711458,20,711438
17350,19,13,103,1053983,19,1053964
17351,19,-19,787,60102,19,60083
17352,7,-12,907,269377,7,269370
17353,14,-3,684,559236,14,559222
17354,6,6,24,812809,6,812803
17355,11,6,661,841074,11,841063
17356,12,-5,88,491584,12,491572
17357,12,0,265,650152,12,650140
17358,6,9,494,917134,6,917128
17359,14,5,692,808837,14,808823
17360,17,-11,139,304827,17,304810
17361,10,-10,148,315905,10,315895
17362,5,16,937,1144689,5,1144684
17363,11,-3,376,556589,11,556578
17364,17,11,703,995827,17,995810
17365,9,-4,583,511999,9,511990
17366,18,2,99,711341,18,711323
17367,13,0,770,654170,13,654157
17368,19,5,471,807263,19,807244
17369,12,2,836,716739,12,716727
17370,7,-1,171,597420,7,597413
17371,17,-12,284,274614,17,274597
17372,20,-17,685,120662,20,120642
17373,15,-10,120,335984,15,335969
17374,16,-17,81,116153,16,116137
17375,9,-2,315,569536,9,569527
17376,12,0,608,652844,12,652832
17377,18,8,383,900978,18,900960
17378,20,-20,616,27468,20,27448
17379,7,8,189,879155,7,879148
17380,12,4,176,774552,12,774540
17381,10,19,696,1232944,10,1232934
17382,9,-2,434,572018,9,572009
17383,10,-17,958,113653,10,113643
17384,14,-4,488,525721,14,525707
17385,5,-7,33,406843,5,406838
17386,14,14,499,1089364,14,1089350
17387,5,-10,174,316432,5,316427
17388,9,-4,912,519013,9,519004
17389,13,-16,1,146711,13,146698
17390,19,18,322,1211421,19,1211402
17391,14,-9,756,372467,14,372453
17392,12,17,843,1184337,12,1184325
17393,7,-10,808,329926,7,329919
17394,14,12,977,1029654,14,1029640
17395,17,15,509,1120454,17,1120437
17396,14,-19,129,55047,14,55033
17397,18,-14,398,212671,18,212653
17398,14,12,736,1027546,14,1027532
17399,17,-8,57,398365,17,398348
17400,16,-20,343,25500,16,25484
17401,8,0,650,639554,8,639546
17402,12,-18,449,88631,12,88619
17403,5,-10,3,312555,5,312550
17404,17,13,724,1058609,17,1058592
17405,8,12,479,1009355,8,1009347
17406,19,-9,47,366984,19,366965
17407,8,5,947,801700,8,801692
17408,7,17,349,1162855,7,1162848
17409,18,-14,581,214086,18,214068
17410,18,-14,486,213248,18,213230
17411,20,8,661,903170,20,903150
17412,17,14,310,1087850,17,1087833
17413,15,-16,536,150928,15,150913
17414,6,17,600,1168075,6,1168069
17415,18,-8,726,403037,18,403019
17416,19,-14,39,209610,19,209591
17417,16,-14,123,210245,16,210229
17418,14,6,369,838625,14,838611
17419,8,7,532,856106,8,856098
17420,18,6,972,843534,18,843516
17421,13,-3,767,559941,13,559928
17422,16,-4,619,526748,16,526732
17423,8,-8,969,396076,8,396068
17424,8,1,594,670174,8,670166
17425,7,-6,890,455799,7,455792
17426,5,-12,375,257773,5,257768
17427,17,9,189,930444,17,930427
17428,16,5,293,805987,16,805971
17429,15,16,53,1147458,15,1147443
17430,15,-18,378,88146,15,88131
17431,13,4,38,773552,13,773539
17432,11,18,29,1209110,11,1209099
17433,16,2,266,712547,16,712531
17434,13,17,477,1181490,13,1181477
17435,11,-13,817,247087,11,247076
17436,14,4,647,777980,14,777966
17437,6,4,280,756595,6,756589
17438,10,3,888,737948,10,737938
17439,7,11,428,977618,7,977611
17440,11,18,697,1213995,11,1213984
17441,18,-20,255,24739,18,24721
17442,9,14,361,1069775,9,1069766
17443,9,16,131,1127839,9,1127830
17444,9,-20,858,18982,9,18973
17445,8,-10,146,315849,8,315841
17446,13,3,86,742463,13,742450
17447,14,-6,665,464211,14,464197
17448,11,8,206,899608,11,899597
17449,6,1,930,677261,6,677255
17450,16,-19,218,55793,16,55777
17451,14,-1,4,616531,14,616517
17452,18,19,272,1242936,18,1242918
17453,19,3,252,743785,19,743766
17454,6,-9,235,348679,6,348673
17455,16,11,217,992348,16,992332
17456,16,-17,647,120310,16,120294
17457,13,-18,869,91517,13,91504
17458,19,15,743,1122306,19,1122287
17459,16,9,964,936291,16,936275
17460,9,-4,957,519961,9,519952
17461,6,16,567,1137141,6,1137135
17462,15,-7,808,434175,15,434160
17463,17,-19,219,55809,17,55792
17464,16,7,591,871369,16,871353
17465,14,7,273,868974,14,868960
17466,15,2,177,711924,15,711909
17467,6,-12,118,252112,6,252106
17468,12,11,503,994494,12,994482
17469,15,15,230,1118523,15,1118508
17470,8,16,670,1139259,8,1139251
17471,15,-12,860,278913,15,278898
17472,14,-9,556,371116,14,371102
17473,6,-11,375,289491,6,289485
17474,15,-11,1000,311519,15,311504
17475,5,7,328,851871,5,851866
17476,7,2,276,694533,7,694526
17477,17,-20,897,29711,17,29694
17478,19,-5,331,493591,19,493572
17479,7,18,848,1204714,7,1204707
17480,7,6,983,834353,7,834346
17481,13,1,156,681103,13,681090
17482,17,6,298,838057,17,838040
17483,14,6,394,838901,14,838887
17484,15,-20,490,26469,15,26454
17485,13,-5,559,495170,13,495157
17486,20,-2,57,585594,20,585574
17487,19,-2,316,587495,19,587476
17488,7,-16,10,124026,7,124019
17489,14,17,949,1185006,14,1184992
17490,7,-16,217,128784,7,128777
17491,19,-12,756,278078,19,278059
17492,8,-16,660,138256,8,138248
17493,5,2,610,701496,5,701491
17494,8,9,90,908595,8,908587
17495,10,-6,183,440898,10,440888
17496,8,-12,17,249955,8,249947
17497,14,-14,218,211047,14,211033
17498,6,0,680,640247,6,640241
17499,12,10,508,963754,12,963742
17500,18,17,544,1181939,18,1181921
17501,14,14,669,1090672,14,1090658
17502,10,-11,822,298686,10,298676
17503,10,-11,664,295766,10,295756
17504,16,2,372,713416,16,713400
17505,17,-9,259,368482,17,368465
17506,12,5,1,803784,12,803772
17507,7,11,215,972738,7,972731
17508,13,15,846,1122959,13,1122946
17509,10,-6,579,449204,10,449194
17510,13,-7,691,433302,13,433289
17511,17,-6,520,463187,17,463170
17512,11,-1,338,619276,11,619265
17513,6,5,66,783056,6,783050
17514,7,3,938,739197,7,739190
17515,12,-13,603,245481,12,245469
17516,10,13,483,1041089,10,1041079
17517,19,18,209,1210704,19,1210685
17518,9,-9,710,359233,9,359224
17519,8,-2,417,571603,8,571595
17520,13,-6,285,461399,13,461386
17521,15,-10,255,336958,15,336943
17522,20,-2,811,591217,20,591197
17523,12,4,617,777762,12,777750
17524,7,7,434,854152,7,854145
17525,6,19,979,1239149,6,1239143
17526,13,-6,242,461069,13,461056
17527,8,1,896,676488,8,676480
17528,12,-2,89,585802,12,585790
17529,15,-4,531,526125,15,526110
17530,13,1,66,680263,13,680250
17531,19,7,717,872215,19,872196
17532,9,9,341,913919,9,913910
17533,12,8,162,899224,12,899212
17534,15,19,878,1247866,15,1247851
17535,10,4,627,764181,10,764171
17536,18,-20,701,28184,18,28166
17537,16,-6,894,465904,16,465888
17538,17,18,64,1209479,17,1209462
17539,8,1,569,669767,8,669759
17540,6,-14,419,195994,6,195988
17541,6,-4,465,509489,6,509483
17542,18,15,906,1123389,18,1123371
17543,10,-20,947,20834,10,20824
17544,9,-8,491,385557,9,385548
17545,17,15,506,1120423,17,1120406
17546,16,1,530,684061,16,684045
17547,19,-3,883,560857,19,560838
17548,10,-8,53,376556,10,376546
17549,14,-3,329,556194,14,556180
17550,15,11,157,991944,15,991929
17551,11,-9,345,369221,11,369210
17552,8,4,162,754099,8,754091
17553,7,11,83,970219,7,970212
17554,9,5,645,794921,9,794912
17555,18,-6,222,460864,18,460846
17556,11,7,352,869580,11,869569
17557,17,19,12,1240747,17,1240730
17558,11,-2,42,585445,11,585434
17559,12,13,548,1057371,12,1057359
17560,5,16,498,1135772,5,1135767
17561,9,10,789,954530,9,954521
17562,7,17,753,1171317,7,1171310
17563,13,-18,95,85962,13,85949
17564,14,-9,960,374105,14,374091
17565,7,-13,756,234558,7,234551
17566,14,0,843,654661,14,654647
17567,12,-7,510,432163,12,432151
17568,6,17,219,1159819,6,1159813
17569,11,9,21,929183,11,929172
17570,6,-17,688,108211,6,108205
17571,8,6,929,833078,8,833070
17572,8,-4,30,499928,8,499920
17573,14,7,608,871510,14,871496
17574,19,10,87,960514,19,960495
17575,10,9,901,925868,10,925858
17576,5,8,766,892052,5,892047
17577,19,9,119,929917,19,929898
17578,10,-5,294,474546,10,474536
17579,8,-5,557,480041,8,480033
17580,17,-14,692,214954,17,214937
17581,8,4,448,760274,8,760266
17582,10,-1,865,612452,10,612442
17583,13,-12,969,279858,13,279845
17584,19,10,982,967320,19,967301
17585,8,-7,575,418212,8,418204
17586,20,-14,173,210641,20,210621
17587,16,19,504,1244931,16,1244915
17588,5,1,17,657375,5,657370
17589,9,9,766,922800,9,922791
17590,17,-4,248,524053,17,524036
17591,19,2,589,714997,19,714978
17592,9,9,290,912701,9,912692
17593,19,11,889,997328,19,997309
17594,14,-14,877,216347,14,216333
17595,17,-12,163,273735,17,273718
17596,12,-6,355,461892,12,461880
17597,9,12,156,1002543,9,1002534
17598,19,-8,439,400935,19,400916
17599,14,-11,907,310838,14,310824
17600,6,0,220,630264,6,630258
17601,7,-12,277,255526,7,255519
17602,8,-9,904,363962,8,363954
17603,5,11,572,980756,5,980751
17604,8,5,296,787808,8,787800
17605,16,8,694,903451,16,903435
17606,11,-12,936,279553,11,279542
17607,11,-13,359,243661,11,243650
17608,16,8,933,905215,16,905199
17609,10,18,425,1195811,10,1195801
17610,10,-12,58,250811,10,250801
17611,10,-13,869,237144,10,237134
17612,19,16,115,1147894,19,1147875
17613,5,4,372,758615,5,758610
17614,6,12,751,1015434,6,1015428
17615,7,17,764,1171513,7,1171506
17616,18,13,112,1054041,18,1054023
17617,19,-9,623,371487,19,371468
17618,12,5,755,809263,12,809251
17619,11,5,416,806779,11,806768
17620,15,-3,346,556330,15,556315
17621,18,-18,389,88214,18,88196
17622,15,-19,737,59814,15,59799
17623,8,4,543,762295,8,762287
17624,5,5,835,799083,5,799078
17625,15,3,829,748043,15,748028
17626,6,-7,358,413627,6,413621
17627,16,-1,296,618893,16,618877
17628,6,3,301,725445,6,725439
17629,16,-18,1000,92488,16,92472
17630,19,10,100,960672,19,960653
17631,11,17,490,1181569,11,1181558
17632,17,-16,29,146954,17,146937
17633,16,13,936,1060179,16,1060163
17634,6,7,771,861064,6,861058
17635,20,16,346,1149635,20,1149615
17636,10,12,570,1011267,10,1011257
17637,8,-16,954,144473,8,144465
17638,14,3,685,747052,14,747038
17639,11,2,225,712277,11,712266
17640,7,-13,250,223700,7,223693
17641,17,-19,107,54784,17,54767
17642,7,9,711,921727,7,921720
17643,7,4,213,755288,7,755281
17644,18,9,962,936260,18,936242
17645,13,-13,545,245036,13,245023
17646,16,-2,472,588703,16,588687
17647,10,-19,387,39877,10,39867
17648,10,3,156,722168,10,722158
17649,11,-18,271,87373,11,87362
17650,19,-11,890,310674,19,310655
17651,15,-7,907,435012,15,434997
17652,14,-16,313,149248,14,149234
17653,18,-9,629,371512,18,371494
17654,10,-5,28,468459,10,468449
17655,15,-17,482,119064,15,119049
17656,8,-8,31,376006,8,375998
17657,18,-3,291,555877,18,555859
17658,12,9,512,932819,12,932807
17659,6,5,46,782567,6,782561
17660,17,-15,338,180225,17,180208
17661,15,-15,225,179371,15,179356
17662,9,-17,687,108188,9,108179
17663,12,7,90,867660,12,867648
17664,9,11,227,972993,9,972984
17665,17,0,350,650694,17,650677
17666,14,7,502,870718,14,870704
17667,6,9,201,910974,6,910968
17668,5,0,712,640960,5,640955
17669,10,19,685,1232678,10,1232668
17670,13,-2,604,589676,13,589663
17671,7,13,303,1037196,7,1037189
17672,8,-2,403,571245,8,571237
17673,15,-7,123,429195,15,429180
17674,17,16,412,1150127,17,1150110
17675,5,-9,277,349629,5,349624
17676,6,15,711,1109575,6,1109569
17677,9,-3,657,545260,9,545251
17678,12,12,419,1025097,12,1025085
17679,17,-8,126,398758,17,398741
17680,11,11,911,997482,11,997471
17681,16,-4,835,528178,16,528162
17682,20,-12,825,278566,20,278546
17683,20,-12,879,279065,20,279045
17684,13,-10,887,341766,13,341753
17685,17,8,599,902664,17,902647
17686,5,1,116,659622,5,659617
17687,5,-14,167,190075,5,190070
17688,20,-1,316,619109,20,619089
17689,13,15,771,1122473,13,1122460
17690,10,-2,83,564592,10,564582
17691,18,-10,184,336440,18,336422
17692,8,-15,522,166668,8,166660
17693,19,-7,830,434315,19,434296
17694,5,-12,710,264902,5,264897
17695,5,-14,574,199121,5,199116
17696,19,1,261,681985,19,681966
17697,20,4,844,779558,20,779538
17698,11,12,950,1029416,11,1029405
17699,6,18,646,1200386,6,1200380
17700,11,9,10,929111,11,929100
17701,17,12,914,1029049,17,1029032
17702,17,-8,367,400444,17,400427
17703,6,17,25,1155813,6,1155807
17704,5,-13,366,226024,5,226019
17705,18,-14,224,211110,18,211092
17706,10,-14,394,195440,10,195430
17707,16,-13,766,246713,16,246697
17708,5,-20,967,21262,5,21257
17709,11,16,740,1152363,11,1152352
17710,14,-7,500,432073,14,432059
17711,19,-3,615,558659,19,558640
17712,9,-3,226,535212,9,535203
17713,9,-9,188,347569,9,347560
17714,20,11,837,996896,20,996876
17715,6,-11,979,302196,6,302190
17716,19,-5,288,493195,19,493176
17717,7,-17,754,109634,7,109627
17718,17,-13,176,242324,17,242307
17719,16,18,911,1215591,16,1215575
17720,14,-14,921,216694,14,216680
17721,6,-8,264,381057,6,381051
17722,10,17,864,1173991,10,1173981
17723,19,-12,931,279516,19,279497
17724,10,13,962,1051299,10,1051289
17725,9,10,886,956525,9,956516
17726,6,-1,951,614482,6,614476
17727,14,14,713,1091073,14,1091059
17728,6,-15,237,160391,6,160385
17729,13,9,23,929208,13,929195
17730,16,7,351,869580,16,869564
17731,7,-17,443,102816,7,102809
17732,11,9,374,931777,11,931766
17733,7,-14,455,196557,7,196550
17734,18,-12,493,276159,18,276141
17735,9,-13,99,220539,9,220530
17736,9,1,643,671217,9,671208
17737,7,-5,620,481420,7,481413
17738,20,0,409,651175,20,651155
17739,7,18,167,1190446,7,1190439
17740,6,-20,63,1334,6,1328
17741,20,1,741,685635,20,685615
17742,13,-3,921,561171,13,561158
17743,6,-11,381,289611,6,289605
17744,15,-20,822,29179,15,29164
17745,5,17,148,1158388,5,1158383
17746,11,14,784,1091634,11,1091623
17747,16,3,985,749407,16,749391
17748,11,-19,90,54622,11,54611
17749,15,15,826,1122834,15,1122819
17750,6,19,446,1227852,6,1227846
17751,12,2,689,715792,12,715780
17752,11,-17,709,120823,11,120812
17753,5,-9,168,347147,5,347142
17754,19,-7,201,429787,19,429768
17755,9,2,365,696569,9,696560
17756,6,15,679,1108867,6,1108861
17757,14,2,988,717788,14,717774
17758,13,-14,227,211163,13,211150
17759,19,-11,173,305099,19,305080
17760,20,8,236,899912,20,899892
17761,10,5,285,787646,10,787636
17762,16,-2,885,591919,16,591903
17763,13,-19,147,55188,13,55175
17764,14,-11,226,305470,14,305456
17765,8,-5,724,483610,8,483602
17766,10,8,157,878525,10,878515
17767,8,19,60,1218746,8,1218738
17768,17,-1,200,618051,17,618034
17769,16,-4,127,523011,16,522995
17770,14,-17,67,115992,14,115978
17771,10,-4,769,515873,10,515863
17772,19,17,387,1180806,19,1180787
17773,9,8,25,875629,9,875620
17774,13,-5,138,491980,13,491967
17775,8,10,83,939286,8,939278
17776,6,12,949,1020007,6,1020001
17777,18,19,897,1248044,18,1248026
17778,11,6,966,843455,11,843444
17779,19,-13,211,242578,19,242559
17780,13,-17,942,122413,13,122400
17781,8,-17,665,107772,8,107764
17782,16,-1,96,617301,16,617285
17783,9,-3,631,544654,9,544645
17784,15,-12,887,279142,15,279127
17785,14,-11,278,305899,14,305885
17786,16,-1,475,620367,16,620351
17787,8,4,665,764894,8,764886
17788,9,-8,609,388283,9,388274
17789,16,-4,987,529541,16,529525
17790,5,-2,245,568017,5,568012
17791,16,-18,801,91088,16,91072
17792,5,-2,282,568795,5,568790
17793,7,11,340,975699,7,975692
17794,14,-20,23,13889,14,13875
17795,7,-16,657,138215,7,138208
17796,14,16,218,1148691,14,1148677
17797,14,11,753,996279,14,996265
17798,17,-15,408,180777,17,180760
17799,6,2,497,699199,6,699193
17800,5,-3,920,551085,5,551080
17801,13,6,245,837596,13,837583
17802,7,-5,855,486533,7,486526
17803,6,-14,264,192547,6,192541
17804,7,17,317,1162156,7,1162149
17805,15,-17,400,118418,15,118403
17806,10,-11,471,291629,10,291619
17807,16,-4,420,525370,16,525354
17808,17,-6,609,463783,17,463766
17809,9,-2,476,572930,9,572921
17810,6,3,521,729842,6,729836
17811,11,12,604,1026484,11,1026473
17812,6,-4,432,508952,6,508946
17813,15,-3,572,558329,15,558314
17814,17,-14,316,211844,17,211827
17815,17,-6,932,466190,17,466173
17816,20,7,428,870218,20,870198
17817,17,10,115,960787,17,960770
17818,11,-16,858,153218,11,153207
17819,5,10,479,947674,5,947669
17820,7,14,284,1068123,7,1068116
17821,7,16,58,1126403,7,1126396
17822,10,-14,112,188938,10,188928
17823,10,-9,131,346335,10,346325
17824,15,-9,776,372677,15,372662
17825,15,17,476,1181488,15,1181473
17826,14,16,553,1151024,14,1151010
17827,12,-8,142,398894,12,398882
17828,20,-14,224,211120,20,211100
17829,8,14,198,1066096,8,1066088
17830,19,2,70,711086,19,711067
17831,6,-8,304,381824,6,381818
17832,5,5,686,795885,5,795880
17833,16,-7,564,432563,16,432547
17834,17,4,528,777083,17,777066
17835,13,4,552,777254,13,777241
17836,11,17,391,1180864,11,1180853
17837,7,2,333,695804,7,695797
17838,17,8,132,898962,17,898945
17839,12,1,50,680175,12,680163
17840,5,-10,140,315748,5,315743
17841,14,2,260,712525,14,712511
17842,12,13,898,1059914,12,1059902
17843,14,-15,84,178417,14,178403
17844,13,11,72,991407,13,991394
17845,20,5,954,810823,20,810803
17846,9,-4,726,514999,9,514990
17847,20,-9,238,368312,20,368292
17848,15,-3,270,555686,15,555671
17849,14,3,394,744851,14,744837
17850,20,8,805,904301,20,904281
17851,13,-16,448,150332,13,150319
17852,14,19,66,1241271,14,1241257
17853,13,-3,897,560975,13,560962
17854,7,-15,442,164966,7,164959
17855,11,15,510,1120455,11,1120444
17856,14,-11,392,306872,14,306858
17857,9,-15,174,159135,9,159126
17858,15,15,342,1119304,15,1119289
17859,6,-18,569,74623,6,74617
17860,17,2,400,713653,17,713636
17861,12,15,904,1123370,12,1123358
17862,17,3,867,748372,17,748355
17863,10,-18,218,67140,10,67130
17864,19,19,369,1243771,19,1243752
17865,12,9,46,929419,12,929407
17866,9,-16,150,127261,9,127252
17867,5,-1,55,594963,5,594958
17868,11,19,474,1244695,11,1244684
17869,8,-14,77,188250,8,188242
17870,16,-19,218,55799,16,55783
17871,10,9,964,927294,10,927284
17872,5,-8,291,381563,5,381558
17873,12,-6,458,462653,12,462641
17874,20,8,77,898514,20,898494
17875,17,-2,788,591047,17,591030
17876,15,-7,533,432366,15,432351
17877,15,-16,36,146997,15,146982
17878,7,13,620,1044139,7,1044132
17879,6,-6,994,458013,6,458007
17880,17,4,624,777817,17,777800
17881,11,-18,135,86233,11,86222
17882,19,17,387,1180815,19,1180796
17883,14,-7,678,433216,14,433202
17884,12,-6,390,462124,12,462112
17885,16,-15,716,183115,16,183099
17886,7,-20,44,984,7,977
17887,15,-6,918,466096,15,466081
17888,20,15,487,1120247,20,1120227
17889,7,0,687,640399,7,640392
17890,15,-20,154,23925,15,23910
17891,12,-13,186,242439,12,242427
17892,7,3,467,728815,7,728808
17893,8,11,603,981378,8,981370
17894,9,9,253,912020,9,912011
17895,17,14,500,1089383,17,1089366
17896,12,-10,758,340814,12,340802
17897,16,4,411,776178,16,776162
17898,5,-7,880,424602,5,424597
17899,7,-9,839,362233,7,362226
17900,5,2,137,691528,5,691523
17901,7,16,405,1133870,7,1133863
17902,7,-13,715,233618,7,233611
17903,17,-15,753,183382,17,183365
17904,20,-6,443,462500,20,462480
17905,10,0,662,639838,10,639828
17906,16,-6,668,464241,16,464225
17907,6,1,613,670632,6,670626
17908,16,-9,698,371960,16,371944
17909,11,3,415,744981,11,744970
17910,9,15,473,1104435,9,1104426
17911,14,8,582,902515,14,902501
17912,13,19,854,1247663,13,1247650
17913,12,15,725,1122161,12,1122149
17914,13,19,416,1244253,13,1244240
17915,13,-9,879,373546,13,373533
17916,16,5,708,808965,16,808949
17917,17,-9,617,371467,17,371450
17918,10,-19,440,40984,10,40974
17919,6,-13,448,227765,6,227759
17920,8,-19,253,37096,8,37088
17921,11,12,265,1024066,11,1024055
17922,20,-19,182,55491,20,55471
17923,9,17,213,1159745,9,1159736
17924,11,7,942,873704,11,873693
17925,13,-8,129,398779,13,398766
17926,12,4,722,778567,12,778555
17927,9,-3,630,544612,9,544603
17928,9,3,437,728192,9,728183
17929,19,-1,596,621220,19,621201
17930,8,19,403,1226671,8,1226663
17931,12,-14,705,215018,12,215006
17932,19,5,807,809672,19,809653
17933,11,-12,805,278383,11,278372
17934,10,-6,144,439827,10,439817
17935,16,-11,721,309330,16,309314
17936,8,-15,838,173239,8,173231
17937,9,-18,697,77321,9,77312
17938,5,-10,72,314192,5,314187
17939,18,-15,368,180475,18,180457
17940,14,1,451,683376,14,683362
17941,17,-10,701,340388,17,340371
17942,18,4,805,779155,18,779137
17943,7,14,407,1070863,7,1070856
17944,11,-18,737,90646,11,90635
17945,7,8,701,890645,7,890638
17946,7,-5,716,483487,7,483480
17947,7,-18,898,81887,7,81880
17948,20,4,655,778033,20,778013
17949,7,-17,844,111350,7,111343
17950,7,0,343,632646,7,632639
17951,16,-2,837,591500,16,591484
17952,20,15,95,1117478,20,1117458
17953,20,-13,258,242974,20,242954
17954,10,16,172,1128726,10,1128716
17955,19,-15,295,179935,19,179916
17956,9,-7,942,425929,9,425920
17957,14,-18,713,90431,14,90417
17958,7,-18,327,69587,7,69580
17959,5,-19,46,32496,5,32491
17960,9,2,883,706986,9,706977
17961,16,-16,117,147788,16,147772
17962,8,-8,342,382641,8,382633
17963,10,-15,384,163695,10,163685
17964,16,-2,716,590537,16,590521
17965,9,5,998,802685,9,802676
17966,7,-4,65,500764,7,500757
17967,19,-5,21,490951,19,490932
17968,12,6,717,841594,12,841582
17969,19,15,78,1117362,19,1117343
17970,7,-2,91,564742,7,564735
17971,7,16,767,1140973,7,1140966
17972,10,13,773,1047366,10,1047356
17973,17,9,93,929743,17,929726
17974,17,14,442,1088906,17,1088889
17975,6,-20,312,7034,6,7028
17976,18,-5,469,494507,18,494489
17977,12,-11,876,310598,12,310586
17978,16,9,112,929864,16,929848
17979,5,10,660,951787,5,951782
17980,9,-9,386,352093,9,352084
17981,9,-8,983,396445,9,396436
17982,14,-15,976,185179,14,185165
17983,13,14,859,1092133,13,1092120
17984,20,0,880,654920,20,654900
17985,19,11,860,997090,19,997071
17986,6,18,925,1206284,6,1206278
17987,18,16,494,1150611,18,1150593
17988,17,-15,405,180750,17,180733
17989,5,10,996,958757,5,958752
17990,15,-1,904,623499,15,623484
17991,16,16,46,1147411,16,1147395
17992,13,-10,593,339473,13,339460
17993,9,-8,911,394845,9,394836
17994,18,4,770,778914,18,778896
17995,13,16,381,1149882,13,1149869
17996,11,-13,150,242114,11,242103
17997,5,13,446,1040369,5,1040364
17998,15,7,601,871457,15,871442
17999,9,-3,852,549435,9,549426
18000,11,17,221,1179491,11,1179480
18001,16,-16,598,151410,16,151394
18002,19,16,900,1153500,19,1153481
18003,16,4,266,775116,16,775100
18004,12,6,665,841121,12,841109
18005,11,4,761,778869,11,778858
18006,12,9,675,934026,12,934014
18007,16,-16,752,152430,16,152414
18008,20,1,478,683636,20,683616
18009,8,-12,469,259755,8,259747
18010,13,2,601,715081,13,715068
18011,16,-18,855,91410,16,91394
18012,6,-2,545,574282,6,574276
18013,11,-4,949,529167,11,529156
18014,20,1,792,686012,20,685992
18015,16,-15,386,180590,16,180574
18016,6,-7,743,421574,6,421568
18017,7,18,58,1187975,7,1187968
18018,10,-3,802,548335,10,548325
18019,15,5,539,807724,15,807709
18020,17,15,73,1117308,17,1117291
18021,19,8,518,902082,19,902063
18022,19,3,978,749350,19,749331
18023,20,-16,421,150040,20,150020
18024,15,6,809,842289,15,842274
18025,15,14,91,1086160,15,1086145
18026,11,6,361,838546,11,838535
18027,18,-19,752,59899,18,59881
18028,14,11,604,995191,14,995177
18029,8,-19,283,37718,8,37710
18030,5,17,553,1167081,5,1167076
18031,14,1,905,686896,14,686882
18032,9,7,229,849651,9,849642
18033,13,13,587,1057725,13,1057712
18034,17,5,342,806300,17,806283
18035,5,-2,316,569556,5,569551
18036,20,-20,878,29574,20,29554
18037,17,19,885,1247950,17,1247933
18038,15,-14,764,215459,15,215444
18039,16,-4,969,529387,16,529371
18040,8,14,487,1072657,8,1072649
18041,13,-15,997,185372,13,185359
18042,12,-11,715,309286,12,309274
18043,9,13,767,1047246,9,1047237
18044,17,18,363,1211732,17,1211715
18045,7,-6,229,441925,7,441918
18046,20,-11,52,304055,20,304035
18047,9,17,290,1161593,9,1161584
18048,10,-5,798,485115,10,485105
18049,7,-18,12,62714,7,62707
18050,13,12,12,1022166,13,1022153
18051,11,-14,821,215927,11,215916
18052,11,-15,761,183409,11,183398
18053,16,-13,245,242841,16,242825
18054,17,12,900,1028890,17,1028873
18055,15,5,898,810313,15,810298
18056,5,-9,825,361950,5,361945
18057,19,-17,23,115725,19,115706
18058,19,-19,368,56853,19,56834
18059,14,1,921,687063,14,687049
18060,15,5,238,805599,15,805584
18061,6,1,959,677874,6,677868
18062,10,19,70,1218995,10,1218985
18063,19,-3,753,559804,19,559785
18064,16,-6,674,464262,16,464246
18065,19,10,311,962165,19,962146
18066,19,1,815,686183,19,686164
18067,18,15,507,1120430,18,1120412
18068,13,-17,72,116026,13,116013
18069,11,17,657,1182743,11,1182732
18070,8,8,508,886380,8,886372
18071,13,-15,720,183155,13,183142
18072,19,-19,94,54643,19,54624
18073,14,-8,942,404551,14,404537
18074,5,15,440,1103740,5,1103735
18075,19,-19,673,59205,19,59186
18076,19,4,252,775064,19,775045
18077,13,-13,255,242913,13,242900
18078,20,-11,381,306808,20,306788
18079,7,-10,316,319415,7,319408
18080,19,14,30,1085609,19,1085590
18081,5,5,471,791383,5,791378
18082,13,6,37,836100,13,836087
18083,12,11,761,996350,12,996338
18084,13,-4,634,526866,13,526853
18085,14,-18,123,86151,14,86137
18086,10,-3,54,531694,10,531684
18087,11,9,424,932115,11,932104
18088,15,14,591,1089971,15,1089956
18089,6,4,202,755004,6,754998
18090,7,-14,515,197767,7,197760
18091,11,-11,871,310528,11,310517
18092,7,-6,290,443138,7,443131
18093,15,16,48,1147432,15,1147417
18094,19,-5,433,494185,19,494166
18095,17,-6,127,460025,17,460008
18096,5,-3,141,533474,5,533469
18097,6,4,753,766988,6,766982
18098,14,8,417,901306,14,901292
18099,5,-20,798,17652,5,17647
18100,12,3,391,744823,12,744811
18101,18,-8,280,399858,18,399840
18102,19,-1,998,624144,19,624125
18103,10,5,519,792409,10,792399
18104,10,-15,440,164922,10,164912
18105,17,3,836,748098,17,748081
18106,16,-9,126,367530,16,367514
18107,14,13,45,1053546,14,1053532
18108,18,15,693,1121861,18,1121843
18109,7,6,535,824443,7,824436
18110,18,-18,748,90710,18,90692
18111,19,-19,907,60855,19,60836
18112,14,10,622,964717,14,964703
18113,14,-13,323,243458,14,243444
18114,15,-17,299,117764,15,117749
18115,16,11,510,994551,16,994535
18116,10,-5,354,475888,10,475878
18117,19,-10,420,338142,19,338123
18118,16,-1,226,618357,16,618341
18119,11,16,728,1152305,11,1152294
18120,10,-12,818,267285,10,267275
18121,11,-3,554,558164,11,558153
18122,5,-8,603,388086,5,388081
18123,12,3,467,745332,12,745320
18124,11,-13,385,243839,11,243828
18125,18,12,323,1024485,18,1024467
18126,20,-4,860,528433,20,528413
18127,9,17,271,1161086,9,1161077
18128,14,17,610,1182405,14,1182391
18129,5,6,546,824614,5,824609
18130,13,5,681,808761,13,808748
18131,20,-3,159,554883,20,554863
18132,20,18,247,1210953,20,1210933
18133,15,-15,782,183599,15,183584
18134,11,-4,52,522404,11,522393
18135,12,-16,459,150437,12,150425
18136,7,10,268,943201,7,943194
18137,10,-19,50,32547,10,32537
18138,14,-3,139,554755,14,554741
18139,6,-16,7,123929,6,123923
18140,7,-4,225,504453,7,504446
18141,5,15,119,1097073,5,1097068
18142,16,16,330,1149501,16,1149485
18143,11,-9,117,367464,11,367453
18144,10,16,602,1137805,10,1137795
18145,17,6,248,837631,17,837614
18146,7,8,225,880071,7,880064
18147,5,-1,765,610252,5,610247
18148,9,-9,911,364131,9,364122
18149,8,-14,812,204321,8,204313
18150,14,19,248,1242709,14,1242695
18151,6,-8,996,396724,6,396718
18152,17,3,100,742552,17,742535
18153,6,-7,564,418003,6,417997
18154,7,-18,758,78898,7,78891
18155,19,12,111,1022874,19,1022855
18156,8,18,481,1197018,8,1197010
18157,19,-3,483,557492,19,557473
18158,7,12,435,1008429,7,1008422
18159,18,-14,285,211648,18,211630
18160,19,10,193,961337,19,961318
18161,17,-10,918,341973,17,341956
18162,12,-19,817,60266,12,60254
18163,20,8,492,901857,20,901837
18164,14,1,714,685366,14,685352
18165,7,-8,610,388318,7,388311
18166,18,0,386,651009,18,650991
18167,7,8,69,876507,7,876500
18168,7,-5,849,486384,7,486377
18169,7,14,463,1072131,7,1072124
18170,11,9,894,935681,11,935670
18171,18,-17,493,119173,18,119155
18172,12,-8,180,399188,12,399176
18173,6,-5,589,480796,6,480790
18174,9,15,439,1103696,9,1103687
18175,17,-13,268,243073,17,243056
18176,9,-18,493,73052,9,73043
18177,16,-11,543,308114,16,308098
18178,17,-6,529,463229,17,463212
18179,17,-14,842,216059,17,216042
18180,14,6,781,842012,14,841998
18181,7,-8,64,376811,7,376804
18182,14,-17,309,117816,14,117802
18183,14,19,253,1242743,14,1242729
18184,18,-18,483,88886,18,88868
18185,14,7,993,874064,14,874050
18186,7,-4,100,501534,7,501527
18187,20,12,124,1022966,20,1022946
18188,6,-20,112,2445,6,2439
18189,13,-11,770,309738,13,309725
18190,19,0,949,655463,19,655444
18191,20,16,582,1151195,20,1151175
18192,15,9,120,929921,15,929906
18193,9,-15,346,162934,9,162925
18194,20,0,882,654973,20,654953
18195,20,16,836,1153138,20,1153118
18196,17,-19,161,55326,17,55309
18197,20,3,463,745306,20,745286
18198,14,14,668,1090661,14,1090647
18199,16,5,289,805963,16,805947
18200,17,-9,463,370225,17,370208
18201,8,5,156,784786,8,784778
18202,11,-18,613,89665,11,89654
18203,16,-15,229,179398,16,179382
18204,20,-12,302,274774,20,274754
18205,18,2,544,714709,18,714691
18206,5,1,809,674603,5,674598
18207,12,4,24,773417,12,773405
18208,8,16,152,1128311,8,1128303
18209,18,6,491,839729,18,839711
18210,11,-11,869,310516,11,310505
18211,13,13,257,1055070,13,1055057
18212,12,4,197,774659,12,774647
18213,16,-14,498,213342,16,213326
18214,9,16,912,1144133,9,1144124
18215,17,14,258,1087430,17,1087413
18216,11,4,556,777274,11,777263
18217,13,19,786,1247162,13,1247149
18218,10,-4,719,514845,10,514835
18219,8,0,805,642976,8,642968
18220,9,-4,885,518439,9,518430
18221,11,-17,587,119960,11,119949
18222,19,-9,402,369686,19,369667
18223,9,-3,168,533986,9,533977
18224,17,-19,455,57465,17,57448
18225,17,-3,786,560122,17,560105
18226,12,-4,734,527559,12,527547
18227,7,-5,83,469796,7,469789
18228,17,-14,116,210207,17,210190
18229,18,18,554,1213018,18,1213000
18230,11,3,244,743704,11,743693
18231,10,-6,472,446880,10,446870
18232,7,-17,250,98751,7,98744
18233,9,10,610,950629,9,950620
18234,20,-2,788,591057,20,591037
18235,5,1,403,665957,5,665952
18236,9,-20,769,16922,9,16913
18237,7,11,342,975748,7,975741
18238,6,-15,507,166410,6,166404
18239,10,1,204,661649,10,661639
18240,14,-4,494,525787,14,525773
18241,19,6,396,838945,19,838926
18242,13,16,481,1150573,13,1150560
18243,14,-4,201,523636,14,523622
18244,20,-14,625,214436,20,214416
18245,19,-8,194,399271,19,399252
18246,11,-2,822,591353,11,591342
18247,16,18,263,1211096,16,1211080
18248,6,4,838,768983,6,768977
18249,12,4,643,777925,12,777913
18250,8,4,669,765010,8,765002
18251,11,4,582,777471,11,777460
18252,15,14,585,1089943,15,1089928
18253,9,-17,567,105728,9,105719
18254,10,-1,36,594566,10,594556
18255,12,8,742,903830,12,903818
18256,12,17,35,1178131,12,1178119
18257,13,-12,610,276934,13,276921
18258,7,12,553,1010955,7,1010948
18259,12,14,919,1092592,12,1092580
18260,6,15,736,1110142,6,1110136
18261,20,-19,480,57659,20,57639
18262,20,9,765,934618,20,934598
18263,15,15,821,1122786,15,1122771
18264,8,-7,633,419232,8,419224
18265,10,1,196,661448,10,661438
18266,10,-2,95,564825,10,564815
18267,5,-16,345,131329,5,131324
18268,20,-9,462,370217,20,370197
18269,19,-11,283,305943,19,305924
18270,8,16,402,1133764,8,1133756
18271,15,1,631,684818,15,684803
18272,17,0,475,651724,17,651707
18273,20,14,273,1087542,20,1087522
18274,17,3,294,744117,17,744100
18275,13,-12,208,273979,13,273966
18276,16,17,933,1184880,16,1184864
18277,9,4,348,757991,9,757982
18278,11,2,796,716416,11,716405
18279,14,1,287,682139,14,682125
18280,12,-3,485,557522,12,557510
18281,19,2,438,713918,19,713899
18282,16,2,330,713071,16,713055
18283,16,7,532,870956,16,870940
18284,17,2,217,712223,17,712206
18285,13,-5,302,493322,13,493309
18286,13,2,141,711674,13,711661
18287,19,-11,149,304906,19,304887
18288,18,-16,912,153653,18,153635
18289,18,10,973,967262,18,967244
18290,11,10,336,962371,11,962360
18291,10,3,572,730968,10,730958
18292,7,17,748,1171215,7,1171208
18293,5,4,730,766470,5,766465
18294,17,-12,857,278893,17,278876
18295,13,18,260,1211067,13,1211054
18296,12,-12,953,279717,12,279705
18297,9,-3,574,543423,9,543414
18298,17,-16,317,149287,17,149270
18299,12,-19,508,57908,12,57896
18300,10,-3,141,533484,10,533474
18301,20,-9,37,366882,20,366862
18302,13,-12,567,276697,13,276684
18303,11,-2,797,591121,11,591110
18304,20,-8,947,404595,20,404575
18305,8,9,839,924661,8,924653
18306,9,12,82,1000910,9,1000901
18307,5,-12,970,270753,5,270748
18308,10,8,753,891744,10,891734
18309,14,-6,175,460491,14,460477
18310,9,17,616,1168410,9,1168401
18311,11,-11,6,303727,11,303716
18312,6,-14,479,197034,6,197028
18313,18,-15,919,184778,18,184760
18314,11,0,669,653361,11,653350
18315,19,-14,936,216756,19,216737
18316,14,19,648,1246058,14,1246044
18317,16,-17,252,117327,16,117311
18318,14,3,618,746472,14,746458
18319,11,-3,766,559912,11,559901
18320,5,-10,102,314768,5,314763
18321,18,10,557,964139,18,964121
18322,11,2,14,710557,11,710546
18323,18,11,193,992196,18,992178
18324,17,16,358,1149735,17,1149718
18325,8,16,495,1135679,8,1135671
18326,8,-1,48,594831,8,594823
18327,9,6,871,831892,9,831883
18328,11,4,335,775611,11,775600
18329,7,19,861,1236726,7,1236719
18330,19,17,460,1181380,19,1181361
18331,8,6,369,820574,8,820566
18332,19,17,539,1181862,19,1181843
18333,18,-4,354,524874,18,524856
18334,12,-18,746,90679,12,90667
18335,6,-5,84,469821,6,469815
18336,8,-15,637,169146,8,169138
18337,5,2,168,692258,5,692253
18338,6,6,192,816377,6,816371
18339,5,-11,719,296662,5,296657
18340,18,-5,840,497117,18,497099
18341,19,-7,3,428293,19,428274
18342,7,-16,1000,145673,7,145666
18343,15,-1,695,621908,15,621893
18344,5,11,184,972175,5,972170
18345,14,15,955,1123800,14,1123786
18346,20,6,175,837048,20,837028
18347,8,17,382,1163486,8,1163478
18348,13,4,167,774482,13,774469
18349,9,8,546,887147,9,887138
18350,16,-3,728,559572,16,559556
18351,14,-11,277,305892,14,305878
18352,20,-1,646,621539,20,621519
18353,12,1,361,682737,12,682725
18354,20,17,700,1183125,20,1183105
18355,14,8,264,900037,14,900023
18356,9,14,392,1070442,9,1070433
18357,19,16,146,1148127,19,1148108
18358,12,-1,22,616692,12,616680
18359,18,14,491,1089275,18,1089257
18360,5,0,411,634235,5,634230
18361,7,-14,402,195638,7,195631
18362,14,13,562,1057467,14,1057453
18363,20,-8,890,404199,20,404179
18364,14,17,902,1184724,14,1184710
18365,6,-1,668,608221,6,608215
18366,19,7,248,868795,19,868776
18367,20,-9,1,366634,20,366614
18368,16,-1,265,618613,16,618597
18369,7,-10,805,329863,7,329856
18370,16,12,214,1023644,16,1023628
18371,19,-2,497,588899,19,588880
18372,9,17,717,1170567,9,1170558
18373,14,4,503,776876,14,776862
18374,18,19,537,1245199,18,1245181
18375,12,18,61,1209424,12,1209412
18376,15,-1,432,619989,15,619974
18377,14,-3,6,553897,14,553883
18378,5,-18,809,79910,5,79905
18379,12,-19,1000,61448,12,61436
18380,9,14,798,1079783,9,1079774
18381,15,7,785,872675,15,872660
18382,13,-8,810,403677,13,403664
18383,19,15,495,1120279,19,1120260
18384,10,-17,321,100422,10,100412
18385,5,-13,46,219401,5,219396
18386,20,-17,305,117792,20,117772
18387,6,11,385,976740,6,976734
18388,7,8,512,886466,7,886459
18389,10,-18,164,66050,10,66040
18390,14,15,34,1117008,14,1116994
18391,5,14,682,1077324,5,1077319
18392,12,-20,117,23652,12,23640
18393,17,6,989,843664,17,843647
18394,12,14,409,1088652,12,1088640
18395,7,11,506,979262,7,979255
18396,20,-8,374,400533,20,400513
18397,18,-11,897,310715,18,310697
18398,5,5,267,787238,5,787233
18399,17,14,620,1090238,17,1090221
18400,9,7,664,858879,9,858870
18401,9,-18,691,77160,9,77151
18402,15,13,219,1054858,15,1054843
18403,12,0,889,655037,12,655025
18404,7,17,877,1174180,7,1174173
18405,16,13,48,1053580,16,1053564
18406,9,-13,97,220497,9,220488
18407,9,7,973,865323,9,865314
18408,8,19,164,1221117,8,1221109
18409,11,-6,256,461175,11,461164
18410,19,5,961,810907,19,810888
18411,15,-3,812,560310,15,560295
18412,11,-1,571,621053,11,621042
18413,8,15,186,1098449,8,1098441
18414,5,-7,625,419094,5,419089
18415,16,2,322,713021,16,713005
18416,12,-5,233,492691,12,492679
18417,6,1,488,667903,6,667897
18418,8,-13,935,238602,8,238594
18419,8,1,944,677502,8,677494
18420,11,15,200,1118287,11,1118276
18421,11,13,328,1055642,11,1055631
18422,16,-6,381,462075,16,462059
18423,20,-5,303,493331,20,493311
18424,16,-15,400,180675,16,180659
18425,7,-4,814,516736,7,516729
18426,12,8,657,903138,12,903126
18427,8,0,97,627518,8,627510
18428,13,-11,878,310610,13,310597
18429,16,15,669,1121705,16,1121689
18430,18,-9,124,367508,18,367490
18431,13,-14,932,216721,13,216708
18432,11,-7,942,435269,11,435258
18433,7,11,126,971092,7,971085
18434,13,16,801,1152864,13,1152851
18435,17,5,830,809826,17,809809
18436,5,-4,768,515839,5,515834
18437,13,17,706,1183135,13,1183122
18438,14,-11,267,305834,14,305820
18439,17,5,330,806198,17,806181
18440,10,-16,76,125503,10,125493
18441,12,-6,666,464227,12,464215
18442,7,-13,763,234822,7,234815
18443,8,-8,949,395639,8,395631
18444,16,1,877,686610,16,686594
18445,20,-3,822,560378,20,560358
18446,12,2,617,715180,12,715168
18447,14,-18,358,88004,14,87990
18448,11,15,357,1119398,11,1119387
18449,15,18,185,1210494,15,1210479
18450,12,-1,256,618529,12,618517
18451,10,-15,181,159269,10,159259
18452,7,-8,974,396236,7,396229
18453,12,3,633,746619,12,746607
18454,11,13,261,1055112,11,1055101
18455,5,19,159,1221014,5,1221009
18456,9,1,93,659073,9,659064
18457,10,-7,211,410345,10,410335
18458,16,-7,278,430385,16,430369
18459,15,-2,892,591955,15,591940
18460,20,-11,292,306003,20,305983
18461,20,17,61,1178343,20,1178323
18462,15,-20,944,29958,15,29943
18463,15,-16,804,152794,15,152779
18464,9,-2,105,565078,9,565069
18465,15,18,943,1215858,15,1215843
18466,11,-8,848,403891,11,403880
18467,8,2,157,691943,8,691935
18468,19,18,636,1213540,19,1213521
18469,13,-5,221,492597,13,492584
18470,17,8,483,901768,17,901751
18471,5,-18,675,76858,5,76853
18472,9,13,334,1038006,9,1037997
18473,10,-1,811,611290,10,611280
18474,16,-19,776,60050,16,60034
18475,8,19,762,1234348,8,1234340
18476,11,-11,50,304016,11,304005
18477,20,-11,307,306217,20,306197
18478,7,-13,521,229410,7,229403
18479,14,-19,62,54328,14,54314
18480,19,17,591,1182227,19,1182208
18481,8,14,454,1071908,8,1071900
18482,12,-10,711,340419,12,340407
18483,14,-16,161,148098,14,148084
18484,19,-4,113,522897,19,522878
18485,16,13,544,1057302,16,1057286
18486,12,7,74,867540,12,867528
18487,7,13,597,1043623,7,1043616
18488,18,12,223,1023709,18,1023691
18489,13,-16,64,147267,13,147254
18490,17,-18,366,88042,17,88025
18491,12,-5,35,491074,12,491062
18492,14,8,653,903134,14,903120
18493,8,-3,390,538966,8,538958
18494,16,-2,835,591489,16,591473
18495,14,11,555,994830,14,994816
18496,17,-4,348,524831,17,524814
18497,20,14,808,1091802,20,1091782
18498,6,17,642,1169048,6,1169042
18499,9,-3,623,544394,9,544385
18500,15,-10,410,338065,15,338050
18501,6,-8,900,394647,6,394641
18502,14,-15,69,178255,14,178241
18503,12,-9,897,373668,12,373656
18504,7,-3,926,551218,7,551211
18505,5,3,469,728872,5,728867
18506,10,14,191,1065986,10,1065976
18507,6,6,10,812349,6,812343
18508,7,-3,115,532896,7,532889
18509,12,12,446,1025307,12,1025295
18510,20,-2,292,587349,20,587329
18511,17,8,195,899486,17,899469
18512,7,0,747,641770,7,641763
18513,19,6,789,842085,19,842066
18514,14,12,41,1022398,14,1022384
18515,9,-19,558,43653,9,43644
18516,16,0,643,653123,16,653107
18517,11,-20,815,29143,11,29132
18518,13,-13,33,241326,13,241313
18519,6,14,358,1069723,6,1069717
18520,13,-19,395,57088,13,57075
18521,10,-3,735,546884,10,546874
18522,6,4,388,759004,6,758998
18523,20,19,903,1248114,20,1248094
18524,10,-1,307,600686,10,600676
18525,10,0,261,631027,10,631017
18526,20,14,968,1093011,20,1092991
18527,8,6,508,823869,8,823861
18528,19,-14,796,215758,19,215739
18529,15,0,34,648528,15,648513
18530,17,7,597,871428,17,871411
18531,14,12,299,1024350,14,1024336
18532,15,2,266,712552,15,712537
18533,13,16,940,1153812,13,1153799
18534,10,-16,932,144042,10,144032
18535,10,14,422,1071264,10,1071254
18536,19,-18,795,91025,19,91006
18537,9,-10,134,315630,9,315621
18538,9,17,281,1161369,9,1161360
18539,12,9,899,935708,12,935696
18540,18,-3,751,559778,18,559760
18541,6,-18,978,83717,6,83711
18542,18,17,533,1181849,18,1181831
18543,6,-3,811,548535,6,548529
18544,5,14,281,1068089,5,1068084
18545,17,-18,376,88126,17,88109
18546,10,5,940,801457,10,801447
18547,10,-8,485,385375,10,385365
18548,5,-19,231,36657,5,36652
18549,19,-19,206,55720,19,55701
18550,17,1,340,682623,17,682606
18551,8,-2,831,580608,8,580600
18552,6,-5,985,489435,6,489429
18553,9,-14,986,208007,9,207998
18554,8,-8,387,383453,8,383445
18555,6,-8,679,389940,6,389934
18556,10,15,969,1115134,10,1115124
18557,20,-14,253,211410,20,211390
18558,10,-12,11,249871,10,249861
18559,11,6,441,839287,11,839276
18560,12,-11,369,306717,12,306705
18561,13,-17,465,118953,13,118940
18562,17,3,652,746774,17,746757
18563,15,-8,537,401653,15,401638
18564,18,-3,796,560198,18,560180
18565,9,1,520,668671,9,668662
18566,5,-5,223,472897,5,472892
18567,8,-6,966,457348,8,457340
18568,5,17,582,1167642,5,1167637
18569,6,-19,280,37634,6,37628
18570,9,-9,262,349351,9,349342
18571,9,-15,187,159366,9,159357
18572,19,17,842,1184311,19,1184292
18573,10,-11,133,284031,10,284021
18574,5,-16,993,145483,5,145478
18575,7,-2,588,575213,7,575206
18576,7,3,759,735256,7,735249
18577,11,17,327,1180426,11,1180415
18578,14,11,324,993233,14,993219
18579,18,-3,845,560530,18,560512
18580,11,11,299,993096,11,993085
18581,8,19,904,1237626,8,1237618
18582,20,9,68,929551,20,929531
18583,17,11,866,997142,17,997125
18584,14,-7,742,433683,14,433669
18585,11,-6,630,463960,11,463949
18586,18,2,161,711814,18,711796
18587,18,-11,413,307037,18,307019
18588,16,-13,506,244774,16,244758
18589,18,18,70,1209509,18,1209491
18590,10,-16,324,130995,10,130985
18591,13,-16,768,152548,13,152535
18592,20,11,772,996433,20,996413
18593,15,-10,30,335388,15,335373
18594,14,19,465,1244618,14,1244604
18595,11,-20,495,26516,11,26505
18596,9,-9,355,351429,9,351420
18597,12,17,417,1181022,12,1181010
18598,8,-20,941,20706,8,20698
18599,19,0,411,651201,19,651182
18600,14,-8,630,402279,14,402265
18601,5,-20,373,8173,5,8168
18602,13,-11,30,303887,13,303874
18603,7,15,157,1097785,7,1097778
18604,12,5,657,808559,12,808547
18605,10,-6,72,438285,10,438275
18606,17,18,682,1213872,17,1213855
18607,8,17,949,1175635,8,1175627
18608,13,-16,933,153805,13,153792
18609,19,-17,432,118653,19,118634
18610,18,18,222,1210767,18,1210749
18611,16,1,1,679741,16,679725
18612,7,17,174,1158948,7,1158941
18613,17,8,571,902445,17,902428
18614,6,5,659,795207,6,795201
18615,14,-19,730,59707,14,59693
18616,5,19,114,1220021,5,1220016
18617,12,-4,917,528957,12,528945
18618,12,4,632,777873,12,777861
18619,16,-5,466,494487,16,494471
18620,19,-19,521,58008,19,57989
18621,11,14,402,1088588,11,1088577
18622,7,15,920,1114010,7,1114003
18623,14,-14,75,209891,14,209877
18624,11,17,313,1180308,11,1180297
18625,12,-11,207,305345,12,305333
18626,17,-2,214,586697,17,586680
18627,14,10,514,963811,14,963797
18628,10,9,305,913132,10,913122
18629,20,-17,826,121677,20,121657
18630,12,4,342,775698,12,775686
18631,12,-13,574,245292,12,245280
18632,18,-12,715,277766,18,277748
18633,15,-8,929,404428,15,404413
18634,15,7,861,873229,15,873214
18635,19,-16,612,151534,19,151515
18636,6,-4,195,503676,6,503670
18637,19,-13,522,244893,19,244874
18638,12,5,763,809323,12,809311
18639,8,0,988,646813,8,646805
18640,5,-16,917,143700,5,143695
18641,17,-9,532,370929,17,370912
18642,17,-15,572,182001,17,181984
18643,20,-19,976,61291,20,61271
18644,5,-9,494,354873,5,354868
18645,16,13,41,1053526,16,1053510
18646,19,1,758,685759,19,685740
18647,5,-18,776,79217,5,79212
18648,12,7,595,871413,12,871401
18649,19,18,727,1214144,19,1214125
18650,11,7,541,871019,11,871008
18651,19,7,335,869478,19,869459
18652,5,-13,721,233753,5,233748
18653,11,12,448,1025316,11,1025305
18654,20,-15,271,179708,20,179688
18655,17,3,564,746015,17,745998
18656,19,7,930,873631,19,873612
18657,8,-3,894,550418,8,550410
18658,20,-7,475,431909,20,431889
18659,19,19,646,1246047,19,1246028
18660,7,5,310,787993,7,787986
18661,7,-9,718,359402,7,359395
18662,14,-15,540,181723,14,181709
18663,7,-12,793,266648,7,266641
18664,16,4,586,777492,16,777476
18665,7,-11,93,283065,7,283058
18666,9,10,296,943770,9,943761
18667,12,-4,306,524453,12,524441
18668,10,-5,92,470129,10,470119
18669,5,-11,982,302277,5,302272
18670,8,-3,641,544868,8,544860
18671,9,-19,594,44539,9,44530
18672,6,-19,195,35885,6,35879
18673,16,11,80,991443,16,991427
18674,5,-20,578,12577,5,12572
18675,16,-15,98,178528,16,178512
18676,17,10,92,960576,17,960559
18677,16,-5,908,497693,16,497677
18678,11,8,823,904367,11,904356
18679,5,-14,127,189209,5,189204
18680,6,4,584,763166,6,763160
18681,7,-1,802,611079,7,611072
18682,20,0,935,655355,20,655335
18683,5,-4,515,510637,5,510632
18684,11,10,34,960118,11,960107
18685,15,5,862,810048,15,810033
18686,16,-16,466,150479,16,150463
18687,12,-18,633,89836,12,89824
18688,16,15,489,1120266,16,1120250
18689,17,-1,122,617488,17,617471
18690,13,-1,116,617437,13,617424
18691,10,-13,927,238405,10,238395
18692,12,15,439,1119883,12,1119871
18693,19,8,383,900987,19,900968
18694,20,2,11,710550,20,710530
18695,10,16,381,1133290,10,1133280
18696,5,10,698,952570,5,952565
18697,19,-16,804,152803,19,152784
18698,10,-8,545,386833,10,386823
18699,20,9,657,933904,20,933884
18700,5,-5,177,471961,5,471956
18701,11,-15,417,180839,11,180828
18702,20,8,768,904047,20,904027
18703,5,15,889,1113320,5,1113315
18704,11,17,51,1178277,11,1178266
18705,15,-11,590,308435,15,308420
18706,11,15,868,1123128,11,1123117
18707,6,12,282,1005431,6,1005425
18708,10,-7,726,421203,10,421193
18709,14,10,548,964032,14,964018
18710,8,18,105,1189090,8,1189082
18711,14,-9,678,371774,14,371760
18712,12,12,577,1026273,12,1026261
18713,5,-9,406,352448,5,352443
18714,18,-16,909,153627,18,153609
18715,15,-7,683,433266,15,433251
18716,6,0,84,627110,6,627104
18717,17,18,837,1215032,17,1215015
18718,13,-20,615,27459,13,27446
18719,9,3,657,732952,9,732943
18720,12,4,108,774053,12,774041
18721,9,8,496,886034,9,886025
18722,13,-15,850,184192,13,184179
18723,9,0,459,635376,9,635367
18724,11,1,112,680694,11,680683
18725,9,-19,146,34843,9,34834
18726,13,0,775,654192,13,654179
18727,6,-15,655,169596,6,169590
18728,15,-9,910,373802,15,373787
18729,20,16,933,1153775,20,1153755
18730,20,-11,297,306059,20,306039
18731,18,-8,38,398196,18,398178
18732,10,-6,74,438336,10,438326
18733,10,-17,970,113921,10,113911
18734,17,-15,631,182446,17,182429
18735,6,-10,986,333722,6,333716
18736,10,17,792,1172239,10,1172229
18737,16,15,10,1116836,16,1116820
18738,9,0,796,642740,9,642731
18739,10,-17,31,94179,10,94169
18740,6,-5,785,484850,6,484844
18741,18,4,395,776056,18,776038
18742,12,13,422,1056372,12,1056360
18743,9,-1,831,611702,9,611693
18744,16,4,578,777452,16,777436
18745,14,-16,830,152996,14,152982
18746,19,9,560,933186,19,933167
18747,13,-10,465,338505,13,338492
18748,15,7,585,871324,15,871309
18749,19,15,392,1119636,19,1119617
18750,20,0,453,651538,20,651518
18751,9,-1,740,609748,9,609739
18752,17,5,815,809728,17,809711
18753,19,1,689,685233,19,685214
18754,8,-9,816,361802,8,361794
18755,11,3,188,743300,11,743289
18756,13,-5,413,494056,13,494043
18757,7,-12,930,269758,7,269751
18758,11,3,677,746999,11,746988
18759,15,18,726,1214133,15,1214118
18760,11,11,603,995187,11,995176
18761,13,9,970,936341,13,936328
18762,13,3,49,742187,13,742174
18763,13,-8,725,403020,13,403007
18764,10,8,558,887427,10,887417
18765,5,-5,726,483679,5,483674
18766,18,4,413,776203,18,776185
18767,9,-4,312,506267,9,506258
18768,20,0,480,651767,20,651747
18769,11,17,896,1184674,11,1184663
18770,12,0,455,651564,12,651552
18771,8,-12,278,255560,8,255552
18772,18,13,568,1057505,18,1057487
18773,10,9,434,915775,10,915765
18774,6,-12,261,255103,6,255097
18775,9,14,625,1075826,9,1075817
18776,19,1,49,680163,19,680144
18777,8,7,523,856002,8,855994
18778,6,0,194,629728,6,629722
18779,6,3,763,735361,6,735355
18780,17,-12,400,275436,17,275419
18781,8,2,649,702334,8,702326
18782,12,0,119,649167,12,649155
18783,19,4,59,773665,19,773646
18784,17,13,575,1057606,17,1057589
18785,13,-6,930,466174,13,466161
18786,8,-3,148,533590,8,533582
18787,20,-6,797,465234,20,465214
18788,13,14,606,1090129,13,1090116
18789,19,13,78,1053801,19,1053782
18790,18,8,676,903330,18,903312
18791,14,12,510,1025774,14,1025760
18792,19,1,396,682999,19,682980
18793,18,15,578,1120982,18,1120964
18794,10,-14,610,200117,10,200107
18795,6,12,916,1019239,6,1019233
18796,15,17,951,1185017,15,1185002
18797,20,-8,850,403900,20,403880
18798,6,0,533,636866,6,636860
18799,14,-13,510,244806,14,244792
18800,5,-12,381,257881,5,257876
18801,12,-20,503,26621,12,26609
18802,12,0,352,650709,12,650697
18803,8,-3,309,537119,8,537111
18804,16,15,915,1123478,16,1123462
18805,14,-8,999,405023,14,405009
18806,15,13,7,1053307,15,1053292
18807,12,-4,674,527154,12,527142
18808,19,-18,930,91974,19,91955
18809,17,-5,81,491492,17,491475
18810,17,-4,515,526018,17,526001
18811,14,18,177,1210370,14,1210356
18812,15,-1,692,621891,15,621876
18813,13,7,118,867857,13,867844
18814,12,19,570,1245424,12,1245412
18815,5,-20,634,13848,5,13843
18816,7,16,771,1141075,7,1141068
18817,19,15,793,1122588,19,1122569
18818,16,9,244,930792,16,930776
18819,12,-9,746,372337,12,372325
18820,12,8,580,902507,12,902495
18821,14,-12,916,279445,14,279431
18822,7,-19,705,46986,7,46979
18823,8,1,362,665132,8,665124
18824,8,9,957,927090,8,927082
18825,5,-18,67,63875,5,63870
18826,5,18,482,1197060,5,1197055
18827,8,-4,117,501863,8,501855
18828,5,-9,225,348394,5,348389
18829,9,16,418,1134173,9,1134164
18830,14,17,79,1178470,14,1178456
18831,8,1,954,677759,8,677751
18832,13,-11,373,306737,13,306724
18833,17,1,729,685534,17,685517
18834,11,17,440,1181193,11,1181182
18835,19,7,446,870352,19,870333
18836,12,18,660,1213745,12,1213733
18837,5,10,436,946837,5,946832
18838,16,-5,126,491893,16,491877
18839,14,15,346,1119341,14,1119327
18840,19,-9,328,369024,19,369005
18841,17,-16,875,153419,17,153402
18842,15,11,24,991051,15,991036
18843,18,-5,896,497609,18,497591
18844,17,5,251,805666,17,805649
18845,16,-12,356,275196,16,275180
18846,5,3,997,740723,5,740718
18847,19,14,941,1092846,19,1092827
18848,14,-8,887,404159,14,404145
18849,8,-7,236,410783,8,410775
18850,15,-13,529,244932,15,244917
18851,13,15,744,1122323,13,1122310
18852,17,12,285,1024240,17,1024223
18853,11,-4,424,525382,11,525371
18854,7,12,261,1004966,7,1004959
18855,13,-19,908,60868,13,60855
18856,18,-15,966,185135,18,185117
18857,14,-9,465,370251,14,370237
18858,16,5,630,808411,16,808395
18859,7,5,468,791336,7,791329
18860,13,-1,181,617897,13,617884
18861,10,14,221,1066611,10,1066601
18862,5,-8,343,382665,5,382660
18863,10,-13,769,235050,10,235040
18864,20,-12,688,277559,20,277539
18865,12,14,42,1085739,12,1085727
18866,12,5,860,810013,12,810001
18867,18,7,379,869793,18,869775
18868,8,12,73,1000646,8,1000638
18869,19,-16,749,152381,19,152362
18870,10,-14,804,204166,10,204156
18871,10,4,213,755298,10,755288
18872,5,10,379,945563,5,945558
18873,8,-8,99,377463,8,377455
18874,14,-5,997,498307,14,498293
18875,11,15,321,1119123,11,1119112
18876,5,-19,220,36407,5,36402
18877,9,10,324,944403,9,944394
18878,12,-10,587,339428,12,339416
18879,14,-3,324,556141,14,556127
18880,15,17,182,1179243,15,1179228
18881,7,14,3,1061742,7,1061735
18882,10,17,792,1172249,10,1172239
18883,13,-4,766,527771,13,527758
18884,7,13,51,1031848,7,1031841
18885,15,11,317,993167,15,993152
18886,14,8,629,902968,14,902954
18887,7,-6,489,447309,7,447302
18888,10,-11,986,302420,10,302410
18889,12,18,696,1213987,12,1213975
18890,9,-14,690,201839,9,201830
18891,17,-1,392,619688,17,619671
18892,17,-2,800,591146,17,591129
18893,7,7,737,860436,7,860429
18894,9,-9,877,363234,9,363225
18895,20,-5,91,491626,20,491606
18896,16,8,757,903926,16,903910
18897,13,13,413,1056322,13,1056309
18898,8,7,218,849381,8,849373
18899,17,18,234,1210842,17,1210825
18900,14,0,634,653044,14,653030
18901,17,-5,861,497290,17,497273
18902,6,-14,529,197986,6,197980
18903,15,11,25,991061,15,991046
18904,6,8,837,893374,6,893368
18905,7,-2,980,583791,7,583784
18906,18,-3,592,558465,18,558447
18907,15,3,892,748537,15,748522
18908,11,19,78,1241411,11,1241400
18909,10,16,460,1135073,10,1135063
18910,7,-8,715,390723,7,390716
18911,10,12,107,1001421,10,1001411
18912,8,17,107,1157527,8,1157519
18913,7,-6,371,444722,7,444715
18914,15,3,424,745042,15,745027
18915,9,12,715,1014754,9,1014745
18916,11,-15,418,180842,11,180831
18917,9,-6,567,449031,9,449022
18918,9,8,98,877167,9,877158
18919,18,11,971,997828,18,997810
18920,9,-18,2,62491,9,62482
18921,7,-13,540,229793,7,229786
18922,13,-6,849,465559,13,465546
18923,18,17,782,1183721,18,1183703
18924,18,-17,733,121058,18,121040
18925,14,4,288,775262,14,775248
18926,15,16,356,1149728,15,1149713
18927,9,-14,553,198454,9,198445
18928,17,17,404,1180911,17,1180894
18929,18,-11,365,306672,18,306654
18930,18,-11,735,309422,18,309404
18931,7,-8,828,393039,7,393032
18932,14,-1,230,618395,14,618381
18933,7,0,737,641563,7,641556
18934,8,6,960,833767,8,833759
18935,20,2,244,712414,20,712394
18936,12,-1,366,619524,12,619512
18937,11,-1,674,621739,11,621728
18938,9,-18,695,77268,9,77259
18939,14,-9,0,366617,14,366603
18940,12,5,124,804690,12,804678
18941,11,-18,67,85724,11,85713
18942,8,2,240,693735,8,693727
18943,8,18,118,1189413,8,1189405
18944,13,1,834,686298,13,686285
18945,12,0,979,655791,12,655779
18946,16,7,973,873910,16,873894
18947,6,6,825,830856,6,830850
18948,17,-4,969,529394,17,529377
18949,7,4,500,761322,7,761315
18950,9,9,538,918131,9,918122
18951,17,-5,259,492951,17,492934
18952,20,-3,630,558835,20,558815
18953,9,8,579,887858,9,887849
18954,7,-2,483,573071,7,573064
18955,5,-7,94,407819,5,407814
18956,16,5,132,804724,16,804708
18957,12,-6,745,464864,12,464852
18958,15,2,400,713658,15,713643
18959,14,16,42,1147360,14,1147346
18960,14,-5,629,495652,14,495638
18961,12,-2,246,586981,12,586969
18962,6,5,700,796186,6,796180
18963,15,19,766,1246986,15,1246971
18964,9,-18,142,65510,9,65501
18965,18,6,997,843718,18,843700
18966,19,18,199,1210617,19,1210598
18967,16,-6,79,459626,16,459610
18968,17,-19,16,53997,17,53980
18969,5,-6,54,438005,5,438000
18970,17,-11,186,305216,17,305199
18971,19,-9,705,371998,19,371979
18972,18,12,329,1024533,18,1024515
18973,19,11,349,993418,19,993399
18974,18,4,377,775950,18,775932
18975,16,15,312,1119082,16,1119066
18976,13,-8,632,402322,13,402309
18977,19,10,286,961974,19,961955
18978,8,-6,171,440488,8,440480
18979,8,1,487,667888,8,667880
18980,5,-20,480,10292,5,10287
18981,11,-19,514,57945,11,57934
18982,7,-4,251,505148,7,505141
18983,8,5,775,797782,8,797774
18984,15,11,924,997612,15,997597
18985,6,-11,635,295140,6,295134
18986,17,-20,512,26687,17,26670
18987,20,16,636,1151652,20,1151632
18988,18,7,69,867510,18,867492
18989,6,-6,643,450629,6,450623
18990,13,-6,72,459610,13,459597
18991,13,-12,649,277292,13,277279
18992,20,-6,266,461256,20,461236
18993,8,10,24,938056,8,938048
18994,15,-6,798,465257,15,465242
18995,9,12,112,1001578,9,1001569
18996,11,5,730,809084,11,809073
18997,14,-15,389,180606,14,180592
18998,7,11,370,976371,7,976364
18999,20,2,864,716937,20,716917
19000,14,-13,655,245801,14,245787
19001,18,16,769,1152528,18,1152510
19002,20,11,795,996641,20,996621
19003,16,9,977,936399,16,936383
19004,16,-13,770,246771,16,246755
19005,16,-11,213,305388,16,305372
19006,5,14,76,1063509,5,1063504
19007,14,14,671,1090698,14,1090684
19008,5,-7,334,413136,5,413131
19009,17,-2,813,591239,17,591222
19010,15,-20,927,29869,15,29854
19011,10,-17,301,100009,10,99999
19012,9,6,203,816616,9,816607
19013,14,8,641,903071,14,903057
19014,17,-11,38,303932,17,303915
19015,5,-20,925,20372,5,20367
19016,5,-14,543,198239,5,198234
19017,12,16,871,1153293,12,1153281
19018,16,3,949,749080,16,749064
19019,10,5,490,791801,10,791791
19020,15,-3,569,558302,15,558287
19021,12,15,924,1123514,12,1123502
19022,6,-5,812,485496,6,485490
19023,16,16,19,1147222,16,1147206
19024,19,-14,754,215374,19,215355
19025,15,-6,270,461289,15,461274
19026,10,-16,907,143500,10,143490
19027,17,12,852,1028489,17,1028472
19028,9,14,570,1074469,9,1074460
19029,7,-5,847,486319,7,486312
19030,13,4,647,777983,13,777970
19031,16,0,459,651602,16,651586
19032,10,-17,961,113735,10,113725
19033,17,-8,109,398665,17,398648
19034,18,17,619,1182443,18,1182425
19035,10,9,484,916926,10,916916
19036,19,16,785,1152680,19,1152661
19037,12,10,301,962062,12,962050
19038,14,-3,922,561175,14,561161
19039,10,-10,930,332380,10,332370
19040,14,4,794,779092,14,779078
19041,8,11,435,977790,8,977782
19042,6,18,497,1197332,6,1197326
19043,11,-15,876,184400,11,184389
19044,11,6,965,843432,11,843421
19045,17,0,805,654450,17,654433
19046,5,-15,708,170541,5,170536
19047,18,13,114,1054059,18,1054041
19048,13,12,272,1024138,13,1024125
19049,11,0,540,652296,11,652285
19050,17,0,65,648734,17,648717
19051,10,3,878,737764,10,737754
19052,10,6,596,825807,10,825797
19053,11,-14,265,211487,11,211476
19054,14,1,596,684533,14,684519
19055,7,-6,680,451337,7,451330
19056,7,-5,0,467727,7,467720
19057,10,-16,974,144966,10,144956
19058,19,5,668,808654,19,808635
19059,11,10,703,965322,11,965311
19060,11,12,813,1028083,11,1028072
19061,13,-1,742,622291,13,622278
19062,6,-12,856,268216,6,268210
19063,19,2,541,714678,19,714659
19064,8,8,410,884215,8,884207
19065,19,5,95,804490,19,804471
19066,9,-14,25,187008,9,186999
19067,10,-1,770,610363,10,610353
19068,13,-3,677,559208,13,559195
19069,8,-16,329,131062,8,131054
19070,15,-15,896,184538,15,184523
19071,11,11,714,995940,11,995929
19072,17,-20,646,27703,17,27686
19073,16,19,501,1244882,16,1244866
19074,7,11,102,970676,7,970669
19075,17,-8,865,404031,17,404014
19076,12,14,661,1090622,12,1090610
19077,16,-9,908,373783,16,373767
19078,5,16,208,1129592,5,1129587
19079,15,18,475,1212475,15,1212460
19080,10,-17,292,99747,10,99737
19081,16,-11,145,304877,16,304861
19082,7,9,506,917410,7,917403
19083,20,2,395,713599,20,713579
19084,18,14,259,1087443,18,1087425
19085,8,18,666,1200767,8,1200759
19086,14,18,214,1210713,14,1210699
19087,15,-10,705,340392,15,340377
19088,14,-17,655,120400,14,120386
19089,18,5,638,808461,18,808443
19090,17,-11,390,306861,17,306844
19091,16,-2,336,587605,16,587589
19092,6,-13,719,233702,6,233696
19093,9,10,53,938660,9,938651
19094,7,-18,427,71568,7,71561
19095,7,11,307,974904,7,974897
19096,20,-1,733,622241,20,622221
19097,19,-13,996,248561,19,248542
19098,8,-3,391,538998,8,538990
19099,19,-14,909,216597,19,216578
19100,15,-15,714,183082,15,183067
19101,17,18,972,1216127,17,1216110
19102,14,16,921,1153722,14,1153708
19103,9,2,949,708409,9,708400
19104,16,-18,794,91011,16,90995
19105,15,-15,896,184543,15,184528
19106,7,-16,949,144380,7,144373
19107,14,3,392,744831,14,744817
19108,15,-3,223,555326,15,555311
19109,20,-11,576,308323,20,308303
19110,17,-16,50,147154,17,147137
19111,15,-3,247,555512,15,555497
19112,20,-7,398,431375,20,431355
19113,15,17,543,1181922,15,1181907
19114,16,-5,617,495568,16,495552
19115,11,8,56,898297,11,898286
19116,19,-18,330,87790,19,87771
19117,20,-7,919,435105,20,435085
19118,18,6,118,836677,18,836659
19119,7,-8,847,393388,7,393381
19120,19,-8,724,403011,19,402992
19121,9,-11,781,297982,9,297973
19122,15,11,128,991734,15,991719
19123,8,17,528,1166619,8,1166611
19124,15,-18,322,87751,15,87736
19125,7,-5,660,482318,7,482311
19126,19,-5,147,492076,19,492057
19127,10,-20,985,21770,10,21760
19128,15,-12,281,274597,15,274582
19129,8,-13,322,225203,8,225195
19130,12,-19,715,59566,12,59554
19131,9,-19,235,36735,9,36726
19132,8,-9,813,361715,8,361707
19133,18,-7,865,434652,18,434634
19134,14,4,304,775390,14,775376
19135,9,-12,295,255951,9,255942
19136,13,14,671,1090701,13,1090688
19137,15,-2,62,585615,15,585600
19138,12,0,415,651265,12,651253
19139,6,5,965,802074,6,802068
19140,19,0,900,655115,19,655096
19141,17,-2,886,591925,17,591908
19142,6,14,968,1083446,6,1083440
19143,8,16,373,1133075,8,1133067
19144,8,-20,475,10162,8,10154
19145,17,7,213,868500,17,868483
19146,11,-16,190,148321,11,148310
19147,17,0,834,654606,17,654589
19148,11,5,791,809527,11,809516
19149,10,-16,314,130783,10,130773
19150,20,-9,156,367724,20,367704
19151,14,-2,485,588820,14,588806
19152,16,-12,749,278011,16,277995
19153,8,0,73,626854,8,626846
19154,17,-19,456,57485,17,57468
19155,15,-15,616,182289,15,182274
19156,6,11,719,983832,6,983826
19157,10,9,471,916558,10,916548
19158,14,-17,652,120382,14,120368
19159,18,-4,962,529329,18,529311
19160,20,1,236,681760,20,681740
19161,6,-8,328,382390,6,382384
19162,11,-20,375,25688,11,25677
19163,12,14,984,1093174,12,1093162
19164,17,16,96,1147734,17,1147717
19165,12,2,506,714425,12,714413
19166,10,-17,561,105571,10,105561
19167,20,-19,723,59625,20,59605
19168,10,8,244,880602,10,880592
19169,11,9,683,934079,11,934068
19170,10,14,756,1078912,10,1078902
19171,20,3,788,747770,20,747750
19172,18,-4,819,528105,18,528087
19173,11,0,451,651516,11,651505
19174,17,-3,576,558351,17,558334
19175,17,7,426,870176,17,870159
19176,9,-17,691,108279,9,108270
19177,10,15,908,1113746,10,1113736
19178,20,2,640,715367,20,715347
19179,11,5,902,810360,11,810349
19180,14,12,109,1022841,14,1022827
19181,13,2,513,714492,13,714479
19182,18,5,714,809009,18,808991
19183,15,-4,275,524212,15,524197
19184,12,9,51,929470,12,929458
19185,7,-19,339,38872,7,38865
19186,14,-19,76,54473,14,54459
19187,9,1,785,674056,9,674047
19188,8,-2,207,567168,8,567160
19189,5,16,226,1130049,5,1130044
19190,7,5,995,802629,7,802622
19191,11,-10,989,342580,11,342569
19192,5,-19,873,50534,5,50529
19193,17,6,771,841936,17,841919
19194,13,11,712,995912,13,995899
19195,15,14,716,1091131,15,1091116
19196,14,-3,953,561428,14,561414
19197,6,-19,797,48893,6,48887
19198,13,11,438,994072,13,994059
19199,8,-18,220,67181,8,67173
19200,6,13,429,1039966,6,1039960
19201,19,-12,484,276074,19,276055
19202,20,-17,280,117568,20,117548
19203,19,-10,633,339779,19,339760
19204,16,13,63,1053684,16,1053668
19205,18,-10,474,338651,18,338633
19206,9,6,754,829253,9,829244
19207,12,19,901,1248088,12,1248076
19208,20,18,327,1211494,20,1211474
19209,18,4,894,779864,18,779846
19210,15,12,446,1025312,15,1025297
19211,20,-10,926,342029,20,342009
19212,13,-13,418,244039,13,244026
19213,19,-9,586,371301,19,371282
19214,16,13,284,1055277,16,1055261
19215,12,3,764,747626,12,747614
19216,12,-6,586,463619,12,463607
19217,14,-6,786,465160,14,465146
19218,18,5,319,806090,18,806072
19219,11,15,499,1120322,11,1120311
19220,11,1,259,681942,11,681931
19221,7,-9,442,353425,7,353418
19222,15,0,993,655874,15,655859
19223,13,4,990,780503,13,780490
19224,8,6,989,834529,8,834521
19225,12,11,549,994778,12,994766
19226,5,-4,570,511737,5,511732
19227,16,-4,243,524012,16,523996
19228,11,-2,632,589871,11,589860
19229,10,-12,575,262016,10,262006
19230,13,-5,271,493036,13,493023
19231,9,7,1,844765,9,844756
19232,10,-18,584,74987,10,74977
19233,12,19,207,1242416,12,1242404
19234,10,-16,399,132529,10,132519
19235,17,-3,86,554362,17,554345
19236,20,-8,995,404986,20,404966
19237,10,-18,824,80275,10,80265
19238,14,2,476,714211,14,714197
19239,7,0,424,634530,7,634523
19240,12,11,686,995707,12,995695
19241,17,-1,987,624081,17,624064
19242,5,-9,384,352001,5,351996
19243,18,-2,473,588726,18,588708
19244,12,-7,739,433662,12,433650
19245,13,-18,640,89897,13,89884
19246,9,-19,898,50906,9,50897
19247,11,-17,446,118789,11,118778
19248,16,-16,990,154231,16,154215
19249,10,-6,382,444990,10,444980
19250,10,-5,168,471767,10,471757
19251,19,6,902,842947,19,842928
19252,20,-20,485,26433,20,26413
19253,15,-12,746,277976,15,277961
19254,7,4,685,765354,7,765347
19255,5,-4,528,510931,5,510926
19256,11,-16,400,149804,11,149793
19257,17,-9,270,368555,17,368538
19258,19,1,131,680871,19,680852
19259,6,1,431,666513,6,666507
19260,11,16,310,1149369,11,1149358
19261,7,3,222,723611,7,723604
19262,15,12,181,1023372,15,1023357
19263,12,19,38,1240992,12,1240980
19264,20,-7,360,431087,20,431067
19265,12,-5,201,492420,12,492408
19266,8,5,384,789532,8,789524
19267,15,-1,935,623728,15,623713
19268,10,-13,834,236417,10,236407
19269,12,-14,685,214910,12,214898
19270,6,-13,703,233292,6,233286
19271,12,-9,322,368955,12,368943
19272,7,-16,278,130097,7,130090
19273,13,-16,603,151443,13,151430
19274,13,6,559,840251,13,840238
19275,12,9,200,930526,12,930514
19276,10,13,718,1046116,10,1046106
19277,5,12,128,1001893,5,1001888
19278,11,-2,204,586621,11,586610
19279,11,-12,738,277874,11,277863
19280,14,-5,63,491299,14,491285
19281,11,2,29,710682,11,710671
19282,9,4,889,770186,9,770177
19283,17,-12,427,275602,17,275585
19284,15,-6,656,464132,15,464117
19285,5,-11,642,295313,5,295308
19286,13,0,196,649739,13,649726
19287,20,8,278,900156,20,900136
19288,9,15,646,1108141,9,1108132
19289,15,-4,565,526347,15,526332
19290,17,-9,864,373424,17,373407
19291,15,-2,183,586402,15,586387
19292,9,-1,911,613608,9,613599
19293,5,2,564,700541,5,700536
19294,13,13,157,1054364,13,1054351
19295,18,10,71,960395,18,960377
19296,16,8,682,903373,16,903357
19297,8,-12,152,252848,8,252840
19298,8,-19,717,47267,8,47259
19299,9,12,436,1008457,9,1008448
19300,18,13,418,1056335,18,1056317
19301,6,9,23,907240,6,907234
19302,13,1,919,687026,13,687013
19303,18,-11,240,305557,18,305539
19304,19,-5,929,497859,19,497840
19305,14,-4,425,525399,14,525385
19306,7,4,693,765494,7,765487
19307,9,-2,260,568369,9,568360
19308,15,2,667,715593,15,715578
19309,11,-7,834,434360,11,434349
19310,12,-7,664,433088,12,433076
19311,7,3,638,732514,7,732507
19312,16,-11,84,304307,16,304291
19313,9,-20,838,18596,9,18587
19314,18,8,640,903064,18,903046
19315,8,18,420,1195717,8,1195709
19316,17,-16,140,147973,17,147956
19317,7,-20,214,4894,7,4887
19318,13,18,681,1213862,13,1213849
19319,19,-18,934,92013,19,91994
19320,16,11,347,993398,16,993382
19321,15,-5,797,496784,15,496769
19322,13,-19,441,57399,13,57386
19323,5,-2,77,564488,5,564483
19324,16,-6,505,463052,16,463036
19325,17,16,799,1152839,17,1152822
19326,7,-12,665,263979,7,263972
19327,10,19,602,1230997,10,1230987
19328,16,-13,21,241216,16,241200
19329,13,-6,43,459446,13,459433
19330,19,-18,850,91356,19,91337
19331,19,8,978,905566,19,905547
19332,20,-19,366,56843,20,56823
19333,14,16,164,1148240,14,1148226
19334,12,1,589,684521,12,684509
19335,9,-15,603,168342,9,168333
19336,20,-13,15,241167,20,241147
19337,10,-13,393,226594,10,226584
19338,8,15,161,1097857,8,1097849
19339,17,-12,997,280075,17,280058
19340,14,-13,887,247651,14,247637
19341,16,7,254,868871,16,868855
19342,13,3,266,743896,13,743883
19343,19,-15,739,183308,19,183289
19344,18,-2,50,585528,18,585510
19345,14,12,523,1025850,14,1025836
19346,12,-11,458,307424,12,307412
19347,11,-15,519,181574,11,181563
19348,20,14,531,1089602,20,1089582
19349,12,-18,480,88863,12,88851
19350,16,-14,325,211927,16,211911
19351,12,-15,675,182784,12,182772
19352,14,5,780,809437,14,809423
19353,11,6,725,841660,11,841649
19354,10,-19,874,50563,10,50553
19355,17,7,180,868313,17,868296
19356,16,-5,598,495455,16,495439
19357,6,-13,233,223318,6,223312
19358,14,-5,517,494861,14,494847
19359,12,-17,710,120832,12,120820
19360,8,3,425,727935,8,727927
19361,10,-20,83,1842,10,1832
19362,9,-15,946,175624,9,175615
19363,10,-4,33,499985,10,499975
19364,13,-13,119,241892,13,241879
19365,19,-7,172,429598,19,429579
19366,19,8,355,900758,19,900739
19367,15,14,857,1092104,15,1092089
19368,8,11,703,983415,8,983407
19369,20,19,619,1245838,20,1245818
19370,9,13,404,1039453,9,1039444
19371,14,16,602,1151345,14,1151331
19372,12,-19,230,55854,12,55842
19373,12,-5,826,496981,12,496969
19374,13,0,720,653810,13,653797
19375,9,-6,928,456583,9,456574
19376,19,0,534,652259,19,652240
19377,9,-18,407,71135,9,71126
19378,6,5,549,793022,6,793016
19379,6,12,602,1012060,6,1012054
19380,12,5,498,807416,12,807404
19381,14,6,105,836543,14,836529
19382,7,17,547,1166971,7,1166964
19383,5,-2,688,577471,5,577466
19384,18,16,153,1148165,18,1148147
19385,20,-15,723,183181,20,183161
19386,11,-8,195,399281,11,399270
19387,6,17,870,1174099,6,1174093
19388,14,-15,732,183243,14,183229
19389,12,13,660,1058227,12,1058215
19390,7,4,545,762320,7,762313
19391,19,-8,27,398103,19,398084
19392,17,17,205,1179433,17,1179416
19393,18,3,575,746127,18,746109
19394,9,-16,630,137690,9,137681
19395,6,-12,659,263859,6,263853
19396,20,-18,136,86243,20,86223
19397,5,-19,682,46522,5,46517
19398,5,-12,883,268791,5,268786
19399,11,-16,379,149668,11,149657
19400,12,-3,702,559372,12,559360
19401,16,-7,672,433156,16,433140
19402,18,-7,5,428303,18,428285
19403,8,-20,451,9665,8,9657
19404,20,-11,837,310247,20,310227
19405,14,-18,25,85404,14,85390
19406,12,14,926,1092660,12,1092648
19407,9,9,236,911703,9,911694
19408,9,18,760,1202729,9,1202720
19409,9,-2,801,579825,9,579816
19410,8,1,984,678392,8,678384
19411,8,13,149,1033839,8,1033831
19412,19,-4,259,524113,19,524094
19413,9,4,130,753357,9,753348
19414,18,14,1000,1093347,18,1093329
19415,18,-9,354,369304,18,369286
19416,12,-17,108,116368,12,116356
19417,17,7,568,871189,17,871172
19418,18,9,857,935427,18,935409
19419,15,17,758,1183521,15,1183506
19420,16,0,64,648728,16,648712
19421,14,12,877,1028659,14,1028645
19422,18,-3,649,558970,18,558952
19423,13,-19,631,58987,13,58974
19424,6,11,47,969456,6,969450
19425,18,19,835,1247532,18,1247514
19426,14,-10,984,342501,14,342487
19427,11,2,406,713721,11,713710
19428,12,6,210,837280,12,837268
19429,18,-8,362,400408,18,400390
19430,16,19,992,1248730,16,1248714
19431,10,15,220,1099233,10,1099223
19432,10,5,286,787665,10,787655
19433,14,-8,229,399530,14,399516
19434,17,0,996,655915,17,655898
19435,9,-11,361,289129,9,289120
19436,16,7,399,869989,16,869973
19437,13,3,704,747193,13,747180
19438,19,-4,19,522178,19,522159
19439,9,19,498,1228840,9,1228831
19440,15,-15,941,184952,15,184937
19441,14,6,120,836701,14,836687
19442,19,-19,107,54793,19,54774
19443,6,12,56,1000317,6,1000311
19444,11,-8,421,400812,11,400801
19445,11,17,295,1180189,11,1180178
19446,13,3,967,749264,13,749251
19447,14,14,195,1086942,14,1086928
19448,16,-19,797,60161,16,60145
19449,13,-6,305,461540,13,461527
19450,7,-4,365,507549,7,507542
19451,20,-10,487,338697,20,338677
19452,15,-18,760,90812,15,90797
19453,17,2,583,714929,17,714912
19454,8,14,277,1068017,8,1068009
19455,11,1,438,683269,11,683258
19456,10,-17,483,103812,10,103802
19457,10,-13,850,236751,10,236741
19458,11,14,147,1086605,11,1086594
19459,12,-15,246,179562,12,179550
19460,16,-10,673,340168,16,340152
19461,16,-6,934,466205,16,466189
19462,10,-6,466,446755,10,446745
19463,12,-10,206,336560,12,336548
19464,6,12,559,1011076,6,1011070
19465,12,-11,435,307264,12,307252
19466,8,18,502,1197439,8,1197431
19467,6,-8,736,391130,6,391124
19468,19,1,183,681312,19,681293
19469,6,-15,874,174049,6,174043
19470,17,0,414,651245,17,651228
19471,12,-19,301,56346,12,56334
19472,11,-14,875,216308,11,216297
19473,18,-3,843,560511,18,560493
19474,14,-3,174,555011,14,554997
19475,18,-1,717,622116,18,622098
19476,20,-13,859,247455,20,247435
19477,5,3,654,732891,5,732886
19478,20,3,709,747242,20,747222
19479,11,9,315,931317,11,931306
19480,14,-10,587,339432,14,339418
19481,13,-20,70,23312,13,23299
19482,7,-9,87,345489,7,345482
19483,19,-6,174,460472,19,460453
19484,11,10,460,963338,11,963327
19485,17,-19,262,56057,17,56040
19486,18,-3,908,561057,18,561039
19487,17,1,100,680609,17,680592
19488,5,-4,889,518523,5,518518
19489,18,1,610,684658,18,684640
19490,8,-4,942,519666,8,519658
19491,7,-10,682,327400,7,327393
19492,20,-3,762,559891,20,559871
19493,18,6,111,836615,18,836597
19494,17,14,226,1087171,17,1087154
19495,5,16,200,1129381,5,1129376
19496,5,7,322,851749,5,851744
19497,14,-20,519,26734,14,26720
19498,16,-15,570,181960,16,181944
19499,15,-13,568,245243,15,245228
19500,11,-16,662,151798,11,151787
19501,18,3,377,744702,18,744684
19502,14,-15,458,181137,14,181123
19503,7,-17,208,97837,7,97830
19504,14,7,645,871740,14,871726
19505,10,-7,788,422467,10,422457
19506,11,-20,230,24536,11,24525
19507,15,-19,74,54460,15,54445
19508,10,2,22,689058,10,689048
19509,14,14,968,1093015,14,1093001
19510,15,-16,427,150082,15,150067
19511,8,0,101,627663,8,627655
19512,12,-1,795,622686,12,622674
19513,20,5,64,804298,20,804278
19514,5,-11,956,301742,5,301737
19515,12,-10,958,342275,12,342263
19516,12,2,884,717080,12,717068
19517,5,-13,741,234185,5,234180
19518,10,-8,893,394418,10,394408
19519,17,-15,127,178748,17,178731
19520,6,13,340,1038103,6,1038097
19521,12,3,908,748663,12,748651
19522,12,-1,727,622193,12,622181
19523,13,-12,635,277126,13,277113
19524,18,-1,919,623597,18,623579
19525,11,-13,794,246924,11,246913
19526,17,-14,831,215990,17,215973
19527,6,16,924,1144454,6,1144448
19528,15,0,857,654736,15,654721
19529,12,-6,296,461480,12,461468
19530,14,0,616,652915,14,652901
19531,20,15,179,1118144,20,1118124
19532,9,-16,870,142767,9,142758
19533,20,-2,215,586730,20,586710
19534,8,11,957,988915,8,988907
19535,9,-19,141,34727,9,34718
19536,20,1,925,687107,20,687087
19537,16,14,534,1089651,16,1089635
19538,13,-5,647,495756,13,495743
19539,6,14,459,1072031,6,1072025
19540,14,-16,949,153887,14,153873
19541,11,13,101,1053976,11,1053965
19542,5,-20,371,8108,5,8103
19543,5,3,627,732251,5,732246
19544,14,-16,355,149518,14,149504
19545,13,12,771,1027784,13,1027771
19546,14,-13,919,247956,14,247942
19547,20,1,468,683556,20,683536
19548,16,-7,987,435619,16,435603
19549,11,13,946,1060243,11,1060232
19550,15,-4,73,522602,15,522587
19551,19,4,517,777010,19,776991
19552,13,-4,99,522791,13,522778
19553,16,-2,321,587537,16,587521
19554,20,-9,109,367386,20,367366
19555,20,-11,589,308427,20,308407
19556,19,-17,756,121249,19,121230
19557,15,-19,435,57361,15,57346
19558,14,-13,503,244737,14,244723
19559,14,-16,114,147762,14,147748
19560,9,-6,34,437589,9,437580
19561,12,-16,277,149013,12,149001
19562,16,6,677,841202,16,841186
19563,12,9,454,932323,12,932311
19564,17,10,166,961159,17,961142
19565,14,13,943,1060231,14,1060217
19566,6,-4,495,510122,6,510116
19567,13,-19,805,60196,13,60183
19568,13,-4,337,524691,13,524678
19569,17,-13,672,245873,17,245856
19570,17,-11,776,309809,17,309792
19571,9,-11,248,286468,9,286459
19572,9,15,404,1102935,9,1102926
19573,10,3,276,724849,10,724839
19574,16,0,857,654742,16,654726
19575,16,-8,25,398082,16,398066
19576,19,19,905,1248130,19,1248111
19577,20,-1,237,618452,20,618432
19578,17,-14,40,209616,17,209599
19579,12,-5,658,495805,12,495793
19580,18,10,116,960794,18,960776
19581,10,-11,123,283789,10,283779
19582,5,13,661,1045027,5,1045022
19583,20,17,998,1185480,20,1185460
19584,13,-17,667,120533,13,120520
19585,17,-4,808,528040,17,528023
19586,12,-15,388,180603,12,180591
19587,6,15,21,1094902,6,1094896
19588,17,-5,114,491786,17,491769
19589,6,16,353,1132678,6,1132672
19590,6,3,812,736275,6,736269
19591,5,-19,68,32912,5,32907
19592,14,-13,514,244828,14,244814
19593,15,-3,10,553933,15,553918
19594,5,-16,955,144497,5,144492
19595,6,-11,322,288237,6,288231
19596,8,3,11,719062,8,719054
19597,17,-4,323,524614,17,524597
19598,10,-4,595,512255,10,512245
19599,17,-9,219,368113,17,368096
19600,7,-7,530,417213,7,417206
19601,7,-5,638,481805,7,481798
19602,14,11,607,995195,14,995181
19603,16,-6,308,461551,16,461535
19604,9,8,508,886389,9,886380
19605,16,-15,840,184067,16,184051
19606,5,19,2,1217399,5,1217394
19607,17,-1,590,621182,17,621165
19608,12,-17,320,117863,12,117851
19609,12,11,250,992625,12,992613
19610,17,2,555,714778,17,714761
19611,13,16,607,1151381,13,1151368
19612,11,9,837,935277,11,935266
19613,5,-11,868,299698,5,299693
19614,18,15,821,1122794,18,1122776
19615,16,0,966,655676,16,655660
19616,17,-1,682,621794,17,621777
19617,16,13,892,1059897,16,1059881
19618,20,-8,926,404426,20,404406
19619,17,-11,356,306622,17,306605
19620,18,-7,74,428823,18,428805
19621,8,4,200,754958,8,754950
19622,16,-2,900,591994,16,591978
19623,7,-6,395,445228,7,445221
19624,17,8,387,901029,17,901012
19625,6,-16,245,129406,6,129400
19626,8,-3,839,549148,8,549140
19627,6,-12,996,271332,6,271326
19628,20,-14,369,212359,20,212339
19629,13,10,482,963496,13,963483
19630,17,12,388,1024894,17,1024877
19631,14,-17,532,119446,14,119432
19632,20,-9,732,372158,20,372138
19633,6,12,298,1005762,6,1005756
19634,17,-14,178,210655,17,210638
19635,5,-4,837,517160,5,517155
19636,7,11,345,975808,7,975801
19637,7,-6,511,447880,7,447873
19638,10,-19,43,32418,10,32408
19639,12,16,277,1149110,12,1149098
19640,9,-9,715,359340,9,359331
19641,20,18,364,1211757,20,1211737
19642,16,10,31,960101,16,960085
19643,20,-16,986,154174,20,154154
19644,17,-19,350,56730,17,56713
19645,9,19,815,1235546,9,1235537
19646,18,-2,97,585854,18,585836
19647,17,2,508,714451,17,714434
19648,8,0,79,626951,8,626943
19649,18,16,581,1151176,18,1151158
19650,16,-5,919,497778,16,497762
19651,15,-14,664,214705,15,214690
19652,7,-13,536,229721,7,229714
19653,12,-8,141,398889,12,398877
19654,8,-1,860,612328,8,612320
19655,10,19,39,1218258,10,1218248
19656,19,9,833,935235,19,935216
19657,10,9,613,919791,10,919781
19658,18,-13,561,245160,18,245142
19659,6,2,623,701781,6,701775
19660,19,19,776,1247074,19,1247055
19661,13,18,93,1209671,13,1209658
19662,19,14,748,1091312,19,1091293
19663,15,-6,245,461093,15,461078
19664,16,4,825,779366,16,779350
19665,19,-3,703,559385,19,559366
19666,12,-18,350,87962,12,87950
19667,9,19,361,1225597,9,1225588
19668,9,9,481,916832,9,916823
19669,10,15,833,1112148,10,1112138
19670,14,-6,30,459404,14,459390
19671,8,13,966,1051380,8,1051372
19672,11,2,284,712690,11,712679
19673,13,-11,474,307524,13,307511
19674,9,18,904,1205848,9,1205839
19675,19,17,654,1182725,19,1182706
19676,14,-8,229,399534,14,399520
19677,6,15,958,1114905,6,1114899
19678,15,8,773,904082,15,904067
19679,5,-15,31,155998,5,155993
19680,17,4,195,774643,17,774626
19681,17,0,631,653017,17,653000
19682,7,-1,334,601368,7,601361
19683,13,-8,810,403680,13,403667
19684,8,-8,24,375862,8,375854
19685,6,-8,104,377571,6,377565
19686,20,-5,544,495060,20,495040
19687,13,-8,640,402362,13,402349
19688,6,5,879,800134,6,800128
19689,5,10,117,940211,5,940206
19690,14,4,482,776714,14,776700
19691,17,-14,100,210097,17,210080
19692,15,3,488,745469,15,745454
19693,12,11,498,994474,12,994462
19694,18,-12,356,275204,18,275186
19695,15,9,311,931268,15,931253
19696,16,-16,570,151198,16,151182
19697,12,13,274,1055184,12,1055172
19698,16,-18,173,86633,16,86617
19699,8,-3,934,551431,8,551423
19700,5,-9,81,345385,5,345380
19701,20,4,297,775335,20,775315
19702,5,-14,936,206825,5,206820
19703,13,15,441,1119911,13,1119898
19704,5,4,795,767944,5,767939
19705,9,-19,591,44459,9,44450
19706,19,14,830,1091959,19,1091940
19707,12,-12,398,275415,12,275403
19708,7,8,623,888791,7,888784
19709,17,-16,321,149351,17,149334
19710,9,-13,979,239517,9,239508
19711,14,0,328,650506,14,650492
19712,18,-1,311,619057,18,619039
19713,9,9,376,914618,9,914609
19714,12,6,187,837156,12,837144
19715,9,-19,664,46048,9,46039
19716,16,15,831,1122873,16,1122857
19717,15,1,808,686136,15,686121
19718,5,11,833,986217,5,986212
19719,15,-13,466,244387,15,244372
19720,12,-6,446,462532,12,462520
19721,10,19,898,1237456,10,1237446
19722,19,18,803,1214810,19,1214791
19723,15,14,560,1089820,15,1089805
19724,7,-12,428,258830,7,258823
19725,8,8,215,879831,8,879823
19726,11,12,803,1028007,11,1027996
19727,18,-7,32,428585,18,428567
19728,11,6,154,836927,11,836916
19729,13,-2,102,585894,13,585881
19730,8,-13,652,232202,8,232194
19731,11,1,952,687296,11,687285
19732,13,3,685,747055,13,747042
19733,16,-4,82,522657,16,522641
19734,12,14,183,1086847,12,1086835
19735,8,-12,962,270543,8,270535
19736,5,-14,67,187951,5,187946
19737,9,-5,902,487625,9,487616
19738,10,16,30,1125801,10,1125791
19739,5,5,781,797942,5,797937
19740,13,18,740,1214268,13,1214255
19741,8,-15,204,159621,8,159613
19742,10,-6,973,457485,10,457475
19743,14,-7,581,432692,14,432678
19744,13,6,159,836949,13,836936
19745,11,12,139,1023045,11,1023034
19746,9,-8,704,390494,9,390485
19747,8,9,28,907386,8,907378
19748,20,19,665,1246155,20,1246135
19749,11,-8,128,398774,11,398763
19750,7,2,753,704524,7,704517
19751,11,-11,404,306944,11,306933
19752,16,-17,145,116537,16,116521
19753,16,11,504,994499,16,994483
19754,20,19,812,1247361,20,1247341
19755,9,13,741,1046631,9,1046622
19756,17,-16,690,151970,17,151953
19757,17,-6,223,460873,17,460856
19758,9,-14,545,198256,9,198247
19759,18,-7,389,431288,18,431270
19760,16,12,399,1024996,16,1024980
19761,14,7,576,871274,14,871260
19762,17,12,976,1029642,17,1029625
19763,15,9,745,934497,15,934482
19764,14,8,671,903282,14,903268
19765,8,17,736,1170982,8,1170974
19766,19,10,455,963292,19,963273
19767,10,-5,596,480968,10,480958
19768,9,16,552,1136863,9,1136854
19769,14,-10,878,341690,14,341676
19770,19,-13,468,244430,19,244411
19771,5,-4,844,517332,5,517327
19772,12,-20,805,29065,12,29053
19773,7,-9,947,364822,7,364815
19774,11,15,662,1121652,11,1121641
19775,12,-1,348,619373,12,619361
19776,7,1,293,663539,7,663532
19777,15,-17,376,118259,15,118244
19778,12,-9,728,372131,12,372119
19779,20,-16,442,150286,20,150266
19780,18,-4,331,524650,18,524632
19781,13,-7,877,434725,13,434712
19782,9,12,125,1001866,9,1001857
19783,19,-10,303,337251,19,337232
19784,6,-15,570,167675,6,167669
19785,16,-17,932,122356,16,122340
19786,9,6,283,818637,9,818628
19787,11,19,837,1247550,11,1247539
19788,10,4,374,758674,10,758664
19789,10,19,747,1234102,10,1234092
19790,16,-14,304,211764,16,211748
19791,16,-7,924,435156,16,435140
19792,10,-17,772,110022,10,110012
19793,7,6,332,819770,7,819763
19794,6,10,790,954545,6,954539
19795,7,-14,303,193286,7,193279
19796,20,-4,225,523868,20,523848
19797,9,15,388,1102704,9,1102695
19798,20,-15,328,180138,20,180118
19799,17,-18,222,87003,17,86986
19800,20,-12,533,276492,20,276472
19801,7,-11,106,283403,7,283396
19802,6,-13,655,232255,6,232249
19803,10,7,834,862491,10,862481
19804,19,-3,440,557124,19,557105
19805,19,-1,267,618642,19,618623
19806,18,-2,126,586062,18,586044
19807,15,0,199,649775,15,649760
19808,14,7,812,872871,14,872857
19809,17,18,45,1209249,17,1209232
19810,11,13,212,1054810,11,1054799
19811,20,16,1000,1154285,20,1154265
19812,14,11,259,992699,14,992685
19813,5,-19,440,40989,5,40984
19814,7,10,895,956722,7,956715
19815,9,-2,238,567868,9,567859
19816,15,-7,156,429452,15,429437
19817,11,5,232,805555,11,805544
19818,10,5,134,784332,10,784322
19819,17,-15,282,179816,17,179799
19820,6,-3,868,549813,6,549807
19821,8,-5,944,488553,8,488545
19822,17,-5,410,494026,17,494009
19823,20,-3,170,554966,20,554946
19824,13,-8,613,402176,13,402163
19825,10,1,314,664020,10,664010
19826,8,11,379,976564,8,976556
19827,17,-10,670,340151,17,340134
19828,14,19,441,1244492,14,1244478
19829,11,0,691,653562,11,653551
19830,17,-10,602,339548,17,339531
19831,6,16,556,1136923,6,1136917
19832,6,-4,344,507051,6,507045
19833,12,9,393,931872,12,931860
19834,15,-8,716,402948,15,402933
19835,11,14,864,1092162,11,1092151
19836,17,-4,354,524881,17,524864
19837,15,14,509,1089432,15,1089417
19838,14,16,643,1151729,14,1151715
19839,11,0,247,650053,11,650042
19840,20,-17,797,121517,20,121497
19841,15,-15,189,179110,15,179095
19842,19,15,951,1123772,19,1123753
19843,19,-3,936,561296,19,561277
19844,7,18,274,1192851,7,1192844
19845,19,5,328,806177,19,806158
19846,14,-15,227,179381,14,179367
19847,13,14,320,1087939,13,1087926
19848,15,-20,660,27861,15,27846
19849,20,11,990,997980,20,997960
19850,19,-6,725,464691,19,464672
19851,7,8,123,877681,7,877674
19852,17,-15,245,179542,17,179525
19853,11,18,320,1211408,11,1211397
19854,18,-19,641,59056,18,59038
19855,18,12,390,1024910,18,1024892
19856,17,-14,470,213152,17,213135
19857,5,14,566,1074395,5,1074390
19858,7,-14,374,194943,7,194936
19859,7,17,890,1174426,7,1174419
19860,5,-15,160,158841,5,158836
19861,5,-3,872,549899,5,549894
19862,19,7,698,872112,19,872093
19863,11,-7,363,431119,11,431108
19864,7,-16,438,133610,7,133603
19865,5,-10,562,324856,5,324851
19866,17,-8,913,404382,17,404365
19867,13,-15,265,179679,13,179666
19868,9,17,558,1167172,9,1167163
19869,7,-11,26,281606,7,281599
19870,18,-11,605,308565,18,308547
19871,20,13,442,1056550,20,1056530
19872,14,-6,126,460019,14,460005
19873,8,-12,957,270445,8,270437
19874,20,-10,192,336504,20,336484
19875,15,-17,830,121709,15,121694
19876,7,-12,773,266219,7,266212
19877,18,-20,164,24005,18,23987
19878,14,-6,822,465426,14,465412
19879,13,-11,901,310793,13,310780
19880,6,-19,684,46562,6,46556
19881,7,-12,844,267887,7,267880
19882,19,17,168,1179152,19,1179133
19883,16,-10,559,339227,16,339211
19884,19,4,311,775420,19,775401
19885,8,10,644,951440,8,951432
19886,8,-5,715,483447,8,483439
19887,6,-4,14,499603,6,499597
19888,6,15,637,1107962,6,1107956
19889,12,-15,121,178698,12,178686
19890,9,8,939,895594,9,895585
19891,15,-20,988,30349,15,30334
19892,10,5,15,781936,10,781926
19893,11,-12,107,273306,11,273295
19894,9,11,919,988338,9,988329
19895,8,15,81,1096151,8,1096143
19896,6,-11,372,289397,6,289391
19897,9,-11,155,284553,9,284544
19898,12,-7,11,428357,12,428345
19899,10,1,842,675256,10,675246
19900,19,10,906,966745,19,966726
19901,10,-4,436,509009,10,508999
19902,15,18,908,1215583,15,1215568
19903,8,-5,716,483495,8,483487
19904,19,12,956,1029460,19,1029441
19905,13,19,324,1243378,13,1243365
19906,6,-6,174,440601,6,440595
19907,12,19,752,1246863,12,1246851
19908,13,6,884,842821,13,842808
19909,5,-17,100,95629,5,95624
19910,19,7,213,868509,19,868490
19911,15,-12,641,277220,15,277205
19912,6,11,93,970449,6,970443
19913,7,-16,742,139913,7,139906
19914,13,8,12,897979,13,897966
19915,18,4,587,777503,18,777485
19916,8,9,508,917495,8,917487
19917,16,2,846,716817,16,716801
19918,19,14,415,1088700,19,1088681
19919,9,-7,888,424885,9,424876
19920,9,0,239,630600,9,630591
19921,11,-9,899,373713,11,373702
19922,8,-3,565,543217,8,543209
19923,16,16,875,1153314,16,1153298
19924,11,17,635,1182561,11,1182550
19925,11,-14,919,216677,11,216666
19926,5,15,654,1108325,5,1108320
19927,12,14,540,1089670,12,1089658
19928,15,-9,549,371067,15,371052
19929,13,-19,976,61294,13,61281
19930,14,-18,601,89588,14,89574
19931,10,12,234,1004267,10,1004257
19932,20,19,414,1244234,20,1244214
19933,11,11,514,994559,11,994548
19934,5,14,679,1077213,5,1077208
19935,14,-18,947,92088,14,92074
19936,9,-1,837,611848,9,611839
19937,20,-13,555,245121,20,245101
19938,5,-11,688,296228,5,296223
19939,10,1,972,678192,10,678182
19940,13,7,831,873017,13,873004
19941,14,4,145,774295,14,774281
19942,10,-20,511,11010,10,11000
19943,9,-6,719,452263,9,452254
19944,11,-8,601,402047,11,402036
19945,16,1,685,685189,16,685173
19946,11,-3,239,555451,11,555440
19947,19,14,945,1092871,19,1092852
19948,6,9,88,908569,6,908563
19949,17,13,493,1056867,17,1056850
19950,18,-16,941,153842,18,153824
19951,17,13,206,1054747,17,1054730
19952,17,-19,97,54695,17,54678
19953,14,-5,160,492192,14,492178
19954,7,-5,635,481726,7,481719
19955,12,-8,924,404403,12,404391
19956,12,3,227,743589,12,743577
19957,14,7,243,868753,14,868739
19958,8,-12,340,257009,8,257001
19959,12,-5,493,494670,12,494658
19960,7,-18,19,62809,7,62802
19961,17,14,932,1092732,17,1092715
19962,13,6,106,836555,13,836542
19963,14,19,554,1245327,14,1245313
19964,14,-6,484,462879,14,462865
19965,13,14,734,1091197,13,1091184
19966,13,-14,183,210696,13,210683
19967,9,17,140,1158266,9,1158257
19968,18,-15,122,178705,18,178687
19969,11,-4,774,527820,11,527809
19970,15,19,820,1247380,15,1247365
19971,17,-17,881,122042,17,122025
19972,7,6,632,826539,7,826532
19973,13,-14,215,211012,13,210999
19974,10,1,167,660806,10,660796
19975,14,5,337,806260,14,806246
19976,9,-6,226,441782,9,441773
19977,11,-6,584,463609,11,463598
19978,7,-7,143,408826,7,408819
19979,14,10,628,964765,14,964751
19980,16,18,393,1211937,16,1211921
19981,9,16,458,1135037,9,1135028
19982,9,-20,360,7909,9,7900
19983,19,12,276,1024179,19,1024160
19984,13,2,587,714957,13,714944
19985,10,-18,912,82282,10,82272
19986,15,-11,22,303828,15,303813
19987,9,-3,42,531412,9,531403
19988,8,8,223,880026,8,880018
19989,13,-4,727,527528,13,527515
19990,16,-3,505,557676,16,557660
19991,17,-9,781,372723,17,372706
19992,11,-11,777,309814,11,309803
19993,16,-16,438,150237,16,150221
19994,11,-5,882,497501,11,497490
19995,7,3,209,723383,7,723376
19996,13,-8,266,399748,13,399735
19997,9,6,573,825217,9,825208
19998,6,-10,837,330564,6,330558
19999,17,14,7,1085400,17,1085383
20000,18,-19,621,58898,18,58880
20001,5,10,114,940113,5,940108
20002,13,-15,792,183640,13,183627
20003,6,-10,458,322599,6,322593
20004,8,-5,87,469979,8,469971
20005,6,-14,498,197438,6,197432
20006,16,16,459,1150414,16,1150398
20007,5,19,864,1236807,5,1236802
20008,12,-6,599,463713,12,463701
20009,10,15,632,1107868,10,1107858
20010,10,14,416,1071126,10,1071116
20011,11,-12,194,273877,11,273866
20012,16,9,202,930541,16,930525
20013,11,-12,882,279110,11,279099
20014,18,13,47,1053567,18,1053549
20015,6,-18,387,70715,6,70709
20016,15,-2,518,589039,15,589024
20017,10,-2,97,564897,10,564887
20018,14,-17,581,119910,14,119896
20019,7,-1,257,599458,7,599451
20020,13,8,616,902802,13,902789
20021,6,19,582,1230641,6,1230635
20022,6,-13,292,224639,6,224633
20023,20,-15,264,179662,20,179642
20024,9,-9,125,346268,9,346259
20025,15,-17,95,116284,15,116269
20026,15,7,569,871214,15,871199
20027,16,-10,332,337452,16,337436
20028,8,-7,841,423647,8,423639
20029,15,-14,546,213695,15,213680
20030,6,15,449,1103980,6,1103974
20031,18,-15,970,185139,18,185121
20032,12,-3,191,555120,12,555108
20033,18,-17,973,122603,18,122585
20034,17,-16,7,146765,17,146748
20035,12,1,622,684732,12,684720
20036,16,13,48,1053586,16,1053570
20037,16,-20,374,25688,16,25672
20038,19,-1,423,619915,19,619896
20039,6,-8,972,396165,6,396159
20040,14,-7,285,430456,14,430442
20041,15,-12,844,278754,15,278739
20042,19,-13,903,247747,19,247728
20043,18,-11,995,311478,18,311460
20044,18,-1,355,619457,18,619439
20045,5,-5,391,476554,5,476549
20046,7,-11,510,292533,7,292526
20047,18,-4,338,524707,18,524689
20048,8,-5,999,489702,8,489694
20049,12,5,581,808029,12,808017
20050,5,12,719,1014829,5,1014824
20051,8,-2,744,578562,8,578554
20052,11,-5,966,498163,11,498152
20053,18,0,197,649756,18,649738
20054,8,-1,798,611011,8,611003
20055,18,13,598,1057792,18,1057774
20056,20,5,281,805895,20,805875
20057,16,-17,886,122076,16,122060
20058,12,12,451,1025350,12,1025338
20059,14,9,792,934919,14,934905
20060,12,0,127,649219,12,649207
20061,10,0,686,640363,10,640353
20062,20,14,801,1091726,20,1091706
20063,6,13,995,1051994,6,1051988
20064,8,-7,983,426870,8,426862
20065,19,0,710,653692,19,653673
20066,8,-1,640,607704,8,607696
20067,8,1,320,664155,8,664147
20068,17,12,186,1023402,17,1023385
20069,16,-20,31,17376,16,17360
20070,6,16,305,1131607,6,1131601
20071,9,1,512,668493,9,668484
20072,12,-6,812,465365,12,465353
20073,9,-1,434,603442,9,603433
20074,9,8,902,894758,9,894749
20075,8,-1,907,613524,8,613516
20076,10,9,366,914438,10,914428
20077,17,2,452,714014,17,713997
20078,17,-9,863,373395,17,373378
20079,8,-9,331,350842,8,350834
20080,12,11,974,997857,12,997845
20081,20,-10,717,340455,20,340435
20082,20,-14,672,214778,20,214758
20083,16,17,30,1178084,16,1178068
20084,12,19,587,1245562,12,1245550
20085,7,16,646,1138776,7,1138769
20086,8,13,268,1036351,8,1036343
20087,11,-1,72,617128,11,617117
20088,18,-11,550,308154,18,308136
20089,10,7,959,865024,10,865014
20090,6,-17,645,107334,6,107328
20091,11,-14,911,216615,11,216604
20092,8,4,204,755034,8,755026
20093,9,-14,45,187551,9,187542
20094,9,6,330,819712,9,819703
20095,11,-11,576,308324,11,308313
20096,20,5,108,804593,20,804573
20097,9,-15,333,162632,9,162623
20098,15,-17,467,118961,15,118946
20099,10,17,153,1158427,10,1158417
20100,12,-9,544,371009,12,370997
20101,15,-17,28,115749,15,115734
20102,5,10,778,954276,5,954271
20103,5,-18,407,71140,5,71135
20104,6,14,58,1063057,6,1063051
20105,7,19,941,1238370,7,1238363
20106,5,-19,203,36114,5,36109
20107,19,-7,406,431414,19,431395
20108,19,1,269,682038,19,682019
20109,5,-3,749,547179,5,547174
20110,13,19,945,1248378,13,1248365
20111,20,-5,687,496031,20,496011
20112,16,5,941,810697,16,810681
20113,6,-13,216,222910,6,222904
20114,17,15,677,1121753,17,1121736
20115,8,11,970,989233,8,989225
20116,14,-1,241,618470,14,618456
20117,12,16,926,1153745,12,1153733
20118,12,18,326,1211473,12,1211461
20119,16,-16,49,147142,16,147126
20120,14,-18,193,86775,14,86761
20121,6,17,0,1155301,6,1155295
20122,17,6,89,836396,17,836379
20123,12,2,470,714160,12,714148
20124,16,15,617,1121293,16,1121277
20125,9,4,563,762704,9,762695
20126,18,17,761,1183527,18,1183509
20127,13,9,586,933378,13,933365
20128,5,16,567,1137146,5,1137141
20129,12,15,754,1122415,12,1122403
20130,5,14,51,1062947,5,1062942
20131,9,-2,219,567478,9,567469
20132,7,-19,463,41456,7,41449
20133,14,6,704,841493,14,841479
20134,6,-3,443,540316,6,540310
20135,11,-11,287,305960,11,305949
20136,18,-9,931,373935,18,373917
20137,9,-12,725,265114,9,265105
20138,7,-18,154,65830,7,65823
20139,16,3,948,749072,16,749056
20140,11,-16,202,148418,11,148407
20141,8,-3,720,546605,8,546597
20142,15,1,318,682371,15,682356
20143,13,-12,214,274061,13,274048
20144,7,12,847,1017603,7,1017596
20145,5,-10,718,328037,5,328032
20146,9,1,96,659147,9,659138
20147,10,-4,387,507982,10,507972
20148,16,19,111,1241663,16,1241647
20149,12,-7,587,432726,12,432714
20150,6,-14,501,197456,6,197450
20151,7,12,900,1018866,7,1018859
20152,13,-14,846,216094,13,216081
20153,11,10,856,966376,11,966365
20154,16,-1,653,621636,16,621620
20155,9,18,255,1192440,9,1192431
20156,13,-10,426,338180,13,338167
20157,18,10,70,960377,18,960359
20158,11,0,362,650782,11,650771
20159,8,-13,127,221072,8,221064
20160,12,9,986,936418,12,936406
20161,8,12,641,1013136,8,1013128
20162,13,6,522,840053,13,840040
20163,16,3,643,746676,16,746660
20164,11,1,154,681076,11,681065
20165,12,-15,124,178714,12,178702
20166,20,8,232,899874,20,899854
20167,15,7,500,870706,15,870691
20168,7,-9,943,364765,7,364758
20169,10,1,527,668853,10,668843
20170,13,-19,263,56071,13,56058
20171,11,2,489,714294,11,714283
20172,13,11,373,993592,13,993579
20173,18,6,378,838722,18,838704
20174,16,18,141,1210126,16,1210110
20175,5,-7,971,426572,5,426567
20176,16,-19,862,60635,16,60619
20177,13,2,859,716891,13,716878
20178,9,-3,906,550699,9,550690
20179,20,5,732,809104,20,809084
20180,20,-4,608,526654,20,526634
20181,8,-5,375,476252,8,476244
20182,17,12,949,1029396,17,1029379
20183,9,-1,872,612583,9,612574
20184,12,2,120,711490,12,711478
20185,10,-13,35,219146,10,219136
20186,14,-11,70,304237,14,304223
20187,14,-7,134,429258,14,429244
20188,9,9,686,921151,9,921142
20189,7,-9,941,364693,7,364686
20190,19,8,482,901748,19,901729
20191,13,10,534,963934,13,963921
20192,5,17,670,1169729,5,1169724
20193,13,11,951,997704,13,997691
20194,7,-15,437,164876,7,164869
20195,15,-20,395,25816,15,25801
20196,15,9,986,936423,15,936408
20197,18,16,622,1151474,18,1151456
20198,10,-3,365,538360,10,538350
20199,11,5,51,804182,11,804171
20200,15,-18,290,87482,15,87467
20201,12,-14,87,210003,12,209991
20202,18,-11,257,305717,18,305699
20203,19,-18,670,90141,19,90122
20204,16,7,668,871953,16,871937
20205,18,-11,749,309553,18,309535
20206,8,15,484,1104735,8,1104727
20207,6,-1,56,594968,6,594962
20208,5,-13,364,225984,5,225979
20209,7,18,665,1200740,7,1200733
20210,13,-20,307,25225,13,25212
20211,6,19,319,1224666,6,1224660
20212,11,-16,37,146998,11,146987
20213,6,-1,939,614219,6,614213
20214,20,-17,724,120995,20,120975
20215,6,-13,534,229655,6,229649
20216,19,-14,32,209567,19,209548
20217,10,-4,948,519731,10,519721
20218,13,-17,975,122631,13,122618
20219,6,15,131,1097356,6,1097350
20220,13,0,86,648856,13,648843
20221,6,-20,678,14976,6,14970
20222,5,1,10,657199,5,657194
20223,7,-6,538,448425,7,448418
20224,16,-13,534,244975,16,244959
20225,6,5,136,784376,6,784370
20226,19,-3,32,554036,19,554017
20227,9,3,422,727855,9,727846
20228,18,3,618,746480,18,746462
20229,18,0,830,654568,18,654550
20230,10,0,585,638027,10,638017
20231,6,-10,567,324953,6,324947
20232,12,-2,416,588223,12,588211
20233,7,15,620,1107619,7,1107612
20234,8,12,617,1012428,8,1012420
20235,18,15,361,1119408,18,1119390
20236,10,-13,535,229700,10,229690
20237,13,16,203,1148557,13,1148544
20238,18,4,498,776827,18,776809
20239,6,-19,900,50917,6,50911
20240,11,-11,431,307224,11,307213
20241,8,6,681,827652,8,827644
20242,6,-7,340,413270,6,413264
20243,20,-12,349,275143,20,275123
20244,9,7,203,849104,9,849095
20245,18,-4,391,525158,18,525140
20246,17,3,284,744049,17,744032
20247,14,13,753,1058836,14,1058822
20248,5,-15,943,175548,5,175543
20249,13,0,804,654433,13,654420
20250,15,-8,891,404203,15,404188
20251,10,-12,748,265695,10,265685
20252,12,-16,603,151445,12,151433
20253,20,-20,381,25752,20,25732
20254,8,-19,597,44604,8,44596
20255,16,11,283,992911,16,992895
20256,14,6,958,843370,14,843356
20257,14,-15,428,180968,14,180954
20258,13,-20,404,25885,13,25872
20259,15,-2,274,587192,15,587177
20260,7,-2,257,568263,7,568256
20261,20,10,150,961029,20,961009
20262,17,-8,392,400666,17,400649
20263,20,-14,364,212271,20,212251
20264,15,-13,794,246929,15,246914
20265,12,7,108,867807,12,867795
20266,19,-17,716,120915,19,120896
20267,10,-11,309,287995,10,287985
20268,10,0,667,639968,10,639958
20269,14,11,640,995396,14,995382
20270,17,14,143,1086578,17,1086561
20271,19,-5,334,493627,19,493608
20272,10,18,53,1187833,10,1187823
20273,16,13,573,1057589,16,1057573
20274,17,-9,182,367843,17,367826
20275,18,18,176,1210367,18,1210349
20276,6,11,809,985811,6,985805
20277,16,1,86,680451,16,680435
20278,11,3,754,747523,11,747512
20279,9,8,384,883535,9,883526
20280,15,-5,22,490973,15,490958
20281,6,-16,80,125596,6,125590
20282,10,13,827,1048517,10,1048507
20283,14,6,321,838264,14,838250
20284,19,-13,296,243300,19,243281
20285,5,6,711,828440,5,828435
20286,12,-1,164,617769,12,617757
20287,16,-18,574,89408,16,89392
20288,9,11,984,989546,9,989537
20289,9,-16,837,141934,9,141925
20290,9,-9,755,360306,9,360297
20291,18,3,897,748566,18,748548
20292,7,8,804,892809,7,892802
20293,20,-18,337,87831,20,87811
20294,14,-15,394,180643,14,180629
20295,6,12,576,1011424,6,1011418
20296,11,-20,597,27327,11,27316
20297,8,9,432,915716,8,915708
20298,13,8,610,902758,13,902745
20299,6,-8,339,382611,6,382605
20300,10,-1,331,601230,10,601220
20301,16,6,858,842592,16,842576
20302,6,-17,729,109126,6,109120
20303,9,6,937,833303,9,833294
20304,11,13,655,1058180,11,1058169
20305,18,-6,690,464418,18,464400
20306,5,-18,872,81222,5,81217
20307,17,16,544,1150937,17,1150920
20308,17,1,606,684621,17,684604
20309,5,17,734,1170943,5,1170938
20310,15,8,720,903691,15,903676
20311,9,15,675,1108752,9,1108743
20312,11,19,486,1244780,11,1244769
20313,19,0,807,654465,19,654446
20314,9,-3,527,542376,9,542367
20315,20,-4,504,525919,20,525899
20316,15,3,252,743790,15,743775
20317,7,-19,550,43475,7,43468
20318,19,6,869,842698,19,842679
20319,8,4,398,759200,8,759192
20320,8,4,561,762648,8,762640
20321,7,-20,198,4681,7,4674
20322,14,9,777,934793,14,934779
20323,17,0,520,652107,17,652090
20324,11,-4,783,527903,11,527892
20325,7,14,347,1069444,7,1069437
20326,9,-10,6,312621,9,312612
20327,13,19,512,1244998,13,1244985
20328,18,-19,385,56988,18,56970
20329,15,-5,4,490796,15,490781
20330,19,15,382,1119585,19,1119566
20331,20,14,454,1089014,20,1088994
20332,10,0,183,629542,10,629532
20333,18,-14,172,210618,18,210600
20334,13,-11,655,308965,13,308952
20335,7,5,300,787853,7,787846
20336,10,10,988,958604,10,958594
20337,12,-19,474,57627,12,57615
20338,18,5,626,808383,18,808365
20339,20,-2,730,590603,20,590583
20340,8,-4,655,513501,8,513493
20341,13,1,998,687552,13,687539
20342,15,12,457,1025387,15,1025372
20343,17,-15,313,180029,17,180012
20344,15,16,547,1150966,15,1150951
20345,12,-2,715,590529,12,590517
20346,18,-19,333,56567,18,56549
20347,20,-8,607,402121,20,402101
20348,14,3,496,745529,14,745515
20349,6,19,707,1233110,6,1233104
20350,7,-15,870,173952,7,173945
20351,8,18,882,1205332,8,1205324
20352,8,18,474,1196897,8,1196889
20353,12,-13,578,245314,12,245302
20354,14,2,397,713616,14,713602
20355,19,-17,222,117106,19,117087
20356,6,10,326,944427,6,944421
20357,17,18,179,1210407,17,1210390
20358,5,6,709,828377,5,828372
20359,10,-9,384,352011,10,352001
20360,8,-2,840,580810,8,580802
20361,19,17,181,1179234,19,1179215
20362,10,-16,98,126159,10,126149
20363,7,15,864,1112846,7,1112839
20364,19,-15,769,183512,19,183493
20365,13,4,554,777257,13,777244
20366,20,10,655,964975,20,964955
20367,13,-16,578,151247,13,151234
20368,13,-18,913,91867,13,91854
20369,16,-8,451,401014,16,400998
20370,13,-4,345,524769,13,524756
20371,9,-18,101,64709,9,64700
20372,9,7,1,844774,9,844765
20373,7,-11,800,298291,7,298284
20374,20,-6,784,465145,20,465125
20375,13,10,108,960700,13,960687
20376,8,-15,28,155960,8,155952
20377,19,-18,776,90887,19,90868
20378,12,9,943,936114,12,936102
20379,20,-3,579,558372,20,558352
20380,16,-4,439,525457,16,525441
20381,7,13,752,1046869,7,1046862
20382,13,4,55,773649,13,773636
20383,11,2,119,711489,11,711478
20384,12,3,767,747637,12,747625
20385,15,5,855,809972,15,809957
20386,12,12,92,1022739,12,1022727
20387,10,10,565,949623,10,949613
20388,15,-11,600,308513,15,308498
20389,11,-16,892,153515,11,153504
20390,11,-6,595,463659,11,463648
20391,6,7,818,862127,6,862121
20392,9,-12,78,251266,9,251257
20393,12,4,212,774778,12,774766
20394,18,5,926,810589,18,810571
20395,17,4,793,779086,17,779069
20396,17,-5,60,491277,17,491260
20397,12,2,155,711760,12,711748
20398,5,11,752,984507,5,984502
20399,13,15,815,1122758,13,1122745
20400,16,-18,680,90195,16,90179
20401,19,-12,673,277463,19,277444
20402,14,-2,88,585793,14,585779
20403,17,2,20,710605,17,710588
20404,16,-20,141,23843,16,23827
20405,12,13,775,1059036,12,1059024
20406,6,9,515,917671,6,917665
20407,20,-9,501,370635,20,370615
20408,7,-9,892,363638,7,363631
20409,6,16,218,1129835,6,1129829
20410,14,-10,942,342184,14,342170
20411,14,0,748,654038,14,654024
20412,14,10,582,964379,14,964365
20413,14,5,234,805564,14,805550
20414,10,13,725,1046259,10,1046249
20415,16,18,454,1212348,16,1212332
20416,10,15,422,1103277,10,1103267
20417,5,-19,421,40551,5,40546
20418,8,8,779,892382,8,892374
20419,18,10,682,965196,18,965178
20420,8,-4,706,514589,8,514581
20421,11,-2,797,591122,11,591111
20422,8,-10,995,334011,8,334003
20423,6,8,156,878476,6,878470
20424,17,-9,676,371760,17,371743
20425,11,-10,993,342647,11,342636
20426,16,-4,630,526832,16,526816
20427,12,-7,639,432983,12,432971
20428,9,14,448,1071778,9,1071769
20429,13,3,908,748666,13,748653
20430,11,-19,575,58565,11,58554
20431,8,0,837,643540,8,643532
20432,13,-17,167,116706,13,116693
20433,15,14,978,1093132,15,1093117
20434,14,-17,13,115663,14,115649
20435,19,4,933,780134,19,780115
20436,14,-1,856,623098,14,623084
20437,12,-4,709,527414,12,527402
20438,11,0,753,654045,11,654034
20439,5,-11,710,296536,5,296531
20440,20,3,17,741931,20,741911
20441,8,1,284,663361,8,663353
20442,5,-12,159,252975,5,252970
20443,8,-13,99,220547,8,220539
20444,13,10,199,961353,13,961340
20445,15,-17,495,119214,15,119199
20446,8,14,243,1067173,8,1067165
20447,16,-12,925,279499,16,279483
20448,6,5,876,800022,6,800016
20449,11,18,592,1213169,11,1213158
20450,17,15,651,1121581,17,1121564
20451,20,-12,507,276335,20,276315
20452,20,-2,525,589100,20,589080
20453,7,-1,331,601237,7,601230
20454,6,1,548,669338,6,669332
20455,17,-4,723,527483,17,527466
20456,17,-13,455,244305,17,244288
20457,6,-7,43,406987,6,406981
20458,11,2,459,714093,11,714082
20459,10,5,844,799274,10,799264
20460,15,19,519,1245070,15,1245055
20461,9,16,587,1137481,9,1137472
20462,16,7,336,869483,16,869467
20463,12,-15,386,180592,12,180580
20464,6,13,55,1031972,6,1031966
20465,10,18,644,1200367,10,1200357
20466,19,17,227,1179542,19,1179523
20467,13,-2,947,592360,13,592347
20468,6,-20,455,9732,6,9726
20469,20,3,220,743519,20,743499
20470,9,7,956,864947,9,864938
20471,20,-13,943,248147,20,248127
20472,7,-12,443,259151,7,259144
20473,6,-11,622,294929,6,294923
20474,18,6,985,843605,18,843587
20475,13,5,242,805623,13,805610
20476,13,1,577,684456,13,684443
20477,11,-19,102,54730,11,54719
20478,19,4,205,774707,19,774688
20479,16,-11,938,311003,16,310987
20480,10,13,740,1046607,10,1046597
20481,16,-1,515,620662,16,620646
20482,18,-16,410,149918,18,149900
20483,16,18,734,1214195,16,1214179
20484,8,-2,620,575953,8,575945
20485,10,13,885,1049774,10,1049764
20486,7,-6,693,451735,7,451728
20487,8,-4,360,507449,8,507441
20488,12,-20,837,29291,12,29279
20489,16,14,29,1085590,16,1085574
20490,5,-11,288,287373,5,287368
20491,16,10,696,965269,16,965253
20492,8,16,747,1140630,8,1140622
20493,16,4,225,774895,16,774879
20494,12,1,601,684555,12,684543
20495,13,8,813,904349,13,904336
20496,16,-9,584,371286,16,371270
20497,20,-4,834,528163,20,528143
20498,19,-3,258,555604,19,555585
20499,20,-19,83,54561,20,54541
20500,15,6,542,840135,15,840120
20501,15,-10,262,337015,15,337000
20502,6,13,187,1034661,6,1034655
20503,12,10,65,960326,12,960314
20504,17,-7,273,430367,17,430350
20505,6,-16,936,144177,6,144171
20506,7,-7,445,415389,7,415382
20507,16,-6,955,466362,16,466346
20508,9,10,834,955512,9,955503
20509,5,9,244,911854,5,911849
20510,20,15,170,1118055,20,1118035
20511,15,3,429,745073,15,745058
20512,14,3,393,744834,14,744820
20513,18,-15,995,185299,18,185281
20514,11,13,559,1057454,11,1057443
20515,15,-6,980,466588,15,466573
20516,18,3,932,748910,18,748892
20517,15,12,29,1022306,15,1022291
20518,16,1,20,679924,16,679908
20519,17,-20,170,24055,17,24038
20520,8,-10,230,317576,8,317568
20521,7,-11,117,283712,7,283705
20522,18,-2,284,587249,18,587231
20523,11,-7,676,433196,11,433185
20524,18,-10,731,340571,18,340553
20525,14,-14,564,213917,14,213903
20526,10,12,410,1007839,10,1007829
20527,13,7,358,869610,13,869597
20528,6,-19,738,47834,6,47828
20529,8,7,452,854496,8,854488
20530,13,-2,221,586805,13,586792
20531,19,-18,967,92248,19,92229
20532,9,5,2,781652,9,781643
20533,18,-3,440,557132,18,557114
20534,17,-16,469,150502,17,150485
20535,19,-19,351,56748,19,56729
20536,7,-1,212,598318,7,598311
20537,9,-6,947,456962,9,456953
20538,13,19,413,1244208,13,1244195
20539,14,6,334,838362,14,838348
20540,14,-11,782,309848,14,309834
20541,16,-6,665,464217,16,464201
20542,5,-19,523,42885,5,42880
20543,10,8,872,894121,10,894111
20544,20,-20,289,25042,20,25022
20545,19,2,290,712795,19,712776
20546,18,-14,187,210735,18,210717
20547,16,-8,21,398040,16,398024
20548,8,18,332,1193919,8,1193911
20549,7,-6,333,443975,7,443968
20550,10,12,12,999274,10,999264
20551,11,-10,611,339646,11,339635
20552,15,7,333,869447,15,869432
20553,13,-18,703,90337,13,90324
20554,15,11,933,997643,15,997628
20555,7,-4,932,519369,7,519362
20556,14,5,329,806192,14,806178
20557,5,-6,231,441953,5,441948
20558,14,-19,535,58146,14,58132
20559,13,-19,873,60715,13,60702
20560,7,-17,214,98016,7,98009
20561,11,12,180,1023354,11,1023343
20562,10,-6,758,453103,10,453093
20563,16,0,473,651719,16,651703
20564,19,2,946,717520,19,717501
20565,17,16,104,1147801,17,1147784
20566,18,-1,60,616990,18,616972
20567,11,-2,978,592581,11,592570
20568,12,6,66,836247,12,836235
20569,17,-17,338,118007,17,117990
20570,14,6,548,840185,14,840171
20571,5,6,97,814294,5,814289
20572,5,-19,437,40918,5,40913
20573,20,5,757,809280,20,809260
20574,13,-4,588,526527,13,526514
20575,18,-14,767,215527,18,215509
20576,19,4,173,774544,19,774525
20577,16,-13,377,243796,16,243780
20578,16,-3,689,559275,16,559259
20579,9,-1,850,612077,9,612068
20580,11,1,14,679823,11,679812
20581,5,13,180,1034542,5,1034537
20582,6,-10,261,318248,6,318242
20583,8,-13,65,219743,8,219735
20584,18,8,659,903148,18,903130
20585,19,14,145,1086605,19,1086586
20586,7,-16,751,140141,7,140134
20587,13,4,780,778984,13,778971
20588,12,1,835,686299,12,686287
20589,19,-9,892,373650,19,373631
20590,20,-1,26,616725,20,616705
20591,7,-6,883,455598,7,455591
20592,8,-13,387,226455,8,226447
20593,14,-13,721,246335,14,246321
20594,19,-3,803,560237,19,560218
20595,9,-5,757,484325,9,484316
20596,9,9,49,907822,9,907813
20597,6,-20,164,3629,6,3623
20598,12,-8,574,401885,12,401873
20599,8,15,827,1111960,8,1111952
20600,10,14,404,1070754,10,1070744
20601,19,17,778,1183645,19,1183626
20602,8,-9,900,363853,8,363845
20603,17,-15,977,185187,17,185170
20604,20,12,936,1029255,20,1029235
20605,17,7,35,867276,17,867259
20606,18,-7,692,433324,18,433306
20607,15,18,140,1210096,15,1210081
20608,16,11,333,993317,16,993301
20609,19,-13,168,242266,19,242247
20610,6,19,773,1234629,6,1234623
20611,12,17,90,1178506,12,1178494
20612,15,-13,442,244232,15,244217
20613,8,-10,83,314475,8,314467
20614,7,-16,841,142013,7,142006
20615,6,-10,585,325267,6,325261
20616,20,7,938,873686,20,873666
20617,20,-11,539,308085,20,308065
20618,7,-19,213,36301,7,36294
20619,12,8,232,899876,12,899864
20620,7,-8,294,381587,7,381580
20621,9,-13,264,224003,9,223994
20622,17,-13,508,244789,17,244772
20623,5,17,142,1158287,5,1158282
20624,17,-15,903,184617,17,184600
20625,6,7,549,856464,6,856458
20626,5,-3,228,535274,5,535269
20627,12,-18,577,89438,12,89426
20628,10,-6,108,439003,10,438993
20629,19,8,775,904110,19,904091
20630,14,-17,241,117244,14,117230
20631,16,-9,891,373642,16,373626
20632,15,-19,468,57562,15,57547
20633,12,15,45,1117121,12,1117109
20634,10,-18,702,77418,10,77408
20635,11,18,143,1210137,11,1210126
20636,6,17,414,1164107,6,1164101
20637,11,1,331,682532,11,682521
20638,10,-2,585,575163,10,575153
20639,14,11,187,992145,14,992131
20640,7,-18,121,65124,7,65117
20641,6,-15,118,158062,6,158056
20642,8,-3,41,531378,8,531370
20643,13,9,479,932519,13,932506
20644,16,16,631,1151604,16,1151588
20645,8,16,973,1145560,8,1145552
20646,6,5,39,782414,6,782408
20647,10,17,106,1157488,10,1157478
20648,16,9,748,934514,16,934498
20649,19,19,405,1244107,19,1244088
20650,14,1,629,684796,14,684782
20651,7,9,977,927622,7,927615
20652,16,-5,526,494944,16,494928
20653,17,0,536,652270,17,652253
20654,20,-11,787,309881,20,309861
20655,13,15,443,1119932,13,1119919
20656,6,0,6,625301,6,625295
20657,17,11,589,995109,17,995092
20658,8,-9,459,353778,8,353770
20659,14,-14,830,215977,14,215963
20660,18,-10,211,336626,18,336608
20661,11,-2,434,588407,11,588396
20662,9,-10,564,324909,9,324900
20663,13,3,595,746270,13,746257
20664,16,-2,873,591782,16,591766
20665,19,16,253,1148926,19,1148907
20666,6,-7,333,413102,6,413096
20667,17,5,213,805428,17,805411
20668,5,-8,861,393714,5,393709
20669,17,-17,801,121553,17,121536
20670,20,-14,393,212626,20,212606
20671,14,-3,700,559336,14,559322
20672,8,-5,553,479942,8,479934
20673,8,18,466,1196719,8,1196711
20674,14,-5,688,496052,14,496038
20675,9,6,246,817696,9,817687
20676,16,-19,780,60070,16,60054
20677,13,-2,820,591331,13,591318
20678,8,-13,109,220753,8,220745
20679,11,14,486,1089228,11,1089217
20680,15,-9,801,372891,15,372876
20681,5,-20,358,7877,5,7872
20682,20,-16,430,150136,20,150116
20683,10,-6,200,441230,10,441220
20684,6,0,581,637931,6,637925
20685,8,-14,47,187590,8,187582
20686,14,-12,283,274599,14,274585
20687,7,1,829,674930,7,674923
20688,15,-2,647,589970,15,589955
20689,13,12,521,1025841,13,1025828
20690,11,-1,638,621483,11,621472
20691,9,7,51,845977,9,845968
20692,19,-4,386,525093,19,525074
20693,8,-12,760,265970,8,265962
20694,10,-18,682,77001,10,76991
20695,8,-11,116,283689,8,283681
20696,10,15,542,1106019,10,1106009
20697,12,-1,792,622657,12,622645
20698,14,1,200,681454,14,681440
20699,10,-3,903,550638,10,550628
20700,5,-12,854,268185,5,268180
20701,11,-7,144,429334,11,429323
20702,12,6,147,836874,12,836862
20703,7,-10,116,315065,7,315058
20704,6,-4,592,512175,6,512169
20705,18,0,292,650255,18,650237
20706,9,-2,285,568884,9,568875
20707,5,2,67,690080,5,690075
20708,9,-3,308,537082,9,537073
20709,15,-10,304,337255,15,337240
20710,10,2,405,697448,10,697438
20711,15,8,386,901013,15,900998
20712,8,2,590,701006,8,700998
20713,8,0,752,641838,8,641830
20714,16,14,879,1092300,16,1092284
20715,8,6,634,826597,8,826589
20716,16,8,483,901774,16,901758
20717,9,16,931,1144586,9,1144577
20718,18,15,380,1119571,18,1119553
20719,20,-2,478,588748,20,588728
20720,11,-13,426,244123,11,244112
20721,10,18,663,1200715,10,1200705
20722,13,-12,706,277704,13,277691
20723,6,-19,288,37805,6,37799
20724,10,-7,632,419225,10,419215
20725,13,7,193,868384,13,868371
20726,5,16,399,1133722,5,1133717
20727,17,5,483,807357,17,807340
20728,5,-3,260,536077,5,536072
20729,12,-10,123,336013,12,336001
20730,19,3,687,747074,19,747055
20731,10,7,81,846584,10,846574
20732,17,15,874,1123155,17,1123138
20733,7,-14,390,195363,7,195356
20734,14,-3,809,560293,14,560279
20735,16,11,289,992969,16,992953
20736,11,6,169,837002,11,836991
20737,16,1,703,685290,16,685274
20738,17,15,405,1119678,17,1119661
20739,18,12,204,1023522,18,1023504
20740,5,1,158,660662,5,660657
20741,8,-5,169,471789,8,471781
20742,5,-1,999,615463,5,615458
20743,20,16,320,1149441,20,1149421
20744,7,18,238,1192019,7,1192012
20745,15,9,490,932631,15,932616
20746,9,5,18,781988,9,781979
20747,16,4,627,777833,16,777817
20748,19,-15,214,179282,19,179263
20749,9,-9,194,347707,9,347698
20750,8,10,225,942302,8,942294
20751,15,-10,295,337156,15,337141
20752,11,1,158,681129,11,681118
20753,18,-4,166,523343,18,523325
20754,14,-17,252,117331,14,117317
20755,19,7,229,868621,19,868602
20756,15,17,744,1183424,15,1183409
20757,12,16,558,1151056,12,1151044
20758,6,11,659,982494,6,982488
20759,7,-11,384,289643,7,289636
20760,8,8,94,877077,8,877069
20761,12,-11,146,304882,12,304870
20762,7,-11,172,284845,7,284838
20763,9,-12,456,259400,9,259391
20764,8,17,777,1171829,8,1171821
20765,7,4,846,769291,7,769284
20766,5,-11,558,293536,5,293531
20767,12,9,410,932013,12,932001
20768,8,-15,608,168461,8,168453
20769,13,4,548,777221,13,777208
20770,17,-5,851,497206,17,497189
20771,5,18,810,1203847,5,1203842
20772,11,14,838,1091993,11,1091982
20773,12,-19,799,60179,12,60167
20774,14,19,247,1242696,14,1242682
20775,5,14,248,1067338,5,1067333
20776,19,8,737,903808,19,903789
20777,8,-13,892,237646,8,237638
20778,15,3,341,744466,15,744451
20779,6,-14,548,198326,6,198320
20780,12,-2,3,585140,12,585128
20781,10,-20,454,9717,10,9707
20782,12,-20,64,23269,12,23257
20783,12,9,692,934145,12,934133
20784,9,9,833,924462,9,924453
20785,11,-4,414,525312,11,525301
20786,16,15,994,1124108,16,1124092
20787,9,8,499,886184,9,886175
20788,10,-6,369,444634,10,444624
20789,9,18,563,1198750,9,1198741
20790,8,13,461,1040654,8,1040646
20791,14,9,902,935758,14,935744
20792,19,2,948,717541,19,717522
20793,17,-3,817,560351,17,560334
20794,14,6,388,838829,14,838815
20795,7,-1,721,609402,7,609395
20796,8,19,656,1232060,8,1232052
20797,14,15,767,1122454,14,1122440
20798,8,-16,310,130691,8,130683
20799,10,-20,675,14896,10,14886
20800,20,-4,309,524500,20,524480
20801,11,-17,860,121883,11,121872
20802,20,-9,38,366895,20,366875
20803,5,7,446,854370,5,854365
20804,15,-12,927,279502,15,279487
20805,10,15,178,1098283,10,1098273
20806,14,-4,457,525533,14,525519
20807,18,8,979,905574,18,905556
20808,15,-16,787,152694,15,152679
20809,7,-4,857,517681,7,517674
20810,19,-9,214,368056,19,368037
20811,5,15,352,1102002,5,1101997
20812,9,15,898,1113568,9,1113559
20813,16,-1,343,619340,16,619324
20814,6,5,182,785418,6,785412
20815,7,19,330,1224977,7,1224970
20816,15,-15,197,179165,15,179150
20817,8,19,905,1237659,8,1237651
20818,7,-6,12,437106,7,437099
20819,12,5,208,805392,12,805380
20820,16,-10,968,342357,16,342341
20821,17,-18,711,90420,17,90403
20822,16,16,821,1152995,16,1152979
20823,15,-3,399,556721,15,556706
20824,17,-19,296,56298,17,56281
20825,12,-3,477,557441,12,557429
20826,15,5,988,811036,15,811021
20827,13,-7,895,434934,13,434921
20828,16,-4,791,527952,16,527936
20829,17,8,622,902861,17,902844
20830,10,-9,129,346321,10,346311
20831,7,18,267,1192707,7,1192700
20832,19,4,878,779814,19,779795
20833,6,-6,687,451592,6,451586
20834,20,-14,559,213828,20,213808
20835,20,18,236,1210868,20,1210848
20836,19,19,238,1242597,19,1242578
20837,16,-5,837,497100,16,497084
20838,5,1,720,672614,5,672609
20839,12,-18,292,87501,12,87489
20840,6,5,667,795404,6,795398
20841,17,9,64,929522,17,929505
20842,12,9,153,930169,12,930157
20843,15,-17,533,119450,15,119435
20844,16,-16,58,147215,16,147199
20845,18,-5,23,490980,18,490962
20846,12,15,296,1118970,12,1118958
20847,16,6,85,836367,16,836351
20848,8,-5,909,487831,8,487823
20849,16,-16,642,151720,16,151704
20850,13,14,117,1086381,13,1086368
20851,18,5,405,806726,18,806708
20852,5,-20,710,15672,5,15667
20853,16,-5,909,497703,16,497687
20854,20,9,110,929850,20,929830
20855,9,6,131,814981,9,814972
20856,16,18,391,1211922,16,1211906
20857,18,11,810,996741,18,996723
20858,5,-8,758,391594,5,391589
20859,12,-4,459,525544,12,525532
20860,7,16,59,1126449,7,1126442
20861,5,-15,993,176576,5,176571
20862,14,-12,865,278994,14,278980
20863,8,-2,298,569214,8,569206
20864,12,-13,915,247919,12,247907
20865,14,-1,506,620581,14,620567
20866,6,7,752,860618,6,860612
20867,9,-6,715,452154,9,452145
20868,12,-1,910,623521,12,623509
20869,11,5,599,808178,11,808167
20870,19,-5,515,494840,19,494821
20871,13,-17,242,117254,13,117241
20872,11,-17,168,116706,11,116695
20873,13,11,744,996171,13,996158
20874,12,6,965,843434,12,843422
20875,6,6,469,823023,6,823017
20876,17,19,885,1247957,17,1247940
20877,7,12,876,1018316,7,1018309
20878,20,2,157,711775,20,711755
20879,12,5,702,808907,12,808895
20880,19,-15,571,181972,19,181953
20881,20,-20,112,23600,20,23580
20882,16,6,7,835782,16,835766
20883,19,17,540,1181901,19,1181882
20884,19,8,707,903575,19,903556
20885,12,9,967,936325,12,936313
20886,7,17,902,1174749,7,1174742
20887,7,-6,749,452931,7,452924
20888,9,-19,293,37884,9,37875
20889,19,9,134,930056,19,930037
20890,15,-1,333,619232,15,619217
20891,6,2,576,700743,6,700737
20892,9,-14,605,199946,9,199937
20893,19,-7,917,435096,19,435077
20894,10,-19,497,42212,10,42202
20895,7,-4,843,517288,7,517281
20896,9,-19,763,48320,9,48311
20897,7,-6,42,437726,7,437719
20898,5,-15,433,164808,5,164803
20899,15,16,969,1154063,15,1154048
20900,5,-5,501,478855,5,478850
20901,13,-8,144,398910,13,398897
20902,12,13,166,1054418,12,1054406
20903,5,-10,742,328566,5,328561
20904,16,-19,280,56200,16,56184
20905,13,5,41,804074,13,804061
20906,14,19,804,1247297,14,1247283
20907,13,-12,708,277731,13,277718
20908,18,5,356,806354,18,806336
20909,5,-5,451,477680,5,477675
20910,6,-20,124,2755,6,2749
20911,10,-17,907,112706,10,112696
20912,11,17,686,1182946,11,1182935
20913,19,-18,253,87292,19,87273
20914,9,13,442,1040308,9,1040299
20915,13,-16,96,147608,13,147595
20916,12,4,415,776221,12,776209
20917,11,0,130,649220,11,649209
20918,15,-11,531,307991,15,307976
20919,7,0,317,631970,7,631963
20920,12,14,303,1087759,12,1087747
20921,8,-10,59,313922,8,313914
20922,12,-6,587,463624,12,463612
20923,8,1,317,664091,8,664083
20924,20,18,865,1215251,20,1215231
20925,9,-17,362,101204,9,101195
20926,8,-8,949,395647,8,395639
20927,9,4,8,750708,9,750699
20928,12,9,914,935873,12,935861
20929,18,1,328,682519,18,682501
20930,6,15,120,1097136,6,1097130
20931,7,9,424,915583,7,915576
20932,13,18,250,1210990,13,1210977
20933,5,12,683,1014131,5,1014126
20934,7,1,775,673856,7,673849
20935,5,-7,151,408965,5,408960
20936,15,10,983,967325,15,967310
20937,18,2,983,717764,18,717746
20938,13,18,117,1209897,13,1209884
20939,11,8,121,898895,11,898884
20940,15,-20,301,25154,15,25139
20941,12,-18,559,89328,12,89316
20942,18,0,724,653874,18,653856
20943,14,-9,750,372378,14,372364
20944,13,-14,323,211907,13,211894
20945,12,3,25,741966,12,741954
20946,8,-13,819,236096,8,236088
20947,8,4,772,767409,8,767401
20948,19,7,980,873985,19,873966
20949,6,-12,217,254185,6,254179
20950,16,10,520,963860,16,963844
20951,5,-1,895,613151,5,613146
20952,9,-3,714,546506,9,546497
20953,18,12,939,1029286,18,1029268
20954,13,11,844,996983,13,996970
20955,16,17,611,1182414,16,1182398
20956,7,-2,901,582085,7,582078
20957,11,17,654,1182726,11,1182715
20958,5,-10,721,328105,5,328100
20959,13,8,969,905486,13,905473
20960,17,12,31,1022320,17,1022303
20961,13,4,916,780024,13,780011
20962,14,-14,735,215225,14,215211
20963,13,3,351,744546,13,744533
20964,18,-15,876,184408,18,184390
20965,8,-11,627,295006,8,294998
20966,7,-17,848,111426,7,111419
20967,9,-1,858,612278,9,612269
20968,8,19,541,1229723,8,1229715
20969,7,2,478,698853,7,698846
20970,5,-8,14,375634,5,375629
20971,19,12,305,1024381,19,1024362
20972,11,5,104,804547,11,804536
20973,20,-16,842,153065,20,153045
20974,14,-6,333,461745,14,461731
20975,6,-15,622,168765,6,168759
20976,19,4,877,779804,19,779785
20977,15,-4,113,522902,15,522887
20978,8,16,811,1142029,8,1142021
20979,17,3,14,741917,17,741900
20980,7,-9,188,347576,7,347569
20981,16,-1,791,622652,16,622636
20982,9,-10,190,316734,9,316725
20983,17,13,998,1060632,17,1060615
20984,17,4,200,774690,17,774673
20985,15,6,632,840866,15,840851
20986,12,6,158,836941,12,836929
20987,14,-9,214,368060,14,368046
20988,10,14,690,1077569,10,1077559
20989,14,-6,177,460526,14,460512
20990,8,-14,792,203897,8,203889
20991,17,-9,1000,374250,17,374233
20992,5,9,681,921048,5,921043
20993,6,-13,630,231818,6,231812
20994,13,14,283,1087614,13,1087601
20995,10,9,788,923398,10,923388
20996,9,-7,797,422625,9,422616
20997,12,-2,997,592686,12,592674
20998,15,-11,633,308746,15,308731
20999,5,-20,390,8461,5,8456
21000,20,-2,351,587729,20,587709
21001,19,15,217,1118437,19,1118418
21002,16,17,304,1180238,16,1180222
21003,8,0,105,627763,8,627755
21004,20,14,552,1089769,20,1089749
21005,14,7,636,871665,14,871651
21006,6,1,46,658073,6,658067
21007,18,12,472,1025502,18,1025484
21008,13,18,647,1213628,13,1213615
21009,17,-3,892,560915,17,560898
21010,19,-15,220,179320,19,179301
21011,5,14,461,1072074,5,1072069
21012,17,-13,29,241298,17,241281
21013,13,11,865,997131,13,997118
21014,17,-3,524,557917,17,557900
21015,18,-19,185,55532,18,55514
21016,17,-18,747,90693,17,90676
21017,7,12,23,999572,7,999565
21018,17,2,24,710648,17,710631
21019,8,-17,609,106610,8,106602
21020,17,-5,346,493673,17,493656
21021,9,-8,828,393048,9,393039
21022,13,-4,206,523713,13,523700
21023,11,-11,971,311314,11,311303
21024,9,12,682,1014091,9,1014082
21025,5,-19,319,38413,5,38408
21026,17,14,312,1087862,17,1087845
21027,10,-17,804,110630,10,110620
21028,14,-9,415,369804,14,369790
21029,13,1,255,681933,13,681920
21030,7,-16,807,141343,7,141336
21031,10,-14,157,189903,10,189893
21032,6,15,676,1108783,6,1108777
21033,7,9,219,911455,7,911448
21034,6,13,942,1050877,6,1050871
21035,13,-19,516,57964,13,57951
21036,16,3,773,747656,16,747640
21037,20,-11,720,309312,20,309292
21038,7,9,223,911542,7,911535
21039,16,-8,13,397964,16,397948
21040,13,-4,468,525606,13,525593
21041,9,-3,261,536085,9,536076
21042,12,-8,124,398749,12,398737
21043,11,-5,60,491278,11,491267
21044,10,15,689,1109040,10,1109030
21045,10,6,463,822877,10,822867
21046,11,2,931,717376,11,717365
21047,8,-18,190,66590,8,66582
21048,20,-1,701,621951,20,621931
21049,5,19,162,1221071,5,1221066
21050,10,10,804,954989,10,954979
21051,11,4,642,777918,11,777907
21052,6,-19,430,40758,6,40752
21053,12,-20,61,23247,12,23235
21054,9,17,564,1167258,9,1167249
21055,9,-10,475,323064,9,323055
21056,11,-16,652,151771,11,151760
21057,19,-19,790,60126,19,60107
21058,11,-13,308,243345,11,243334
21059,16,-10,405,337982,16,337966
21060,6,12,71,1000630,6,1000624
21061,16,-4,504,525925,16,525909
21062,19,-7,932,435186,19,435167
21063,12,17,159,1179050,12,1179038
21064,6,16,69,1126631,6,1126625
21065,9,17,268,1160989,9,1160980
21066,18,12,826,1028189,18,1028171
21067,9,-17,839,111264,9,111255
21068,9,-6,564,448973,9,448964
21069,12,6,16,835918,12,835906
21070,10,-6,66,438176,10,438166
21071,15,-19,360,56802,15,56787
21072,14,-11,56,304105,14,304091
21073,5,-10,368,320529,5,320524
21074,7,6,252,817848,7,817841
21075,9,-7,264,411420,9,411411
21076,20,12,985,1029725,20,1029705
21077,14,-12,878,279051,14,279037
21078,20,-10,29,335383,20,335363
21079,5,12,804,1016532,5,1016527
21080,18,-18,909,91827,18,91809
21081,19,0,707,653662,19,653643
21082,5,19,672,1232392,5,1232387
21083,20,-16,176,148192,20,148172
21084,10,-18,266,68300,10,68290
21085,10,-12,648,263563,10,263553
21086,14,-20,413,25924,14,25910
21087,5,19,235,1222689,5,1222684
21088,20,-1,70,617098,20,617078
21089,17,-19,51,54251,17,54234
21090,16,12,940,1029324,16,1029308
21091,20,-20,953,30006,20,29986
21092,12,-2,771,590897,12,590885
21093,17,14,767,1091472,17,1091455
21094,15,-8,30,398119,15,398104
21095,7,8,970,896272,7,896265
21096,18,-19,379,56963,18,56945
21097,17,13,256,1055066,17,1055049
21098,7,-20,384,8410,7,8403
21099,11,-11,144,304855,11,304844
21100,18,-14,125,210255,18,210237
21101,16,18,656,1213700,16,1213684
21102,11,12,595,1026401,11,1026390
21103,15,-16,141,147977,15,147962
21104,15,-10,471,338611,15,338596
21105,16,-13,875,247582,16,247566
21106,12,16,459,1150416,12,1150404
21107,16,-15,461,181158,16,181142
21108,16,-8,607,402127,16,402111
21109,16,-9,689,371874,16,371858
21110,13,9,932,936023,13,936010
21111,11,10,294,962030,11,962019
21112,8,19,469,1228212,8,1228204
21113,19,-19,57,54280,19,54261
21114,6,13,317,1037500,6,1037494
21115,12,-11,324,306328,12,306316
21116,11,0,421,651317,11,651306
21117,12,12,241,1023832,12,1023820
21118,12,-9,226,368206,12,368194
21119,19,-13,507,244783,19,244764
21120,11,-8,220,399480,11,399469
21121,6,17,68,1156769,6,1156763
21122,13,-7,27,428522,13,428509
21123,10,-2,856,581134,10,581124
21124,15,-17,466,118957,15,118942
21125,14,14,478,1089155,14,1089141
21126,20,-13,147,242083,20,242063
21127,17,17,546,1181949,17,1181932
21128,13,17,175,1179200,13,1179187
21129,17,4,849,779637,17,779620
21130,12,8,222,899734,12,899722
21131,17,-3,358,556416,17,556399
21132,20,13,921,1060042,20,1060022
21133,20,-16,928,153751,20,153731
21134,7,-20,415,8911,7,8904
21135,11,-14,308,211784,11,211773
21136,12,-9,590,371313,12,371301
21137,16,1,693,685250,16,685234
21138,17,2,334,713100,17,713083
21139,14,8,867,904689,14,904675
21140,7,-19,424,40625,7,40618
21141,16,-9,225,368183,16,368167
21142,7,7,95,846874,7,846867
21143,6,-14,466,196772,6,196766
21144,14,11,380,993646,14,993632
21145,12,3,224,743545,12,743533
21146,19,12,893,1028798,19,1028779
21147,13,11,162,991988,13,991975
21148,7,1,544,669217,7,669210
21149,8,-13,429,227338,8,227330
21150,17,-8,587,401945,17,401928
21151,15,-13,317,243408,15,243393
21152,14,11,341,993353,14,993339
21153,16,-13,746,246550,16,246534
21154,14,15,13,1116852,14,1116838
21155,17,6,227,837457,17,837440
21156,8,15,382,1102596,8,1102588
21157,8,10,451,947165,8,947157
21158,14,6,89,836400,14,836386
21159,8,10,439,946954,8,946946
21160,6,18,158,1190232,6,1190226
21161,13,-18,864,91478,13,91465
21162,15,-3,487,557570,15,557555
21163,7,-2,373,570596,7,570589
21164,20,-6,989,466676,20,466656
21165,12,-3,124,554680,12,554668
21166,16,0,977,655762,16,655746
21167,19,-9,56,367081,19,367062
21168,18,18,701,1214014,18,1213996
21169,5,0,693,640558,5,640553
21170,11,-16,335,149379,11,149368
21171,6,-2,928,582686,6,582680
21172,19,4,676,778205,19,778186
21173,6,15,773,1110860,6,1110854
21174,17,-4,953,529226,17,529209
21175,9,18,37,1187383,9,1187374
21176,14,-3,996,561726,14,561712
21177,7,14,136,1064898,7,1064891
21178,9,-3,835,549060,9,549051
21179,17,12,355,1024682,17,1024665
21180,18,2,753,716244,18,716226
21181,16,7,127,867922,16,867906
21182,16,18,501,1212609,16,1212593
21183,13,-13,783,246877,13,246864
21184,16,12,909,1029010,16,1028994
21185,10,-3,946,551684,10,551674
21186,9,-19,827,49499,9,49490
21187,10,19,826,1235789,10,1235779
21188,17,6,312,838141,17,838124
21189,19,-7,769,433907,19,433888
21190,16,-6,343,461835,16,461819
21191,10,-7,659,419733,10,419723
21192,13,-5,791,496758,13,496745
21193,18,19,74,1241378,18,1241360
21194,5,-4,380,507880,5,507875
21195,18,15,160,1117952,18,1117934
21196,9,18,220,1191594,9,1191585
21197,5,16,692,1139608,5,1139603
21198,19,10,160,961106,19,961087
21199,18,1,904,686881,18,686863
21200,14,8,547,902250,14,902236
21201,17,4,177,774558,17,774541
21202,9,1,797,674344,9,674335
21203,16,0,549,652388,16,652372
21204,18,-9,735,372208,18,372190
21205,13,-5,313,493387,13,493374
21206,19,-13,487,244592,19,244573
21207,9,11,62,969803,9,969794
21208,9,9,815,924056,9,924047
21209,12,16,142,1148097,12,1148085
21210,8,2,934,708024,8,708016
21211,12,-17,653,120383,12,120371
21212,15,-13,611,245563,15,245548
21213,5,-3,165,533903,5,533898
21214,9,16,738,1140413,9,1140404
21215,6,-9,876,363206,6,363200
21216,12,-11,987,311444,12,311432
21217,5,-19,264,37340,5,37335
21218,11,-16,182,148240,11,148229
21219,7,-7,818,423104,7,423097
21220,5,-19,188,35741,5,35736
21221,15,6,22,835992,15,835977
21222,19,-1,32,616791,19,616772
21223,12,8,304,900352,12,900340
21224,14,-5,214,492546,14,492532
21225,20,-8,582,401920,20,401900
21226,5,-16,863,142589,5,142584
21227,8,-4,621,512784,8,512776
21228,13,-16,758,152501,13,152488
21229,12,9,959,936224,12,936212
21230,20,-17,31,115781,20,115761
21231,16,-19,969,61272,16,61256
21232,20,14,176,1086824,20,1086804
21233,10,-4,541,511194,10,511184
21234,11,-7,685,433276,11,433265
21235,16,-18,506,88983,16,88967
21236,6,5,556,793131,6,793125
21237,16,10,910,966805,16,966789
21238,7,-9,987,365368,7,365361
21239,19,0,592,652747,19,652728
21240,17,0,600,652778,17,652761
21241,7,2,596,701139,7,701132
21242,11,0,20,648357,11,648346
21243,7,9,266,912205,7,912198
21244,6,14,639,1076229,6,1076223
21245,19,8,272,900078,19,900059
21246,7,-14,495,197379,7,197372
21247,18,13,45,1053554,18,1053536
21248,14,-10,803,341175,14,341161
21249,6,-19,314,38284,6,38278
21250,9,17,875,1174165,9,1174156
21251,7,-19,538,43173,7,43166
21252,9,-4,653,513458,9,513449
21253,17,-12,88,273172,17,273155
21254,13,-6,743,464849,13,464836
21255,7,-11,275,287035,7,287028
21256,8,-14,345,194187,8,194179
21257,17,-7,136,429270,17,429253
21258,13,-4,283,524261,13,524248
21259,7,4,731,766483,7,766476
21260,16,-10,309,337296,16,337280
21261,9,-10,830,330374,9,330365
21262,6,-16,132,126932,6,126926
21263,14,11,967,997789,14,997775
21264,15,12,876,1028656,15,1028641
21265,8,3,247,724192,8,724184
21266,9,5,644,794913,9,794904
21267,7,2,837,706065,7,706058
21268,12,-2,520,589063,12,589051
21269,13,2,71,711096,13,711083
21270,14,-7,558,432522,14,432508
21271,10,18,883,1205354,10,1205344
21272,17,-13,26,241266,17,241249
21273,9,5,82,783339,9,783330
21274,13,-1,821,622856,13,622843
21275,17,16,101,1147772,17,1147755
21276,16,-19,970,61277,16,61261
21277,14,-10,580,339371,14,339357
21278,18,-1,872,623218,18,623200
21279,17,2,352,713258,17,713241
21280,19,6,974,843552,19,843533
21281,10,8,523,886745,10,886735
21282,15,18,50,1209287,15,1209272
21283,11,8,876,904736,11,904725
21284,20,11,453,994152,20,994132
21285,9,0,892,644735,9,644726
21286,16,-8,259,399732,16,399716
21287,16,-11,704,309234,16,309218
21288,5,16,176,1128898,5,1128893
21289,13,5,406,806733,13,806720
21290,6,-13,380,226326,6,226320
21291,9,-13,224,223106,9,223097
21292,10,6,54,813356,10,813346
21293,6,-11,875,299884,6,299878
21294,14,-2,592,589584,14,589570
21295,5,6,708,828343,5,828338
21296,18,-12,807,278405,18,278387
21297,18,-13,904,247769,18,247751
21298,12,18,816,1214859,12,1214847
21299,16,-12,205,273946,16,273930
21300,7,7,135,847720,7,847713
21301,16,-15,304,179982,16,179966
21302,11,-16,346,149442,11,149431
21303,5,16,842,1142622,5,1142617
21304,19,1,84,680428,19,680409
21305,5,-19,694,46785,5,46780
21306,7,-19,146,34850,7,34843
21307,12,-20,393,25789,12,25777
21308,20,-17,121,116434,20,116414
21309,14,-19,840,60479,14,60465
21310,13,-14,878,216350,13,216337
21311,13,-1,372,619570,13,619557
21312,11,-10,995,342672,11,342661
21313,7,-20,184,4259,7,4252
21314,5,7,340,852183,5,852178
21315,16,-15,943,184972,16,184956
21316,10,-6,765,453233,10,453223
21317,10,16,897,1143742,10,1143732
21318,12,-6,883,465772,12,465760
21319,17,-2,66,585657,17,585640
21320,17,6,699,841461,17,841444
21321,13,11,728,996064,13,996051
21322,12,-5,158,492170,12,492158
21323,15,4,266,775121,15,775106
21324,18,-18,919,91883,18,91865
21325,15,-14,841,216053,15,216038
21326,15,-16,332,149381,15,149366
21327,15,13,803,1059283,15,1059268
21328,18,11,470,994279,18,994261
21329,18,13,557,1057447,18,1057429
21330,6,-8,976,396338,6,396332
21331,20,-11,263,305811,20,305791
21332,14,-7,536,432398,14,432384
21333,11,6,656,841037,11,841026
21334,18,15,861,1123077,18,1123059
21335,5,-14,959,207368,5,207363
21336,10,-16,281,130134,10,130124
21337,13,-14,213,210978,13,210965
21338,13,-14,599,214251,13,214238
21339,15,17,902,1184729,15,1184714
21340,13,-17,316,117835,13,117822
21341,18,-1,650,621597,18,621579
21342,13,-14,584,214109,13,214096
21343,10,-8,620,388549,10,388539
21344,16,-9,736,372237,16,372221
21345,15,13,793,1059193,15,1059178
21346,15,8,461,901615,15,901600
21347,13,-15,173,179015,13,179002
21348,5,-7,213,410396,5,410391
21349,9,18,47,1187654,9,1187645
21350,11,-6,182,460586,11,460575
21351,7,-15,452,165173,7,165166
21352,16,-20,40,22628,16,22612
21353,19,-11,818,310068,19,310049
21354,6,-17,873,111924,6,111918
21355,5,13,826,1048498,5,1048493
21356,19,9,311,931277,19,931258
21357,15,17,139,1178898,15,1178883
21358,14,19,836,1247543,14,1247529
21359,17,9,262,930845,17,930828
21360,17,10,75,960423,17,960406
21361,17,19,574,1245487,17,1245470
21362,15,9,161,930266,15,930251
21363,15,17,66,1178368,15,1178353
21364,7,17,841,1173417,7,1173410
21365,14,5,878,810170,14,810156
21366,14,-12,636,277140,14,277126
21367,13,-16,228,148669,13,148656
21368,8,-12,785,266450,8,266442
21369,17,11,964,997760,17,997743
21370,16,0,292,650261,16,650245
21371,17,19,34,1240981,17,1240964
21372,20,15,174,1118110,20,1118090
21373,5,12,401,1007736,5,1007731
21374,14,-9,969,374146,14,374132
21375,7,0,81,627012,7,627005
21376,6,5,710,796425,6,796419
21377,7,-18,982,83785,7,83778
21378,6,6,789,830038,6,830032
21379,14,-12,712,277759,14,277745
21380,7,17,776,1171767,7,1171760
21381,15,16,463,1150428,15,1150413
21382,9,6,473,823099,9,823090
21383,7,3,989,740524,7,740517
21384,15,-15,422,180920,15,180905
21385,7,-14,585,199384,7,199377
21386,15,19,435,1244427,15,1244412
21387,11,8,706,903560,11,903549
21388,11,-12,109,273315,11,273304
21389,8,-8,621,388572,8,388564
21390,20,-4,267,524155,20,524135
21391,9,-5,854,486527,9,486518
21392,12,-12,535,276515,12,276503
21393,17,-18,668,90134,17,90117
21394,5,-13,477,228376,5,228371
21395,13,-13,45,241385,13,241372
21396,5,-19,828,49536,5,49531
21397,6,14,632,1076017,6,1076011
21398,9,-13,415,226958,9,226949
21399,11,2,980,717742,11,717731
21400,6,-11,721,296755,6,296749
21401,16,8,720,903697,16,903681
21402,19,-12,247,274321,19,274302
21403,7,13,452,1040454,7,1040447
21404,9,-11,990,302511,9,302502
21405,10,5,972,802152,10,802142
21406,10,11,538,979964,10,979954
21407,17,-17,893,122138,17,122121
21408,6,-12,828,267503,6,267497
21409,20,-13,715,246292,20,246272
21410,10,13,572,1043065,10,1043055
21411,16,-12,480,276042,16,276026
21412,6,-9,974,365232,6,365226
21413,10,13,726,1046304,10,1046294
21414,11,3,490,745481,11,745470
21415,13,-12,636,277143,13,277130
21416,11,8,624,902888,11,902877
21417,8,-6,737,452659,8,452651
21418,19,-20,484,26415,19,26396
21419,7,-7,52,407118,7,407111
21420,17,10,910,966812,17,966795
21421,11,10,25,960030,11,960019
21422,18,19,639,1245972,18,1245954
21423,17,-2,978,592588,17,592571
21424,15,5,460,807155,15,807140
21425,5,-18,860,80954,5,80949
21426,6,19,744,1234011,6,1234005
21427,5,-19,724,47393,5,47388
21428,14,8,846,904540,14,904526
21429,13,16,587,1151246,13,1151233
21430,9,10,346,944835,9,944826
21431,5,-20,162,3549,5,3544
21432,19,15,445,1119957,19,1119938
21433,10,19,451,1227902,10,1227892
21434,13,-9,336,369112,13,369099
21435,14,7,353,869587,14,869573
21436,10,-19,35,32237,10,32227
21437,11,-5,588,495375,11,495364
21438,17,16,75,1147614,17,1147597
21439,14,-17,959,122547,14,122533
21440,19,-3,834,560459,19,560440
21441,14,-11,104,304516,14,304502
21442,15,3,500,745553,15,745538
21443,17,4,726,778602,17,778585
21444,10,5,40,782448,10,782438
21445,6,-12,639,263363,6,263357
21446,18,-14,376,212429,18,212411
21447,6,-10,968,333234,6,333228
21448,16,11,642,995400,16,995384
21449,8,-17,714,108743,8,108735
21450,7,-3,529,542401,7,542394
21451,17,8,413,901278,17,901261
21452,15,-9,833,373142,15,373127
21453,7,0,248,630733,7,630726
21454,12,19,300,1243168,12,1243156
21455,8,7,818,862135,8,862127
21456,13,10,574,964319,13,964306
21457,6,8,896,894621,6,894615
21458,15,-7,102,428996,15,428981
21459,17,-13,784,246891,17,246874
21460,12,-10,652,339947,12,339935
21461,13,14,272,1087526,13,1087513
21462,15,15,331,1119216,15,1119201
21463,8,-4,657,513574,8,513566
21464,6,-14,932,206710,6,206704
21465,11,-3,98,554477,11,554466
21466,5,16,294,1131374,5,1131369
21467,12,-13,23,241242,12,241230
21468,8,15,876,1113090,8,1113082
21469,7,-3,505,541772,7,541765
21470,15,2,247,712424,15,712409
21471,18,8,519,902097,18,902079
21472,12,-8,165,399065,12,399053
21473,6,-18,209,66996,6,66990
21474,13,17,786,1183741,13,1183728
21475,6,2,350,696190,6,696184
21476,10,-1,673,608361,10,608351
21477,16,-11,422,307107,16,307091
21478,12,-13,587,245369,12,245357
21479,5,12,70,1000625,5,1000620
21480,7,-20,459,9782,7,9775
21481,5,1,882,676134,5,676129
21482,18,-15,609,182238,18,182220
21483,8,19,19,1217842,8,1217834
21484,18,7,229,868629,18,868611
21485,8,-11,427,290656,8,290648
21486,17,-15,571,181979,17,181962
21487,6,13,909,1050168,6,1050162
21488,5,-10,654,326725,5,326720
21489,12,8,669,903251,12,903239
21490,14,-13,754,246604,14,246590
21491,7,-13,917,238215,7,238208
21492,11,8,923,905131,11,905120
21493,19,-9,432,369977,19,369958
21494,18,13,220,1054871,18,1054853
21495,15,4,481,776711,15,776696
21496,17,-3,602,558527,17,558510
21497,8,2,803,705317,8,705309
21498,11,-2,126,586063,11,586052
21499,15,2,551,714746,15,714731
21500,8,-6,195,441145,8,441137
21501,8,-20,7,175,8,167
21502,7,-6,847,454872,7,454865
21503,7,17,724,1170709,7,1170702
21504,8,-15,927,175130,8,175122
21505,16,10,41,960157,16,960141
21506,11,17,277,1179992,11,1179981
21507,11,1,77,680339,11,680328
21508,5,-6,406,445450,5,445445
21509,7,-12,457,259426,7,259419
21510,17,18,620,1213380,17,1213363
21511,19,-15,335,180198,19,180179
21512,5,13,318,1037535,5,1037530
21513,19,19,443,1244505,19,1244486
21514,5,-11,567,293682,5,293677
21515,13,-20,307,25228,13,25215
21516,7,18,795,1203625,7,1203618
21517,18,0,18,648339,18,648321
21518,9,-4,801,516513,9,516504
21519,11,-19,966,61245,11,61234
21520,13,-20,760,28655,13,28642
21521,6,17,558,1167178,6,1167172
21522,15,-1,985,624066,15,624051
21523,6,-18,89,64454,6,64448
21524,16,19,693,1246383,16,1246367
21525,9,11,408,977256,9,977247
21526,20,3,338,744445,20,744425
21527,17,13,714,1058550,17,1058533
21528,20,7,265,868920,20,868900
21529,13,6,775,841964,13,841951
21530,12,10,892,966635,12,966623
21531,18,1,443,683313,18,683295
21532,12,-16,177,148219,12,148207
21533,8,0,264,631089,8,631081
21534,16,0,924,655301,16,655285
21535,20,-12,218,274097,20,274077
21536,6,1,857,675635,6,675629
21537,14,15,584,1121001,14,1120987
21538,17,-8,424,400831,17,400814
21539,14,16,100,1147766,14,1147752
21540,8,-9,150,346798,8,346790
21541,12,19,33,1240975,12,1240963
21542,18,-9,296,368728,18,368710
21543,20,17,369,1180728,20,1180708
21544,8,-5,359,475965,8,475957
21545,7,-5,726,483686,7,483679
21546,6,-20,11,268,6,262
21547,20,5,211,805423,20,805403
21548,20,12,405,1025008,20,1024988
21549,7,15,534,1105892,7,1105885
21550,18,13,476,1056749,18,1056731
21551,14,-8,697,402819,14,402805
21552,8,-19,737,47801,8,47793
21553,19,14,499,1089373,19,1089354
21554,16,-4,614,526707,16,526691
21555,8,-14,391,195370,8,195362
21556,7,8,96,877122,7,877115
21557,8,-4,593,512206,8,512198
21558,18,-16,323,149357,18,149339
21559,14,-14,902,216525,14,216511
21560,16,-17,373,118248,16,118232
21561,20,-11,190,305251,20,305231
21562,8,9,216,911353,8,911345
21563,19,-20,111,23585,19,23566
21564,10,-12,42,250451,10,250441
21565,20,15,147,1117909,20,1117889
21566,19,19,135,1241834,19,1241815
21567,17,-4,495,525812,17,525795
21568,12,6,72,836293,12,836281
21569,20,-7,807,434158,20,434138
21570,17,19,412,1244201,17,1244184
21571,16,18,482,1212521,16,1212505
21572,17,6,836,842505,17,842488
21573,17,-20,595,27314,17,27297
21574,9,-2,709,577952,9,577943
21575,17,-11,636,308787,17,308770
21576,16,12,364,1024760,16,1024744
21577,15,12,490,1025671,15,1025656
21578,10,14,228,1066868,10,1066858
21579,6,3,350,726459,6,726453
21580,10,-12,702,264674,10,264664
21581,13,12,620,1026654,13,1026641
21582,17,-18,352,87975,17,87958
21583,17,-6,779,465109,17,465092
21584,20,6,284,837948,20,837928
21585,17,-1,920,623613,17,623596
21586,9,6,556,824772,9,824763
21587,11,-16,476,150532,11,150521
21588,12,-10,331,337414,12,337402
21589,10,16,351,1132604,10,1132594
21590,7,19,773,1234636,7,1234629
21591,18,12,506,1025763,18,1025745
21592,13,-14,140,210412,13,210399
21593,18,-2,471,588694,18,588676
21594,18,4,134,774220,18,774202
21595,19,2,193,712033,19,712014
21596,18,-17,555,119662,18,119644
21597,16,-16,47,147118,16,147102
21598,8,4,800,768012,8,768004
21599,16,-5,514,494827,16,494811
21600,7,9,960,927165,7,927158
21601,12,-5,23,490982,12,490970
21602,16,-4,397,525203,16,525187
21603,7,6,785,829934,7,829927
21604,7,-19,681,46502,7,46495
21605,18,8,148,899108,18,899090
21606,11,-4,74,522612,11,522601
21607,17,-13,197,242510,17,242493
21608,17,-1,768,622445,17,622428
21609,7,1,992,678546,7,678539
21610,5,-20,93,2058,5,2053
21611,19,9,590,933443,19,933424
21612,12,16,322,1149444,12,1149432
21613,20,-19,432,57321,20,57301
21614,10,3,767,735423,10,735413
21615,18,-13,367,243732,18,243714
21616,12,5,849,809945,12,809933
21617,12,1,781,685928,12,685916
21618,17,-20,194,24370,17,24353
21619,9,11,422,977483,9,977474
21620,12,-16,761,152504,12,152492
21621,7,7,798,861648,7,861641
21622,17,-9,380,369493,17,369476
21623,19,-3,231,555380,19,555361
21624,8,4,314,757279,8,757271
21625,12,9,433,932167,12,932155
21626,11,-12,332,275003,11,274992
21627,6,12,389,1007479,6,1007473
21628,11,-2,580,589483,11,589472
21629,15,-3,750,559757,15,559742
21630,8,0,255,630907,8,630899
21631,16,1,197,681418,16,681402
21632,6,10,373,945414,6,945408
21633,12,16,901,1153516,12,1153504
21634,16,-2,415,588201,16,588185
21635,12,-8,189,399247,12,399235
21636,12,5,933,810631,12,810619
21637,18,-6,404,462218,18,462200
21638,5,5,245,786767,5,786762
21639,12,18,803,1214812,12,1214800
21640,8,7,905,863958,8,863950
21641,12,-4,727,527530,12,527518
21642,11,2,756,716258,11,716247
21643,10,-6,450,446359,10,446349
21644,18,-12,684,277543,18,277525
21645,18,-14,845,216092,18,216074
21646,9,11,710,983574,9,983565
21647,17,19,274,1242941,17,1242924
21648,18,-14,172,210626,18,210608
21649,9,-20,73,1620,9,1611
21650,11,19,6,1240684,11,1240673
21651,10,3,330,726086,10,726076
21652,18,9,137,930074,18,930056
21653,20,14,872,1092250,20,1092230
21654,15,-13,446,244273,15,244258
21655,19,-7,357,431050,19,431031
21656,9,-8,19,375758,9,375749
21657,18,-12,467,275929,18,275911
21658,16,5,663,808621,16,808605
21659,6,11,886,987599,6,987593
21660,14,0,712,653728,14,653714
21661,10,19,283,1223755,10,1223745
21662,15,-3,458,557306,15,557291
21663,13,-20,761,28657,13,28644
21664,13,-20,523,26733,13,26720
21665,16,-5,995,498301,16,498285
21666,16,-10,575,339363,16,339347
21667,13,-2,143,586172,13,586159
21668,14,-13,585,245357,14,245343
21669,13,-20,697,28177,13,28164
21670,6,-20,754,16608,6,16602
21671,10,11,760,984729,10,984719
21672,6,-13,491,228722,6,228716
21673,16,17,478,1181500,16,1181484
21674,5,-19,445,41075,5,41070
21675,6,-15,167,158991,6,158985
21676,18,-5,199,492408,18,492390
21677,15,-1,326,619144,15,619129
21678,9,-11,925,300908,9,300899
21679,7,13,955,1051193,7,1051186
21680,11,-17,800,121546,11,121535
21681,16,3,287,744091,16,744075
21682,14,-1,307,619015,14,619001
21683,18,-15,448,181081,18,181063
21684,6,13,430,1040001,6,1039995
21685,15,-17,192,116863,15,116848
21686,14,10,574,964323,14,964309
21687,18,15,479,1120154,18,1120136
21688,9,-12,870,268528,9,268519
21689,10,-20,648,14195,10,14185
21690,20,19,310,1243285,20,1243265
21691,15,1,313,682323,15,682308
21692,8,9,202,911011,8,911003
21693,9,1,410,666137,9,666128
21694,8,3,119,721407,8,721399
21695,15,2,461,714106,15,714091
21696,14,18,61,1209428,14,1209414
21697,17,6,901,842937,17,842920
21698,20,0,853,654717,20,654697
21699,17,-6,564,463499,17,463482
21700,8,15,90,1096378,8,1096370
21701,9,0,120,628070,9,628061
21702,8,15,875,1113051,8,1113043
21703,14,-3,789,560138,14,560124
21704,17,-16,65,147288,17,147271
21705,9,-4,781,516127,9,516118
21706,9,-12,731,265243,9,265234
21707,18,-7,287,430468,18,430450
21708,16,4,664,778091,16,778075
21709,10,14,736,1078516,10,1078506
21710,19,0,867,654833,19,654814
21711,17,1,935,687172,17,687155
21712,7,-10,667,327154,7,327147
21713,16,16,644,1151748,16,1151732
21714,8,-5,155,471479,8,471471
21715,8,-12,103,251751,8,251743
21716,19,-20,138,23799,19,23780
21717,18,-5,253,492894,18,492876
21718,12,17,453,1181327,12,1181315
21719,10,9,120,909282,10,909272
21720,6,15,115,1096980,6,1096974
21721,7,1,548,669345,7,669338
21722,13,17,184,1179266,13,1179253
21723,7,4,612,763905,7,763898
21724,7,6,726,828798,7,828791
21725,20,-1,919,623607,20,623587
21726,12,-16,439,150243,12,150231
21727,16,-12,739,277898,16,277882
21728,5,1,969,678102,5,678097
21729,20,13,447,1056586,20,1056566
21730,17,-3,137,554748,17,554731
21731,18,-4,325,524644,18,524626
21732,7,3,894,738076,7,738069
21733,17,-16,410,149925,17,149908
21734,19,-3,380,556626,19,556607
21735,18,7,820,872935,18,872917
21736,16,-20,711,28257,16,28241
21737,12,-6,899,465929,12,465917
21738,20,9,60,929499,20,929479
21739,16,1,476,683593,16,683577
21740,13,16,375,1149846,13,1149833
21741,13,-3,355,556386,13,556373
21742,13,18,233,1210826,13,1210813
21743,20,-3,105,554528,20,554508
21744,6,11,117,970946,6,970940
21745,17,3,567,746042,17,746025
21746,20,14,898,1092494,20,1092474
21747,20,-10,392,337862,20,337842
21748,20,-10,729,340550,20,340530
21749,11,-1,459,620207,11,620196
21750,5,-2,299,569238,5,569233
21751,10,14,601,1075196,10,1075186
21752,7,-20,366,8024,7,8017
21753,18,19,715,1246574,18,1246556
21754,17,-12,338,275022,17,275005
21755,16,-20,421,25959,16,25943
21756,16,10,234,961581,16,961565
21757,13,-17,608,120064,13,120051
21758,9,6,218,817000,9,816991
21759,7,17,515,1166346,7,1166339
21760,12,-5,566,495201,12,495189
21761,13,-9,949,374073,13,374060
21762,6,-15,738,171301,6,171295
21763,18,-13,737,246469,18,246451
21764,18,-19,733,59765,18,59747
21765,5,-20,822,18253,5,18248
21766,10,14,913,1082169,10,1082159
21767,9,2,33,689339,9,689330
21768,16,6,176,837071,16,837055
21769,18,12,840,1028365,18,1028347
21770,9,-3,30,531180,9,531171
21771,16,5,835,809881,16,809865
21772,14,-3,2,553855,14,553841
21773,18,-2,963,592470,18,592452
21774,14,8,702,903546,14,903532
21775,19,-8,53,398328,19,398309
21776,6,7,374,852849,6,852843
21777,8,11,992,989689,8,989681
21778,19,-15,36,178051,19,178032
21779,10,9,277,912465,10,912455
21780,18,-14,519,213552,18,213534
21781,15,11,507,994534,15,994519
21782,20,1,317,682367,20,682347
21783,10,14,143,1065048,10,1065038
21784,11,4,801,779120,11,779109
21785,19,7,105,867786,19,867767
21786,12,-12,189,273849,12,273837
21787,6,-8,48,376415,6,376409
21788,6,5,353,788815,6,788809
21789,16,11,10,990938,16,990922
21790,10,13,554,1042648,10,1042638
21791,11,16,432,1150252,11,1150241
21792,14,-9,81,367258,14,367244
21793,11,15,849,1122969,11,1122958
21794,15,-10,634,339818,15,339803
21795,10,3,626,732211,10,732201
21796,15,-9,998,374234,15,374219
21797,19,7,281,869023,19,869004
21798,19,6,894,842894,19,842875
21799,7,1,134,660122,7,660115
21800,20,-7,444,431651,20,431631
21801,11,14,557,1089804,11,1089793
21802,16,18,140,1210102,16,1210086
21803,12,-17,193,116864,12,116852
21804,20,14,881,1092318,20,1092298
21805,16,-17,653,120389,16,120373
21806,7,7,657,858700,7,858693
21807,20,1,52,680200,20,680180
21808,20,-10,874,341645,20,341625
21809,10,-7,261,411328,10,411318
21810,11,-12,522,276408,11,276397
21811,19,-3,97,554477,19,554458
21812,5,5,763,797543,5,797538
21813,10,5,512,792195,10,792185
21814,18,10,790,965953,18,965935
21815,14,-9,352,369273,14,369259
21816,20,11,780,996493,20,996473
21817,9,-18,424,71530,9,71521
21818,8,-4,362,507502,8,507494
21819,19,14,713,1091082,19,1091063
21820,6,14,311,1068666,6,1068660
21821,19,9,446,932284,19,932265
21822,6,-16,966,144803,6,144797
21823,11,15,564,1120867,11,1120856
21824,7,-8,333,382508,7,382501
21825,16,1,64,680240,16,680224
21826,6,1,196,661454,6,661448
21827,18,-17,434,118679,18,118661
21828,8,5,479,791577,8,791569
21829,17,16,55,1147476,17,1147459
21830,12,1,859,686494,12,686482
21831,7,8,393,883779,7,883772
21832,11,-15,588,182103,11,182092
21833,12,-1,223,618307,12,618295
21834,15,-7,123,429200,15,429185
21835,6,11,718,983807,6,983801
21836,8,1,364,665203,8,665195
21837,11,10,260,961773,11,961762
21838,14,4,500,776839,14,776825
21839,15,-20,394,25802,15,25787
21840,6,-3,115,532902,6,532896
21841,18,3,541,745788,18,745770
21842,13,5,445,807011,13,806998
21843,12,-16,437,150214,12,150202
21844,13,11,233,992447,13,992434
21845,15,-6,180,460582,15,460567
21846,12,12,364,1024762,12,1024750
21847,7,3,105,721157,7,721150
21848,15,16,8,1147162,15,1147147
21849,18,10,854,966364,18,966346
21850,11,-19,87,54598,11,54587
21851,15,-12,939,279590,15,279575
21852,9,11,411,977298,9,977289
21853,18,9,153,930177,18,930159
21854,5,-6,174,440606,5,440601
21855,13,-4,667,527139,13,527126
21856,14,-12,705,277685,14,277671
21857,16,19,115,1241720,16,1241704
21858,13,6,605,840632,13,840619
21859,5,-3,887,550259,5,550254
21860,7,-6,859,455157,7,455150
21861,13,-2,663,590113,13,590100
21862,10,-6,581,449272,10,449262
21863,14,18,103,1209763,14,1209749
21864,17,10,87,960521,17,960504
21865,6,2,934,708030,6,708024
21866,15,9,618,933651,15,933636
21867,20,14,634,1090377,20,1090357
21868,7,-4,849,517491,7,517484
21869,20,6,835,842489,20,842469
21870,9,-4,260,505272,9,505263
21871,14,5,597,808153,14,808139
21872,19,-2,186,586456,19,586437
21873,7,-3,669,545555,7,545548
21874,19,-2,193,586522,19,586503
21875,5,-15,283,161451,5,161446
21876,18,12,936,1029263,18,1029245
21877,7,-7,240,410854,7,410847
21878,11,7,629,871608,11,871597
21879,10,18,450,1196387,10,1196377
21880,17,-3,464,557359,17,557342
21881,17,11,268,992775,17,992758
21882,7,-10,114,315030,7,315023
21883,13,9,856,935416,13,935403
21884,20,-13,694,246042,20,246022
21885,8,5,173,785128,8,785120
21886,9,5,764,797581,9,797572
21887,11,7,662,871857,11,871846
21888,13,1,256,681935,13,681922
21889,9,4,251,756103,9,756094
21890,11,-12,691,277584,11,277573
21891,11,12,639,1026783,11,1026772
21892,7,17,862,1173944,7,1173937
21893,5,4,698,765579,5,765574
21894,9,-11,464,291526,9,291517
21895,15,-9,659,371697,15,371682
21896,17,6,658,841068,17,841051
21897,7,16,885,1143472,7,1143465
21898,19,-9,374,369451,19,369432
21899,6,-13,210,222796,6,222790
21900,7,-9,183,347479,7,347472
21901,9,17,429,1164413,9,1164404
21902,14,-7,261,430233,14,430219
21903,6,-8,900,394653,6,394647
21904,9,-5,622,481481,9,481472
21905,8,-6,516,447980,8,447972
21906,20,-10,432,338206,20,338186
21907,18,10,53,960261,18,960243
21908,14,0,332,650533,14,650519
21909,16,5,677,808710,16,808694
21910,8,0,875,644290,8,644282
21911,11,-20,796,28984,11,28973
21912,20,-12,674,277480,20,277460
21913,5,-7,659,419738,5,419733
21914,17,-4,507,525947,17,525930
21915,14,3,0,741823,14,741809
21916,8,5,172,785081,8,785073
21917,6,1,991,678514,6,678508
21918,17,14,560,1089827,17,1089810
21919,19,18,550,1213010,19,1212991
21920,18,4,237,775009,18,774991
21921,12,-10,938,342164,12,342152
21922,7,-20,926,20406,7,20399
21923,11,-20,136,23782,11,23771
21924,15,-19,868,60679,15,60664
21925,6,5,903,800648,6,800642
21926,6,-3,90,532331,6,532325
21927,20,13,37,1053499,20,1053479
21928,10,6,516,824007,10,823997
21929,14,-5,642,495712,14,495698
21930,11,5,730,809085,11,809074
21931,12,13,371,1055954,12,1055942
21932,15,-15,926,184796,15,184781
21933,18,-14,185,210708,18,210690
21934,10,-14,32,187163,10,187153
21935,18,-9,225,368191,18,368173
21936,15,-2,375,587873,15,587858
21937,13,5,52,804202,13,804189
21938,19,2,297,712833,19,712814
21939,12,12,536,1025970,12,1025958
21940,16,-16,154,148067,16,148051
21941,11,-2,3,585141,11,585130
21942,9,10,577,949898,9,949889
21943,12,17,234,1179596,12,1179584
21944,10,3,315,725831,10,725821
21945,10,-3,393,539054,10,539044
21946,11,10,463,963383,11,963372
21947,13,-5,141,492013,13,492000
21948,15,11,718,995988,15,995973
21949,18,-14,684,214890,18,214872
21950,6,-10,446,322256,6,322250
21951,16,8,964,905439,16,905423
21952,5,13,183,1034614,5,1034609
21953,16,-17,110,116372,16,116356
21954,17,-19,717,59587,17,59570
21955,7,3,3,718933,7,718926
21956,12,-12,330,274988,12,274976
21957,8,4,714,766028,8,766020
21958,7,-20,666,14690,7,14683
21959,20,9,232,930726,20,930706
21960,13,-20,591,27293,13,27280
21961,14,-19,855,60574,14,60560
21962,10,-4,125,502097,10,502087
21963,16,8,150,899118,16,899102
21964,13,5,693,808848,13,808835
21965,15,-19,342,56688,15,56673
21966,14,-10,323,337377,14,337363
21967,10,-10,421,321772,10,321762
21968,8,18,363,1194541,8,1194533
21969,20,-3,448,557219,20,557199
21970,11,11,975,997881,11,997870
21971,13,-5,307,493350,13,493337
21972,19,5,47,804130,19,804111
21973,14,17,404,1180915,14,1180901
21974,9,13,430,1040010,9,1040001
21975,16,-16,913,153658,16,153642
21976,16,-9,962,374116,16,374100
21977,17,2,320,712973,17,712956
21978,17,-1,60,616997,17,616980
21979,9,-6,440,446116,9,446107
21980,8,5,195,785796,8,785788
21981,9,-6,223,441741,9,441732
21982,5,-13,238,223393,5,223388
21983,19,18,922,1215675,19,1215656
21984,5,-15,308,162080,5,162075
21985,13,-15,93,178474,13,178461
21986,12,13,888,1059865,12,1059853
21987,8,4,138,753561,8,753553
21988,17,1,397,683017,17,683000
21989,7,2,668,702693,7,702686
21990,11,17,753,1183477,11,1183466
21991,8,-12,126,252314,8,252306
21992,8,-10,218,317389,8,317381
21993,10,-13,150,221583,10,221573
21994,12,-9,272,368555,12,368543
21995,8,-20,864,19163,8,19155
21996,20,-11,428,307191,20,307171
21997,16,-11,772,309776,16,309760
21998,18,-5,806,496851,18,496833
21999,14,1,440,683290,14,683276
22000,19,-18,886,91630,19,91611
22001,16,-1,879,623311,16,623295
22002,11,-8,630,402280,11,402269
22003,10,11,851,986714,10,986704
22004,16,19,606,1245692,16,1245676
22005,7,-18,466,72462,7,72455
22006,14,19,379,1243839,14,1243825
22007,5,-12,778,266318,5,266313
22008,5,-2,557,574626,5,574621
22009,9,-14,74,188181,9,188172
22010,13,19,662,1246139,13,1246126
22011,14,-9,830,373116,14,373102
22012,6,-14,926,206648,6,206642
22013,9,1,726,672779,9,672770
22014,20,-4,650,526990,20,526970
22015,15,-19,494,57765,15,57750
22016,17,-19,289,56257,17,56240
22017,6,-2,537,574110,6,574104
22018,9,-13,681,232705,9,232696
22019,8,-19,109,33883,8,33875
22020,9,-8,907,394781,9,394772
22021,11,-13,194,242480,11,242469
22022,6,-2,668,577021,6,577015
22023,17,19,402,1244083,17,1244066
22024,19,-15,49,178164,19,178145
22025,12,-18,696,90272,12,90260
22026,15,8,314,900429,15,900414
22027,6,16,179,1128936,6,1128930
22028,17,-2,247,586990,17,586973
22029,9,-1,543,605819,9,605810
22030,6,-1,32,594416,6,594410
22031,20,19,197,1242305,20,1242285
22032,12,-13,582,245345,12,245333
22033,15,19,734,1246753,15,1246738
22034,12,5,60,804263,12,804251
22035,5,3,620,732079,5,732074
22036,13,-8,962,404709,13,404696
22037,18,-16,932,153798,18,153780
22038,6,-14,605,199952,6,199946
22039,18,6,566,840340,18,840322
22040,20,15,964,1123869,20,1123849
22041,18,-20,340,25459,18,25441
22042,19,2,953,717592,19,717573
22043,15,-6,798,465262,15,465247
22044,10,-7,868,424272,10,424262
22045,17,-4,238,523985,17,523968
22046,16,-18,521,89096,16,89080
22047,10,-18,259,68062,10,68052
22048,9,2,742,704261,9,704252
22049,10,-17,146,96475,10,96465
22050,14,12,481,1025606,14,1025592
22051,8,-14,25,187016,8,187008
22052,12,10,686,965214,12,965202
22053,16,-6,596,463667,16,463651
22054,14,-6,175,460495,14,460481
22055,12,3,906,748633,12,748621
22056,6,-8,812,392747,6,392741
22057,6,17,446,1164821,6,1164815
22058,6,-10,327,319604,6,319598
22059,15,-13,513,244825,15,244810
22060,20,-10,835,341367,20,341347
22061,13,16,960,1153922,13,1153909
22062,19,-12,523,276416,19,276397
22063,17,8,976,905540,17,905523
22064,10,15,336,1101675,10,1101665
22065,14,12,510,1025778,14,1025764
22066,17,-19,299,56324,17,56307
22067,7,-19,933,51542,7,51535
22068,17,7,997,874102,17,874085
22069,14,8,242,899940,14,899926
22070,9,-4,83,501138,9,501129
22071,13,-12,495,276179,13,276166
22072,16,-7,757,433787,16,433771
22073,5,8,740,891535,5,891530
22074,19,8,326,900555,19,900536
22075,10,-13,947,238866,10,238856
22076,9,-12,71,251148,9,251139
22077,19,-3,815,560328,19,560309
22078,6,-1,782,610666,6,610660
22079,6,17,625,1168645,6,1168639
22080,13,-17,205,116949,13,116936
22081,12,-11,950,311146,12,311134
22082,15,7,587,871342,15,871327
22083,17,-17,579,119906,17,119889
22084,5,-12,409,258544,5,258539
22085,6,-3,329,537618,6,537612
22086,9,-15,71,156847,9,156838
22087,12,17,533,1181851,12,1181839
22088,15,14,913,1092564,15,1092549
22089,19,3,657,746811,19,746792
22090,14,-9,424,369916,14,369902
22091,13,-11,301,306118,13,306105
22092,9,4,302,757029,9,757020
22093,14,-1,593,621198,14,621184
22094,13,11,808,996720,13,996707
22095,16,9,335,931471,16,931455
22096,11,-6,95,459791,11,459780
22097,15,0,546,652361,15,652346
22098,18,15,769,1122467,18,1122449
22099,10,-11,684,296156,10,296146
22100,9,10,898,956767,9,956758
22101,5,8,27,875669,5,875664
22102,15,-6,929,466164,15,466149
22103,7,-6,7,436990,7,436983
22104,16,0,601,652804,16,652788
22105,12,-5,206,492449,12,492437
22106,20,12,443,1025299,20,1025279
22107,14,13,381,1056028,14,1056014
22108,5,5,598,794055,5,794050
22109,12,-2,468,588654,12,588642
22110,7,4,190,754672,7,754665
22111,11,8,392,901064,11,901053
22112,20,11,280,992897,20,992877
22113,5,15,143,1097604,5,1097599
22114,8,-14,585,199392,8,199384
22115,20,15,290,1118948,20,1118928
22116,9,14,295,1068341,9,1068332
22117,18,-2,198,586581,18,586563
22118,17,-6,545,463398,17,463381
22119,20,-15,254,179612,20,179592
22120,8,14,219,1066548,8,1066540
22121,8,2,696,703332,8,703324
22122,7,-14,660,201103,7,201096
22123,17,1,650,684980,17,684963
22124,10,-18,541,74000,10,73990
22125,13,9,562,933208,13,933195
22126,18,15,946,1123715,18,1123697
22127,5,-10,567,324958,5,324953
22128,19,2,577,714891,19,714872
22129,12,-17,265,117429,12,117417
22130,6,-19,852,50127,6,50121
22131,13,-12,51,272866,13,272853
22132,19,1,99,680591,19,680572
22133,6,4,331,757670,6,757664
22134,6,10,763,953887,6,953881
22135,5,13,972,1051551,5,1051546
22136,7,-14,669,201362,7,201355
22137,17,9,791,934914,17,934897
22138,14,-1,913,623545,14,623531
22139,16,14,465,1089075,16,1089059
22140,6,17,271,1161092,6,1161086
22141,6,-15,301,161859,6,161853
22142,16,-13,13,241138,16,241122
22143,5,19,731,1233713,5,1233708
22144,5,13,24,1031292,5,1031287
22145,5,-6,673,451185,5,451180
22146,20,-14,559,213838,20,213818
22147,10,-18,791,79557,10,79547
22148,11,12,984,1029711,11,1029700
22149,7,11,481,978701,7,978694
22150,17,-7,454,431743,17,431726
22151,5,-6,160,440215,5,440210
22152,6,9,133,909611,6,909605
22153,9,14,61,1063177,9,1063168
22154,20,14,100,1086262,20,1086242
22155,6,-16,701,139045,6,139039
22156,15,-20,427,25986,15,25971
22157,10,10,92,939594,10,939584
22158,8,-17,344,100866,8,100858
22159,18,-8,684,402741,18,402723
22160,16,-2,767,590849,16,590833
22161,17,19,57,1241192,17,1241175
22162,8,-3,470,540987,8,540979
22163,5,-16,381,132162,5,132157
22164,10,-12,586,262187,10,262177
22165,20,19,661,1246137,20,1246117
22166,20,-1,326,619154,20,619134
22167,8,-15,687,170062,8,170054
22168,7,-17,808,110701,7,110694
22169,10,19,942,1238389,10,1238379
22170,19,-15,562,181918,19,181899
22171,12,-1,357,619481,12,619469
22172,10,15,114,1096936,10,1096926
22173,18,19,293,1243096,18,1243078
22174,11,8,432,901396,11,901385
22175,19,5,868,810090,19,810071
22176,20,-17,546,119601,20,119581
22177,7,16,33,1125866,7,1125859
22178,11,-1,519,620713,11,620702
22179,10,4,879,769960,10,769950
22180,9,5,232,786509,9,786500
22181,6,-6,43,437751,6,437745
22182,13,-20,400,25838,13,25825
22183,15,-5,138,491985,15,491970
22184,6,-18,689,77110,6,77104
22185,18,-16,761,152512,18,152494
22186,14,15,348,1119352,14,1119338
22187,5,0,213,630103,5,630098
22188,16,-20,457,26261,16,26245
22189,6,-2,129,565612,6,565606
22190,8,1,951,677700,8,677692
22191,12,19,208,1242417,12,1242405
22192,5,-17,970,113926,5,113921
22193,17,12,794,1027960,17,1027943
22194,12,8,260,900004,12,899992
22195,14,8,63,898364,14,898350
22196,20,-4,843,528223,20,528203
22197,12,-9,81,367260,12,367248
22198,18,13,475,1056737,18,1056719
22199,7,-17,715,108804,7,108797
22200,10,17,364,1163115,10,1163105
22201,8,-11,74,282704,8,282696
22202,12,6,276,837882,12,837870
22203,14,16,362,1149754,14,1149740
22204,6,9,980,927667,6,927661
22205,16,-16,864,153312,16,153296
22206,20,3,540,745781,20,745761
22207,19,-12,619,277029,19,277010
22208,15,-15,616,182294,15,182279
22209,16,17,404,1180921,16,1180905
22210,18,-8,212,399400,18,399382
22211,9,-5,890,487405,9,487396
22212,17,-17,90,116250,17,116233
22213,13,2,849,716832,13,716819
22214,13,-1,271,618681,13,618668
22215,8,8,348,882851,8,882843
22216,10,13,480,1041017,10,1041007
22217,17,18,23,1209070,17,1209053
22218,18,12,448,1025324,18,1025306
22219,11,15,849,1122970,11,1122959
22220,16,9,390,931853,16,931837
22221,7,17,479,1165571,7,1165564
22222,10,-18,924,82499,10,82489
22223,8,-16,741,139898,8,139890
22224,19,12,919,1029111,19,1029092
22225,5,-1,301,600562,5,600557
22226,9,-18,616,75623,9,75614
22227,14,5,498,807420,14,807406
22228,11,8,405,901215,11,901204
22229,11,3,502,745565,11,745554
22230,5,-4,719,514850,5,514845
22231,7,-12,298,256068,7,256061
22232,13,-6,552,463451,13,463438
22233,20,6,265,837784,20,837764
22234,6,-1,679,608492,6,608486
22235,11,11,550,994787,11,994776
22236,8,-12,760,265978,8,265970
22237,13,-17,867,121931,13,121918
22238,10,10,535,948908,10,948898
22239,13,10,263,961792,13,961779
22240,12,11,558,994858,12,994846
22241,15,4,387,776020,15,776005
22242,10,-3,680,545853,10,545843
22243,11,11,634,995359,11,995348
22244,12,11,302,993105,12,993093
22245,11,-5,975,498199,11,498188
22246,5,-14,159,189941,5,189936
22247,5,3,549,730383,5,730378
22248,14,-9,926,373889,14,373875
22249,12,11,760,996332,12,996320
22250,17,3,133,742828,17,742811
22251,13,11,767,996400,13,996387
22252,7,17,347,1162830,7,1162823
22253,20,-9,541,370984,20,370964
22254,9,9,486,916992,9,916983
22255,10,1,294,663568,10,663558
22256,5,16,905,1143924,5,1143919
22257,16,15,57,1117223,16,1117207
22258,8,1,773,673831,8,673823
22259,6,-11,52,282184,6,282178
22260,19,-4,148,523193,19,523174
22261,12,12,433,1025217,12,1025205
22262,16,-9,780,372717,16,372701
22263,8,-18,102,64736,8,64728
22264,11,13,486,1056801,11,1056790
22265,17,14,712,1091062,17,1091045
22266,19,-3,524,557926,19,557907
22267,5,7,284,850878,5,850873
22268,12,16,681,1151981,12,1151969
22269,8,-20,512,11037,8,11029
22270,7,-18,677,76890,7,76883
22271,7,-12,325,256735,7,256728
22272,18,11,323,993226,18,993208
22273,13,-12,481,276044,13,276031
22274,7,7,195,848895,7,848888
22275,8,-10,498,323443,8,323435
22276,15,18,573,1213110,15,1213095
22277,19,17,224,1179514,19,1179495
22278,18,-4,561,526325,18,526307
22279,16,13,981,1060494,16,1060478
22280,14,16,730,1152319,14,1152305
22281,7,11,74,970070,7,970063
22282,9,6,186,816244,9,816235
22283,6,10,645,951485,6,951479
22284,10,-17,33,94239,10,94229
22285,13,-20,747,28542,13,28529
22286,20,-7,567,432579,20,432559
22287,13,15,424,1119767,13,1119754
22288,13,16,461,1150420,13,1150407
22289,17,8,119,898867,17,898850
22290,9,4,135,753520,9,753511
22291,17,5,893,810251,17,810234
22292,10,7,996,865895,10,865885
22293,15,11,268,992780,15,992765
22294,12,17,802,1183927,12,1183915
22295,18,3,11,741881,18,741863
22296,10,4,196,754853,10,754843
22297,13,-19,879,60752,13,60739
22298,19,12,693,1027285,19,1027266
22299,11,9,288,931033,11,931022
22300,12,-14,669,214750,12,214738
22301,5,-2,403,571250,5,571245
22302,18,-12,77,273098,18,273080
22303,5,10,407,946231,5,946226
22304,9,-16,957,144578,9,144569
22305,12,13,529,1057119,12,1057107
22306,10,-3,128,533185,10,533175
22307,12,-7,950,435356,12,435344
22308,8,7,516,855845,8,855837
22309,13,-16,897,153531,13,153518
22310,9,17,350,1162863,9,1162854
22311,16,-4,844,528243,16,528227
22312,6,11,617,981675,6,981669
22313,16,-1,277,618724,16,618708
22314,6,14,488,1072672,6,1072666
22315,8,-8,998,396785,8,396777
22316,9,-7,389,414308,9,414299
22317,19,-3,46,554141,19,554122
22318,7,13,920,1050334,7,1050327
22319,13,18,293,1211239,13,1211226
22320,15,-8,908,404361,15,404346
22321,18,-9,197,367948,18,367930
22322,5,-12,101,251695,5,251690
22323,20,12,897,1028854,20,1028834
22324,5,-18,59,63651,5,63646
22325,17,9,332,931436,17,931419
22326,18,-7,857,434561,18,434543
22327,15,8,411,901270,15,901255
22328,14,-13,649,245778,14,245764
22329,6,3,17,719193,6,719187
22330,7,-7,522,417066,7,417059
22331,6,16,57,1126367,6,1126361
22332,13,-16,988,154190,13,154177
22333,19,1,722,685461,19,685442
22334,7,8,773,892216,7,892209
22335,14,-7,758,433795,14,433781
22336,19,7,76,867565,19,867546
22337,20,-20,642,27674,20,27654
22338,12,-8,666,402596,12,402584
22339,18,6,732,841712,18,841694
22340,5,-4,664,513711,5,513706
22341,15,11,762,996356,15,996341
22342,17,12,685,1027229,17,1027212
22343,20,2,512,714490,20,714470
22344,5,-7,624,419080,5,419075
22345,7,2,105,690883,7,690876
22346,18,1,222,681656,18,681638
22347,14,0,190,649691,14,649677
22348,8,4,372,758623,8,758615
22349,9,16,488,1135580,9,1135571
22350,5,17,382,1163491,5,1163486
22351,18,-1,509,620590,18,620572
22352,17,11,838,996907,17,996890
22353,6,8,646,889368,6,889362
22354,14,2,724,716054,14,716040
22355,12,13,218,1054845,12,1054833
22356,8,3,686,733714,8,733706
22357,12,-11,543,308116,12,308104
22358,6,-16,413,132897,6,132891
22359,20,-16,265,148922,20,148902
22360,7,-9,424,352965,7,352958
22361,6,-4,731,515113,6,515107
22362,18,-17,573,119844,18,119826
22363,8,-19,455,41277,8,41269
22364,16,14,396,1088514,16,1088498
22365,17,-19,888,60782,17,60765
22366,10,2,11,688743,10,688733
22367,16,-19,423,57252,16,57236
22368,6,-12,491,260166,6,260160
22369,8,-15,445,165027,8,165019
22370,14,0,248,650056,14,650042
22371,15,-16,589,151316,15,151301
22372,6,12,829,1017093,6,1017087
22373,13,11,552,994806,13,994793
22374,13,3,31,742019,13,742006
22375,8,-7,450,415492,8,415484
22376,7,8,413,884296,7,884289
22377,10,-15,297,161795,10,161785
22378,17,-18,86,85861,17,85844
22379,15,-12,340,275046,15,275031
22380,19,-19,536,58154,19,58135
22381,19,-14,856,216192,19,216173
22382,13,19,411,1244175,13,1244162
22383,5,-18,480,72767,5,72762
22384,18,3,776,747680,18,747662
22385,14,-7,184,429668,14,429654
22386,6,9,62,908049,6,908043
22387,10,-12,126,252324,10,252314
22388,5,3,913,738546,5,738541
22389,20,-5,446,494302,20,494282
22390,8,3,245,724127,8,724119
22391,8,9,412,915338,8,915330
22392,6,-13,474,228311,6,228305
22393,15,-2,755,590769,15,590754
22394,16,19,843,1247592,16,1247576
22395,8,13,494,1041330,8,1041322
22396,18,-7,203,429827,18,429809
22397,18,14,190,1086920,18,1086902
22398,20,11,481,994372,20,994352
22399,10,13,599,1043690,10,1043680
22400,13,1,615,684676,13,684663
22401,9,-8,696,390373,9,390364
22402,17,13,497,1056904,17,1056887
22403,5,7,294,851101,5,851096
22404,5,-3,457,540680,5,540675
22405,6,-17,624,106962,6,106956
22406,10,11,87,970300,10,970290
22407,17,5,85,804409,17,804392
22408,18,-5,626,495622,18,495604
22409,16,13,325,1055587,16,1055571
22410,12,5,417,806786,12,806774
22411,13,-9,628,371501,13,371488
22412,18,1,697,685259,18,685241
22413,16,15,929,1123559,16,1123543
22414,17,0,530,652215,17,652198
22415,14,12,468,1025473,14,1025459
22416,11,3,830,748050,11,748039
22417,16,-2,589,589549,16,589533
22418,11,12,307,1024384,11,1024373
22419,18,-11,404,306952,18,306934
22420,14,-4,544,526233,14,526219
22421,17,-13,557,245127,17,245110
22422,18,-4,120,522930,18,522912
22423,20,-19,890,60797,20,60777
22424,18,-2,27,585338,18,585320
22425,12,-12,597,276861,12,276849
22426,19,1,862,686537,19,686518
22427,19,5,803,809613,19,809594
22428,18,-8,9,397938,18,397920
22429,14,1,818,686202,14,686188
22430,8,3,962,739797,8,739789
22431,6,-9,534,355756,6,355750
22432,11,-10,896,341825,11,341814
22433,15,-19,518,57976,15,57961
22434,11,-14,68,209811,11,209800
22435,8,-1,163,597203,8,597195
22436,12,11,660,995545,12,995533
22437,10,-1,435,603470,10,603460
22438,15,5,697,808867,15,808852
22439,15,-8,650,402437,15,402422
22440,9,-2,873,581465,9,581456
22441,15,-5,209,492496,15,492481
22442,11,15,579,1120983,11,1120972
22443,6,-1,965,614659,6,614653
22444,17,-12,33,272745,17,272728
22445,5,16,224,1129996,5,1129991
22446,10,-15,950,175715,10,175705
22447,16,18,336,1211561,16,1211545
22448,11,-13,764,246691,11,246680
22449,13,7,663,871877,13,871864
22450,10,12,628,1012740,10,1012730
22451,17,-16,195,148380,17,148363
22452,7,-11,890,300214,7,300207
22453,12,-6,831,465447,12,465435
22454,10,11,400,977105,10,977095
22455,12,6,412,839078,12,839066
22456,9,-13,360,225872,9,225863
22457,19,-6,795,465200,19,465181
22458,6,-8,765,391795,6,391789
22459,9,6,41,813118,9,813109
22460,6,-17,28,94121,6,94115
22461,6,11,872,987239,6,987233
22462,20,-11,252,305689,20,305669
22463,8,-9,790,361271,8,361263
22464,15,14,236,1087260,15,1087245
22465,14,11,870,997190,14,997176
22466,8,-10,133,315582,8,315574
22467,13,-11,321,306316,13,306303
22468,6,-16,645,137993,6,137987
22469,9,3,568,730875,9,730866
22470,11,-20,724,28350,11,28339
22471,10,-2,46,563895,10,563885
22472,20,-11,341,306457,20,306437
22473,11,-18,680,90196,11,90185
22474,19,-10,450,338409,19,338390
22475,5,-9,571,356537,5,356532
22476,11,7,723,872259,11,872248
22477,11,-4,314,524538,11,524527
22478,11,9,537,932980,11,932969
22479,7,-10,748,328712,7,328705
22480,17,9,44,929383,17,929366
22481,8,-9,873,363140,8,363132
22482,8,9,116,909209,8,909201
22483,7,8,968,896214,7,896207
22484,16,10,743,965588,16,965572
22485,12,14,360,1088227,12,1088215
22486,14,2,530,714598,14,714584
22487,19,3,790,747808,19,747789
22488,13,10,305,962091,13,962078
22489,18,0,530,652223,18,652205
22490,6,13,496,1041397,6,1041391
22491,10,-18,911,82234,10,82224
22492,19,3,752,747522,19,747503
22493,12,15,751,1122393,12,1122381
22494,7,3,135,721746,7,721739
22495,20,-5,716,496265,20,496245
22496,10,-6,430,445956,10,445946
22497,14,8,263,900023,14,900009
22498,9,0,317,631979,9,631970
22499,12,-12,567,276699,12,276687
22500,11,11,895,997377,11,997366
22501,19,-7,138,429299,19,429280
22502,8,-17,280,99478,8,99470
22503,17,3,468,745349,17,745332
22504,15,-15,675,182789,15,182774
22505,16,5,732,809110,16,809094
22506,11,-17,834,121746,11,121735
22507,5,3,120,721421,5,721416
22508,18,4,674,778188,18,778170
22509,16,7,821,872943,16,872927
22510,15,-12,238,274275,15,274260
22511,10,5,979,802300,10,802290
22512,12,-10,132,336095,12,336083
22513,12,13,311,1055478,12,1055466
22514,16,9,362,931683,16,931667
22515,17,-12,432,275629,17,275612
22516,5,12,599,1011938,5,1011933
22517,9,9,64,908084,9,908075
22518,12,10,470,963439,12,963427
22519,9,10,749,953597,9,953588
22520,11,-20,502,26596,11,26585
22521,13,-15,792,183643,13,183630
22522,8,-1,379,602272,8,602264
22523,14,-15,909,184651,14,184637
22524,5,1,557,669524,5,669519
22525,15,-9,306,368823,15,368808
22526,20,14,154,1086675,20,1086655
22527,11,5,799,809581,11,809570
22528,10,10,625,951005,10,950995
22529,15,18,785,1214670,15,1214655
22530,5,-14,298,193171,5,193166
22531,10,-15,103,157655,10,157645
22532,5,12,994,1020995,5,1020990
22533,16,-20,129,23740,16,23724
22534,5,-14,235,191873,5,191868
22535,6,-18,974,83632,6,83626
22536,20,-10,854,341507,20,341487
22537,15,0,582,652671,15,652656
22538,9,-13,266,224109,9,224100
22539,8,-4,116,501849,8,501841
22540,8,8,566,887625,8,887617
22541,17,-4,574,526435,17,526418
22542,9,19,369,1225846,9,1225837
22543,7,-15,500,166291,7,166284
22544,20,11,241,992565,20,992545
22545,11,-17,8,115620,11,115609
22546,19,1,329,682528,19,682509
22547,13,12,627,1026694,13,1026681
22548,18,1,463,683498,18,683480
22549,18,11,981,997912,18,997894
22550,13,-19,763,59969,13,59956
22551,5,12,954,1020114,5,1020109
22552,15,6,843,842527,15,842512
22553,8,-20,1000,22141,8,22133
22554,9,-7,150,408951,9,408942
22555,15,-16,442,150291,15,150276
22556,9,-10,265,318314,9,318305
22557,12,12,487,1025660,12,1025648
22558,20,0,925,655318,20,655298
22559,10,-15,594,168192,10,168182
22560,5,-15,783,172122,5,172117
22561,17,-6,397,462150,17,462133
22562,11,18,376,1211821,11,1211810
22563,8,9,777,923122,8,923114
22564,11,8,22,898065,11,898054
22565,10,9,822,924191,10,924181
22566,10,-10,222,317472,10,317462
22567,18,-1,188,617945,18,617927
22568,7,3,958,739697,7,739690
22569,12,-10,661,340058,12,340046
22570,19,9,50,929456,19,929437
22571,16,0,672,653380,16,653364
22572,8,-14,5,186524,8,186516
22573,13,-10,111,335921,13,335908
22574,8,-6,822,454479,8,454471
22575,16,-13,566,245228,16,245212
22576,15,1,728,685515,15,685500
22577,19,-13,99,241759,19,241740
22578,10,-16,432,133415,10,133405
22579,15,-9,277,368595,15,368580
22580,6,15,637,1107968,6,1107962
22581,5,-18,970,83546,5,83541
22582,14,2,32,710742,14,710728
22583,20,12,297,1024348,20,1024328
22584,18,19,264,1242855,18,1242837
22585,5,17,758,1171424,5,1171419
22586,17,-15,679,182831,17,182814
22587,7,19,798,1235136,7,1235129
22588,12,-20,956,30024,12,30012
22589,16,-1,490,620480,16,620464
22590,18,4,942,780186,18,780168
22591,9,2,738,704183,9,704174
22592,7,3,706,734169,7,734162
22593,10,15,502,1105087,10,1105077
22594,6,2,405,697454,6,697448
22595,15,-10,503,338825,15,338810
22596,16,6,822,842377,16,842361
22597,12,-5,920,497786,12,497774
22598,14,19,957,1248471,14,1248457
22599,9,9,448,916107,9,916098
22600,17,15,706,1121985,17,1121968
22601,8,7,860,863074,8,863066
22602,15,-11,418,307070,15,307055
22603,8,-10,595,325480,8,325472
22604,8,12,254,1004704,8,1004696
22605,14,-11,334,306421,14,306407
22606,17,-9,668,371727,17,371710
22607,12,0,532,652243,12,652231
22608,19,-17,536,119503,19,119484
22609,8,-5,997,489646,8,489638
22610,13,8,337,900638,13,900625
22611,18,18,538,1212920,18,1212902
22612,17,-5,518,494878,17,494861
22613,10,-11,969,302015,10,302005
22614,19,12,513,1025792,19,1025773
22615,10,-18,784,79434,10,79424
22616,11,-12,46,272810,11,272799
22617,7,-1,410,602947,7,602940
22618,19,-13,126,241922,19,241903
22619,16,3,42,742114,16,742098
22620,7,5,346,788758,7,788751
22621,13,-14,395,212634,13,212621
22622,6,-18,680,76945,6,76939
22623,18,-7,623,432890,18,432872
22624,11,3,75,742382,11,742371
22625,17,9,82,929647,17,929630
22626,18,-9,250,368419,18,368401
22627,13,-8,208,399356,13,399343
22628,11,10,69,960343,11,960332
22629,17,17,898,1184701,17,1184684
22630,6,-6,905,456108,6,456102
22631,20,10,924,966965,20,966945
22632,17,14,704,1090987,17,1090970
22633,18,-12,386,275348,18,275330
22634,12,-6,192,460665,12,460653
22635,14,-18,831,91264,14,91250
22636,14,-7,858,434575,14,434561
22637,12,-5,307,493352,12,493340
22638,17,-5,848,497192,17,497175
22639,10,-2,414,571498,10,571488
22640,15,-1,61,617022,15,617007
22641,6,6,513,823990,6,823984
22642,5,-5,212,472654,5,472649
22643,18,-18,662,90108,18,90090
22644,14,1,262,681995,14,681981
22645,14,9,391,931856,14,931842
22646,9,12,672,1013831,9,1013822
22647,19,19,137,1241857,19,1241838
22648,11,-17,331,117933,11,117922
22649,19,-17,981,122690,19,122671
22650,5,1,797,674349,5,674344
22651,9,5,340,788619,9,788610
22652,13,7,241,868728,13,868715
22653,16,18,36,1209157,16,1209141
22654,16,18,545,1212956,16,1212940
22655,9,-11,322,288246,9,288237
22656,5,19,337,1225118,5,1225113
22657,9,-7,710,420929,9,420920
22658,9,-11,618,294826,9,294817
22659,8,-18,949,83031,8,83023
22660,14,18,173,1210326,14,1210312
22661,19,5,633,808430,19,808411
22662,20,-4,818,528094,20,528074
22663,17,-9,493,370578,17,370561
22664,19,-10,125,336035,19,336016
22665,7,8,296,881646,7,881639
22666,12,-3,114,554596,12,554584
22667,13,17,989,1185410,13,1185397
22668,9,12,608,1012247,9,1012238
22669,8,17,86,1157084,8,1157076
22670,17,-20,236,24567,17,24550
22671,16,-4,27,522241,16,522225
22672,17,7,730,872322,17,872305
22673,20,-15,82,178385,20,178365
22674,7,-20,659,14477,7,14470
22675,11,14,497,1089346,11,1089335
22676,18,-7,671,433146,18,433128
22677,8,16,16,1125543,8,1125535
22678,10,3,432,728115,10,728105
22679,7,6,926,833031,7,833024
22680,8,-6,954,457105,8,457097
22681,6,3,207,723323,6,723317
22682,7,-11,615,294774,7,294767
22683,11,-18,923,91903,11,91892
22684,12,-20,212,24437,12,24425
22685,17,-20,238,24592,17,24575
22686,14,1,242,681796,14,681782
22687,10,14,356,1069627,10,1069617
22688,16,-12,386,275354,16,275338
22689,13,6,71,836274,13,836261
22690,15,-16,187,148292,15,148277
22691,13,-19,97,54698,13,54685
22692,15,-8,355,400395,15,400380
22693,18,-17,189,116839,18,116821
22694,11,-9,432,369978,11,369967
22695,8,8,304,881884,8,881876
22696,20,9,471,932447,20,932427
22697,6,-1,130,596591,6,596585
22698,18,-18,470,88805,18,88787
22699,9,15,802,1111389,9,1111380
22700,18,-9,926,373897,18,373879
22701,15,15,745,1122327,15,1122312
22702,13,-10,703,340389,13,340376
22703,12,-3,280,555742,12,555730
22704,15,16,397,1150000,15,1149985
22705,20,-9,225,368201,20,368181
22706,12,0,381,650982,12,650970
22707,20,-13,532,244960,20,244940
22708,20,3,184,743250,20,743230
22709,19,-17,695,120712,19,120693
22710,14,4,190,774612,14,774598
22711,16,-8,216,399428,16,399412
22712,5,15,178,1098288,5,1098283
22713,13,18,589,1213171,13,1213158
22714,14,11,508,994537,14,994523
22715,10,-19,975,52389,10,52379
22716,13,7,474,870554,13,870541
22717,14,5,763,809327,14,809313
22718,9,-12,296,255999,9,255990
22719,7,-13,49,219415,7,219408
22720,16,8,174,899308,16,899292
22721,10,-13,969,239343,10,239333
22722,5,3,773,735488,5,735483
22723,10,-2,389,570940,10,570930
22724,6,19,595,1230888,6,1230882
22725,17,-7,73,428816,17,428799
22726,19,-17,6,115593,19,115574
22727,20,16,269,1149067,20,1149047
22728,19,3,345,744499,19,744480
22729,5,-18,558,74412,5,74407
22730,9,-16,436,133549,9,133540
22731,19,8,46,898226,19,898207
22732,17,15,23,1116946,17,1116929
22733,5,2,304,695138,5,695133
22734,6,18,545,1198435,6,1198429
22735,12,-8,656,402510,12,402498
22736,17,-6,477,462822,17,462805
22737,10,15,458,1104143,10,1104133
22738,18,-1,689,621861,18,621843
22739,15,2,535,714642,15,714627
22740,13,13,442,1056553,13,1056540
22741,10,-11,391,289779,10,289769
22742,9,-6,249,442252,9,442243
22743,8,-16,788,140962,8,140954
22744,8,7,354,852446,8,852438
22745,17,-18,593,89540,17,89523
22746,19,12,110,1022859,19,1022840
22747,18,-19,5,53919,18,53901
22748,5,-14,168,190118,5,190113
22749,13,-2,787,591041,13,591028
22750,5,11,160,971759,5,971754
22751,5,7,373,852796,5,852791
22752,7,-16,578,136531,7,136524
22753,16,-17,489,119122,16,119106
22754,12,-9,937,374016,12,374004
22755,20,19,784,1247140,20,1247120
22756,18,-19,489,57718,18,57700
22757,17,-4,236,523971,17,523954
22758,18,-8,23,398063,18,398045
22759,10,-14,533,198057,10,198047
22760,20,-16,185,148269,20,148249
22761,19,17,450,1181319,19,1181300
22762,8,6,216,816946,8,816938
22763,5,-12,635,263219,5,263214
22764,15,11,83,991477,15,991462
22765,13,-8,547,401719,13,401706
22766,20,-20,647,27717,20,27697
22767,20,-13,674,245881,20,245861
22768,11,-7,275,430372,11,430361
22769,5,6,790,830057,5,830052
22770,19,-3,366,556495,19,556476
22771,14,6,259,837746,14,837732
22772,14,13,920,1060007,14,1059993
22773,8,-4,784,516182,8,516174
22774,15,14,62,1085917,15,1085902
22775,8,-13,769,235058,8,235050
22776,11,-4,679,527230,11,527219
22777,16,6,155,836932,16,836916
22778,12,-8,677,402707,12,402695
22779,12,5,691,808834,12,808822
22780,10,-5,248,473478,10,473468
22781,14,2,353,713264,14,713250
22782,14,18,292,1211228,14,1211214
22783,13,-15,980,185204,13,185191
22784,13,9,303,931170,13,931157
22785,10,-19,145,34819,10,34809
22786,17,-20,926,29843,17,29826
22787,8,-14,88,188484,8,188476
22788,13,10,902,966695,13,966682
22789,8,-15,577,167909,8,167901
22790,12,-16,668,151813,12,151801
22791,11,-6,968,466446,11,466435
22792,9,-20,354,7809,9,7800
22793,16,-13,257,242955,16,242939
22794,14,19,513,1245002,14,1244988
22795,18,-5,712,496232,18,496214
22796,15,-19,16,54002,15,53987
22797,16,17,909,1184764,16,1184748
22798,12,-12,374,275295,12,275283
22799,9,-18,881,81441,9,81432
22800,19,-3,486,557531,19,557512
22801,17,-8,315,400098,17,400081
22802,9,14,574,1074557,9,1074548
22803,15,18,222,1210772,15,1210757
22804,16,15,811,1122711,16,1122695
22805,5,-2,104,565051,5,565046
22806,12,14,34,1085673,12,1085661
22807,17,-14,878,216357,17,216340
22808,14,-18,61,85663,14,85649
22809,15,13,326,1055612,15,1055597
22810,8,9,834,924499,8,924491
22811,14,-11,926,310916,14,310902
22812,8,-19,267,37408,8,37400
22813,15,16,447,1150358,15,1150343
22814,13,17,124,1178775,13,1178762
22815,11,-6,794,465192,11,465181
22816,18,15,96,1117492,18,1117474
22817,11,-2,926,592175,11,592164
22818,14,17,488,1181556,14,1181542
22819,15,1,377,682878,15,682863
22820,11,18,182,1210436,11,1210425
22821,5,18,129,1189609,5,1189604
22822,8,7,199,848978,8,848970
22823,15,9,866,935488,15,935473
22824,10,1,120,659734,10,659724
22825,12,2,543,714694,12,714682
22826,8,19,499,1228862,8,1228854
22827,19,13,34,1053466,19,1053447
22828,13,10,201,961360,13,961347
22829,11,-12,434,275639,11,275628
22830,15,-18,119,86107,15,86092
22831,11,19,479,1244717,11,1244706
22832,16,13,452,1056599,16,1056583
22833,18,3,417,745000,18,744982
22834,17,-20,635,27608,17,27591
22835,9,-9,441,353389,9,353380
22836,20,-15,974,185171,20,185151
22837,16,-4,479,525683,16,525667
22838,18,-5,697,496101,18,496083
22839,12,19,873,1247843,12,1247831
22840,10,-3,811,548545,10,548535
22841,9,4,704,765731,9,765722
22842,5,12,736,1015139,5,1015134
22843,16,-9,314,368913,16,368897
22844,18,0,952,655512,18,655494
22845,18,-15,139,178853,18,178835
22846,15,17,956,1185040,15,1185025
22847,17,-10,329,337409,17,337392
22848,13,-6,332,461742,13,461729
22849,18,4,711,778502,18,778484
22850,10,2,657,702498,10,702488
22851,8,-8,86,377274,8,377266
22852,10,-3,545,542776,10,542766
22853,11,9,224,930708,11,930697
22854,7,-16,587,136748,7,136741
22855,14,-2,546,589223,14,589209
22856,5,3,970,740062,5,740057
22857,10,19,551,1229925,10,1229915
22858,17,-4,339,524717,17,524700
22859,13,-10,238,336813,13,336800
22860,17,-12,739,277905,17,277888
22861,5,-18,36,63153,5,63148
22862,17,14,684,1090858,17,1090841
22863,10,0,142,628551,10,628541
22864,12,-3,678,559209,12,559197
22865,13,11,96,991559,13,991546
22866,18,10,564,964218,18,964200
22867,5,15,49,1095526,5,1095521
22868,7,-10,4,312584,7,312577
22869,8,-12,521,260911,8,260903
22870,9,-5,696,483053,9,483044
22871,14,13,405,1056253,14,1056239
22872,5,5,813,798596,5,798591
22873,5,-15,79,156975,5,156970
22874,13,4,849,779640,13,779627
22875,12,10,177,961207,12,961195
22876,9,-9,467,354050,9,354041
22877,15,-11,976,311359,15,311344
22878,10,-18,746,78535,10,78525
22879,15,3,662,746845,15,746830
22880,11,-9,889,373624,11,373613
22881,11,-11,336,306433,11,306422
22882,9,11,535,979913,9,979904
22883,6,-18,748,78636,6,78630
22884,17,-1,52,616968,17,616951
22885,12,15,372,1119501,12,1119489
22886,16,-3,842,560502,16,560486
22887,20,-16,536,150938,20,150918
22888,13,-3,952,561423,13,561410
22889,10,8,894,894562,10,894552
22890,11,-3,638,558888,11,558877
22891,6,15,284,1100631,6,1100625
22892,20,11,162,991998,20,991978
22893,10,11,715,983744,10,983734
22894,10,-1,58,594991,10,594981
22895,9,14,111,1064341,9,1064332
22896,18,3,579,746187,18,746169
22897,20,-6,569,463515,20,463495
22898,6,-20,163,3598,6,3592
22899,9,4,815,768375,9,768366
22900,14,-2,446,588479,14,588465
22901,11,14,632,1090351,11,1090340
22902,19,-5,781,496677,19,496658
22903,18,17,434,1181158,18,1181140
22904,10,-19,562,43761,10,43751
22905,17,11,130,991781,17,991764
22906,16,-8,652,402466,16,402450
22907,12,17,967,1185190,12,1185178
22908,17,15,516,1120524,17,1120507
22909,9,-6,392,445180,9,445171
22910,18,0,881,654946,18,654928
22911,12,-17,380,118285,12,118273
22912,19,-12,614,276957,19,276938
22913,18,2,745,716176,18,716158
22914,17,1,631,684825,17,684808
22915,6,-16,401,132600,6,132594
22916,15,1,272,682063,15,682048
22917,12,3,450,745217,12,745205
22918,7,-1,774,610467,7,610460
22919,10,14,632,1076037,10,1076027
22920,7,-2,910,582334,7,582327
22921,20,-20,237,24586,20,24566
22922,17,-14,43,209647,17,209630
22923,11,-14,567,213974,11,213963
22924,7,19,977,1239125,7,1239118
22925,10,14,593,1074977,10,1074967
22926,5,10,195,941716,5,941711
22927,9,10,286,943567,9,943558
22928,12,-15,958,185094,12,185082
22929,8,3,704,734127,8,734119
22930,20,2,966,717693,20,717673
22931,14,3,152,742971,14,742957
22932,16,8,799,904280,16,904264
22933,19,-2,932,592222,19,592203
22934,15,-2,984,592619,15,592604
22935,16,-5,49,491222,16,491206
22936,7,-3,697,546135,7,546128
22937,15,-14,209,210938,15,210923
22938,13,-9,952,374076,13,374063
22939,5,3,421,727813,5,727808
22940,11,-3,668,559095,11,559084
22941,19,19,398,1244063,19,1244044
22942,19,-7,807,434167,19,434148
22943,11,19,641,1245981,11,1245970
22944,17,-2,846,591567,17,591550
22945,19,-13,656,245809,19,245790
22946,12,-4,536,526159,12,526147
22947,14,-1,804,622749,14,622735
22948,14,17,572,1182066,14,1182052
22949,11,12,798,1027993,11,1027982
22950,12,-10,234,336784,12,336772
22951,5,18,601,1199323,5,1199318
22952,9,-11,764,297542,9,297533
22953,16,-8,67,398463,16,398447
22954,13,3,287,744094,13,744081
22955,20,12,433,1025227,20,1025207
22956,6,4,87,752484,6,752478
22957,7,-9,947,364829,7,364822
22958,20,-1,873,623233,20,623213
22959,14,-3,280,555746,14,555732
22960,12,10,560,964161,12,964149
22961,14,-10,794,341046,14,341032
22962,11,-7,968,435476,11,435465
22963,7,4,769,767344,7,767337
22964,18,9,551,933072,18,933054
22965,16,-20,674,27972,16,27956
22966,7,-17,332,100636,7,100629
22967,20,-7,68,428783,20,428763
22968,17,-11,826,310160,17,310143
22969,17,-10,467,338542,17,338525
22970,11,14,862,1092163,11,1092152
22971,13,16,338,1149553,13,1149540
22972,18,12,242,1023844,18,1023826
22973,15,-2,902,591997,15,591982
22974,11,-9,885,373606,11,373595
22975,8,14,992,1084061,8,1084053
22976,13,-8,391,400655,13,400642
22977,20,-10,7,335169,20,335149
22978,8,-5,845,486258,8,486250
22979,7,19,683,1232635,7,1232628
22980,8,5,999,802738,8,802730
22981,6,-2,286,568899,6,568893
22982,15,6,512,839936,15,839921
22983,5,-3,849,549373,5,549368
22984,7,4,964,771588,7,771581
22985,11,-17,307,117804,11,117793
22986,19,-14,270,211535,19,211516
22987,12,4,123,774124,12,774112
22988,11,10,551,964067,11,964056
22989,14,-4,802,528016,14,528002
22990,15,-5,240,492769,15,492754
22991,11,5,663,808622,11,808611
22992,12,18,5,1208946,12,1208934
22993,16,13,954,1060326,16,1060310
22994,20,1,238,681782,20,681762
22995,15,-4,121,522944,15,522929
22996,7,12,289,1005570,7,1005563
22997,16,9,614,933615,16,933599
22998,12,-7,79,428834,12,428822
22999,9,16,895,1143686,9,1143677
23000,14,-18,648,89956,14,89942
23001,9,19,838,1236128,9,1236119
23002,15,-9,750,372383,15,372368
23003,11,13,488,1056815,11,1056804
23004,16,-7,809,434188,16,434172
23005,12,-14,71,209853,12,209841
23006,11,11,378,993621,11,993610
23007,12,17,275,1179979,12,1179967
23008,16,10,56,960267,16,960251
23009,12,-1,984,624053,12,624041
23010,18,-14,819,215920,18,215902
23011,12,3,913,748709,12,748697
23012,14,-17,43,115879,14,115865
23013,14,-6,232,460977,14,460963
23014,14,14,27,1085577,14,1085563
23015,6,11,606,981449,6,981443
23016,7,-10,449,322357,7,322350
23017,9,5,203,785961,9,785952
23018,10,-20,235,5255,10,5245
23019,18,9,690,934142,18,934124
23020,12,13,856,1059628,12,1059616
23021,13,0,633,653032,13,653019
23022,17,14,186,1086867,17,1086850
23023,8,-10,578,325136,8,325128
23024,10,-17,873,111934,10,111924
23025,20,-1,367,619538,20,619518
23026,6,-8,462,384875,6,384869
23027,16,5,42,804084,16,804068
23028,6,11,599,981292,6,981286
23029,5,-11,706,296437,5,296432
23030,10,-1,784,610718,10,610708
23031,20,12,239,1023809,20,1023789
23032,19,-3,678,559218,19,559199
23033,17,-16,935,153816,17,153799
23034,5,-10,892,331696,5,331691
23035,11,-14,37,209600,11,209589
23036,19,9,749,934531,19,934512
23037,19,19,410,1244154,19,1244135
23038,20,14,695,1090933,20,1090913
23039,9,-19,495,42148,9,42139
23040,15,-8,830,403809,15,403794
23041,6,-12,295,255957,6,255951
23042,20,6,176,837081,20,837061
23043,15,-14,954,216884,15,216869
23044,14,15,894,1123307,14,1123293
23045,10,-20,772,16986,10,16976
23046,6,-13,958,239138,6,239132
23047,17,-1,174,617868,17,617851
23048,17,2,999,717849,17,717832
23049,16,11,157,991950,16,991934
23050,6,-4,564,511532,6,511526
23051,7,6,459,822746,7,822739
23052,11,-5,85,491541,11,491530
23053,17,17,421,1181041,17,1181024
23054,10,-20,159,3459,10,3449
23055,11,-5,80,491485,11,491474
23056,10,12,241,1004415,10,1004405
23057,15,17,586,1182194,15,1182179
23058,20,-12,361,275235,20,275215
23059,10,-6,773,453445,10,453435
23060,9,-18,895,81796,9,81787
23061,7,-1,550,605949,7,605942
23062,20,9,280,930988,20,930968
23063,19,8,563,902366,19,902347
23064,20,7,585,871334,20,871314
23065,12,-13,946,248165,12,248153
23066,8,-9,757,360412,8,360404
23067,13,-20,95,23469,13,23456
23068,18,-2,526,589107,18,589089
23069,12,3,860,748334,12,748322
23070,8,-17,294,99791,8,99783
23071,10,17,276,1161222,10,1161212
23072,19,-5,652,495773,19,495754
23073,5,14,959,1083273,5,1083268
23074,9,8,323,882340,9,882331
23075,12,7,282,869031,12,869019
23076,12,-9,876,373513,12,373501
23077,8,11,308,974935,8,974927
23078,16,0,623,652942,16,652926
23079,10,-15,485,165970,10,165960
23080,14,-11,422,307111,14,307097
23081,13,-13,774,246814,13,246801
23082,17,-1,133,617583,17,617566
23083,19,-4,735,527580,19,527561
23084,20,3,271,743939,20,743919
23085,8,0,894,644765,8,644757
23086,17,-6,828,465441,17,465424
23087,17,8,136,899002,17,898985
23088,5,3,950,739481,5,739476
23089,9,9,127,909480,9,909471
23090,5,-12,298,256073,5,256068
23091,14,3,881,748450,14,748436
23092,16,-4,890,528750,16,528734
23093,18,-5,907,497688,18,497670
23094,14,-12,486,276076,14,276062
23095,19,-19,467,57548,19,57529
23096,9,15,621,1107627,9,1107618
23097,6,14,882,1081598,6,1081592
23098,20,9,179,930399,20,930379
23099,14,11,153,991915,14,991901
23100,16,-17,170,116732,16,116716
23101,16,-18,888,91668,16,91652
23102,5,-13,336,225448,5,225443
23103,17,9,899,935715,17,935698
23104,13,-1,402,619757,13,619744
23105,5,-11,4,281185,5,281180
23106,8,-14,913,206426,8,206418
23107,13,17,104,1178574,13,1178561
23108,6,2,672,702821,6,702815
23109,7,7,885,863565,7,863558
23110,12,10,889,966598,12,966586
23111,18,14,366,1088303,18,1088285
23112,20,-1,457,620195,20,620175
23113,13,18,752,1214419,13,1214406
23114,19,-7,26,428510,19,428491
23115,6,-14,985,207971,6,207965
23116,13,-6,809,465344,13,465331
23117,12,18,730,1214184,12,1214172
23118,14,-18,705,90371,14,90357
23119,20,11,753,996289,20,996269
23120,18,-5,16,490876,18,490858
23121,13,-9,533,370940,13,370927
23122,5,-2,993,583985,5,583980
23123,18,-16,686,151938,18,151920
23124,11,-14,816,215914,11,215903
23125,7,4,643,764534,7,764527
23126,17,5,680,808749,17,808732
23127,5,6,523,824232,5,824227
23128,8,8,927,895272,8,895264
23129,7,-2,553,574522,7,574515
23130,10,7,547,856450,10,856440
23131,18,14,837,1091990,18,1091972
23132,16,-18,153,86422,16,86406
23133,8,0,929,645538,8,645530
23134,17,-7,657,433062,17,433045
23135,14,17,403,1180904,14,1180890
23136,14,6,767,841920,14,841906
23137,11,-13,954,248255,11,248244
23138,11,-9,63,367109,11,367098
23139,10,4,936,771095,10,771085
23140,18,-19,877,60732,18,60714
23141,7,14,518,1073377,7,1073370
23142,18,6,115,836644,18,836626
23143,17,-16,532,150907,17,150890
23144,13,-20,627,27530,13,27517
23145,10,2,838,706104,10,706094
23146,6,-5,465,478060,6,478054
23147,15,12,104,1022790,15,1022775
23148,10,18,94,1188794,10,1188784
23149,7,11,384,976695,7,976688
23150,20,2,315,712932,20,712912
23151,16,14,126,1086467,16,1086451
23152,15,13,924,1060093,15,1060078
23153,16,19,653,1246076,16,1246060
23154,17,18,90,1209641,17,1209624
23155,10,9,679,921020,10,921010
23156,19,-10,801,341156,19,341137
23157,20,8,152,899134,20,899114
23158,8,18,463,1196686,8,1196678
23159,14,-15,927,184808,14,184794
23160,10,-18,743,78445,10,78435
23161,9,-1,359,601985,9,601976
23162,8,-4,577,511897,8,511889
23163,11,-10,274,337064,11,337053
23164,5,12,815,1016781,5,1016776
23165,6,3,486,729220,6,729214
23166,14,18,957,1216007,14,1215993
23167,19,18,851,1215182,19,1215163
23168,13,-14,888,216412,13,216399
23169,12,3,986,749411,12,749399
23170,19,-6,335,461760,19,461741
23171,7,4,702,765665,7,765658
23172,8,19,436,1227630,8,1227622
23173,16,13,837,1059500,16,1059484
23174,6,-11,596,294333,6,294327
23175,17,3,100,742559,17,742542
23176,13,5,133,804733,13,804720
23177,16,15,568,1120906,16,1120890
23178,10,-20,469,10025,10,10015
23179,16,-20,297,25115,16,25099
23180,18,19,20,1240843,18,1240825
23181,9,-9,385,352059,9,352050
23182,20,-18,857,91437,20,91417
23183,17,-8,745,403164,17,403147
23184,13,10,655,964978,13,964965
23185,14,9,879,935602,14,935588
23186,10,-15,377,163629,10,163619
23187,10,0,456,635321,10,635311
23188,19,-11,646,308883,19,308864
23189,7,9,170,910422,7,910415
23190,17,-12,368,275262,17,275245
23191,8,3,872,737674,8,737666
23192,14,-2,464,588622,14,588608
23193,20,2,301,712846,20,712826
23194,20,5,358,806379,20,806359
23195,12,-18,430,88509,12,88497
23196,18,-5,422,494116,18,494098
23197,7,16,637,1138591,7,1138584
23198,14,1,645,684931,14,684917
23199,9,-1,932,614084,9,614075
23200,15,0,150,649330,15,649315
23201,9,-17,198,97606,9,97597
23202,13,2,177,711927,13,711914
23203,6,2,556,700370,6,700364
23204,17,18,175,1210348,17,1210331
23205,19,1,320,682394,19,682375
23206,8,-17,210,97896,8,97888
23207,16,7,417,870125,16,870109
23208,10,14,112,1064376,10,1064366
23209,12,-18,896,91711,12,91699
23210,19,-6,533,463250,19,463231
23211,19,16,609,1151405,19,1151386
23212,18,6,788,842076,18,842058
23213,12,-11,215,305405,12,305393
23214,19,3,503,745582,19,745563
23215,10,-2,294,569169,10,569159
23216,18,12,959,1029492,18,1029474
23217,9,-4,926,519256,9,519247
23218,16,12,412,1025038,16,1025022
23219,20,-8,755,403248,20,403228
23220,8,13,413,1039730,8,1039722
23221,7,17,747,1171159,7,1171152
23222,6,12,282,1005437,6,1005431
23223,6,-12,188,253458,6,253452
23224,17,-16,811,152848,17,152831
23225,8,-13,304,224859,8,224851
23226,17,9,86,929682,17,929665
23227,17,-10,646,339906,17,339889
23228,16,-16,986,154180,16,154164
23229,15,-1,286,618841,15,618826
23230,16,-6,997,466695,16,466679
23231,7,-13,422,227119,7,227112
23232,5,-18,403,71055,5,71050
23233,20,-5,236,492737,20,492717
23234,18,2,868,716974,18,716956
23235,20,11,210,992305,20,992285
23236,20,15,968,1123895,20,1123875
23237,19,12,934,1029247,19,1029228
23238,8,13,946,1050957,8,1050949
23239,12,3,994,749480,12,749468
23240,17,6,569,840398,17,840381
23241,20,-4,639,526901,20,526881
23242,17,-8,817,403752,17,403735
23243,11,17,447,1181273,11,1181262
23244,14,-18,742,90667,14,90653
23245,12,16,173,1148316,12,1148304
23246,18,10,617,964683,18,964665
23247,5,18,44,1187559,5,1187554
23248,8,-18,25,62971,8,62963
23249,14,-6,418,462348,14,462334
23250,5,-16,551,136010,5,136005
23251,5,-12,190,253525,5,253520
23252,7,-4,453,509280,7,509273
23253,14,-12,185,273831,14,273817
23254,9,-7,9,406189,9,406180
23255,7,18,751,1202554,7,1202547
23256,19,8,520,902121,19,902102
23257,15,-8,587,401950,15,401935
23258,11,-2,801,591146,11,591135
23259,8,-13,217,222957,8,222949
23260,6,10,336,944641,6,944635
23261,13,-13,347,243617,13,243604
23262,20,-17,661,120481,20,120461
23263,17,10,755,965643,17,965626
23264,6,-16,595,136945,6,136939
23265,5,13,47,1031755,5,1031750
23266,19,-8,675,402697,19,402678
23267,18,7,518,870897,18,870879
23268,16,-16,388,149737,16,149721
23269,13,9,662,933951,13,933938
23270,9,12,902,1018959,9,1018950
23271,20,10,792,965992,20,965972
23272,8,-18,542,74062,8,74054
23273,11,7,828,873005,11,872994
23274,17,8,793,904241,17,904224
23275,10,-13,486,228570,10,228560
23276,14,-11,427,307163,14,307149
23277,9,8,320,882237,9,882228
23278,5,10,62,938834,5,938829
23279,18,-8,72,398530,18,398512
23280,14,2,631,715331,14,715317
23281,7,-1,291,600304,7,600297
23282,18,14,651,1090536,18,1090518
23283,11,-3,485,557523,11,557512
23284,9,13,611,1043939,9,1043930
23285,20,19,184,1242208,20,1242188
23286,9,2,606,701400,9,701391
23287,9,18,547,1198478,9,1198469
23288,6,-5,631,481689,6,481683
23289,10,-19,634,45454,10,45444
23290,8,-17,458,103242,8,103234
23291,14,-7,50,428663,14,428649
23292,16,-18,945,92084,16,92068
23293,5,14,388,1070353,5,1070348
23294,6,16,456,1135014,6,1135008
23295,18,-12,694,277603,18,277585
23296,5,-12,572,261924,5,261919
23297,5,2,505,699333,5,699328
23298,10,-14,153,189821,10,189811
23299,14,4,721,778565,14,778551
23300,17,-20,217,24462,17,24445
23301,13,14,976,1093086,13,1093073
23302,16,-4,469,525611,16,525595
23303,9,19,940,1238315,9,1238306
23304,9,9,972,927550,9,927541
23305,7,-12,922,269638,7,269631
23306,11,-13,897,247703,11,247692
23307,16,-7,347,430967,16,430951
23308,11,19,56,1241183,11,1241172
23309,17,-5,23,490989,17,490972
23310,10,11,131,971252,10,971242
23311,7,3,103,721094,7,721087
23312,8,-9,743,360072,8,360064
23313,6,12,638,1012973,6,1012967
23314,7,9,469,916530,7,916523
23315,15,18,674,1213834,15,1213819
23316,7,-8,555,387057,7,387050
23317,17,-16,262,148884,17,148867
23318,11,8,813,904350,11,904339
23319,19,16,350,1149672,19,1149653
23320,13,14,427,1088812,13,1088799
23321,14,-12,501,276262,14,276248
23322,14,-10,382,337809,14,337795
23323,10,-8,143,378491,10,378481
23324,6,1,653,671449,6,671443
23325,13,-10,602,339551,13,339538
23326,5,-2,781,579379,5,579374
23327,7,9,625,920065,7,920058
23328,8,-7,543,417554,8,417546
23329,9,-12,674,264133,9,264124
23330,7,-20,915,20237,7,20230
23331,19,9,433,932176,19,932157
23332,9,-6,382,444999,9,444990
23333,20,-1,564,621013,20,620993
23334,14,0,378,650940,14,650926
23335,20,15,36,1117044,20,1117024
23336,13,-2,702,590435,13,590422
23337,20,9,457,932359,20,932339
23338,11,7,829,873005,11,872994
23339,8,-6,767,453275,8,453267
23340,15,15,587,1121054,15,1121039
23341,17,19,185,1242215,17,1242198
23342,17,-13,344,243601,17,243584
23343,15,18,759,1214450,15,1214435
23344,16,-8,700,402847,16,402831
23345,9,-19,768,48418,9,48409
23346,19,7,442,870345,19,870326
23347,13,-14,198,210830,13,210817
23348,15,-16,151,148062,15,148047
23349,19,-6,362,461932,19,461913
23350,17,-15,768,183488,17,183471
23351,18,-18,234,87156,18,87138
23352,20,-20,498,26550,20,26530
23353,14,-12,554,276612,14,276598
23354,13,-16,84,147476,13,147463
23355,16,-11,480,307557,16,307541
23356,6,-11,780,297944,6,297938
23357,19,9,645,933828,19,933809
23358,18,-13,791,246920,18,246902
23359,13,10,131,960904,13,960891
23360,6,19,90,1219529,6,1219523
23361,18,18,135,1210022,18,1210004
23362,16,5,349,806336,16,806320
23363,19,13,605,1057844,19,1057825
23364,8,0,510,636373,8,636365
23365,9,-19,279,37629,9,37620
23366,6,15,193,1098593,6,1098587
23367,14,19,364,1243731,14,1243717
23368,5,-9,244,348913,5,348908
23369,8,11,245,973471,8,973463
23370,9,7,581,857153,9,857144
23371,9,-17,78,95060,9,95051
23372,17,-13,99,241766,17,241749
23373,15,16,349,1149664,15,1149649
23374,18,12,211,1023610,18,1023592
23375,10,-13,608,231377,10,231367
23376,8,10,778,954284,8,954276
23377,11,14,929,1092664,11,1092653
23378,15,17,830,1184181,15,1184166
23379,7,-12,734,265297,7,265290
23380,16,-1,942,623752,16,623736
23381,9,4,917,770779,9,770770
23382,11,-2,906,592029,11,592018
23383,6,12,388,1007464,6,1007458
23384,6,0,896,644824,6,644818
23385,17,-6,408,462262,17,462245
23386,18,17,77,1178443,18,1178425
23387,16,14,760,1091424,16,1091408
23388,9,4,609,763814,9,763805
23389,17,0,343,650653,17,650636
23390,15,-11,981,311385,15,311370
23391,14,5,579,808006,14,807992
23392,11,-14,388,212600,11,212589
23393,11,-12,292,274670,11,274659
23394,6,-5,245,473413,6,473407
23395,17,10,513,963808,17,963791
23396,17,1,363,682762,17,682745
23397,19,11,709,995883,19,995864
23398,11,-9,198,367957,11,367946
23399,18,-11,4,303692,18,303674
23400,9,-8,439,384448,9,384439
23401,8,3,546,730280,8,730272
23402,9,-16,141,127082,9,127073
23403,9,-11,456,291322,9,291313
23404,12,-8,3,397846,12,397834
23405,11,-17,946,122466,11,122455
23406,6,15,965,1115048,6,1115042
23407,20,-18,215,86932,20,86912
23408,9,-1,497,604916,9,604907
23409,18,3,548,745849,18,745831
23410,20,-10,874,341655,20,341635
23411,9,1,85,658862,9,658853
23412,8,5,21,782036,8,782028
23413,15,-1,779,622586,15,622571
23414,13,-15,862,184313,13,184300
23415,9,18,315,1193562,9,1193553
23416,15,0,264,650143,15,650128
23417,6,-12,106,251816,6,251810
23418,11,2,326,713048,11,713037
23419,11,-10,288,337123,11,337112
23420,11,14,738,1091211,11,1091200
23421,17,12,930,1029209,17,1029192
23422,11,-9,138,367580,11,367569
23423,12,1,690,685240,12,685228
23424,7,13,265,1036311,7,1036304
23425,7,8,204,879644,7,879637
23426,7,7,589,857314,7,857307
23427,12,8,948,905334,12,905322
23428,19,6,898,842903,19,842884
23429,5,-6,393,445199,5,445194
23430,7,8,789,892538,7,892531
23431,16,9,21,929189,16,929173
23432,20,-5,159,492179,20,492159
23433,14,6,40,836110,14,836096
23434,12,14,103,1086282,12,1086270
23435,13,10,275,961901,13,961888
23436,14,-15,106,178578,14,178564
23437,16,9,573,933287,16,933271
23438,17,-8,584,401925,17,401908
23439,7,-7,70,407428,7,407421
23440,6,5,149,784649,6,784643
23441,10,18,280,1192956,10,1192946
23442,20,-7,932,435196,20,435176
23443,6,-20,848,18857,6,18851
23444,18,-6,705,464532,18,464514
23445,13,15,547,1120731,13,1120718
23446,15,-16,948,153883,15,153868
23447,16,-2,619,589798,16,589782
23448,20,18,840,1215055,20,1215035
23449,13,1,687,685206,13,685193
23450,16,18,84,1209591,16,1209575
23451,12,15,822,1122799,12,1122787
23452,10,1,810,674640,10,674630
23453,18,15,124,1117750,18,1117732
23454,14,0,937,655372,14,655358
23455,20,-5,579,495318,20,495298
23456,9,6,155,815527,9,815518
23457,16,14,806,1091766,16,1091750
23458,6,5,554,793107,6,793101
23459,17,-9,465,370258,17,370241
23460,10,0,990,646859,10,646849
23461,9,-2,66,564304,9,564295
23462,14,14,23,1085546,14,1085532
23463,13,-2,689,590338,13,590325
23464,20,3,783,747724,20,747704
23465,14,0,748,654042,14,654028
23466,6,-10,227,317513,6,317507
23467,13,1,958,687310,13,687297
23468,5,13,445,1040365,5,1040360
23469,8,16,389,1133432,8,1133424
23470,5,0,216,630153,5,630148
23471,14,-5,115,491805,14,491791
23472,16,8,93,898635,16,898619
23473,8,18,173,1190582,8,1190574
23474,14,12,795,1027970,14,1027956
23475,9,10,99,939784,9,939775
23476,16,17,505,1181680,16,1181664
23477,11,5,218,805476,11,805465
23478,9,15,214,1099033,9,1099024
23479,5,5,542,792887,5,792882
23480,6,17,520,1166474,6,1166468
23481,7,14,52,1062963,7,1062956
23482,11,-6,372,462020,11,462009
23483,13,-12,80,273123,13,273110
23484,5,-8,630,388768,5,388763
23485,10,5,973,802179,10,802169
23486,20,-6,129,460056,20,460036
23487,18,1,267,682021,18,682003
23488,9,-17,465,103412,9,103403
23489,16,9,693,934162,16,934146
23490,18,-20,748,28563,18,28545
23491,11,-3,616,558668,11,558657
23492,15,-10,405,337987,15,337972
23493,19,4,705,778395,19,778376
23494,11,-16,879,153445,11,153434
23495,17,-1,148,617663,17,617646
23496,6,-18,705,77545,6,77539
23497,14,-18,24,85385,14,85371
23498,10,7,122,847402,10,847392
23499,5,12,396,1007639,5,1007634
23500,16,4,316,775446,16,775430
23501,8,-2,908,582290,8,582282
23502,13,9,881,935619,13,935606
23503,17,-2,410,588182,17,588165
23504,12,7,708,872160,12,872148
23505,12,9,690,934144,12,934132
23506,5,12,614,1012324,5,1012319
23507,6,-19,416,40444,6,40438
23508,13,13,858,1059647,13,1059634
23509,10,9,497,917170,10,917160
23510,7,15,422,1103284,7,1103277
23511,13,17,917,1184806,13,1184793
23512,11,5,748,809238,11,809227
23513,6,8,207,879705,6,879699
23514,9,0,337,632482,9,632473
23515,19,1,980,687458,19,687439
23516,20,-5,86,491562,20,491542
23517,13,-2,944,592339,13,592326
23518,5,-7,584,418427,5,418422
23519,13,-20,242,24626,13,24613
23520,19,1,628,684788,19,684769
23521,6,-16,364,131774,6,131768
23522,9,4,221,755449,9,755440
23523,14,-8,220,399484,14,399470
23524,6,3,716,734388,6,734382
23525,19,16,638,1151659,19,1151640
23526,9,12,885,1018517,9,1018508
23527,12,2,997,717835,12,717823
23528,19,-19,823,60313,19,60294
23529,5,-19,322,38508,5,38503
23530,13,19,526,1245152,13,1245139
23531,19,18,727,1214153,19,1214134
23532,16,-15,810,183812,16,183796
23533,12,0,916,655235,12,655223
23534,13,-3,38,554078,13,554065
23535,17,2,824,716624,17,716607
23536,9,-3,881,550108,9,550099
23537,17,16,824,1153014,17,1152997
23538,18,-5,477,494579,18,494561
23539,15,11,288,992964,15,992949
23540,16,-17,381,118303,16,118287
23541,7,6,465,822931,7,822924
23542,7,-7,975,426697,7,426690
23543,18,-13,839,247266,18,247248
23544,17,11,972,997846,17,997829
23545,12,-20,450,26226,12,26214
23546,6,-5,525,479434,6,479428
23547,18,11,262,992711,18,992693
23548,9,19,51,1218504,9,1218495
23549,13,-3,707,559418,13,559405
23550,14,-17,8,115624,14,115610
23551,18,10,310,962148,18,962130
23552,11,6,612,840675,11,840664
23553,6,-13,695,233002,6,232996
23554,6,-12,130,252414,6,252408
23555,9,-12,310,256364,9,256355
23556,6,9,106,908977,6,908971
23557,18,9,977,936407,18,936389
23558,16,16,281,1149160,16,1149144
23559,6,-15,722,170929,6,170923
23560,15,-8,389,400627,15,400612
23561,9,14,979,1083763,9,1083754
23562,19,4,500,776848,19,776829
23563,18,0,278,650197,18,650179
23564,7,-7,419,414907,7,414900
23565,14,-20,998,30428,14,30414
23566,5,12,909,1019131,5,1019126
23567,8,8,938,895576,8,895568
23568,20,14,602,1090103,20,1090083
23569,9,-9,714,359318,9,359309
23570,17,11,888,997305,17,997288
23571,9,-19,305,38121,9,38112
23572,20,14,158,1086721,20,1086701
23573,7,19,292,1223967,7,1223960
23574,8,0,222,630301,8,630293
23575,20,-15,132,178795,20,178775
23576,18,6,327,838324,18,838306
23577,8,-20,816,18119,8,18111
23578,5,-13,509,229129,5,229124
23579,9,-8,174,379242,9,379233
23580,10,-12,725,265124,10,265114
23581,5,1,788,674110,5,674105
23582,10,-6,67,438185,10,438175
23583,8,-15,695,170204,8,170196
23584,20,-4,949,529177,20,529157
23585,18,11,47,991204,18,991186
23586,5,2,455,698323,5,698318
23587,13,-2,719,590561,13,590548
23588,6,7,418,853821,6,853815
23589,15,16,163,1148223,15,1148208
23590,12,13,328,1055644,12,1055632
23591,20,10,86,960499,20,960479
23592,14,-5,999,498329,14,498315
23593,5,-8,604,388115,5,388110
23594,7,4,998,772274,7,772267
23595,8,-9,851,362549,8,362541
23596,13,-8,550,401748,13,401735
23597,18,-14,405,212719,18,212701
23598,15,-16,812,152874,15,152859
23599,15,13,744,1058766,15,1058751
23600,18,19,168,1242083,18,1242065
23601,14,6,398,838979,14,838965
23602,8,10,21,937944,8,937936
23603,12,-4,68,522543,12,522531
23604,6,8,686,890332,6,890326
23605,19,-5,291,493220,19,493201
23606,19,14,631,1090349,19,1090330
23607,16,-8,319,400138,16,400122
23608,14,3,804,747913,14,747899
23609,6,10,825,955387,6,955381
23610,12,-3,813,560317,12,560305
23611,11,-15,782,183600,11,183589
23612,7,-5,912,487893,7,487886
23613,15,-1,980,623980,15,623965
23614,8,2,883,706994,8,706986
23615,5,-2,940,582983,5,582978
23616,14,3,403,744907,14,744893
23617,7,15,379,1102502,7,1102495
23618,5,7,167,848311,5,848306
23619,11,2,637,715345,11,715334
23620,17,15,59,1117234,17,1117217
23621,6,-19,954,51958,6,51952
23622,7,-3,142,533500,7,533493
23623,9,-9,624,357432,9,357423
23624,7,-10,364,320450,7,320443
23625,9,13,962,1051308,9,1051299
23626,6,-11,719,296668,6,296662
23627,17,-5,639,495700,17,495683
23628,16,-19,713,59550,16,59534
23629,11,-6,22,459318,11,459307
23630,20,0,998,655931,20,655911
23631,20,9,17,929157,20,929137
23632,19,-6,389,462118,19,462099
23633,19,18,142,1210134,19,1210115
23634,18,16,207,1148627,18,1148609
23635,11,-15,909,184652,11,184641
23636,10,-11,98,283221,10,283211
23637,19,-11,597,308479,19,308460
23638,13,16,251,1148905,13,1148892
23639,15,-12,478,276015,15,276000
23640,16,-5,364,493772,16,493756
23641,6,0,765,642192,6,642186
23642,10,-17,786,110282,10,110272
23643,10,-18,240,67768,10,67758
23644,9,6,6,812252,9,812243
23645,13,-19,17,54010,13,53997
23646,10,-1,936,614180,10,614170
23647,19,11,158,991964,19,991945
23648,11,-13,190,242455,11,242444
23649,7,-20,592,12925,7,12918
23650,6,-3,234,535448,6,535442
23651,12,-11,44,303956,12,303944
23652,13,-1,891,623389,13,623376
23653,15,-9,183,367862,15,367847
23654,14,-17,0,115530,14,115516
23655,9,-17,447,102970,9,102961
23656,6,5,249,786830,6,786824
23657,8,2,317,695400,8,695392
23658,14,6,565,840333,14,840319
23659,11,8,221,899706,11,899695
23660,14,15,731,1122213,14,1122199
23661,19,12,313,1024411,19,1024392
23662,20,-9,766,372586,20,372566
23663,20,17,789,1183780,20,1183760
23664,11,-10,668,340142,11,340131
23665,12,0,622,652937,12,652925
23666,18,15,811,1122719,18,1122701
23667,20,17,166,1179127,20,1179107
23668,8,16,849,1142723,8,1142715
23669,13,19,335,1243483,13,1243470
23670,8,2,569,700618,8,700610
23671,8,-1,822,611526,8,611518
23672,18,-10,998,342712,18,342694
23673,5,-10,969,333264,5,333259
23674,15,-13,95,241718,15,241703
23675,9,-8,551,386990,9,386981
23676,16,-18,231,87131,16,87115
23677,14,4,61,773697,14,773683
23678,17,-13,471,244457,17,244440
23679,11,-17,87,116203,11,116192
23680,5,1,946,677539,5,677534
23681,18,16,271,1149077,18,1149059
23682,16,-2,129,586081,16,586065
23683,16,18,736,1214219,16,1214203
23684,12,-15,289,179878,12,179866
23685,7,2,739,704194,7,704187
23686,7,15,420,1103203,7,1103196
23687,9,-9,782,361061,9,361052
23688,6,12,684,1014146,6,1014140
23689,19,-16,70,147319,19,147300
23690,5,6,287,818698,5,818693
23691,8,16,182,1129037,8,1129029
23692,7,-2,20,563207,7,563200
23693,11,11,525,994663,11,994652
23694,9,-18,736,78294,9,78285
23695,6,11,919,988344,6,988338
23696,18,9,33,929301,18,929283
23697,5,1,710,672358,5,672353
23698,11,19,694,1246405,11,1246394
23699,16,-7,110,429093,16,429077
23700,20,4,137,774256,20,774236
23701,16,-11,488,307618,16,307602
23702,5,1,930,677266,5,677261
23703,20,-6,503,463046,20,463026
23704,18,6,813,842308,18,842290
23705,7,7,56,846065,7,846058
23706,8,0,884,644557,8,644549
23707,7,1,77,658654,7,658647
23708,9,-16,668,138383,9,138374
23709,9,8,199,879472,9,879463
23710,7,3,250,724279,7,724272
23711,8,-19,340,38909,8,38901
23712,14,-6,407,462250,14,462236
23713,20,-12,88,273182,20,273162
23714,7,-11,511,292576,7,292569
23715,20,-13,977,248408,20,248388
23716,10,-9,319,350582,10,350572
23717,19,9,481,932559,19,932540
23718,9,4,26,751132,9,751123
23719,8,11,96,970542,8,970534
23720,9,17,422,1164267,9,1164258
23721,11,8,119,898868,11,898857
23722,9,-18,248,67931,9,67922
23723,19,17,115,1178676,19,1178657
23724,16,-9,466,370283,16,370267
23725,7,14,813,1080223,7,1080216
23726,9,18,190,1191101,9,1191092
23727,10,-17,485,103855,10,103845
23728,18,2,72,711108,18,711090
23729,8,-3,944,551628,8,551620
23730,7,1,270,663111,7,663104
23731,7,-13,398,226676,7,226669
23732,5,-5,630,481664,5,481659
23733,12,17,802,1183929,12,1183917
23734,19,3,849,748240,19,748221
23735,19,-18,674,90168,19,90149
23736,15,6,430,839202,15,839187
23737,19,-11,488,307627,19,307608
23738,17,12,104,1022797,17,1022780
23739,10,6,751,829191,10,829181
23740,9,-16,114,126529,9,126520
23741,8,9,103,908931,8,908923
23742,15,-15,473,181269,15,181254
23743,10,-14,605,199962,10,199952
23744,15,-15,305,179990,15,179975
23745,7,-7,388,414270,7,414263
23746,16,-1,645,621523,16,621507
23747,13,-12,352,275158,13,275145
23748,14,18,930,1215765,14,1215751
23749,10,13,667,1045143,10,1045133
23750,18,5,758,809288,18,809270
23751,19,-10,177,336402,19,336383
23752,7,16,35,1125908,7,1125901
23753,19,13,83,1053840,19,1053821
23754,6,11,898,987834,6,987828
23755,8,17,329,1162436,8,1162428
23756,13,18,15,1209024,13,1209011
23757,12,-6,362,461934,12,461922
23758,13,5,933,810634,13,810621
23759,6,-17,349,100997,6,100991
23760,15,10,268,961858,15,961843
23761,19,16,124,1147919,19,1147900
23762,10,-2,438,572102,10,572092
23763,20,10,74,960417,20,960397
23764,6,-5,396,476665,6,476659
23765,15,4,574,777421,15,777406
23766,13,-10,493,338715,13,338702
23767,14,16,69,1147582,14,1147568
23768,16,-4,937,529086,16,529070
23769,18,13,695,1058437,18,1058419
23770,15,15,430,1119824,15,1119809
23771,5,-1,147,596943,5,596938
23772,7,0,169,629121,7,629114
23773,12,12,305,1024383,12,1024371
23774,16,-13,182,242393,16,242377
23775,13,-15,610,182240,13,182227
23776,20,5,397,806701,20,806681
23777,5,1,841,675218,5,675213
23778,7,-18,334,69698,7,69691
23779,11,9,215,930626,11,930615
23780,9,-16,987,145248,9,145239
23781,20,-12,263,274446,20,274426
23782,6,-4,539,511118,6,511112
23783,6,11,522,979588,6,979582
23784,8,-13,720,233729,8,233721
23785,6,-10,564,324915,6,324909
23786,7,-1,270,599775,7,599768
23787,20,-12,763,278125,20,278105
23788,5,8,854,893701,5,893696
23789,14,11,773,996442,14,996428
23790,18,-7,487,431979,18,431961
23791,10,-20,637,13935,10,13925
23792,10,-9,837,362223,10,362213
23793,14,-4,304,524450,14,524436
23794,7,-16,386,132269,7,132262
23795,18,-1,401,619755,18,619737
23796,8,18,571,1198886,8,1198878
23797,12,11,643,995410,12,995398
23798,18,-2,550,589270,18,589252
23799,14,16,650,1151783,14,1151769
23800,8,3,719,734455,8,734447
23801,9,8,834,893317,9,893308
23802,18,-16,96,147616,18,147598
23803,10,-19,978,52461,10,52451
23804,5,-5,771,484552,5,484547
23805,15,-19,125,55007,15,54992
23806,14,0,743,653992,14,653978
23807,5,5,125,784173,5,784168
23808,13,18,502,1212621,13,1212608
23809,5,14,736,1078521,5,1078516
23810,16,-2,649,589992,16,589976
23811,15,-11,77,304273,15,304258
23812,6,2,393,697102,6,697096
23813,16,0,600,652784,16,652768
23814,13,-7,717,433533,13,433520
23815,6,-10,23,313062,6,313056
23816,9,12,82,1000919,9,1000910
23817,14,-9,609,371422,14,371408
23818,7,17,601,1168100,7,1168093
23819,6,9,900,925839,6,925833
23820,12,-11,170,305066,12,305054
23821,9,-16,184,127996,9,127987
23822,19,15,942,1123684,19,1123665
23823,9,-7,450,415501,9,415492
23824,15,-6,859,465636,15,465621
23825,13,12,776,1027808,13,1027795
23826,10,-9,97,345692,10,345682
23827,9,5,409,789976,9,789967
23828,9,10,520,948626,9,948617
23829,11,-15,402,180699,11,180688
23830,9,1,469,667454,9,667445
23831,8,16,935,1144674,8,1144666
23832,5,15,334,1101618,5,1101613
23833,5,-15,106,157737,5,157732
23834,18,0,666,653338,18,653320
23835,8,8,93,877023,8,877015
23836,18,17,996,1185444,18,1185426
23837,19,8,850,904594,19,904575
23838,12,19,822,1247393,12,1247381
23839,5,3,334,726172,5,726167
23840,8,-13,433,227460,8,227452
23841,11,17,788,1183766,11,1183755
23842,16,1,220,681623,16,681607
23843,8,-3,713,546479,8,546471
23844,6,17,231,1160103,6,1160097
23845,13,9,868,935495,13,935482
23846,12,14,550,1089760,12,1089748
23847,12,-14,699,214992,12,214980
23848,14,3,141,742894,14,742880
23849,9,-6,751,452965,9,452956
23850,16,-16,114,147768,16,147752
23851,12,18,37,1209174,12,1209162
23852,5,-4,181,503337,5,503332
23853,9,-8,35,376102,9,376093
23854,8,-20,257,5715,8,5707
23855,19,-9,548,371053,19,371034
23856,17,-3,202,555216,17,555199
23857,16,14,184,1086861,16,1086845
23858,16,-6,597,463704,16,463688
23859,13,-6,987,466662,13,466649
23860,19,2,587,714966,19,714947
23861,6,12,0,999036,6,999030
23862,9,-18,887,81610,9,81601
23863,16,8,136,899008,16,898992
23864,12,17,485,1181544,12,1181532
23865,13,10,635,964815,13,964802
23866,10,6,865,831775,10,831765
23867,7,-20,39,923,7,916
23868,12,-13,70,241561,12,241549
23869,20,-12,839,278712,20,278692
23870,10,-7,815,423044,10,423034
23871,11,-19,819,60267,11,60256
23872,15,-14,857,216197,15,216182
23873,7,-3,286,536577,7,536570
23874,13,-13,999,248580,13,248567
23875,11,10,350,962436,11,962425
23876,7,-19,266,37372,7,37365
23877,7,17,254,1160679,7,1160672
23878,6,-12,626,263022,6,263016
23879,20,17,42,1178205,20,1178185
23880,7,14,621,1075731,7,1075724
23881,8,-15,138,158447,8,158439
23882,6,-1,495,604880,6,604874
23883,14,-15,477,181313,14,181299
23884,6,-6,632,450348,6,450342
23885,20,-6,461,462695,20,462675
23886,14,-15,548,181823,14,181809
23887,15,17,503,1181666,15,1181651
23888,7,6,137,815164,7,815157
23889,7,-19,256,37156,7,37149
23890,13,-4,10,522123,13,522110
23891,18,11,386,993704,18,993686
23892,10,18,517,1197882,10,1197872
23893,19,7,823,872961,19,872942
23894,5,-16,550,135990,5,135985
23895,15,18,579,1213150,15,1213135
23896,19,0,942,655392,19,655373
23897,12,-18,427,88487,12,88475
23898,13,-18,744,90669,13,90656
23899,11,18,661,1213745,11,1213734
23900,18,-12,308,274811,18,274793
23901,19,-19,146,55161,19,55142
23902,17,-5,256,492932,17,492915
23903,18,16,586,1151240,18,1151222
23904,14,15,866,1123111,14,1123097
23905,19,12,410,1025022,19,1025003
23906,17,7,200,868416,17,868399
23907,7,-15,801,172448,7,172441
23908,19,-6,913,466071,19,466052
23909,8,-13,27,218969,8,218961
23910,6,-12,49,250614,6,250608
23911,6,3,180,722727,6,722721
23912,8,-3,728,546773,8,546765
23913,13,2,321,713013,13,713000
23914,17,-5,809,496881,17,496864
23915,17,-15,0,177837,17,177820
23916,19,2,272,712591,19,712572
23917,17,-15,80,178339,17,178322
23918,20,9,548,933043,20,933023
23919,5,12,490,1009647,5,1009642
23920,18,7,305,869222,18,869204
23921,18,3,404,744919,18,744901
23922,19,-1,560,620978,19,620959
23923,16,-7,534,432382,16,432366
23924,10,-7,989,426941,10,426931
23925,19,5,514,807524,19,807505
23926,12,12,944,1029373,12,1029361
23927,8,2,473,698745,8,698737
23928,13,-14,294,211698,13,211685
23929,14,2,243,712398,14,712384
23930,6,-7,709,420878,6,420872
23931,13,-16,128,147908,13,147895
23932,6,17,593,1167874,6,1167868
23933,17,18,12,1209007,17,1208990
23934,14,3,525,745689,14,745675
23935,17,-9,119,367469,17,367452
23936,17,-18,850,91363,17,91346
23937,19,-10,468,338567,19,338548
23938,6,-13,324,225236,6,225230
23939,15,13,728,1058659,15,1058644
23940,5,1,998,678674,5,678669
23941,15,11,32,991125,15,991110
23942,8,7,373,852804,8,852796
23943,18,14,908,1092550,18,1092532
23944,16,-13,899,247717,16,247701
23945,7,-11,58,282366,7,282359
23946,19,19,315,1243306,19,1243287
23947,20,3,93,742506,20,742486
23948,20,-17,443,118758,20,118738
23949,6,-19,400,40236,6,40230
23950,6,-7,342,413321,6,413315
23951,16,-2,357,587792,16,587776
23952,17,-14,397,212658,17,212641
23953,10,1,358,665042,10,665032
23954,18,10,437,963143,18,963125
23955,20,3,576,746152,20,746132
23956,15,-13,562,245165,15,245150
23957,11,13,462,1056655,11,1056644
23958,7,-11,948,301493,7,301486
23959,10,-6,8,437057,10,437047
23960,20,11,7,990923,20,990903
23961,17,13,195,1054664,17,1054647
23962,7,5,920,800929,7,800922
23963,17,-8,1000,405034,17,405017
23964,11,4,264,775112,11,775101
23965,11,11,953,997703,11,997692
23966,9,8,603,888345,9,888336
23967,12,-14,795,215728,12,215716
23968,9,5,392,789694,9,789685
23969,14,-4,584,526486,14,526472
23970,7,-1,130,596598,7,596591
23971,14,-4,488,525725,14,525711
23972,17,19,483,1244740,17,1244723
23973,11,-6,135,460114,11,460103
23974,11,-11,531,307992,11,307981
23975,20,5,319,806100,20,806080
23976,16,3,913,748715,16,748699
23977,20,-19,171,55398,20,55378
23978,6,-13,424,227153,6,227147
23979,5,19,806,1235322,5,1235317
23980,19,-2,459,588590,19,588571
23981,20,11,730,996078,20,996058
23982,6,-12,909,269476,6,269470
23983,13,-10,114,335940,13,335927
23984,19,-2,799,591131,19,591112
23985,18,18,928,1215754,18,1215736
23986,10,-14,289,193023,10,193013
23987,9,-4,332,506740,9,506731
23988,8,11,46,969434,8,969426
23989,10,8,774,892255,10,892245
23990,20,-3,429,557023,20,557003
23991,15,10,812,966169,15,966154
23992,14,1,582,684485,14,684471
23993,17,2,629,715282,17,715265
23994,11,0,330,650520,11,650509
23995,17,-14,396,212640,17,212623
23996,13,-6,490,462939,13,462926
23997,6,15,993,1115611,6,1115605
23998,19,-17,147,116570,19,116551
23999,7,-19,923,51384,7,51377
24000,16,-3,135,554738,16,554722
24001,19,14,128,1086496,19,1086477
24002,11,-10,106,335888,11,335877
24003,9,17,216,1159796,9,1159787
24004,5,16,414,1134142,5,1134137
24005,19,2,10,710541,19,710522
24006,9,1,357,664988,9,664979
24007,14,-20,357,25579,14,25565
24008,10,-20,196,4611,10,4601
24009,6,-3,522,542161,6,542155
24010,5,3,548,730351,5,730346
24011,17,-5,809,496888,17,496871
24012,18,1,573,684429,18,684411
24013,7,-18,366,70288,7,70281
24014,17,1,713,685337,17,685320
24015,14,2,437,713893,14,713879
24016,12,15,540,1120701,12,1120689
24017,8,7,769,861047,8,861039
24018,12,9,538,932981,12,932969
24019,16,-14,522,213560,16,213544
24020,7,-2,253,568185,7,568178
24021,18,-11,158,304984,18,304966
24022,13,12,998,1029808,13,1029795
24023,13,10,350,962439,13,962426
24024,11,14,891,1092436,11,1092425
24025,20,11,364,993521,20,993501
24026,10,1,115,659591,10,659581
24027,7,2,286,694807,7,694800
24028,9,-11,519,292702,9,292693
24029,13,6,264,837760,13,837747
24030,9,0,42,626176,9,626167
24031,19,2,398,713633,19,713614
24032,10,-7,598,418635,10,418625
24033,14,-16,471,150523,14,150509
24034,11,10,826,966242,11,966231
24035,12,16,489,1150590,12,1150578
24036,12,-7,287,430470,12,430458
24037,10,2,237,693653,10,693643
24038,17,-12,899,279262,17,279245
24039,5,3,925,738899,5,738894
24040,12,-17,300,117765,12,117753
24041,19,2,322,713030,19,713011
24042,7,1,518,668636,7,668629
24043,6,7,597,857477,6,857471
24044,19,12,590,1026398,19,1026379
24045,7,-11,683,296137,7,296130
24046,16,-17,632,120235,16,120219
24047,7,18,236,1191954,7,1191947
24048,20,-6,320,461656,20,461636
24049,7,-18,494,73073,7,73066
24050,6,-5,549,479825,6,479819
24051,7,18,570,1198879,7,1198872
24052,18,11,186,992136,18,992118
24053,12,-9,948,374063,12,374051
24054,10,12,69,1000601,10,1000591
24055,19,-4,153,523239,19,523220
24056,11,1,360,682734,11,682723
24057,13,18,268,1211125,13,1211112
24058,7,11,562,980494,7,980487
24059,16,-4,768,527790,16,527774
24060,9,17,537,1166761,9,1166752
24061,12,4,51,773611,12,773599
24062,8,-2,300,569254,8,569246
24063,17,-15,803,183750,17,183733
24064,7,-5,137,471024,7,471017
24065,8,-8,459,384757,8,384749
24066,15,-16,939,153832,15,153817
24067,13,-2,246,586984,13,586971
24068,6,-17,895,112448,6,112442
24069,16,1,312,682313,16,682297
24070,7,16,706,1139817,7,1139810
24071,10,19,725,1233602,10,1233592
24072,13,14,665,1090641,13,1090628
24073,6,-2,596,575403,6,575397
24074,9,-16,277,130045,9,130036
24075,12,17,95,1178524,12,1178512
24076,6,5,721,796652,6,796646
24077,19,-13,113,241878,19,241859
24078,15,11,849,997019,15,997004
24079,5,-11,204,285537,5,285532
24080,8,-9,232,348591,8,348583
24081,13,-5,396,493945,13,493932
24082,19,11,974,997866,19,997847
24083,9,-2,668,577030,9,577021
24084,13,13,650,1058142,13,1058129
24085,15,-16,149,148045,15,148030
24086,8,-13,292,224647,8,224639
24087,7,15,852,1112596,7,1112589
24088,11,17,616,1182432,11,1182421
24089,13,-20,107,23569,13,23556
24090,5,13,419,1039809,5,1039804
24091,12,19,787,1247174,12,1247162
24092,9,12,607,1012219,9,1012210
24093,13,6,729,841699,13,841686
24094,15,18,938,1215821,15,1215806
24095,6,-15,755,171580,6,171574
24096,17,-18,686,90223,17,90206
24097,17,18,692,1213971,17,1213954
24098,6,-15,995,176620,6,176614
24099,10,-10,550,324521,10,324511
24100,6,13,339,1038078,6,1038072
24101,13,-8,651,402439,13,402426
24102,8,-13,563,230306,8,230298
24103,19,6,550,840195,19,840176
24104,18,6,356,838533,18,838515
24105,5,-2,710,577969,5,577964
24106,19,9,553,933097,19,933078
24107,7,-2,865,581302,7,581295
24108,20,-20,9,5456,20,5436
24109,12,-16,144,147995,12,147983
24110,8,19,417,1227125,8,1227117
24111,13,8,342,900672,13,900659
24112,8,1,189,661301,8,661293
24113,6,5,94,783569,6,783563
24114,20,-10,168,336356,20,336336
24115,12,-3,963,561491,12,561479
24116,17,18,98,1209701,17,1209684
24117,13,18,598,1213215,13,1213202
24118,13,3,309,744273,13,744260
24119,15,16,757,1152469,15,1152454
24120,13,-10,469,338579,13,338566
24121,6,4,914,770703,6,770697
24122,5,-12,669,264057,5,264052
24123,10,-9,410,352532,10,352522
24124,5,-5,558,480084,5,480079
24125,9,-9,700,359014,9,359005
24126,12,18,129,1209962,12,1209950
24127,20,-13,443,244251,20,244231
24128,17,-7,517,432241,17,432224
24129,19,1,774,685907,19,685888
24130,5,-10,46,313649,5,313644
24131,12,0,340,650625,12,650613
24132,17,7,972,873882,17,873865
24133,9,-11,312,288069,9,288060
24134,20,-3,620,558732,20,558712
24135,14,-3,809,560297,14,560283
24136,12,5,660,808597,12,808585
24137,9,-10,310,319274,9,319265
24138,5,5,577,793558,5,793553
24139,10,-8,595,387924,10,387914
24140,8,-16,994,145498,8,145490
24141,8,1,93,659081,8,659073
24142,6,10,276,943376,6,943370
24143,6,11,295,974689,6,974683
24144,13,-15,856,184266,13,184253
24145,7,-18,492,73024,7,73017
24146,14,-12,861,278953,14,278939
24147,9,-9,765,360600,9,360591
24148,19,1,115,680716,19,680697
24149,14,17,784,1183727,14,1183713
24150,20,8,305,900378,20,900358
24151,20,13,904,1059943,20,1059923
24152,18,8,892,904872,18,904854
24153,6,6,106,814514,6,814508
24154,17,-18,124,86157,17,86140
24155,8,-2,810,580078,8,580070
24156,14,0,652,653246,14,653232
24157,14,18,855,1215211,14,1215197
24158,14,-14,167,210561,14,210547
24159,9,-14,85,188404,9,188395
24160,10,-2,753,578754,10,578744
24161,10,-12,616,262782,10,262772
24162,8,-9,29,344231,8,344223
24163,20,14,882,1092349,20,1092329
24164,13,0,461,651625,13,651612
24165,8,-18,764,78987,8,78979
24166,19,2,835,716733,19,716714
24167,18,4,357,775803,18,775785
24168,7,12,614,1012331,7,1012324
24169,15,1,551,684243,15,684228
24170,20,18,780,1214630,20,1214610
24171,20,-2,908,592079,20,592059
24172,10,1,893,676430,10,676420
24173,9,-5,811,485491,9,485482
24174,6,-7,471,415912,6,415906
24175,16,-5,504,494745,16,494729
24176,18,6,296,838049,18,838031
24177,14,-16,854,153168,14,153154
24178,11,19,341,1243498,11,1243487
24179,12,13,869,1059735,12,1059723
24180,19,-19,995,61393,19,61374
24181,8,-16,210,128586,8,128578
24182,16,-13,765,246699,16,246683
24183,9,-11,613,294760,9,294751
24184,10,-19,244,36951,10,36941
24185,18,-20,447,26198,18,26180
24186,6,4,185,754561,6,754555
24187,16,-19,642,59064,16,59048
24188,11,-5,891,497566,11,497555
24189,13,-11,872,310542,13,310529
24190,5,-8,484,385356,5,385351
24191,7,16,674,1139306,7,1139299
24192,15,17,119,1178732,15,1178717
24193,7,10,772,954106,7,954099
24194,20,15,236,1118550,20,1118530
24195,20,-5,433,494195,20,494175
24196,7,-1,195,597877,7,597870
24197,6,11,852,986737,6,986731
24198,11,13,296,1055397,11,1055386
24199,10,14,721,1078262,10,1078252
24200,11,-15,712,183064,11,183053
24201,14,7,496,870703,14,870689
24202,7,14,255,1067492,7,1067485
24203,18,-13,980,248431,18,248413
24204,17,-5,324,493527,17,493510
24205,19,-10,620,339701,19,339682
24206,13,18,112,1209873,13,1209860
24207,11,-6,495,462985,11,462974
24208,19,1,252,681890,19,681871
24209,12,-6,482,462866,12,462854
24210,11,-14,646,214579,11,214568
24211,5,-20,205,4796,5,4791
24212,5,-12,331,256846,5,256841
24213,5,18,450,1196392,5,1196387
24214,8,6,562,824961,8,824953
24215,11,-8,737,403092,11,403081
24216,8,-18,611,75509,8,75501
24217,14,10,295,962033,14,962019
24218,13,3,863,748353,13,748340
24219,19,1,252,681899,19,681880
24220,11,-1,833,622944,11,622933
24221,5,-7,166,409268,5,409263
24222,19,9,606,933544,19,933525
24223,10,13,63,1032094,10,1032084
24224,18,6,754,841828,18,841810
24225,13,-16,987,154184,13,154171
24226,11,-13,397,243937,11,243926
24227,6,13,509,1041695,6,1041689
24228,8,-17,963,113761,8,113753
24229,15,-3,837,560481,15,560466
24230,5,-1,30,594336,5,594331
24231,13,-10,342,337540,13,337527
24232,6,-2,560,574669,6,574663
24233,19,-15,376,180559,19,180540
24234,18,8,751,903860,18,903842
24235,18,1,521,683979,18,683961
24236,14,14,270,1087513,14,1087499
24237,14,-12,663,277418,14,277404
24238,14,-7,673,433159,14,433145
24239,8,13,360,1038495,8,1038487
24240,19,-20,139,23814,19,23795
24241,10,-10,16,312917,10,312907
24242,7,-19,557,43612,7,43605
24243,10,17,311,1162016,10,1162006
24244,10,0,334,632400,10,632390
24245,14,-19,175,55429,14,55415
24246,20,18,884,1215407,20,1215387
24247,10,8,71,876550,10,876540
24248,8,13,573,1043118,8,1043110
24249,16,-3,433,557049,16,557033
24250,6,-8,688,390202,6,390196
24251,15,7,313,869296,15,869281
24252,7,5,163,784944,7,784937
24253,6,2,279,694596,6,694590
24254,12,-7,635,432955,12,432943
24255,5,-16,820,141599,5,141594
24256,13,19,565,1245388,13,1245375
24257,5,-13,408,226785,5,226780
24258,19,-1,962,623857,19,623838
24259,20,-15,801,183705,20,183685
24260,18,-15,129,178759,18,178741
24261,19,-15,111,178605,19,178586
24262,13,-12,169,273744,13,273731
24263,19,-4,521,526047,19,526028
24264,12,16,608,1151393,12,1151381
24265,18,-11,809,310037,18,310019
24266,12,11,493,994446,12,994434
24267,16,6,651,841006,16,840990
24268,7,15,734,1110111,7,1110104
24269,10,18,998,1207871,10,1207861
24270,19,17,104,1178583,19,1178564
24271,11,11,240,992540,11,992529
24272,13,-20,64,23272,13,23259
24273,6,-9,445,353493,6,353487
24274,8,15,407,1102981,8,1102973
24275,15,15,597,1121114,15,1121099
24276,16,17,281,1180040,16,1180024
24277,10,-11,249,286507,10,286497
24278,11,-17,196,116899,11,116888
24279,16,10,779,965871,16,965855
24280,19,-17,533,119459,19,119440
24281,14,-6,146,460240,14,460226
24282,16,-11,345,306492,16,306476
24283,6,1,371,665379,6,665373
24284,6,-18,698,77332,6,77326
24285,19,9,948,936148,19,936129
24286,20,-10,392,337872,20,337852
24287,8,4,318,757358,8,757350
24288,15,4,465,776599,15,776584
24289,6,13,27,1031352,6,1031346
24290,15,11,205,992289,15,992274
24291,19,18,720,1214091,19,1214072
24292,11,18,43,1209209,11,1209198
24293,5,-13,706,233354,5,233349
24294,14,-15,552,181857,14,181843
24295,7,-6,563,448943,7,448936
24296,9,11,233,973090,9,973081
24297,16,-2,34,585378,16,585362
24298,14,14,312,1087866,14,1087852
24299,17,-6,313,461604,17,461587
24300,8,-1,621,607348,8,607340
24301,15,3,58,742278,15,742263
24302,19,8,564,902383,19,902364
24303,12,-6,85,459683,12,459671
24304,11,9,505,932752,11,932741
24305,5,-19,166,35318,5,35313
24306,18,18,357,1211675,18,1211657
24307,9,-11,623,294962,9,294953
24308,14,-3,150,554837,14,554823
24309,19,-10,645,339894,19,339875
24310,5,-10,624,326098,5,326093
24311,19,-19,617,58851,19,58832
24312,15,-6,683,464315,15,464300
24313,16,-5,607,495493,16,495477
24314,15,16,508,1150707,15,1150692
24315,5,14,563,1074355,5,1074350
24316,20,-1,775,622534,20,622514
24317,9,7,360,852593,9,852584
24318,18,-2,241,586967,18,586949
24319,18,-14,865,216271,18,216253
24320,18,16,247,1148854,18,1148836
24321,15,9,857,935432,15,935417
24322,14,-17,684,120645,14,120631
24323,5,8,114,877496,5,877491
24324,10,-14,341,194129,10,194119
24325,5,-11,148,284395,5,284390
24326,15,-7,668,433103,15,433088
24327,17,-6,952,466347,17,466330
24328,11,-17,593,119962,11,119951
24329,5,15,285,1100635,5,1100630
24330,9,-16,151,127315,9,127306
24331,12,7,2,867022,12,867010
24332,7,-7,880,424609,7,424602
24333,19,-5,163,492227,19,492208
24334,17,1,211,681564,17,681547
24335,8,-5,234,473152,8,473144
24336,8,1,14,657306,8,657298
24337,8,16,590,1137560,8,1137552
24338,10,-16,489,134738,10,134728
24339,15,11,734,996104,15,996089
24340,19,1,149,681025,19,681006
24341,11,9,927,935986,11,935975
24342,6,-4,357,507375,6,507369
24343,20,-2,131,586107,20,586087
24344,17,15,897,1123333,17,1123316
24345,11,16,304,1149326,11,1149315
24346,9,0,613,638649,9,638640
24347,17,-9,857,373354,17,373337
24348,13,11,56,991297,13,991284
24349,15,1,698,685267,15,685252
24350,15,6,3,835748,15,835733
24351,17,15,479,1120161,17,1120144
24352,17,16,714,1152197,17,1152180
24353,5,-13,748,234360,5,234355
24354,18,0,219,649894,18,649876
24355,18,-13,573,245274,18,245256
24356,10,19,375,1226004,10,1225994
24357,15,5,363,806435,15,806420
24358,15,3,638,746655,15,746640
24359,10,19,429,1227481,10,1227471
24360,17,-14,701,215009,17,214992
24361,19,11,890,997336,19,997317
24362,10,-18,989,83976,10,83966
24363,17,-14,281,211636,17,211619
24364,10,14,499,1073010,10,1073000
24365,19,-3,484,557516,19,557497
24366,14,-2,923,592149,14,592135
24367,6,12,297,1005757,6,1005751
24368,8,-20,774,17032,8,17024
24369,7,13,395,1039211,7,1039204
24370,16,10,359,962531,16,962515
24371,8,11,146,971524,8,971516
24372,18,8,119,898876,18,898858
24373,11,-10,762,340826,11,340815
24374,5,5,313,788077,5,788072
24375,10,-17,819,110828,10,110818
24376,16,-14,587,214146,16,214130
24377,5,19,635,1231623,5,1231618
24378,6,12,178,1003021,6,1003015
24379,17,-6,58,459522,17,459505
24380,5,-9,272,349523,5,349518
24381,9,5,446,790891,9,790882
24382,7,10,178,941354,7,941347
24383,5,8,837,893379,5,893374
24384,12,5,827,809801,12,809789
24385,20,-10,930,342062,20,342042
24386,16,4,201,774695,16,774679
24387,14,7,376,869766,14,869752
24388,12,-17,357,118117,12,118105
24389,5,16,727,1140204,5,1140199
24390,8,-9,649,357923,8,357915
24391,20,0,525,652160,20,652140
24392,7,11,113,970856,7,970849
24393,12,-10,73,335747,12,335735
24394,16,-16,558,151092,16,151076
24395,10,-2,385,570864,10,570854
24396,7,-7,616,418925,7,418918
24397,13,-6,50,459487,13,459474
24398,7,8,783,892441,7,892434
24399,17,0,86,648863,17,648846
24400,13,-1,757,622359,13,622346
24401,20,-15,28,178021,20,178001
24402,11,1,980,687459,11,687448
24403,20,-18,778,90909,20,90889
24404,17,-9,727,372107,17,372090
24405,9,3,393,727293,9,727284
24406,13,-8,416,400807,13,400794
24407,18,8,694,903459,18,903441
24408,15,-1,186,617921,15,617906
24409,16,-17,161,116658,16,116642
24410,12,-11,200,305304,12,305292
24411,19,5,248,805662,19,805643
24412,10,-3,876,550013,10,550003
24413,5,15,910,1113789,5,1113784
24414,16,16,874,1153309,16,1153293
24415,5,-10,523,323893,5,323888
24416,13,15,769,1122470,13,1122457
24417,7,-8,543,386801,7,386794
24418,5,2,158,691987,5,691982
24419,13,5,554,807813,13,807800
24420,20,16,995,1154256,20,1154236
24421,12,3,530,745712,12,745700
24422,5,-17,666,107816,5,107811
24423,12,-16,863,153288,12,153276
24424,17,-4,93,522754,17,522737
24425,14,18,662,1213757,14,1213743
24426,7,-19,394,40068,7,40061
24427,9,-18,475,72632,9,72623
24428,8,-17,752,109609,8,109601
24429,9,18,60,1188020,9,1188011
24430,12,-4,252,524077,12,524065
24431,14,-16,683,151910,14,151896
24432,14,0,259,650110,14,650096
24433,12,-7,896,434947,12,434935
24434,10,-14,695,201907,10,201897
24435,15,-18,259,87311,15,87296
24436,16,-6,908,466013,16,465997
24437,10,-3,328,537567,10,537557
24438,19,-15,153,178934,19,178915
24439,6,12,427,1008235,6,1008229
24440,11,-19,906,60843,11,60832
24441,13,-7,172,429601,13,429588
24442,14,12,391,1024913,14,1024899
24443,16,7,81,867626,16,867610
24444,7,13,313,1037390,7,1037383
24445,18,-17,166,116704,18,116686
24446,17,-11,232,305510,17,305493
24447,15,13,331,1055662,15,1055647
24448,13,-2,768,590871,13,590858
24449,11,-5,605,495489,11,495478
24450,9,17,236,1160222,9,1160213
24451,5,16,923,1144410,5,1144405
24452,16,-12,832,278640,16,278624
24453,7,0,35,626068,7,626061
24454,15,19,223,1242505,15,1242490
24455,9,-18,852,80791,9,80782
24456,6,-14,851,205043,6,205037
24457,6,8,357,882979,6,882973
24458,16,-2,813,591245,16,591229
24459,10,-8,735,391106,10,391096
24460,11,-2,476,588740,11,588729
24461,19,19,71,1241342,19,1241323
24462,18,-10,39,335455,18,335437
24463,13,15,294,1118955,13,1118942
24464,9,6,335,819904,9,819895
24465,14,15,584,1121005,14,1120991
24466,13,15,956,1123807,13,1123794
24467,8,-8,826,393014,8,393006
24468,8,-3,997,552738,8,552730
24469,10,10,435,946833,10,946823
24470,19,1,119,680742,19,680723
24471,20,12,211,1023620,20,1023600
24472,10,12,805,1016558,10,1016548
24473,19,-11,569,308251,19,308232
24474,15,-4,241,523999,15,523984
24475,9,2,475,698782,9,698773
24476,9,7,753,860653,9,860644
24477,13,5,371,806516,13,806503
24478,18,6,448,839343,18,839325
24479,7,-2,536,574085,7,574078
24480,15,-17,918,122304,15,122289
24481,5,3,356,726559,5,726554
24482,5,13,470,1040829,5,1040824
24483,20,14,481,1089203,20,1089183
24484,10,16,8,1125376,10,1125366
24485,16,14,881,1092324,16,1092308
24486,18,19,484,1244756,18,1244738
24487,11,17,518,1181773,11,1181762
24488,9,-8,552,387008,9,386999
24489,5,-12,463,259591,5,259586
24490,18,9,559,933168,18,933150
24491,18,0,574,652612,18,652594
24492,10,11,807,985753,10,985743
24493,16,-7,166,429527,16,429511
24494,19,-20,885,29605,19,29586
24495,16,18,925,1215711,16,1215695
24496,16,0,629,652995,16,652979
24497,8,-9,932,364480,8,364472
24498,15,-17,768,121343,15,121328
24499,6,-18,834,80439,6,80433
24500,11,6,317,838215,11,838204
24501,10,6,322,819510,10,819500
24502,18,-3,421,556931,18,556913
24503,20,-4,375,525027,20,525007
24504,8,17,224,1159937,8,1159929
24505,19,-13,678,245927,19,245908
24506,6,-11,347,288769,6,288763
24507,15,-4,799,527991,15,527976
24508,10,0,197,629841,10,629831
24509,9,13,837,1048751,9,1048742
24510,8,12,315,1006094,8,1006086
24511,12,14,785,1091635,12,1091623
24512,17,0,412,651224,17,651207
24513,20,-12,948,279657,20,279637
24514,19,18,190,1210560,19,1210541
24515,11,6,617,840724,11,840713
24516,15,6,67,836262,15,836247
24517,5,-17,829,111060,5,111055
24518,18,8,376,900901,18,900883
24519,10,16,247,1130450,10,1130440
24520,20,-20,648,27726,20,27706
24521,11,-10,460,338440,11,338429
24522,9,1,996,678596,9,678587
24523,12,-10,302,337238,12,337226
24524,19,3,488,745478,19,745459
24525,6,-15,263,161004,6,160998
24526,7,15,640,1108002,7,1107995
24527,5,-10,837,330569,5,330564
24528,15,-2,913,592093,15,592078
24529,11,0,299,650326,11,650315
24530,9,15,906,1113706,9,1113697
24531,13,11,78,991429,13,991416
24532,19,-11,428,307200,19,307181
24533,9,-12,696,264552,9,264543
24534,14,11,468,994270,14,994256
24535,7,-17,447,102977,7,102970
24536,16,-18,202,86865,16,86849
24537,6,9,598,919472,6,919466
24538,15,10,315,962190,15,962175
24539,20,-14,837,216018,20,215998
24540,9,-1,269,599749,9,599740
24541,9,18,761,1202767,9,1202758
24542,13,14,114,1086371,13,1086358
24543,5,19,556,1230053,5,1230048
24544,9,-11,49,282068,9,282059
24545,19,5,204,805381,19,805362
24546,16,-14,539,213633,16,213617
24547,19,-20,985,30335,19,30316
24548,17,10,820,966214,17,966197
24549,10,9,299,912969,10,912959
24550,5,6,470,823055,5,823050
24551,5,-1,526,605487,5,605482
24552,8,8,995,896807,8,896799
24553,7,17,481,1165635,7,1165628
24554,11,-9,290,368710,11,368699
24555,6,-8,549,386967,6,386961
24556,20,-6,460,462677,20,462657
24557,15,12,651,1026895,15,1026880
24558,8,-19,280,37652,8,37644
24559,8,-4,391,508124,8,508116
24560,6,6,184,816178,6,816172
24561,8,-20,973,21445,8,21437
24562,19,-12,997,280084,19,280065
24563,12,16,676,1151954,12,1151942
24564,12,16,647,1151768,12,1151756
24565,7,-1,468,604310,7,604303
24566,12,4,835,779464,12,779452
24567,13,-13,156,242162,13,242149
24568,15,-16,821,152930,15,152915
24569,5,-19,75,33079,5,33074
24570,19,-1,586,621146,19,621127
24571,16,-7,24,428487,16,428471
24572,6,7,724,860047,6,860041
24573,10,-17,661,107726,10,107716
24574,17,-6,719,464640,17,464623
24575,13,-15,716,183118,13,183105
24576,7,-12,486,260053,7,260046
24577,11,-13,468,244431,11,244420
24578,7,-15,630,168966,7,168959
24579,12,17,593,1182232,12,1182220
24580,6,-18,494,73079,6,73073
24581,6,-16,958,144634,6,144628
24582,18,-14,63,209787,18,209769
24583,10,14,133,1064838,10,1064828
24584,5,-6,239,442083,5,442078
24585,10,-10,667,327164,10,327154
24586,17,-11,575,308288,17,308271
24587,17,3,773,747663,17,747646
24588,20,11,919,997585,20,997565
24589,17,-14,290,211669,17,211652
24590,9,-18,530,73815,9,73806
24591,14,-8,754,403238,14,403224
24592,12,-9,333,369077,12,369065
24593,8,11,522,979596,8,979588
24594,14,-16,13,146838,14,146824
24595,10,12,345,1006677,10,1006667
24596,19,-4,235,523964,19,523945
24597,6,-16,860,142499,6,142493
24598,12,-19,549,58269,12,58257
24599,9,-13,747,234331,9,234322
24600,12,-15,953,185053,12,185041
24601,16,-10,810,341212,16,341196
24602,15,-18,785,90958,15,90943
24603,10,-20,736,16147,10,16137
24604,10,4,369,758541,10,758531
24605,18,-20,689,28133,18,28115
24606,20,3,562,745959,20,745939
24607,9,-5,425,477175,9,477166
24608,15,12,627,1026699,15,1026684
24609,15,-15,897,184553,15,184538
24610,18,17,294,1180179,18,1180161
24611,18,-19,929,61003,18,60985
24612,9,13,625,1044239,9,1044230
24613,17,8,214,899649,17,899632
24614,18,2,400,713666,18,713648
24615,6,-17,186,97312,6,97306
24616,8,-3,801,548306,8,548298
24617,15,2,218,712227,15,712212
24618,14,-12,961,279758,14,279744
24619,19,-1,430,619985,19,619966
24620,20,-12,645,277248,20,277228
24621,11,-12,526,276440,11,276429
24622,18,-16,879,153453,18,153435
24623,9,-10,305,319135,9,319126
24624,14,-12,475,276005,14,275991
24625,9,16,304,1131602,9,1131593
24626,11,-15,652,182662,11,182651
24627,13,-6,492,462963,13,462950
24628,9,-15,20,155783,9,155774
24629,7,-8,29,375960,7,375953
24630,6,17,824,1173023,6,1173017
24631,11,15,396,1119649,11,1119638
24632,16,-4,902,528852,16,528836
24633,16,19,453,1244550,16,1244534
24634,8,6,948,833564,8,833556
24635,9,5,852,799389,9,799380
24636,19,8,341,900670,19,900651
24637,20,-19,675,59240,20,59220
24638,17,-7,435,431586,17,431569
24639,13,-17,185,116809,13,116796
24640,6,13,932,1050677,6,1050671
24641,19,-13,297,243308,19,243289
24642,19,-10,372,337742,19,337723
24643,11,-6,562,463490,11,463479
24644,20,11,898,997397,20,997377
24645,20,11,169,992044,20,992024
24646,16,10,864,966454,16,966438
24647,14,-19,691,59382,14,59368
24648,7,15,847,1112469,7,1112462
24649,16,-16,851,153154,16,153138
24650,18,-18,516,89050,18,89032
24651,18,9,994,936490,18,936472
24652,5,-8,197,379683,5,379678
24653,11,-7,390,431291,11,431280
24654,9,2,535,699988,9,699979
24655,13,10,533,963931,13,963918
24656,15,8,697,903508,15,903493
24657,18,-13,18,241178,18,241160
24658,13,6,987,843633,13,843620
24659,18,5,139,804804,18,804786
24660,16,8,301,900340,16,900324
24661,8,19,311,1224533,8,1224525
24662,10,17,202,1159542,10,1159532
24663,6,-7,156,409085,6,409079
24664,12,7,173,868239,12,868227
24665,7,9,91,908627,7,908620
24666,10,0,536,636918,10,636908
24667,12,-4,48,522393,12,522381
24668,20,18,59,1209389,20,1209369
24669,20,4,943,780201,20,780181
24670,16,-5,607,495499,16,495483
24671,7,-4,478,509726,7,509719
24672,12,-7,389,431290,12,431278
24673,14,11,127,991725,14,991711
24674,14,1,381,682902,14,682888
24675,10,-6,499,447560,10,447550
24676,18,4,314,775437,18,775419
24677,9,14,128,1064748,9,1064739
24678,17,6,484,839658,17,839641
24679,14,6,256,837702,14,837688
24680,11,4,235,774987,11,774976
24681,7,13,156,1033966,7,1033959
24682,7,19,799,1235162,7,1235155
24683,13,7,774,872596,13,872583
24684,11,6,738,841742,11,841731
24685,13,-1,445,620085,13,620072
24686,18,16,371,1149812,18,1149794
24687,18,-11,652,308923,18,308905
24688,12,-12,548,276581,12,276569
24689,17,10,639,964860,17,964843
24690,20,-12,766,278169,20,278149
24691,7,-19,111,33948,7,33941
24692,9,-18,442,71885,9,71876
24693,16,14,713,1091088,16,1091072
24694,11,-7,345,430948,11,430937
24695,14,19,395,1243992,14,1243978
24696,9,6,342,820059,9,820050
24697,15,-5,649,495759,15,495744
24698,17,2,719,716027,17,716010
24699,10,10,424,946588,10,946578
24700,16,8,209,899646,16,899630
24701,5,-9,455,353704,5,353699
24702,7,7,809,861956,7,861949
24703,5,-7,17,406420,5,406415
24704,15,13,614,1057928,15,1057913
24705,18,17,220,1179491,18,1179473
24706,6,14,498,1072939,6,1072933
24707,13,6,292,837986,13,837973
24708,17,5,477,807310,17,807293
24709,7,-20,196,4618,7,4611
24710,12,-12,216,274076,12,274064
24711,17,5,14,803879,17,803862
24712,6,8,561,887480,6,887474
24713,11,-16,930,153786,11,153775
24714,11,-11,845,310293,11,310282
24715,18,-7,611,432814,18,432796
24716,5,10,811,955078,5,955073
24717,14,2,589,715001,14,714987
24718,10,6,131,814991,10,814981
24719,17,-19,126,55016,17,54999
24720,14,2,206,712150,14,712136
24721,16,-8,595,402022,16,402006
24722,19,11,584,995059,19,995040
24723,12,-11,669,309056,12,309044
24724,7,13,455,1040549,7,1040542
24725,13,6,317,838218,13,838205
24726,5,11,849,986677,5,986672
24727,19,-14,758,215405,19,215386
24728,9,19,696,1232953,9,1232944
24729,8,-14,806,204209,8,204201
24730,16,15,570,1120921,16,1120905
24731,14,-17,38,115835,14,115821
24732,10,-2,24,563285,10,563275
24733,14,-10,309,337300,14,337286
24734,9,6,699,828169,9,828160
24735,9,-3,793,548164,9,548155
24736,5,11,867,987071,5,987066
24737,8,-12,832,267599,8,267591
24738,7,5,70,783121,7,783114
24739,20,6,276,837892,20,837872
24740,6,7,497,855455,6,855449
24741,11,-2,350,587710,11,587699
24742,10,-4,620,512767,10,512757
24743,5,13,900,1050036,5,1050031
24744,8,14,291,1068266,8,1068258
24745,5,4,710,765932,5,765927
24746,13,-13,995,248534,13,248521
24747,19,-6,337,461780,19,461761
24748,15,-8,660,402561,15,402546
24749,20,7,686,872029,20,872009
24750,9,16,735,1140341,9,1140332
24751,15,16,817,1152956,15,1152941
24752,11,3,842,748152,11,748141
24753,10,-17,479,103663,10,103653
24754,9,16,520,1136292,9,1136283
24755,13,-6,935,466207,13,466194
24756,18,8,42,898181,18,898163
24757,17,-13,128,241932,17,241915
24758,17,-20,126,23702,17,23685
24759,19,-6,82,459658,19,459639
24760,14,1,710,685312,14,685298
24761,12,-17,720,120936,12,120924
24762,10,2,385,696947,10,696937
24763,10,16,687,1139512,10,1139502
24764,18,-9,889,373632,18,373614
24765,13,-6,756,464916,13,464903
24766,13,-16,921,153697,13,153684
24767,9,14,11,1061974,9,1061965
24768,9,-12,962,270552,9,270543
24769,12,2,601,715083,12,715071
24770,11,-6,623,463919,11,463908
24771,17,4,339,775652,17,775635
24772,6,19,529,1229552,6,1229546
24773,10,13,589,1043458,10,1043448
24774,13,-2,555,589333,13,589320
24775,13,4,934,780136,13,780123
24776,10,4,556,762549,10,762539
24777,20,-19,986,61380,20,61360
24778,9,-13,781,235369,9,235360
24779,15,18,885,1215426,15,1215411
24780,12,19,403,1244090,12,1244078
24781,15,-18,180,86694,15,86679
24782,9,19,342,1225194,9,1225185
24783,17,-8,330,400216,17,400199
24784,13,2,251,712463,13,712450
24785,17,2,806,716500,17,716483
24786,19,9,69,929568,19,929549
24787,20,2,285,712699,20,712679
24788,8,4,588,763276,8,763268
24789,12,16,756,1152450,12,1152438
24790,15,7,398,869974,15,869959
24791,18,-9,994,374213,18,374195
24792,7,-14,234,191857,7,191850
24793,13,19,460,1244590,13,1244577
24794,6,-14,365,194649,6,194643
24795,20,-1,202,618077,20,618057
24796,5,15,194,1098627,5,1098622
24797,5,-17,354,101072,5,101067
24798,18,8,95,898685,18,898667
24799,12,11,596,995160,12,995148
24800,10,-19,607,44840,10,44830
24801,8,-2,644,576452,8,576444
24802,15,16,27,1147285,15,1147270
24803,6,2,502,699291,6,699285
24804,6,18,798,1203651,6,1203645
24805,5,9,568,918721,5,918716
24806,14,-18,631,89812,14,89798
24807,10,18,428,1195865,10,1195855
24808,16,15,501,1120331,16,1120315
24809,11,14,532,1089606,11,1089595
24810,17,12,42,1022416,17,1022399
24811,18,6,249,837641,18,837623
24812,6,4,52,751645,6,751639
24813,10,17,343,1162770,10,1162760
24814,13,-15,970,185142,13,185129
24815,12,-8,168,399083,12,399071
24816,17,3,51,742207,17,742190
24817,8,-3,808,548442,8,548434
24818,16,11,390,993747,16,993731
24819,14,-2,49,585521,14,585507
24820,12,14,645,1090467,12,1090455
24821,10,-11,202,285509,10,285499
24822,15,10,670,965084,15,965069
24823,14,5,206,805383,14,805369
24824,11,2,596,715043,11,715032
24825,10,13,129,1033461,10,1033451
24826,13,-14,641,214564,13,214551
24827,11,-12,728,277819,11,277808
24828,11,-2,102,585895,11,585884
24829,14,5,803,809617,14,809603
24830,5,6,663,827251,5,827246
24831,9,0,726,641326,9,641317
24832,8,18,410,1195471,8,1195463
24833,15,-17,106,116357,15,116342
24834,19,-8,502,401335,19,401316
24835,6,-12,475,259883,6,259877
24836,15,16,511,1150728,15,1150713
24837,17,-11,288,305993,17,305976
24838,13,12,123,1022941,13,1022928
24839,7,18,967,1207240,7,1207233
24840,12,18,815,1214849,12,1214837
24841,11,-9,658,371686,11,371675
24842,6,3,264,724586,6,724580
24843,8,5,440,790664,8,790656
24844,15,10,227,961548,15,961533
24845,16,7,380,869806,16,869790
24846,10,-8,12,375585,10,375575
24847,11,3,335,744425,11,744414
24848,20,-6,243,461080,20,461060
24849,8,-13,946,238832,8,238824
24850,8,9,863,925086,8,925078
24851,9,10,846,955686,9,955677
24852,15,-3,929,561220,15,561205
24853,16,-1,522,620741,16,620725
24854,17,4,741,778710,17,778693
24855,18,3,604,746345,18,746327
24856,18,-6,186,460604,18,460586
24857,15,3,479,745405,15,745390
24858,8,19,628,1231525,8,1231517
24859,8,16,404,1133839,8,1133831
24860,13,-12,950,279689,13,279676
24861,5,-11,836,299016,5,299011
24862,6,-9,630,357547,6,357541
24863,9,-5,578,480515,9,480506
24864,17,3,189,743306,17,743289
24865,13,-5,442,494284,13,494271
24866,15,-8,82,398587,15,398572
24867,20,9,709,934311,20,934291
24868,7,-10,372,320611,7,320604
24869,12,12,247,1023870,12,1023858
24870,19,4,597,777617,19,777598
24871,19,-12,147,273630,19,273611
24872,11,-18,554,89298,11,89287
24873,6,-1,450,603827,6,603821
24874,7,17,525,1166570,7,1166563
24875,18,-5,40,491144,18,491126
24876,20,-20,394,25812,20,25792
24877,10,9,432,915726,10,915716
24878,8,18,34,1187305,8,1187297
24879,5,-11,829,298869,5,298864
24880,6,14,989,1083996,6,1083990
24881,11,-12,398,275416,11,275405
24882,5,-6,846,454856,5,454851
24883,14,8,147,899101,14,899087
24884,8,-4,342,506962,8,506954
24885,17,13,287,1055315,17,1055298
24886,11,2,235,712329,11,712318
24887,14,-7,855,434547,14,434533
24888,6,-5,27,468407,6,468401
24889,16,-5,744,496469,16,496453
24890,8,-14,609,200088,8,200080
24891,15,10,56,960272,15,960257
24892,6,-17,637,107220,6,107214
24893,10,-10,65,314031,10,314021
24894,12,-12,951,279700,12,279688
24895,17,-4,335,524690,17,524673
24896,10,8,53,876178,10,876168
24897,8,-5,549,479833,8,479825
24898,5,-12,17,249960,5,249955
24899,11,9,27,929246,11,929235
24900,6,1,42,657961,6,657955
24901,7,-10,89,314567,7,314560
24902,19,-8,210,399378,19,399359
24903,16,19,594,1245614,16,1245598
24904,12,-19,940,61075,12,61063
24905,15,-4,742,527623,15,527608
24906,12,19,857,1247735,12,1247723
24907,7,-13,290,224635,7,224628
24908,7,18,48,1187685,7,1187678
24909,5,2,897,707272,5,707267
24910,12,3,628,746560,12,746548
24911,15,-10,840,341398,15,341383
24912,17,-1,404,619780,17,619763
24913,7,12,953,1020110,7,1020103
24914,17,-20,669,27942,17,27925
24915,16,-14,604,214280,16,214264
24916,7,-1,922,613835,7,613828
24917,10,19,326,1224879,10,1224869
24918,5,-10,718,328042,5,328037
24919,15,2,28,710672,15,710657
24920,11,-10,211,336627,11,336616
24921,9,11,826,986090,9,986081
24922,8,-18,242,67804,8,67796
24923,10,2,710,703610,10,703600
24924,14,5,78,804359,14,804345
24925,5,-15,806,172635,5,172630
24926,20,8,194,899476,20,899456
24927,15,16,788,1152719,15,1152704
24928,7,-4,518,510690,7,510683
24929,5,16,700,1139706,5,1139701
24930,20,18,911,1215601,20,1215581
24931,5,3,866,737579,5,737574
24932,18,15,917,1123486,18,1123468
24933,5,19,945,1238455,5,1238450
24934,7,9,502,917303,7,917296
24935,8,-6,930,456634,8,456626
24936,20,6,17,835934,20,835914
24937,20,18,922,1215685,20,1215665
24938,8,-7,113,408198,8,408190
24939,16,15,574,1120949,16,1120933
24940,6,-12,596,262403,6,262397
24941,5,-2,937,582908,5,582903
24942,7,-5,161,471594,7,471587
24943,7,-10,448,322321,7,322314
24944,19,-16,5,146747,19,146728
24945,15,1,555,684275,15,684260
24946,8,-8,757,391569,8,391561
24947,15,17,859,1184461,15,1184446
24948,11,-17,693,120688,11,120677
24949,8,-13,475,228328,8,228320
24950,6,11,929,988553,6,988547
24951,20,3,299,744150,20,744130
24952,13,-9,111,367406,13,367393
24953,6,15,41,1095374,6,1095368
24954,10,-6,293,443208,10,443198
24955,15,1,150,681058,15,681043
24956,5,5,575,793502,5,793497
24957,9,17,632,1168834,9,1168825
24958,13,-5,314,493403,13,493390
24959,13,1,326,682496,13,682483
24960,16,8,565,902388,16,902372
24961,14,11,368,993555,14,993541
24962,7,3,531,729958,7,729951
24963,16,10,952,967151,16,967135
24964,8,-5,903,487672,8,487664
24965,20,-5,310,493367,20,493347
24966,7,18,585,1199121,7,1199114
24967,17,-14,221,211081,17,211064
24968,8,-4,594,512240,8,512232
24969,8,6,736,828952,8,828944
24970,5,8,444,884928,5,884923
24971,12,15,932,1123573,12,1123561
24972,17,4,20,773385,17,773368
24973,5,6,472,823081,5,823076
24974,18,17,139,1178906,18,1178888
24975,14,10,276,961905,14,961891
24976,18,11,573,994998,18,994980
24977,11,18,371,1211812,11,1211801
24978,11,-16,990,154232,11,154221
24979,9,0,956,646129,9,646120
24980,7,-15,189,159381,7,159374
24981,18,-17,778,121408,18,121390
24982,18,-7,87,428899,18,428881
24983,16,10,910,966818,16,966802
24984,7,9,729,922049,7,922042
24985,16,-10,597,339518,16,339502
24986,5,9,605,919582,5,919577
24987,10,1,386,665641,10,665631
24988,9,11,648,982270,9,982261
24989,15,-2,267,587138,15,587123
24990,5,-12,390,258030,5,258025
24991,11,3,20,741930,11,741919
24992,14,10,283,961951,14,961937
24993,13,-14,351,212134,13,212121
24994,18,1,384,682942,18,682924
24995,19,14,533,1089628,19,1089609
24996,12,11,867,997152,12,997140
24997,11,-9,894,373656,11,373645
24998,18,0,821,654490,18,654472
24999,13,17,413,1180994,13,1180981
25000,18,-5,263,492959,18,492941
25001,6,-19,280,37658,6,37652
25002,14,-12,862,278956,14,278942
25003,15,12,369,1024804,15,1024789
25004,12,2,659,715536,12,715524
25005,10,13,274,1036495,10,1036485
25006,15,8,848,904567,15,904552
25007,18,-16,86,147516,18,147498
25008,11,5,568,807905,11,807894
25009,13,-8,534,401610,13,401597
25010,13,12,676,1027151,13,1027138
25011,8,-7,479,416106,8,416098
25012,6,4,748,766883,6,766877
25013,12,19,216,1242459,12,1242447
25014,5,18,621,1199839,5,1199834
25015,6,-9,17,344029,6,344023
25016,20,-6,422,462387,20,462367
25017,9,-6,379,444953,9,444944
25018,17,-13,410,243986,17,243969
25019,17,1,339,682613,17,682596
25020,10,-2,125,565545,10,565535
25021,16,14,214,1087072,16,1087056
25022,6,-5,641,481893,6,481887
25023,16,5,217,805449,16,805433
25024,6,3,990,740529,6,740523
25025,17,18,145,1210157,17,1210140
25026,20,-4,858,528396,20,528376
25027,19,13,605,1057853,19,1057834
25028,15,-6,580,463591,15,463576
25029,5,9,659,920588,5,920583
25030,7,5,668,795420,7,795413
25031,10,-3,617,544273,10,544263
25032,7,16,34,1125892,7,1125885
25033,7,-16,87,125798,7,125791
25034,19,6,336,838398,19,838379
25035,20,7,29,867223,20,867203
25036,19,-16,233,148702,19,148683
25037,6,-3,917,550982,6,550976
25038,11,12,991,1029731,11,1029720
25039,9,-2,592,575346,9,575337
25040,17,3,313,744294,17,744277
25041,11,13,128,1054149,11,1054138
25042,5,-9,746,360114,5,360109
25043,5,3,917,738689,5,738684
25044,9,3,987,740464,9,740455
25045,8,-14,602,199869,8,199861
25046,8,-9,358,351489,8,351481
25047,16,7,175,868271,16,868255
25048,19,-16,653,151779,19,151760
25049,6,15,48,1095512,6,1095506
25050,20,-15,548,181833,20,181813
25051,7,-6,296,443262,7,443255
25052,11,10,721,965400,11,965389
25053,20,-5,800,496802,20,496782
25054,7,8,327,882438,7,882431
25055,9,13,283,1036732,9,1036723
25056,8,-18,825,80312,8,80304
25057,13,-13,941,248134,13,248121
25058,10,9,294,912804,10,912794
25059,20,-7,765,433856,20,433836
25060,12,1,828,686261,12,686249
25061,6,-11,484,291946,6,291940
25062,12,-12,616,276975,12,276963
25063,14,-11,722,309350,14,309336
25064,6,15,665,1108538,6,1108532
25065,15,13,62,1053675,15,1053660
25066,16,18,766,1214500,16,1214484
25067,20,-20,525,26773,20,26753
25068,13,-3,119,554663,13,554650
25069,18,-8,130,398794,18,398776
25070,5,12,738,1015189,5,1015184
25071,7,2,971,708954,7,708947
25072,16,-1,932,623692,16,623676
25073,19,12,133,1022996,19,1022977
25074,11,-11,828,310170,11,310159
25075,16,-1,426,619947,16,619931
25076,11,19,383,1243871,11,1243860
25077,6,-13,501,228897,6,228891
25078,5,-20,377,8293,5,8288
25079,18,3,846,748214,18,748196
25080,19,14,102,1086281,19,1086262
25081,18,4,307,775395,18,775377
25082,12,-1,866,623180,12,623168
25083,5,-18,313,69382,5,69377
25084,14,-17,455,118866,14,118852
25085,15,8,987,905615,15,905600
25086,10,16,431,1134494,10,1134484
25087,11,14,454,1089015,11,1089004
25088,15,-18,701,90309,15,90294
25089,15,-14,363,212243,15,212228
25090,20,-17,585,119945,20,119925
25091,5,-2,41,563707,5,563702
25092,20,-3,171,554975,20,554955
25093,10,-12,996,271342,10,271332
25094,20,10,334,962368,20,962348
25095,5,-6,575,449108,5,449103
25096,12,11,766,996378,12,996366
25097,11,12,51,1022428,11,1022417
25098,7,16,344,1132475,7,1132468
25099,13,2,806,716503,13,716490
25100,12,9,483,932595,12,932583
25101,10,-19,942,51750,10,51740
25102,11,3,365,744621,11,744610
25103,5,-10,504,323629,5,323624
25104,9,14,178,1065725,9,1065716
25105,15,-20,118,23656,15,23641
25106,5,-12,999,271416,5,271411
25107,18,-3,149,554831,18,554813
25108,8,10,593,950245,8,950237
25109,20,16,726,1152300,20,1152280
25110,12,-4,884,528712,12,528700
25111,18,-10,390,337851,18,337833
25112,17,18,408,1212051,17,1212034
25113,17,-6,264,461225,17,461208
25114,11,-13,56,241495,11,241484
25115,15,1,791,685991,15,685976
25116,15,-10,210,336619,15,336604
25117,11,-19,239,55908,11,55897
25118,16,19,151,1241980,16,1241964
25119,11,11,315,993156,11,993145
25120,17,2,647,715419,17,715402
25121,9,-20,360,7918,9,7909
25122,9,-13,158,221728,9,221719
25123,20,3,553,745884,20,745864
25124,12,-17,806,121587,12,121575
25125,8,-18,742,78419,8,78411
25126,18,6,346,838479,18,838461
25127,8,-13,819,236104,8,236096
25128,13,12,44,1022422,13,1022409
25129,10,13,961,1051290,10,1051280
25130,17,-11,51,304030,17,304013
25131,12,2,595,715030,12,715018
25132,18,12,292,1024278,18,1024260
25133,19,-3,908,561066,19,561047
25134,15,11,806,996702,15,996687
25135,11,13,836,1059494,11,1059483
25136,11,1,303,682240,11,682229
25137,19,4,996,780539,19,780520
25138,12,-13,456,244316,12,244304
25139,9,-5,807,485337,9,485328
25140,7,-13,763,234829,7,234822
25141,18,-15,87,178454,18,178436
25142,11,7,855,873160,11,873149
25143,10,-9,932,364490,10,364480
25144,5,4,715,766040,5,766035
25145,16,-8,610,402143,16,402127
25146,19,-2,422,588273,19,588254
25147,19,-3,118,554652,19,554633
25148,12,13,786,1059106,12,1059094
25149,17,-5,68,491371,17,491354
25150,17,12,822,1028180,17,1028163
25151,8,0,996,647069,8,647061
25152,14,5,722,809063,14,809049
25153,10,-8,232,380441,10,380431
25154,7,-5,851,486419,7,486412
25155,14,-4,800,528000,14,527986
25156,11,7,337,869486,11,869475
25157,11,16,587,1151247,11,1151236
25158,6,-15,467,165546,6,165540
25159,12,8,314,900431,12,900419
25160,17,-16,103,147683,17,147666
25161,8,-6,591,449497,8,449489
25162,15,16,74,1147598,15,1147583
25163,17,8,487,901803,17,901786
25164,17,-8,286,399890,17,399873
25165,13,11,831,996838,13,996825
25166,9,-2,117,565389,9,565380
25167,14,-18,649,89968,14,89954
25168,9,19,859,1236695,9,1236686
25169,20,-2,306,587434,20,587414
25170,6,6,994,834610,6,834604
25171,20,8,386,901023,20,901003
25172,20,13,568,1057515,20,1057495
25173,17,5,748,809245,17,809228
25174,17,6,771,841943,17,841926
25175,15,-10,795,341061,15,341046
25176,10,-20,574,12530,10,12520
25177,6,-6,286,443079,6,443073
25178,14,-12,193,273862,14,273848
25179,8,-10,117,315091,8,315083
25180,14,6,295,838036,14,838022
25181,16,18,943,1215864,16,1215848
25182,6,-16,977,144989,6,144983
25183,12,2,62,710986,12,710974
25184,9,-12,513,260753,9,260744
25185,15,6,338,838418,15,838403
25186,14,-16,701,152062,14,152048
25187,6,-18,135,65427,6,65421
25188,13,-12,572,276746,13,276733
25189,6,1,770,673771,6,673765
25190,8,-19,449,41150,8,41142
25191,7,16,68,1126606,7,1126599
25192,5,8,50,876117,5,876112
25193,11,12,519,1025818,11,1025807
25194,20,9,777,934803,20,934783
25195,18,-20,161,23977,18,23959
25196,10,5,138,784401,10,784391
25197,12,-15,982,185235,12,185223
25198,18,9,618,933659,18,933641
25199,12,-6,171,460437,12,460425
25200,15,15,695,1121901,15,1121886
25201,7,-9,210,348029,7,348022
25202,6,12,368,1007150,6,1007144
25203,19,-18,334,87806,19,87787
25204,9,11,3,968515,9,968506
25205,18,-5,320,493480,18,493462
25206,14,7,70,867531,14,867517
25207,9,-1,557,606091,9,606082
25208,18,-20,602,27375,18,27357
25209,17,-14,444,212972,17,212955
25210,16,-19,995,61399,16,61383
25211,20,0,519,652094,20,652074
25212,15,9,894,935686,15,935671
25213,9,7,970,865233,9,865224
25214,17,-4,426,525405,17,525388
25215,19,6,724,841649,19,841630
25216,11,1,838,686322,11,686311
25217,6,-14,783,203761,6,203755
25218,17,-20,992,30396,17,30379
25219,18,-5,701,496160,18,496142
25220,14,-13,288,243230,14,243216
25221,13,-1,732,622212,13,622199
25222,19,-2,591,589564,19,589545
25223,14,2,520,714575,14,714561
25224,9,15,442,1103773,9,1103764
25225,15,15,955,1123805,15,1123790
25226,8,5,259,787067,8,787059
25227,16,-15,975,185176,16,185160
25228,19,10,762,965704,19,965685
25229,20,-10,436,338249,20,338229
25230,14,2,250,712461,14,712447
25231,13,-3,234,555393,13,555380
25232,17,18,316,1211375,17,1211358
25233,11,-16,116,147781,11,147770
25234,17,-13,993,248522,17,248505
25235,20,1,687,685216,20,685196
25236,18,-6,591,463649,18,463631
25237,18,4,803,779141,18,779123
25238,18,15,683,1121779,18,1121761
25239,5,10,532,948862,5,948857
25240,7,14,930,1082640,7,1082633
25241,20,2,764,716284,20,716264
25242,19,12,662,1026995,19,1026976
25243,16,-16,784,152677,16,152661
25244,14,12,896,1028845,14,1028831
25245,14,-1,469,620319,14,620305
25246,14,2,251,712467,14,712453
25247,9,4,295,756899,9,756890
25248,10,-10,669,327212,10,327202
25249,15,-16,87,147525,15,147510
25250,20,-3,896,560962,20,560942
25251,7,12,291,1005604,7,1005597
25252,15,4,132,774202,15,774187
25253,18,-18,411,88363,18,88345
25254,14,8,191,899438,14,899424
25255,18,13,134,1054200,18,1054182
25256,9,-8,587,387703,9,387694
25257,11,-5,570,495234,11,495223
25258,12,-17,593,119964,12,119952
25259,6,13,766,1047212,6,1047206
25260,16,-17,215,117061,16,117045
25261,16,8,786,904163,16,904147
25262,14,14,7,1085404,14,1085390
25263,11,1,880,686616,11,686605
25264,13,15,714,1122079,13,1122066
25265,10,8,388,883652,10,883642
25266,9,16,336,1132267,9,1132258
25267,14,9,515,932841,14,932827
25268,5,4,846,769296,5,769291
25269,16,18,286,1211208,16,1211192
25270,20,-8,371,400501,20,400481
25271,17,10,519,963842,17,963825
25272,16,-13,466,244393,16,244377
25273,19,-18,168,86558,19,86539
25274,13,-12,489,276099,13,276086
25275,14,8,428,901375,14,901361
25276,12,19,904,1248122,12,1248110
25277,11,-4,157,523250,11,523239
25278,20,-2,650,590010,20,589990
25279,17,-4,513,526010,17,525993
25280,7,-1,54,594944,7,594937
25281,7,-7,640,419418,7,419411
25282,11,-1,873,623234,11,623223
25283,15,18,787,1214700,15,1214685
25284,7,-3,976,552287,7,552280
25285,10,-19,436,40898,10,40888
25286,10,-13,820,236143,10,236133
25287,6,-15,11,155537,6,155531
25288,9,-6,990,457948,9,457939
25289,15,11,138,991812,15,991797
25290,14,2,719,716031,14,716017
25291,7,-5,825,485770,7,485763
25292,19,-5,707,496202,19,496183
25293,8,18,175,1190677,8,1190669
25294,10,-10,870,331203,10,331193
25295,8,-6,838,454712,8,454704
25296,11,-11,928,310931,11,310920
25297,17,-5,645,495741,17,495724
25298,5,-3,484,541356,5,541351
25299,5,1,454,667121,5,667116
25300,17,-18,719,90484,17,90467
25301,15,3,795,747847,15,747832
25302,17,-18,179,86682,17,86665
25303,5,-17,316,100314,5,100309
25304,20,-15,764,183453,20,183433
25305,20,-20,882,29595,20,29575
25306,14,12,206,1023528,14,1023514
25307,10,-5,54,469029,10,469019
25308,11,14,551,1089760,11,1089749
25309,19,14,772,1091542,19,1091523
25310,11,-16,588,151312,11,151301
25311,11,-1,664,621676,11,621665
25312,6,11,510,979383,6,979377
25313,8,-9,534,355764,8,355756
25314,7,9,421,915475,7,915468
25315,13,14,405,1088622,13,1088609
25316,19,-4,657,527070,19,527051
25317,12,-13,85,241651,12,241639
25318,10,11,211,972691,10,972681
25319,10,-19,998,52838,10,52828
25320,5,2,617,701671,5,701666
25321,15,3,27,741984,15,741969
25322,20,15,660,1121649,20,1121629
25323,18,5,217,805457,18,805439
25324,5,18,47,1187659,5,1187654
25325,12,11,69,991393,12,991381
25326,12,-5,3,490781,12,490769
25327,18,-16,918,153684,18,153666
25328,7,10,459,947303,7,947296
25329,6,-2,836,580699,6,580693
25330,16,5,661,808607,16,808591
25331,17,-9,269,368542,17,368525
25332,18,1,95,680541,18,680523
25333,20,-5,94,491643,20,491623
25334,6,-4,55,500484,6,500478
25335,20,13,321,1055552,20,1055532
25336,5,16,598,1137733,5,1137728
25337,19,5,463,807179,19,807160
25338,17,0,252,650070,17,650053
25339,17,-12,860,278920,17,278903
25340,12,5,369,806510,12,806498
25341,10,-18,237,67713,10,67703
25342,10,3,799,736036,10,736026
25343,20,2,956,717625,20,717605
25344,12,-17,987,122715,12,122703
25345,14,-4,201,523640,14,523626
25346,13,-14,86,209984,13,209971
25347,10,-16,692,138842,10,138832
25348,16,-3,288,555836,16,555820
25349,20,0,879,654902,20,654882
25350,17,0,893,655058,17,655041
25351,5,-4,665,513735,5,513730
25352,16,-20,444,26174,16,26158
25353,13,-18,271,87376,13,87363
25354,15,-7,371,431157,15,431142
25355,19,15,458,1120025,19,1120006
25356,19,5,465,807200,19,807181
25357,10,-8,956,395805,10,395795
25358,6,-4,674,513910,6,513904
25359,6,0,479,635767,6,635761
25360,6,-15,605,168401,6,168395
25361,7,-7,127,408489,7,408482
25362,11,13,812,1059344,11,1059333
25363,20,-5,497,494713,20,494693
25364,18,13,292,1055375,18,1055357
25365,15,-8,802,403614,15,403599
25366,13,-8,514,401454,13,401441
25367,6,-9,708,359181,6,359175
25368,7,-20,434,9275,7,9268
25369,15,-17,629,120205,15,120190
25370,12,4,724,778581,12,778569
25371,11,-17,691,120685,11,120674
25372,10,-5,905,487750,10,487740
25373,16,-6,178,460545,16,460529
25374,12,-5,311,493370,12,493358
25375,20,19,951,1248415,20,1248395
25376,18,-5,253,492902,18,492884
25377,16,16,849,1153176,16,1153160
25378,10,-19,714,47186,10,47176
25379,14,-11,506,307796,14,307782
25380,14,-19,514,57949,14,57935
25381,9,4,503,761419,9,761410
25382,6,15,917,1113971,6,1113965
25383,10,8,487,885856,10,885846
25384,13,10,554,964087,13,964074
25385,13,-13,947,248173,13,248160
25386,14,-8,826,403783,14,403769
25387,9,-18,267,68318,9,68309
25388,10,-11,666,295810,10,295800
25389,18,-15,902,184611,18,184593
25390,18,-3,59,554186,18,554168
25391,11,3,432,745091,11,745080
25392,15,-1,92,617280,15,617265
25393,11,0,749,654042,11,654031
25394,10,-8,318,382158,10,382148
25395,16,-14,739,215248,16,215232
25396,10,-2,188,566771,10,566761
25397,14,-3,847,560550,14,560536
25398,13,17,40,1178174,13,1178161
25399,17,-19,375,56920,17,56903
25400,13,-18,969,92261,13,92248
25401,5,3,290,725213,5,725208
25402,14,-12,100,273248,14,273234
25403,11,-5,458,494413,11,494402
25404,9,1,590,670150,9,670141
25405,17,13,593,1057758,17,1057741
25406,8,-2,150,566003,8,565995
25407,8,3,787,735694,8,735686
25408,10,11,9,968643,10,968633
25409,16,-14,998,217283,16,217267
25410,10,7,304,851323,10,851313
25411,6,-11,212,285661,6,285655
25412,18,-5,21,490959,18,490941
25413,7,-10,594,325443,7,325436
25414,16,15,152,1117933,16,1117917
25415,18,17,252,1179781,18,1179763
25416,16,-4,663,527109,16,527093
25417,12,-3,569,558304,12,558292
25418,5,-13,926,238376,5,238371
25419,15,-6,766,464968,15,464953
25420,20,-17,97,116300,20,116280
25421,15,-17,973,122608,15,122593
25422,5,5,738,797035,5,797030
25423,18,-4,499,525846,18,525828
25424,8,8,676,890048,8,890040
25425,20,13,606,1057866,20,1057846
25426,6,2,130,691416,6,691410
25427,12,13,195,1054666,12,1054654
25428,11,19,55,1241165,11,1241154
25429,9,6,213,816841,9,816832
25430,12,14,216,1087086,12,1087074
25431,7,-12,376,257799,7,257792
25432,13,-20,720,28305,13,28292
25433,6,-18,436,71754,6,71748
25434,12,-15,380,180575,12,180563
25435,17,-3,166,554935,17,554918
25436,10,1,86,658881,10,658871
25437,5,-11,811,298506,5,298501
25438,8,3,362,726716,8,726708
25439,13,12,682,1027189,13,1027176
25440,10,-14,582,199302,10,199292
25441,11,-5,60,491279,11,491268
25442,13,-8,988,404920,13,404907
25443,6,0,771,642268,6,642262
25444,9,1,84,658827,9,658818
25445,20,12,964,1029553,20,1029533
25446,20,7,953,873763,20,873743
25447,6,-12,530,261115,6,261109
25448,5,17,615,1168374,5,1168369
25449,7,8,10,875337,7,875330
25450,10,-12,114,252034,10,252024
25451,15,4,53,773614,15,773599
25452,11,-9,119,367470,11,367459
25453,13,6,344,838448,13,838435
25454,9,-9,684,358589,9,358580
25455,11,-12,278,274579,11,274568
25456,5,7,571,856959,5,856954
25457,14,17,722,1183292,14,1183278
25458,13,13,750,1058804,13,1058791
25459,20,5,791,809537,20,809517
25460,15,11,648,995457,15,995442
25461,7,-1,982,615075,7,615068
25462,17,1,451,683383,17,683366
25463,8,-8,367,383032,8,383024
25464,18,-17,294,117676,18,117658
25465,17,-17,311,117827,17,117810
25466,16,-19,352,56753,16,56737
25467,15,-16,822,152949,15,152934
25468,19,19,265,1242877,19,1242858
25469,20,-15,132,178805,20,178785
25470,11,-20,668,27926,11,27915
25471,20,2,191,712014,20,711994
25472,7,-15,858,173699,7,173692
25473,15,-2,84,585770,15,585755
25474,13,-18,861,91457,13,91444
25475,6,4,768,767328,6,767322
25476,17,18,608,1213288,17,1213271
25477,18,-18,508,88995,18,88977
25478,5,15,819,1111775,5,1111770
25479,8,17,399,1163819,8,1163811
25480,5,-1,927,613967,5,613962
25481,6,18,992,1207705,6,1207699
25482,13,15,815,1122761,13,1122748
25483,10,-3,587,543664,10,543654
25484,6,18,77,1188445,6,1188439
25485,9,13,819,1048400,9,1048391
25486,11,-16,896,153517,11,153506
25487,5,18,211,1191450,5,1191445
25488,6,-13,265,224063,6,224057
25489,19,7,765,872553,19,872534
25490,15,10,416,963013,15,962998
25491,10,-1,737,609705,10,609695
25492,18,16,483,1150581,18,1150563
25493,11,-2,45,585476,11,585465
25494,18,-14,889,216419,18,216401
25495,20,12,739,1027566,20,1027546
25496,18,-9,119,367478,18,367460
25497,18,16,137,1148060,18,1148042
25498,7,1,473,667521,7,667514
25499,19,-13,37,241333,19,241314
25500,16,8,68,898403,16,898387
25501,17,7,753,872460,17,872443
25502,13,-18,495,88921,13,88908
25503,12,17,500,1181634,12,1181622
25504,14,-9,641,371610,14,371596
25505,6,6,176,816026,6,816020
25506,8,-12,689,264392,8,264384
25507,11,-2,240,586960,11,586949
25508,14,15,340,1119275,14,1119261
25509,5,-6,740,452741,5,452736
25510,17,3,958,749176,17,749159
25511,20,-16,751,152406,20,152386
25512,7,12,936,1019696,7,1019689
25513,9,19,351,1225366,9,1225357
25514,18,-14,609,214328,18,214310
25515,14,16,351,1149675,14,1149661
25516,9,-18,262,68145,9,68136
25517,15,9,354,931619,15,931604
25518,7,10,969,958240,7,958233
25519,17,-10,980,342490,17,342473
25520,8,11,993,989706,8,989698
25521,16,19,144,1241939,16,1241923
25522,18,17,965,1185173,18,1185155
25523,5,-3,326,537489,5,537484
25524,19,-20,257,24757,19,24738
25525,5,-19,620,45102,5,45097
25526,11,-4,99,522792,11,522781
25527,8,-3,228,535282,8,535274
25528,19,-1,682,621803,19,621784
25529,5,-8,757,391574,5,391569
25530,11,-10,742,340671,11,340660
25531,14,0,206,649806,14,649792
25532,17,-4,339,524724,17,524707
25533,10,-20,146,3237,10,3227
25534,8,6,814,830679,8,830671
25535,20,-4,740,527597,20,527577
25536,12,17,978,1185276,12,1185264
25537,19,9,844,935330,19,935311
25538,10,17,589,1167818,10,1167808
25539,10,3,724,734575,10,734565
25540,5,-14,284,192937,5,192932
25541,14,-11,334,306425,14,306411
25542,5,-18,365,70243,5,70238
25543,12,10,430,963113,12,963101
25544,19,8,504,901978,19,901959
25545,8,-1,112,596185,8,596177
25546,8,15,614,1107490,8,1107482
25547,15,1,913,686973,15,686958
25548,13,13,505,1056987,13,1056974
25549,12,3,808,747937,12,747925
25550,6,-17,494,104137,6,104131
25551,6,3,576,731119,6,731113
25552,16,12,887,1028744,16,1028728
25553,8,2,541,700108,8,700100
25554,13,-12,958,279749,13,279736
25555,7,-3,526,542368,7,542361
25556,15,-18,707,90385,15,90370
25557,13,-14,300,211730,13,211717
25558,19,-12,837,278685,19,278666
25559,10,-11,412,290247,10,290237
25560,6,-13,87,220228,6,220222
25561,17,0,511,652041,17,652024
25562,13,-6,940,466261,13,466248
25563,11,-10,816,341227,11,341216
25564,14,-9,144,367619,14,367605
25565,16,-3,272,555711,16,555695
25566,17,8,424,901354,17,901337
25567,9,17,14,1155533,9,1155524
25568,12,4,782,779015,12,779003
25569,8,7,83,846656,8,846648
25570,15,-19,854,60547,15,60532
25571,9,12,709,1014675,9,1014666
25572,7,6,518,824106,7,824099
25573,11,-8,831,403809,11,403798
25574,18,5,998,811120,18,811102
25575,15,-9,505,370641,15,370626
25576,6,0,488,636013,6,636007
25577,15,10,310,962153,15,962138
25578,12,-11,419,307078,12,307066
25579,14,-7,430,431544,14,431530
25580,5,9,316,913432,5,913427
25581,17,0,970,655710,17,655693
25582,8,19,925,1237991,8,1237983
25583,10,-16,759,140407,10,140397
25584,7,-19,653,45882,7,45875
25585,6,-1,614,607210,6,607204
25586,20,13,209,1054782,20,1054762
25587,12,11,96,991561,12,991549
25588,11,6,503,839848,11,839837
25589,7,5,593,793908,7,793901
25590,11,-19,870,60690,11,60679
25591,6,-7,890,424927,6,424921
25592,14,18,832,1214986,14,1214972
25593,10,6,461,822804,10,822794
25594,19,-7,279,430397,19,430378
25595,10,16,783,1141348,10,1141338
25596,5,-12,892,268987,5,268982
25597,11,-12,661,277397,11,277386
25598,17,2,782,716341,17,716324
25599,7,-2,703,577840,7,577833
25600,20,4,508,776903,20,776883
25601,9,-10,321,319496,9,319487
25602,10,11,50,969537,10,969527
25603,18,1,871,686588,18,686570
25604,17,-5,861,497297,17,497280
25605,8,-19,411,40406,8,40398
25606,16,-17,772,121377,16,121361
25607,14,5,694,808851,14,808837
25608,6,-2,888,581860,6,581854
25609,13,11,725,996054,13,996041
25610,12,-3,809,560299,12,560287
25611,18,-12,863,278970,18,278952
25612,17,-13,715,246299,17,246282
25613,17,-4,188,523521,17,523504
25614,16,0,521,652128,16,652112
25615,18,2,91,711247,18,711229
25616,13,18,886,1215443,13,1215430
25617,14,13,581,1057689,14,1057675
25618,12,5,270,805825,12,805813
25619,18,16,109,1147830,18,1147812
25620,15,-12,812,278452,15,278437
25621,18,-16,836,153029,18,153011
25622,15,-13,501,244705,15,244690
25623,16,-15,896,184549,16,184533
25624,6,-11,868,299704,6,299698
25625,8,-3,805,548389,8,548381
25626,15,-3,738,559625,15,559610
25627,20,-10,696,340339,20,340319
25628,14,-14,639,214542,14,214528
25629,7,11,85,970276,7,970269
25630,9,1,384,665605,9,665596
25631,18,-11,593,308440,18,308422
25632,15,-4,629,526827,15,526812
25633,17,-1,461,620234,17,620217
25634,10,-11,730,296935,10,296925
25635,9,14,342,1069366,9,1069357
25636,5,16,168,1128676,5,1128671
25637,11,-16,53,147172,11,147161
25638,20,17,917,1184816,20,1184796
25639,16,-10,991,342606,16,342590
25640,9,-3,572,543396,9,543387
25641,20,-10,936,342125,20,342105
25642,10,-8,539,386738,10,386728
25643,8,13,301,1037143,8,1037135
25644,7,-2,189,566777,7,566770
25645,15,19,480,1244722,15,1244707
25646,19,-10,484,338675,19,338656
25647,14,-11,217,305415,14,305401
25648,16,7,766,872558,16,872542
25649,7,-9,775,360867,7,360860
25650,18,-11,173,305107,18,305089
25651,9,14,141,1065002,9,1064993
25652,12,8,89,898610,12,898598
25653,15,-6,775,465071,15,465056
25654,17,-14,85,209972,17,209955
25655,10,11,637,982034,10,982024
25656,7,9,346,914033,7,914026
25657,12,12,535,1025962,12,1025950
25658,19,10,509,963771,19,963752
25659,6,-17,85,95263,6,95257
25660,11,-6,514,463147,11,463136
25661,18,-1,761,622389,18,622371
25662,12,-11,195,305273,12,305261
25663,11,-2,557,589335,11,589324
25664,17,13,263,1055129,17,1055112
25665,11,-20,528,26796,11,26785
25666,12,4,584,777486,12,777474
25667,13,10,463,963386,13,963373
25668,17,-14,861,216244,17,216227
25669,15,-4,861,528437,15,528422
25670,20,1,722,685471,20,685451
25671,19,3,957,749170,19,749151
25672,10,5,860,799600,10,799590
25673,14,5,825,809794,14,809780
25674,12,16,530,1150857,12,1150845
25675,14,8,361,900800,14,900786
25676,13,-14,19,209467,13,209454
25677,9,6,853,831504,9,831495
25678,9,-4,726,515008,9,514999
25679,16,7,975,873924,16,873908
25680,8,17,394,1163733,8,1163725
25681,9,-10,978,333500,9,333491
25682,17,-18,756,90787,17,90770
25683,10,9,717,921842,10,921832
25684,14,-18,898,91723,14,91709
25685,17,-11,324,306335,17,306318
25686,8,0,460,635413,8,635405
25687,19,7,830,873013,19,872994
25688,20,-6,510,463106,20,463086
25689,11,-12,218,274098,11,274087
25690,20,9,125,929986,20,929966
25691,16,-16,25,146927,16,146911
25692,15,-17,888,122107,15,122092
25693,19,-18,996,92458,19,92439
25694,17,-20,373,25676,17,25659
25695,17,-11,517,307855,17,307838
25696,15,-6,680,464302,15,464287
25697,11,-5,270,493030,11,493019
25698,11,-12,486,276077,11,276066
25699,14,-15,282,179820,14,179806
25700,16,8,292,900270,16,900254
25701,13,7,855,873163,13,873150
25702,8,3,19,719222,8,719214
25703,15,-12,487,276081,15,276066
25704,16,-11,876,310604,16,310588
25705,14,14,858,1092107,14,1092093
25706,16,-19,433,57341,16,57325
25707,20,0,155,649394,20,649374
25708,10,18,87,1188645,10,1188635
25709,17,2,667,715600,17,715583
25710,19,5,878,810179,19,810160
25711,14,-6,96,459794,14,459780
25712,9,-2,516,573720,9,573711
25713,19,-13,378,243813,19,243794
25714,12,10,811,966165,12,966153
25715,19,15,947,1123737,19,1123718
25716,20,11,194,992219,20,992199
25717,5,16,375,1133147,5,1133142
25718,8,18,974,1207392,8,1207384
25719,7,10,155,940892,7,940885
25720,20,3,185,743263,20,743243
25721,10,-12,458,259442,10,259432
25722,7,19,175,1221386,7,1221379
25723,11,4,25,773429,11,773418
25724,7,13,21,1031222,7,1031215
25725,11,-7,103,429027,11,429016
25726,14,2,264,712538,14,712524
25727,19,13,279,1055247,19,1055228
25728,20,-15,466,181231,20,181211
25729,17,-5,679,495955,17,495938
25730,20,-10,232,336775,20,336755
25731,17,0,93,648948,17,648931
25732,8,-11,37,281837,8,281829
25733,10,11,800,985586,10,985576
25734,5,4,988,772065,5,772060
25735,13,-2,540,589164,13,589151
25736,17,14,660,1090604,17,1090587
25737,6,6,679,827588,6,827582
25738,5,10,964,958148,5,958143
25739,13,-20,955,30016,13,30003
25740,16,7,350,869568,16,869552
25741,10,16,407,1133896,10,1133886
25742,9,0,979,646646,9,646637
25743,8,-10,492,323325,8,323317
25744,13,14,907,1092531,13,1092518
25745,7,9,940,926718,7,926711
25746,12,19,791,1247191,12,1247179
25747,17,-8,667,402618,17,402601
25748,12,0,538,652288,12,652276
25749,18,-17,655,120408,18,120390
25750,20,12,209,1023578,20,1023558
25751,11,-17,931,122351,11,122340
25752,6,-1,311,600813,6,600807
25753,15,11,337,993337,15,993322
25754,20,16,442,1150313,20,1150293
25755,15,14,975,1093080,15,1093065
25756,18,14,327,1088009,18,1087991
25757,17,1,149,681032,17,681015
25758,7,0,536,636925,7,636918
25759,15,-1,903,623483,15,623468
25760,16,-1,283,618789,16,618773
25761,17,-18,440,88542,17,88525
25762,18,4,66,773730,18,773712
25763,18,-8,703,402864,18,402846
25764,16,-14,202,210869,16,210853
25765,17,-15,719,183153,17,183136
25766,11,15,890,1123252,11,1123241
25767,8,8,550,887260,8,887252
25768,15,-7,511,432167,15,432152
25769,18,-6,228,460935,18,460917
25770,6,14,898,1081942,6,1081936
25771,15,-10,366,337670,15,337655
25772,15,-19,766,59983,15,59968
25773,11,-15,801,183706,11,183695
25774,17,-12,212,274046,17,274029
25775,17,7,475,870571,17,870554
25776,8,15,641,1108038,8,1108030
25777,13,1,568,684372,13,684359
25778,10,-7,775,422305,10,422295
25779,8,18,672,1200881,8,1200873
25780,15,12,351,1024643,15,1024628
25781,5,0,622,638857,5,638852
25782,17,-9,282,368646,17,368629
25783,19,14,498,1089354,19,1089335
25784,13,19,619,1245841,13,1245828
25785,17,4,912,779999,17,779982
25786,9,-13,321,225191,9,225182
25787,17,-14,708,215046,17,215029
25788,14,6,791,842093,14,842079
25789,5,-11,863,299605,5,299600
25790,20,10,769,965769,20,965749
25791,13,16,89,1147718,13,1147705
25792,7,2,789,705094,7,705087
25793,8,-17,346,100934,8,100926
25794,8,2,293,694968,8,694960
25795,11,8,53,898271,11,898260
25796,6,-2,19,563161,6,563155
25797,14,-12,730,277829,14,277815
25798,8,13,145,1033732,8,1033724
25799,10,-4,526,510888,10,510878
25800,20,-18,717,90475,20,90455
25801,13,1,823,686216,13,686203
25802,9,13,194,1034848,9,1034839
25803,15,-16,755,152481,15,152466
25804,12,-18,564,89344,12,89332
25805,11,-18,752,90760,11,90749
25806,17,1,146,681000,17,680983
25807,14,-17,648,120323,14,120309
25808,6,1,127,659949,6,659943
25809,9,18,937,1206519,9,1206510
25810,9,-17,462,103343,9,103334
25811,9,12,267,1005125,9,1005116
25812,6,1,745,673231,6,673225
25813,5,-11,723,296824,5,296819
25814,14,14,170,1086778,14,1086764
25815,13,16,367,1149795,13,1149782
25816,13,19,609,1245724,13,1245711
25817,6,-7,716,421042,6,421036
25818,10,2,258,694178,10,694168
25819,11,-6,167,460426,11,460415
25820,20,1,19,679909,20,679889
25821,13,-8,507,401391,13,401378
25822,15,-3,651,558984,15,558969
25823,13,-3,698,559321,13,559308
25824,10,1,55,658269,10,658259
25825,19,-5,804,496824,19,496805
25826,12,7,573,871238,12,871226
25827,14,-2,126,586067,14,586053
25828,11,13,182,1054570,11,1054559
25829,14,11,450,994105,14,994091
25830,6,-19,616,44977,6,44971
25831,18,-16,294,149122,18,149104
25832,6,17,958,1175860,6,1175854
25833,14,-13,837,247246,14,247232
25834,6,19,79,1219239,6,1219233
25835,18,-12,860,278928,18,278910
25836,20,-14,21,209492,20,209472
25837,17,-10,229,336757,17,336740
25838,8,6,259,818071,8,818063
25839,20,19,679,1246273,20,1246253
25840,15,-12,398,275421,15,275406
25841,12,-14,392,212617,12,212605
25842,20,16,662,1151883,20,1151863
25843,5,3,481,729139,5,729134
25844,14,-17,897,122148,14,122134
25845,6,-1,388,602487,6,602481
25846,19,4,526,777076,19,777057
25847,12,-5,515,494842,12,494830
25848,12,-13,971,248366,12,248354
25849,8,-17,134,96234,8,96226
25850,10,-3,410,539456,10,539446
25851,5,-8,300,381737,5,381732
25852,16,2,156,711766,16,711750
25853,20,13,873,1059780,20,1059760
25854,9,9,761,922661,9,922652
25855,14,5,707,808959,14,808945
25856,10,-1,284,600161,10,600151
25857,19,16,301,1149314,19,1149295
25858,5,11,244,973444,5,973439
25859,16,9,913,935852,16,935836
25860,11,5,722,809064,11,809053
25861,15,3,202,743457,15,743442
25862,5,7,245,850048,5,850043
25863,9,16,160,1128409,9,1128400
25864,7,1,149,660440,7,660433
25865,10,-15,622,168775,10,168765
25866,5,-4,37,500101,5,500096
25867,8,-18,727,78041,8,78033
25868,17,-20,263,24778,17,24761
25869,5,-6,3,436901,5,436896
25870,16,19,690,1246366,16,1246350
25871,19,-7,109,429078,19,429059
25872,7,-6,642,450624,7,450617
25873,6,19,418,1227170,6,1227164
25874,11,12,344,1024619,11,1024608
25875,13,7,299,869165,13,869152
25876,11,-18,986,92363,11,92352
25877,16,-13,804,247027,16,247011
25878,14,-1,860,623142,14,623128
25879,7,7,933,864533,7,864526
25880,12,10,121,960847,12,960835
25881,8,4,310,757202,8,757194
25882,17,-4,585,526504,17,526487
25883,7,-9,115,346017,7,346010
25884,12,7,944,873721,12,873709
25885,6,-18,610,75477,6,75471
25886,20,-18,201,86853,20,86833
25887,17,2,111,711397,17,711380
25888,12,0,926,655319,12,655307
25889,8,17,584,1167708,8,1167700
25890,6,-4,421,508783,6,508777
25891,11,13,991,1060531,11,1060520
25892,7,17,250,1160598,7,1160591
25893,15,10,989,967373,15,967358
25894,13,12,278,1024181,13,1024168
25895,16,-11,131,304736,16,304720
25896,9,8,473,885495,9,885486
25897,6,-11,685,296176,6,296170
25898,10,-9,429,353064,10,353054
25899,14,-14,362,212231,14,212217
25900,17,-3,476,557440,17,557423
25901,20,17,831,1184190,20,1184170
25902,13,6,385,838793,13,838780
25903,5,-10,880,331474,5,331469
25904,5,17,363,1163096,5,1163091
25905,8,-8,687,390165,8,390157
25906,12,13,172,1054464,12,1054452
25907,16,-5,213,492540,16,492524
25908,18,-17,622,120163,18,120145
25909,12,17,184,1179268,12,1179256
25910,12,5,355,806347,12,806335
25911,14,1,572,684406,14,684392
25912,6,18,727,1201841,6,1201835
25913,19,-17,10,115641,19,115622
25914,10,-6,52,437936,10,437926
25915,12,6,888,842853,12,842841
25916,11,1,983,687480,11,687469
25917,12,5,493,807402,12,807390
25918,6,-10,14,312851,6,312845
25919,8,16,822,1142255,8,1142247
25920,18,-5,834,497071,18,497053
25921,8,1,645,671267,8,671259
25922,9,-7,308,412534,9,412525
25923,17,-1,425,619940,17,619923
25924,9,-10,782,329277,9,329268
25925,11,4,943,780202,11,780191
25926,17,3,735,747394,17,747377
25927,5,13,681,1045416,5,1045411
25928,19,-7,755,433759,19,433740
25929,10,-9,4,343797,10,343787
25930,15,-13,465,244373,15,244358
25931,13,19,300,1243171,13,1243158
25932,7,-14,940,206916,7,206909
25933,5,7,160,848243,5,848238
25934,17,15,828,1122848,17,1122831
25935,20,7,915,873557,20,873537
25936,17,-20,118,23663,17,23646
25937,17,9,112,929871,17,929854
25938,16,11,510,994557,16,994541
25939,16,-9,861,373382,16,373366
25940,11,-2,470,588678,11,588667
25941,12,-1,465,620297,12,620285
25942,14,15,505,1120406,14,1120392
25943,20,6,614,840695,20,840675
25944,10,-9,478,354355,10,354345
25945,7,16,648,1138837,7,1138830
25946,9,6,952,833614,9,833605
25947,11,-2,940,592306,11,592295
25948,12,18,456,1212358,12,1212346
25949,18,19,41,1241011,18,1240993
25950,20,-7,280,430409,20,430389
25951,14,14,16,1085500,14,1085486
25952,9,-16,701,139064,9,139055
25953,20,-14,156,210507,20,210487
25954,17,-12,660,277392,17,277375
25955,10,-8,185,379482,10,379472
25956,20,-2,214,586707,20,586687
25957,10,-15,470,165612,10,165602
25958,7,-13,813,235949,7,235942
25959,10,6,740,829021,10,829011
25960,10,8,900,894703,10,894693
25961,14,-8,408,400789,14,400775
25962,10,4,93,752635,10,752625
25963,16,-3,230,555366,16,555350
25964,12,18,676,1213834,12,1213822
25965,14,0,430,651362,14,651348
25966,10,-8,460,384822,10,384812
25967,16,-19,852,60539,16,60523
25968,6,-15,385,163710,6,163704
25969,18,2,651,715458,18,715440
25970,9,-16,91,125954,9,125945
25971,5,8,556,887399,5,887394
25972,8,-9,908,364037,8,364029
25973,8,-11,54,282256,8,282248
25974,11,6,986,843622,11,843611
25975,19,4,710,778482,19,778463
25976,19,18,638,1213573,19,1213554
25977,14,17,464,1181412,14,1181398
25978,6,-6,465,446727,6,446721
25979,16,8,828,904412,16,904396
25980,16,-14,636,214527,16,214511
25981,13,-13,764,246694,13,246681
25982,15,11,747,996194,15,996179
25983,10,-20,75,1697,10,1687
25984,20,16,953,1153894,20,1153874
25985,15,14,701,1090960,15,1090945
25986,15,-16,45,147094,15,147079
25987,19,1,764,685823,19,685804
25988,11,6,897,842895,11,842884
25989,12,-12,3,272527,12,272515
25990,14,-8,319,400142,14,400128
25991,5,14,858,1081025,5,1081020
25992,15,12,673,1027120,15,1027105
25993,10,18,720,1201695,10,1201685
25994,17,-20,572,27155,17,27138
25995,9,-13,110,220770,9,220761
25996,18,15,585,1121031,18,1121013
25997,14,-14,590,214167,14,214153
25998,13,-5,527,494946,13,494933
25999,5,-3,895,550452,5,550447
26000,9,-10,318,319432,9,319423
26001,11,9,717,934345,11,934334
26002,16,3,690,747087,16,747071
26003,19,4,525,777068,19,777049
26004,11,3,714,747277,11,747266
26005,14,10,567,964241,14,964227
26006,6,4,127,753296,6,753290
26007,7,6,944,833463,7,833456
26008,18,4,157,774398,18,774380
26009,16,-13,563,245187,16,245171
26010,20,4,161,774423,20,774403
26011,16,-18,646,89939,16,89923
26012,14,4,900,779909,14,779895
26013,7,1,876,676025,7,676018
26014,15,-13,163,242210,15,242195
26015,13,-3,101,554495,13,554482
26016,14,12,655,1026903,14,1026889
26017,18,-4,1000,529605,18,529587
26018,11,-18,742,90668,11,90657
26019,11,-6,441,462484,11,462473
26020,14,18,441,1212275,14,1212261
26021,8,10,727,953155,8,953147
26022,9,-14,91,188583,9,188574
26023,19,2,742,716158,19,716139
26024,16,-12,300,274756,16,274740
26025,15,8,105,898747,15,898732
26026,14,-8,618,402205,14,402191
26027,7,-20,791,17453,7,17446
26028,12,-20,668,27928,12,27916
26029,7,-6,323,443755,7,443748
26030,14,-19,466,57533,14,57519
26031,13,9,847,935346,13,935333
26032,8,1,972,678200,8,678192
26033,10,7,474,855039,10,855029
26034,16,8,792,904228,16,904212
26035,13,-9,447,370120,13,370107
26036,17,19,15,1240768,17,1240751
26037,19,-17,857,121863,19,121844
26038,14,9,13,929129,14,929115
26039,5,-10,467,322810,5,322805
26040,10,17,56,1156545,10,1156535
26041,12,-11,819,310087,12,310075
26042,14,-7,807,434171,14,434157
26043,10,-13,118,220923,10,220913
26044,17,-7,34,428593,17,428576
26045,6,3,418,727771,6,727765
26046,11,16,929,1153764,11,1153753
26047,5,17,538,1166783,5,1166778
26048,7,8,234,880376,7,880369
26049,11,-18,281,87440,11,87429
26050,17,1,657,685047,17,685030
26051,11,17,701,1183128,11,1183117
26052,8,10,600,950465,8,950457
26053,12,2,74,711120,12,711108
26054,17,0,801,654408,17,654391
26055,13,-8,604,402075,13,402062
26056,9,-8,258,380941,9,380932
26057,20,-3,511,557747,20,557727
26058,8,0,250,630823,8,630815
26059,7,-10,319,319455,7,319448
26060,18,1,49,680171,18,680153
26061,5,-15,686,170035,5,170030
26062,14,-20,658,27839,14,27825
26063,16,-19,662,59155,16,59139
26064,15,1,33,680041,15,680026
26065,12,-4,996,529575,12,529563
26066,9,-3,936,551486,9,551477
26067,18,1,513,683915,18,683897
26068,12,-12,532,276483,12,276471
26069,7,15,371,1102319,7,1102312
26070,19,-18,930,91983,19,91964
26071,18,-3,7,553916,18,553898
26072,19,-16,268,148948,19,148929
26073,9,11,565,980571,9,980562
26074,9,-6,724,452393,9,452384
26075,7,-15,389,163783,7,163776
26076,11,1,725,685504,11,685493
26077,8,-2,782,579436,8,579428
26078,6,10,419,946496,6,946490
26079,9,19,97,1219623,9,1219614
26080,10,18,48,1187695,10,1187685
26081,19,-18,140,86269,19,86250
26082,5,-12,74,251190,5,251185
26083,5,4,66,752028,5,752023
26084,13,16,949,1153840,13,1153827
26085,5,-10,897,331767,5,331762
26086,11,-4,86,522680,11,522669
26087,18,17,615,1182432,18,1182414
26088,9,-12,356,257402,9,257393
26089,17,-19,833,60390,17,60373
26090,16,-5,834,497077,16,497061
26091,18,-2,547,589235,18,589217
26092,10,-10,942,332745,10,332735
26093,11,0,605,652831,11,652820
26094,8,-9,692,358806,8,358798
26095,7,0,120,628077,7,628070
26096,8,-15,159,158828,8,158820
26097,5,8,467,885401,5,885396
26098,6,8,389,883714,6,883708
26099,11,16,578,1151165,11,1151154
26100,19,15,712,1122066,19,1122047
26101,6,-1,682,608564,6,608558
26102,8,-10,296,318932,8,318924
26103,15,8,25,898072,15,898057
26104,7,7,587,857271,7,857264
26105,12,18,104,1209771,12,1209759
26106,6,-18,545,74124,6,74118
26107,14,0,998,655935,14,655921
26108,6,12,389,1007485,6,1007479
26109,9,14,967,1083391,9,1083382
26110,17,5,449,807085,17,807068
26111,11,11,32,991126,11,991115
26112,18,-7,248,430124,18,430106
26113,7,-8,178,379312,7,379305
26114,6,-5,923,488095,6,488089
26115,17,-2,655,590071,17,590054
26116,5,-20,675,14901,5,14896
26117,11,-18,359,88006,11,87995
26118,14,10,406,962903,14,962889
26119,8,14,456,1071970,8,1071962
26120,13,12,349,1024631,13,1024618
26121,13,13,534,1057179,13,1057166
26122,6,-17,534,104916,6,104910
26123,9,4,2,750610,9,750601
26124,20,1,912,686969,20,686949
26125,13,2,113,711438,13,711425
26126,10,-3,226,535222,10,535212
26127,20,7,374,869735,20,869715
26128,9,13,385,1038991,9,1038982
26129,7,4,813,768330,7,768323
26130,17,-11,29,303885,17,303868
26131,14,11,702,995819,14,995805
26132,19,4,394,776035,19,776016
26133,17,-19,352,56760,17,56743
26134,18,5,307,806020,18,806002
26135,5,-10,392,321035,5,321030
26136,5,12,98,1001212,5,1001207
26137,20,9,877,935575,20,935555
26138,16,-20,493,26508,16,26492
26139,10,-14,917,206482,10,206472
26140,13,-9,995,374223,13,374210
26141,13,4,864,779717,13,779704
26142,8,15,675,1108760,8,1108752
26143,16,11,331,993268,16,993252
26144,12,-2,620,589817,12,589805
26145,16,1,416,683132,16,683116
26146,8,19,5,1217527,8,1217519
26147,8,15,446,1103907,8,1103899
26148,19,7,304,869215,19,869196
26149,18,6,819,842359,18,842341
26150,20,2,929,717365,20,717345
26151,20,16,174,1148341,20,1148321
26152,6,9,165,910281,6,910275
26153,6,-5,848,486363,6,486357
26154,8,13,30,1031416,8,1031408
26155,12,-13,722,246337,12,246325
26156,12,-14,466,213118,12,213106
26157,9,-20,145,3190,9,3181
26158,20,-14,276,211591,20,211571
26159,15,-5,137,491978,15,491963
26160,5,13,459,1040609,5,1040604
26161,8,1,865,675824,8,675816
26162,20,-14,207,210932,20,210912
26163,17,3,152,742978,17,742961
26164,11,5,386,806640,11,806629
26165,12,-14,240,211279,12,211267
26166,14,3,122,742760,14,742746
26167,9,-1,281,600019,9,600010
26168,9,12,847,1017612,9,1017603
26169,9,-18,84,64326,9,64317
26170,16,18,790,1214742,16,1214726
26171,8,14,48,1062873,8,1062865
26172,20,19,204,1242391,20,1242371
26173,12,-14,177,210649,12,210637
26174,20,15,73,1117318,20,1117298
26175,17,-4,391,525165,17,525148
26176,8,17,719,1170620,8,1170612
26177,13,-10,947,342211,13,342198
26178,20,17,932,1184875,20,1184855
26179,6,2,343,696041,6,696035
26180,7,15,822,1111849,7,1111842
26181,16,6,504,839863,16,839847
26182,13,18,560,1213030,13,1213017
26183,17,15,288,1118928,17,1118911
26184,5,13,352,1038354,5,1038349
26185,19,-9,993,374205,19,374186
26186,19,-2,516,589031,19,589012
26187,17,-19,110,54841,17,54824
26188,10,-6,148,439913,10,439903
26189,12,2,941,717472,12,717460
26190,8,4,304,757110,8,757102
26191,14,3,70,742354,14,742340
26192,14,-20,401,25852,14,25838
26193,15,-13,469,244435,15,244420
26194,6,3,140,721845,6,721839
26195,14,4,333,775612,14,775598
26196,7,14,915,1082204,7,1082197
26197,15,15,75,1117334,15,1117319
26198,17,18,603,1213243,17,1213226
26199,9,4,731,766492,9,766483
26200,10,-11,727,296908,10,296898
26201,6,-14,122,189111,6,189105
26202,20,-5,317,493437,20,493417
26203,10,12,334,1006479,10,1006469
26204,8,7,832,862464,8,862456
26205,5,4,609,763819,5,763814
26206,16,17,923,1184835,16,1184819
26207,8,-18,317,69466,8,69458
26208,20,-13,470,244451,20,244431
26209,15,-13,757,246634,15,246619
26210,16,-14,365,212282,16,212266
26211,19,6,254,837674,19,837655
26212,14,8,846,904544,14,904530
26213,6,-7,836,423524,6,423518
26214,5,-3,337,537819,5,537814
26215,13,5,878,810182,13,810169
26216,7,-16,511,135163,7,135156
26217,18,4,920,780055,18,780037
26218,19,11,276,992854,19,992835
26219,8,8,460,885247,8,885239
26220,14,8,420,901331,14,901317
26221,10,8,512,886476,10,886466
26222,11,-17,177,116755,11,116744
26223,15,4,912,780004,15,779989
26224,13,-3,460,557326,13,557313
26225,13,8,14,898022,13,898009
26226,13,19,424,1244342,13,1244329
26227,19,19,615,1245793,19,1245774
26228,17,-11,658,308969,17,308952
26229,5,-9,937,364658,5,364653
26230,19,-11,359,306639,19,306620
26231,12,4,876,779787,12,779775
26232,17,18,106,1209825,17,1209808
26233,13,-19,653,59119,13,59106
26234,18,-1,11,616567,18,616549
26235,8,-13,440,227575,8,227567
26236,15,-8,579,401906,15,401891
26237,14,14,531,1089606,14,1089592
26238,7,-14,56,187747,7,187740
26239,18,-5,250,492846,18,492828
26240,14,8,297,900287,14,900273
26241,15,13,560,1057461,15,1057446
26242,13,18,415,1212111,13,1212098
26243,12,8,130,898953,12,898941
26244,19,2,551,714755,19,714736
26245,9,-11,835,299002,9,298993
26246,18,-15,939,184922,18,184904
26247,16,4,271,775148,16,775132
26248,16,-4,694,527321,16,527305
26249,9,-3,802,548344,9,548335
26250,15,0,468,651667,15,651652
26251,15,-1,555,620957,15,620942
26252,13,15,738,1122252,13,1122239
26253,5,-11,798,298259,5,298254
26254,11,19,564,1245378,11,1245367
26255,5,-19,376,39601,5,39596
26256,7,-5,810,485464,7,485457
26257,12,4,527,777077,12,777065
26258,8,10,840,955586,8,955578
26259,10,12,624,1012615,10,1012605
26260,15,-10,35,335423,15,335408
26261,5,1,222,662070,5,662065
26262,20,13,359,1055880,20,1055860
26263,8,1,525,668825,8,668817
26264,18,-20,69,23305,18,23287
26265,11,-20,966,30088,11,30077
26266,10,8,755,891762,10,891752
26267,5,15,275,1100386,5,1100381
26268,19,9,774,934752,19,934733
26269,12,-11,782,309850,12,309838
26270,17,12,463,1025455,17,1025438
26271,7,-5,194,472259,7,472252
26272,10,-14,932,206720,10,206710
26273,14,3,635,746632,14,746618
26274,19,10,135,960935,19,960916
26275,7,11,304,974876,7,974869
26276,13,19,822,1247396,13,1247383
26277,15,-6,185,460588,15,460573
26278,18,-17,493,119181,18,119163
26279,11,13,465,1056671,11,1056660
26280,8,10,73,939074,8,939066
26281,15,-5,86,491567,15,491552
26282,19,1,901,686845,19,686826
26283,9,-11,579,293997,9,293988
26284,8,-11,615,294782,8,294774
26285,5,-5,798,485120,5,485115
26286,20,-14,130,210288,20,210268
26287,12,8,138,899026,12,899014
26288,15,11,318,993180,15,993165
26289,16,7,680,872006,16,871990
26290,6,3,451,728527,6,728521
26291,15,-13,501,244710,15,244695
26292,11,17,915,1184795,11,1184784
26293,6,1,644,671242,6,671236
26294,14,14,371,1088320,14,1088306
26295,20,-1,828,622908,20,622888
26296,15,10,910,966823,15,966808
26297,16,-3,686,559247,16,559231
26298,20,19,268,1242907,20,1242887
26299,10,19,449,1227874,10,1227864
26300,6,18,734,1202008,6,1202002
26301,8,8,677,890088,8,890080
26302,18,-19,89,54618,18,54600
26303,16,9,935,936049,16,936033
26304,5,10,675,952089,5,952084
26305,15,15,678,1121758,15,1121743
26306,5,-17,328,100526,5,100521
26307,17,-13,826,247138,17,247121
26308,16,-15,165,178988,16,178972
26309,20,-3,769,559973,20,559953
26310,10,1,405,666022,10,666012
26311,12,-15,124,178716,12,178704
26312,11,-18,310,87664,11,87653
26313,19,-18,816,91216,19,91197
26314,10,3,744,734951,10,734941
26315,13,-7,505,432111,13,432098
26316,9,11,67,969905,9,969896
26317,15,-11,26,303855,15,303840
26318,16,-2,111,585970,16,585954
26319,8,14,852,1080859,8,1080851
26320,10,10,407,946241,10,946231
26321,9,5,209,786055,9,786046
26322,14,3,672,746922,14,746908
26323,13,-19,96,54682,13,54669
26324,16,-5,344,493666,16,493650
26325,9,-14,348,194260,9,194251
26326,8,0,283,631394,8,631386
26327,14,12,455,1025374,14,1025360
26328,17,17,586,1182201,17,1182184
26329,12,-8,621,402228,12,402216
26330,10,10,971,958264,10,958254
26331,17,19,737,1246773,17,1246756
26332,20,-10,139,336165,20,336145
26333,15,2,696,715867,15,715852
26334,19,-20,925,29835,19,29816
26335,11,-19,398,57116,11,57105
26336,9,-15,69,156776,9,156767
26337,11,5,724,809063,11,809052
26338,20,-20,767,28701,20,28681
26339,8,-16,193,128255,8,128247
26340,17,-14,130,210295,17,210278
26341,17,-6,178,460552,17,460535
26342,8,-13,58,219656,8,219648
26343,8,6,220,817050,8,817042
26344,14,12,557,1026125,14,1026111
26345,16,-10,363,337655,16,337639
26346,18,19,987,1248701,18,1248683
26347,8,-2,202,567067,8,567059
26348,12,10,55,960261,12,960249
26349,14,-5,272,493043,14,493029
26350,5,2,116,691094,5,691089
26351,14,0,588,652722,14,652708
26352,12,9,203,930546,12,930534
26353,14,9,295,931081,14,931067
26354,7,9,558,918538,7,918531
26355,14,9,22,929200,14,929186
26356,14,0,15,648292,14,648278
26357,8,-13,366,226032,8,226024
26358,13,-14,665,214712,13,214699
26359,6,-19,442,41036,6,41030
26360,13,-10,974,342442,13,342429
26361,6,13,848,1048975,6,1048969
26362,15,3,949,749085,15,749070
26363,16,-20,990,30363,16,30347
26364,18,12,615,1026573,18,1026555
26365,13,-9,611,371431,13,371418
26366,16,8,750,903853,16,903837
26367,17,-13,972,248388,17,248371
26368,11,-12,974,279894,11,279883
26369,17,-17,649,120343,17,120326
26370,18,1,178,681289,18,681271
26371,15,-1,254,618514,15,618499
26372,7,-14,981,207899,7,207892
26373,8,-6,337,444063,8,444055
26374,11,14,295,1087708,11,1087697
26375,16,18,314,1211367,16,1211351
26376,10,13,814,1048320,10,1048310
26377,11,-1,634,621448,11,621437
26378,11,-12,576,276762,11,276751
26379,15,18,323,1211434,15,1211419
26380,11,16,102,1147781,11,1147770
26381,16,14,810,1091823,16,1091807
26382,10,-5,76,469572,10,469562
26383,9,-1,408,602922,9,602913
26384,13,-4,795,527964,13,527951
26385,9,17,505,1166133,9,1166124
26386,15,9,583,933356,15,933341
26387,19,19,244,1242646,19,1242627
26388,7,13,455,1040556,7,1040549
26389,6,18,547,1198484,6,1198478
26390,8,-15,109,157781,8,157773
26391,13,-11,462,307444,13,307431
26392,13,2,193,712036,13,712023
26393,7,-9,126,346304,7,346297
26394,13,-6,401,462167,13,462154
26395,17,-15,57,178199,17,178182
26396,5,-15,601,168306,5,168301
26397,15,-8,856,403937,15,403922
26398,5,4,373,758644,5,758639
26399,14,3,538,745762,14,745748
26400,6,19,533,1229589,6,1229583
26401,17,8,520,902128,17,902111
26402,18,10,190,961303,18,961285
26403,11,-3,608,558591,11,558580
26404,9,-19,257,37173,9,37164
26405,17,17,691,1183037,17,1183020
26406,11,-12,306,274795,11,274784
26407,8,-19,143,34759,8,34751
26408,17,1,892,686770,17,686753
26409,10,-20,107,2354,10,2344
26410,13,-7,196,429747,13,429734
26411,12,8,454,901564,12,901552
26412,15,6,913,843077,15,843062
26413,6,-5,802,485228,6,485222
26414,10,-5,799,485129,10,485119
26415,5,-9,61,344933,5,344928
26416,7,-15,683,170023,7,170016
26417,7,-7,627,419157,7,419150
26418,5,15,941,1114456,5,1114451
26419,9,-4,122,501973,9,501964
26420,17,-11,533,308010,17,307993
26421,13,1,854,686463,13,686450
26422,14,-15,72,178299,14,178285
26423,12,-8,269,399749,12,399737
26424,18,-12,465,275923,18,275905
26425,16,14,35,1085678,16,1085662
26426,13,-3,663,559073,13,559060
26427,14,1,661,685071,14,685057
26428,13,10,310,962156,13,962143
26429,6,7,223,849479,6,849473
26430,20,-4,171,523372,20,523352
26431,12,14,805,1091751,12,1091739
26432,7,-11,364,289186,7,289179
26433,17,-3,528,557986,17,557969
26434,14,-13,516,244855,14,244841
26435,15,-1,135,617592,15,617577
26436,7,-1,78,595470,7,595463
26437,12,15,311,1119064,12,1119052
26438,14,14,355,1088182,14,1088168
26439,18,14,9,1085441,18,1085423
26440,12,15,226,1118514,12,1118502
26441,6,-14,804,204172,6,204166
26442,7,1,970,678128,7,678121
26443,20,12,639,1026793,20,1026773
26444,12,-20,587,27258,12,27246
26445,6,-19,825,49472,6,49466
26446,19,-1,528,620794,19,620775
26447,18,9,841,935308,18,935290
26448,5,6,906,832632,5,832627
26449,14,-15,629,182411,14,182397
26450,12,-2,872,591763,12,591751
26451,16,-6,458,462659,16,462643
26452,16,15,354,1119390,16,1119374
26453,6,11,127,971125,6,971119
26454,13,16,781,1152668,13,1152655
26455,17,-10,286,337114,17,337097
26456,12,12,385,1024865,12,1024853
26457,16,-2,238,586948,16,586932
26458,5,19,237,1222738,5,1222733
26459,14,-3,884,560870,14,560856
26460,17,3,378,744708,17,744691
26461,18,1,403,683059,18,683041
26462,10,1,693,672139,10,672129
26463,14,-7,927,435157,14,435143
26464,12,-14,567,213976,12,213964
26465,10,7,779,861262,10,861252
26466,5,18,490,1197210,5,1197205
26467,17,-7,16,428412,17,428395
26468,15,10,254,961728,15,961713
26469,11,-18,417,88406,11,88395
26470,13,1,654,685015,13,685002
26471,8,-9,810,361646,8,361638
26472,20,1,331,682542,20,682522
26473,20,-2,775,590918,20,590898
26474,10,-9,371,351759,10,351749
26475,11,-11,898,310729,11,310718
26476,16,5,683,808790,16,808774
26477,14,9,630,933756,14,933742
26478,10,7,150,847971,10,847961
26479,13,16,64,1147542,13,1147529
26480,20,-6,178,460562,20,460542
26481,14,5,8,803844,14,803830
26482,12,1,652,684993,12,684981
26483,7,-18,415,71303,7,71296
26484,8,-2,939,582969,8,582961
26485,18,-20,34,19620,18,19602
26486,12,-11,98,304467,12,304455
26487,10,0,660,639802,10,639792
26488,18,10,22,960002,18,959984
26489,6,6,730,828869,6,828863
26490,17,1,561,684328,17,684311
26491,10,5,497,791901,10,791891
26492,19,2,598,715053,19,715034
26493,19,9,960,936240,19,936221
26494,19,-13,475,244475,19,244456
26495,7,15,115,1096987,7,1096980
26496,17,0,51,648627,17,648610
26497,8,12,379,1007292,8,1007284
26498,16,7,55,867441,16,867425
26499,11,1,98,680564,11,680553
26500,7,-5,56,469078,7,469071
26501,7,-2,293,569121,7,569114
26502,8,-18,197,66750,8,66742
26503,6,7,354,852452,6,852446
26504,13,8,651,903124,13,903111
26505,9,16,323,1132024,9,1132015
26506,17,-19,88,54604,17,54587
26507,8,16,836,1142544,8,1142536
26508,12,8,118,898852,12,898840
26509,6,19,716,1233395,6,1233389
26510,18,-4,125,523006,18,522988
26511,18,-15,124,178724,18,178706
26512,17,-20,771,28755,17,28738
26513,20,-11,115,304630,20,304610
26514,5,13,125,1033404,5,1033399
26515,19,3,276,743986,19,743967
26516,11,14,90,1086149,11,1086138
26517,18,-9,986,374182,18,374164
26518,20,6,141,836824,20,836804
26519,9,0,458,635338,9,635329
26520,5,-6,199,441211,5,441206
26521,11,-8,551,401748,11,401737
26522,7,-6,749,452938,7,452931
26523,18,8,282,900225,18,900207
26524,16,-1,651,621618,16,621602
26525,15,-2,711,590499,15,590484
26526,13,-14,631,214466,13,214453
26527,5,-9,187,347551,5,347546
26528,5,11,943,988716,5,988711
26529,20,-8,842,403869,20,403849
26530,17,4,340,775673,17,775656
26531,11,-15,622,182327,11,182316
26532,11,-6,2,459151,11,459140
26533,8,8,35,875804,8,875796
26534,9,1,442,666790,9,666781
26535,8,-9,253,349122,8,349114
26536,9,-13,744,234259,9,234250
26537,14,-19,921,60951,14,60937
26538,10,15,502,1105097,10,1105087
26539,14,-2,217,586769,14,586755
26540,9,-19,271,37452,9,37443
26541,5,9,203,911045,5,911040
26542,11,11,317,993168,11,993157
26543,12,-1,894,623402,12,623390
26544,12,15,658,1121625,12,1121613
26545,9,14,660,1076736,9,1076727
26546,5,7,433,854126,5,854121
26547,13,8,164,899247,13,899234
26548,18,18,683,1213901,18,1213883
26549,10,-2,101,564964,10,564954
26550,20,12,660,1026970,20,1026950
26551,7,-14,632,200622,7,200615
26552,8,-14,365,194667,8,194659
26553,11,-18,249,87262,11,87251
26554,12,9,783,934828,12,934816
26555,6,-6,75,438341,6,438335
26556,11,9,1,929070,11,929059
26557,18,-16,192,148346,18,148328
26558,13,16,58,1147507,13,1147494
26559,7,9,542,918207,7,918200
26560,7,6,879,832044,7,832037
26561,15,-3,400,556734,15,556719
26562,6,-16,277,130051,6,130045
26563,11,2,755,716258,11,716247
26564,15,10,312,962170,15,962155
26565,17,-19,387,57024,17,57007
26566,12,12,484,1025633,12,1025621
26567,16,-8,795,403573,16,403557
26568,14,0,651,653226,14,653212
26569,5,-8,689,390240,5,390235
26570,11,-1,524,620751,11,620740
26571,15,-20,235,24548,15,24533
26572,5,8,888,894395,5,894390
26573,7,-20,295,6603,7,6596
26574,9,9,429,915654,9,915645
26575,20,-1,949,623811,20,623791
26576,17,-15,875,184400,17,184383
26577,18,17,38,1178163,18,1178145
26578,8,15,892,1113408,8,1113400
26579,9,19,588,1230763,9,1230754
26580,16,1,376,682857,16,682841
26581,16,-7,431,431549,16,431533
26582,15,-15,626,182395,15,182380
26583,19,8,459,901591,19,901572
26584,15,8,714,903655,15,903640
26585,7,5,394,789736,7,789729
26586,18,9,369,931760,18,931742
26587,5,-17,688,108216,5,108211
26588,10,-19,253,37106,10,37096
26589,17,-10,8,335182,17,335165
26590,14,-17,667,120537,14,120523
26591,12,15,184,1118194,12,1118182
26592,20,18,867,1215274,20,1215254
26593,12,-19,745,59872,12,59860
26594,12,19,93,1241528,12,1241516
26595,17,8,731,903755,17,903738
26596,6,10,314,944179,6,944173
26597,17,-10,69,335703,17,335686
26598,8,6,77,813783,8,813775
26599,14,-19,551,58331,14,58317
26600,18,-4,3,522067,18,522049
26601,6,8,915,895070,6,895064
26602,19,17,669,1182853,19,1182834
26603,16,14,865,1092177,16,1092161
26604,13,-14,891,216439,13,216426
26605,18,-8,771,403338,18,403320
26606,12,-12,4,272528,12,272516
26607,8,-2,475,572922,8,572914
26608,18,-1,540,620845,18,620827
26609,7,18,943,1206656,7,1206649
26610,12,13,493,1056869,12,1056857
26611,10,7,507,855658,10,855648
26612,5,-2,703,577845,5,577840
26613,13,-17,345,118061,13,118048
26614,10,-1,314,600881,10,600871
26615,16,11,401,993843,16,993827
26616,15,17,571,1182063,15,1182048
26617,14,16,918,1153699,14,1153685
26618,11,15,508,1120436,11,1120425
26619,18,-18,789,91000,18,90982
26620,16,-13,839,247272,16,247256
26621,8,18,968,1207274,8,1207266
26622,12,-15,236,179450,12,179438
26623,9,-6,650,450738,9,450729
26624,9,12,38,999925,9,999916
26625,10,-3,931,551331,10,551321
26626,12,-14,200,210848,12,210836
26627,9,13,560,1042810,9,1042801
26628,6,-10,282,318603,6,318597
26629,9,-3,643,544940,9,544931
26630,19,-15,659,182710,19,182691
26631,11,-18,154,86435,11,86424
26632,17,11,266,992761,17,992744
26633,6,-1,222,598605,6,598599
26634,19,-1,848,623065,19,623046
26635,12,17,34,1178130,12,1178118
26636,15,-3,148,554822,15,554807
26637,19,7,325,869409,19,869390
26638,14,0,855,654725,14,654711
26639,16,-19,596,58699,16,58683
26640,17,-15,996,185324,17,185307
26641,10,15,380,1102541,10,1102531
26642,19,16,36,1147329,19,1147310
26643,9,-18,656,76491,9,76482
26644,8,-14,16,186838,8,186830
26645,20,-3,563,558243,20,558223
26646,16,-4,69,522568,16,522552
26647,12,17,998,1185482,12,1185470
26648,19,18,105,1209795,19,1209776
26649,15,-16,13,146843,15,146828
26650,20,12,19,1022223,20,1022203
26651,5,-5,481,478387,5,478382
26652,9,9,161,910189,9,910180
26653,18,18,381,1211856,18,1211838
26654,12,17,946,1184982,12,1184970
26655,15,4,378,775963,15,775948
26656,15,13,756,1058867,15,1058852
26657,18,-19,235,55882,18,55864
26658,13,9,507,932775,13,932762
26659,18,2,161,711822,18,711804
26660,18,1,923,687079,18,687061
26661,12,-6,531,463234,12,463222
26662,9,16,710,1139901,9,1139892
26663,16,3,868,748377,16,748361
26664,16,15,730,1122210,16,1122194
26665,15,4,274,775176,15,775161
26666,10,1,67,658470,10,658460
26667,12,-20,19,11557,12,11545
26668,16,8,328,900562,16,900546
26669,16,16,424,1150184,16,1150168
26670,13,13,996,1060589,13,1060576
26671,14,-17,596,119986,14,119972
26672,14,13,952,1060306,14,1060292
26673,5,-3,699,546174,5,546169
26674,9,1,92,659001,9,658992
26675,8,-17,589,106226,8,106218
26676,16,-6,968,466452,16,466436
26677,11,12,862,1028558,11,1028547
26678,9,-14,660,201112,9,201103
26679,11,19,161,1242050,11,1242039
26680,9,8,524,886762,9,886753
26681,5,-14,496,197405,5,197400
26682,15,-2,40,585426,15,585411
26683,6,14,241,1067138,6,1067132
26684,16,-13,797,246957,16,246941
26685,17,-12,654,277327,17,277310
26686,13,-12,582,276774,13,276761
26687,19,1,885,686689,19,686670
26688,10,10,821,955285,10,955275
26689,15,-6,24,459331,15,459316
26690,15,15,162,1117962,15,1117947
26691,17,9,50,929463,17,929446
26692,17,-3,361,556455,17,556438
26693,18,-2,613,589751,18,589733
26694,15,-13,701,246141,15,246126
26695,11,-11,317,306308,11,306297
26696,14,16,553,1151028,14,1151014
26697,14,-6,635,464018,14,464004
26698,19,12,350,1024639,19,1024620
26699,11,-10,951,342234,11,342223
26700,18,6,664,841117,18,841099
26701,15,-9,964,374131,15,374116
26702,8,13,290,1036909,8,1036901
26703,18,-20,636,27619,18,27601
26704,17,-7,204,429837,17,429820
26705,19,15,702,1121940,19,1121921
26706,17,-18,463,88772,17,88755
26707,11,-15,777,183582,11,183571
26708,11,-17,238,117220,11,117209
26709,16,-15,655,182683,16,182667
26710,13,-1,655,621647,13,621634
26711,19,6,202,837237,19,837218
26712,11,-18,273,87379,11,87368
26713,12,-5,858,497273,12,497261
26714,16,8,155,899165,16,899149
26715,8,16,147,1128223,8,1128215
26716,5,-10,613,325913,5,325908
26717,11,-12,318,274877,11,274866
26718,8,4,806,768174,8,768166
26719,19,2,289,712761,19,712742
26720,16,-17,849,121823,16,121807
26721,12,8,80,898516,12,898504
26722,19,-10,634,339827,19,339808
26723,16,-1,377,619591,16,619575
26724,17,1,713,685344,17,685327
26725,12,-13,54,241487,12,241475
26726,16,-10,37,335429,16,335413
26727,18,16,132,1148027,18,1148009
26728,12,0,711,653715,12,653703
26729,17,18,631,1213495,17,1213478
26730,19,0,167,649490,19,649471
26731,7,-5,274,474073,7,474066
26732,11,12,946,1029375,11,1029364
26733,7,9,535,918075,7,918068
26734,8,12,442,1008569,8,1008561
26735,12,9,525,932897,12,932885
26736,8,6,810,830600,8,830592
26737,13,-18,850,91366,13,91353
26738,6,10,79,939199,6,939193
26739,11,-2,690,590348,11,590337
26740,8,-1,321,601010,8,601002
26741,14,-16,420,150020,14,150006
26742,5,-8,456,384742,5,384737
26743,7,5,381,789471,7,789464
26744,15,2,935,717419,15,717404
26745,15,11,777,996478,15,996463
26746,15,9,809,935031,15,935016
26747,16,-6,718,464617,16,464601
26748,17,11,558,994865,17,994848
26749,5,-8,127,378043,5,378038
26750,18,0,415,651273,18,651255
26751,14,8,465,901647,14,901633
26752,19,-18,150,86397,19,86378
26753,11,-5,978,498214,11,498203
26754,16,-8,479,401163,16,401147
26755,14,10,613,964640,14,964626
26756,10,9,746,922378,10,922368
26757,13,17,580,1182121,13,1182108
26758,10,-1,668,608231,10,608221
26759,15,6,70,836270,15,836255
26760,20,4,346,775714,20,775694
26761,6,-6,190,441028,6,441022
26762,9,-5,993,489574,9,489565
26763,19,17,303,1180221,19,1180202
26764,15,2,118,711483,15,711468
26765,14,14,854,1092061,14,1092047
26766,20,19,283,1243006,20,1242986
26767,16,-15,460,181147,16,181131
26768,19,5,694,808860,19,808841
26769,11,4,772,778928,11,778917
26770,15,-18,246,87244,15,87229
26771,9,-3,632,544700,9,544691
26772,19,-4,149,523201,19,523182
26773,18,-14,80,209938,18,209920
26774,8,16,283,1131180,8,1131172
26775,18,10,820,966222,18,966204
26776,6,-2,421,571689,6,571683
26777,13,8,197,899492,13,899479
26778,17,3,198,743374,17,743357
26779,7,16,935,1144681,7,1144674
26780,8,-3,214,534965,8,534957
26781,19,2,926,717345,19,717326
26782,15,-10,844,341421,15,341406
26783,8,-12,684,264315,8,264307
26784,16,4,70,773769,16,773753
26785,12,-16,116,147783,12,147771
26786,9,-18,463,72422,9,72413
26787,9,-8,119,377865,9,377856
26788,16,-2,813,591251,16,591235
26789,9,-6,681,451375,9,451366
26790,14,-6,279,461354,14,461340
26791,17,1,623,684752,17,684735
26792,10,-20,795,17560,10,17550
26793,6,11,165,971872,6,971866
26794,8,-8,622,388619,8,388611
26795,18,-6,14,459241,18,459223
26796,14,19,808,1247332,14,1247318
26797,16,-8,373,400524,16,400508
26798,20,14,739,1091220,20,1091200
26799,7,-10,809,329968,7,329961
26800,9,7,979,865500,9,865491
26801,20,-8,5,397887,20,397867
26802,9,8,470,885446,9,885437
26803,15,11,748,996217,15,996202
26804,8,10,244,942608,8,942600
26805,8,-14,148,189676,8,189668
26806,18,16,827,1153062,18,1153044
26807,14,-11,765,309696,14,309682
26808,5,8,519,886641,5,886636
26809,16,0,445,651476,16,651460
26810,14,-6,462,462717,14,462703
26811,6,14,326,1069019,6,1069013
26812,13,7,953,873766,13,873753
26813,10,13,271,1036385,10,1036375
26814,8,-3,596,543838,8,543830
26815,12,-20,497,26530,12,26518
26816,7,-4,411,508532,7,508525
26817,19,-19,47,54241,19,54222
26818,6,-19,967,52260,6,52254
26819,12,9,132,930044,12,930032
26820,11,-7,860,434601,11,434590
26821,9,-19,568,43965,9,43956
26822,15,16,795,1152782,15,1152767
26823,17,14,507,1089415,17,1089398
26824,6,-4,364,507533,6,507527
26825,16,5,308,806025,16,806009
26826,6,12,370,1007193,6,1007187
26827,9,-14,630,200587,9,200578
26828,18,14,205,1087001,18,1086983
26829,20,-10,206,336570,20,336550
26830,6,-11,311,288041,6,288035
26831,18,-19,241,55927,18,55909
26832,13,18,405,1212038,13,1212025
26833,19,-12,705,277694,19,277675
26834,16,14,89,1086141,16,1086125
26835,9,-18,365,70252,9,70243
26836,15,-12,749,278016,15,278001
26837,15,1,248,681838,15,681823
26838,7,-9,221,348278,7,348271
26839,9,-11,125,283829,9,283820
26840,20,-4,781,527901,20,527881
26841,18,-7,506,432118,18,432100
26842,20,19,71,1241352,20,1241332
26843,16,13,215,1054835,16,1054819
26844,20,-8,720,402975,20,402955
26845,18,-7,185,429675,18,429657
26846,10,12,353,1006854,10,1006844
26847,9,15,814,1111677,9,1111668
26848,9,-17,820,110855,9,110846
26849,6,-3,476,541141,6,541135
26850,12,-1,341,619316,12,619304
26851,18,-7,462,431799,18,431781
26852,9,-1,234,599033,9,599024
26853,19,-12,74,273086,19,273067
26854,15,-11,180,305193,15,305178
26855,15,-6,21,459304,15,459289
26856,5,-7,319,412809,5,412804
26857,12,7,178,868303,12,868291
26858,13,-17,367,118193,13,118180
26859,16,4,895,779871,16,779855
26860,12,-9,654,371678,12,371666
26861,5,10,431,946752,5,946747
26862,14,-1,647,621549,14,621535
26863,19,-6,241,461067,19,461048
26864,19,15,5,1116795,19,1116776
26865,5,-9,144,346659,5,346654
26866,14,-5,829,497009,14,496995
26867,11,11,561,994879,11,994868
26868,11,15,218,1118451,11,1118440
26869,19,-14,149,210438,19,210419
26870,7,-7,195,409960,7,409953
26871,13,-13,603,245484,13,245471
26872,11,11,467,994255,11,994244
26873,6,1,163,660722,6,660716
26874,15,5,568,807910,15,807895
26875,9,14,976,1083665,9,1083656
26876,8,-15,430,164759,8,164751
26877,7,-17,189,97379,7,97372
26878,20,2,320,712983,20,712963
26879,13,-8,546,401703,13,401690
26880,19,-9,227,368215,19,368196
26881,20,3,646,746716,20,746696
26882,8,-1,135,596767,8,596759
26883,6,15,780,1111005,6,1110999
26884,9,-9,584,356779,9,356770
26885,9,-19,838,49812,9,49803
26886,13,-16,94,147588,13,147575
26887,15,-10,684,340227,15,340212
26888,11,-20,538,26904,11,26893
26889,9,-19,348,39050,9,39041
26890,18,-6,12,459229,18,459211
26891,16,8,150,899124,16,899108
26892,20,-14,14,209446,20,209426
26893,11,-3,68,554253,11,554242
26894,18,-5,500,494724,18,494706
26895,13,8,199,899513,13,899500
26896,5,-6,978,457649,5,457644
26897,14,1,832,686274,14,686260
26898,9,7,676,859158,9,859149
26899,17,-18,295,87533,17,87516
26900,19,-3,711,559448,19,559429
26901,6,-14,608,200053,6,200047
26902,8,5,347,788765,8,788757
26903,16,3,709,747248,16,747232
26904,16,-15,13,177919,16,177903
26905,10,15,335,1101654,10,1101644
26906,13,9,647,933832,13,933819
26907,10,-6,416,445665,10,445655
26908,17,6,673,841166,17,841149
26909,16,-4,716,527448,16,527432
26910,8,-5,103,470354,8,470346
26911,9,9,195,910855,9,910846
26912,16,10,522,963883,16,963867
26913,20,17,996,1185454,20,1185434
26914,15,-10,849,341462,15,341447
26915,20,17,687,1182975,20,1182955
26916,20,-20,730,28404,20,28384
26917,16,7,446,870358,16,870342
26918,12,15,828,1122850,12,1122838
26919,6,16,123,1127599,6,1127593
26920,9,16,421,1134229,9,1134220
26921,20,-1,563,620995,20,620975
26922,17,0,328,650513,17,650496
26923,19,-1,512,620636,19,620617
26924,15,8,538,902201,15,902186
26925,15,1,524,684005,15,683990
26926,19,-12,196,273891,19,273872
26927,14,3,131,742820,14,742806
26928,19,-19,212,55766,19,55747
26929,19,-9,927,373928,19,373909
26930,15,14,950,1092897,15,1092882
26931,9,-20,584,12760,9,12751
26932,9,1,847,675419,9,675410
26933,10,-5,172,471854,10,471844
26934,9,-7,21,406545,9,406536
26935,5,-15,830,173116,5,173111
26936,16,-19,423,57258,16,57242
26937,16,-13,990,248503,16,248487
26938,16,-8,172,399147,16,399131
26939,9,-15,407,164256,9,164247
26940,11,19,757,1246917,11,1246906
26941,12,-14,853,216174,12,216162
26942,8,-6,21,437306,8,437298
26943,20,-12,627,277071,20,277051
26944,16,12,893,1028804,16,1028788
26945,9,-9,911,364140,9,364131
26946,12,9,76,929608,12,929596
26947,12,14,620,1090240,12,1090228
26948,6,1,503,668280,6,668274
26949,17,8,85,898564,17,898547
26950,19,-10,298,337210,19,337191
26951,12,3,398,744868,12,744856
26952,18,12,177,1023340,18,1023322
26953,9,12,201,1003494,9,1003485
26954,7,-12,297,256037,7,256030
26955,17,-19,468,57569,17,57552
26956,5,-15,10,155486,5,155481
26957,15,-1,608,621290,15,621275
26958,12,8,611,902759,12,902747
26959,7,13,887,1049803,7,1049796
26960,12,16,11,1147167,12,1147155
26961,10,-10,216,317345,10,317335
26962,14,-2,405,588146,14,588132
26963,18,-10,196,336517,18,336499
26964,19,19,288,1243052,19,1243033
26965,17,-1,879,623318,17,623301
26966,5,12,56,1000322,5,1000317
26967,11,5,982,810989,11,810978
26968,14,-13,749,246565,14,246551
26969,10,-2,202,567077,10,567067
26970,10,-4,839,517204,10,517194
26971,16,-16,821,152936,16,152920
26972,9,-18,32,63094,9,63085
26973,19,-3,373,556547,19,556528
26974,13,-8,622,402241,13,402228
26975,17,19,186,1242228,17,1242211
26976,10,0,940,645757,10,645747
26977,13,14,940,1092814,13,1092801
26978,6,-18,497,73143,6,73137
26979,15,-8,259,399737,15,399722
26980,12,-19,152,55269,12,55257
26981,12,-7,626,432904,12,432892
26982,13,5,732,809113,13,809100
26983,12,-14,975,217100,12,217088
26984,5,-8,496,385651,5,385646
26985,5,-18,116,65007,5,65002
26986,10,-19,957,52059,10,52049
26987,18,-8,370,400489,18,400471
26988,5,19,967,1238881,5,1238876
26989,11,-17,989,122715,11,122704
26990,10,3,323,725965,10,725955
26991,8,-10,411,321559,8,321551
26992,15,-20,537,26877,15,26862
26993,6,17,660,1169469,6,1169463
26994,13,-3,327,556161,13,556148
26995,16,-10,936,342131,16,342115
26996,8,-14,599,199815,8,199807
26997,9,-15,886,174266,9,174257
26998,8,2,521,699738,8,699730
26999,14,2,437,713897,14,713883
27000,9,1,540,669168,9,669159
27001,11,0,102,649042,11,649031
27002,20,-3,605,558553,20,558533
27003,17,11,173,992062,17,992045
27004,20,-12,146,273605,20,273585
27005,9,-4,972,520348,9,520339
27006,7,-5,155,471486,7,471479
27007,15,0,579,652640,15,652625
27008,14,16,872,1153296,14,1153282
27009,14,-5,959,498056,14,498042
27010,7,-10,932,332448,7,332441
27011,20,-16,91,147576,20,147556
27012,12,6,155,836934,12,836922
27013,11,-2,663,590114,11,590103
27014,17,18,630,1213460,17,1213443
27015,6,-5,126,470807,6,470801
27016,11,7,674,871988,11,871977
27017,9,15,795,1111276,9,1111267
27018,7,-7,737,421463,7,421456
27019,13,-13,734,246438,13,246425
27020,15,5,322,806108,15,806093
27021,6,-13,253,223725,6,223719
27022,8,-8,918,394965,8,394957
27023,17,4,23,773413,17,773396
27024,13,8,866,904686,13,904673
27025,8,18,88,1188662,8,1188654
27026,8,-7,876,424485,8,424477
27027,13,9,592,933461,13,933448
27028,8,-3,168,533994,8,533986
27029,10,8,475,885570,10,885560
27030,11,7,502,870719,11,870708
27031,11,8,670,903260,11,903249
27032,8,-9,719,359429,8,359421
27033,14,3,691,747107,14,747093
27034,16,-7,374,431204,16,431188
27035,12,-20,765,28677,12,28665
27036,6,-3,710,546444,6,546438
27037,15,14,674,1090736,15,1090721
27038,15,16,70,1147591,15,1147576
27039,12,16,534,1150881,12,1150869
27040,15,4,807,779194,15,779179
27041,15,3,592,746253,15,746238
27042,16,10,30,960095,16,960079
27043,13,-14,23,209498,13,209485
27044,15,-6,644,464097,15,464082
27045,17,-14,396,212647,17,212630
27046,9,7,674,859130,9,859121
27047,15,5,312,806043,15,806028
27048,12,-12,119,273417,12,273405
27049,7,-6,778,453557,7,453550
27050,9,-13,268,224156,9,224147
27051,9,19,673,1232410,9,1232401
27052,16,18,235,1210850,16,1210834
27053,9,-7,607,418768,9,418759
27054,7,19,894,1237385,7,1237378
27055,11,-20,599,27353,11,27342
27056,16,-7,305,430619,16,430603
27057,19,2,140,711670,19,711651
27058,17,14,222,1087143,17,1087126
27059,11,-19,987,61380,11,61369
27060,8,-5,653,482133,8,482125
27061,14,-4,615,526715,14,526701
27062,10,-20,965,21211,10,21201
27063,13,8,388,901044,13,901031
27064,7,0,580,637916,7,637909
27065,18,-6,737,464789,18,464771
27066,6,-11,345,288716,6,288710
27067,6,6,317,819403,6,819397
27068,20,-5,251,492869,20,492849
27069,20,-16,72,147334,20,147314
27070,19,-13,999,248589,19,248570
27071,8,-7,433,415165,8,415157
27072,12,14,803,1091743,12,1091731
27073,5,6,344,820097,5,820092
27074,8,-18,93,64560,8,64552
27075,5,8,734,891442,5,891437
27076,6,-3,324,537454,6,537448
27077,14,5,174,805052,14,805038
27078,19,15,736,1122243,19,1122224
27079,18,-9,794,372847,18,372829
27080,8,8,365,883141,8,883133
27081,11,-12,150,273653,11,273642
27082,17,-7,99,428982,17,428965
27083,11,-11,51,304031,11,304020
27084,19,5,615,808323,19,808304
27085,12,0,986,655813,12,655801
27086,14,4,840,779508,14,779494
27087,20,-13,153,242136,20,242116
27088,13,-14,209,210941,13,210928
27089,19,-4,16,522160,19,522141
27090,6,-19,907,51023,6,51017
27091,15,-2,349,587699,15,587684
27092,17,2,125,711548,17,711531
27093,10,12,496,1009742,10,1009732
27094,8,2,397,697185,8,697177
27095,13,19,106,1241623,13,1241610
27096,6,-20,271,5974,6,5968
27097,6,-17,683,108127,6,108121
27098,18,16,890,1153425,18,1153407
27099,9,-17,209,97855,9,97846
27100,12,-4,155,523246,12,523234
27101,14,9,444,932259,14,932245
27102,13,-8,276,399826,13,399813
27103,14,-9,582,371278,14,371264
27104,5,-16,815,141506,5,141501
27105,16,8,855,904630,16,904614
27106,15,-3,99,554481,15,554466
27107,6,15,291,1100787,6,1100781
27108,10,7,31,845408,10,845398
27109,14,19,89,1241516,14,1241502
27110,5,2,228,693485,5,693480
27111,16,6,574,840431,16,840415
27112,17,-9,381,369509,17,369492
27113,8,2,237,693661,8,693653
27114,6,17,929,1175230,6,1175224
27115,12,7,830,873015,12,873003
27116,8,5,766,797642,8,797634
27117,5,-14,693,201891,5,201886
27118,7,1,534,669059,7,669052
27119,15,4,735,778675,15,778660
27120,9,5,738,797044,9,797035
27121,19,-1,284,618810,19,618791
27122,16,-2,450,588540,16,588524
27123,13,7,754,872473,13,872460
27124,10,18,440,1196134,10,1196124
27125,16,-1,841,623004,16,622988
27126,7,3,532,729964,7,729957
27127,16,-10,439,338269,16,338253
27128,9,-6,502,447653,9,447644
27129,9,-13,938,238718,9,238709
27130,18,-11,950,311154,18,311136
27131,11,11,965,997783,11,997772
27132,17,11,1000,998012,17,997995
27133,13,-3,86,554365,13,554352
27134,5,7,353,852429,5,852424
27135,20,-2,394,588019,20,587999
27136,7,19,43,1218316,7,1218309
27137,17,15,144,1117886,17,1117869
27138,20,5,156,804924,20,804904
27139,17,7,11,867103,17,867086
27140,12,-14,16,209459,12,209447
27141,8,-3,473,541098,8,541090
27142,12,-14,811,215885,12,215873
27143,13,-8,834,403809,13,403796
27144,20,-5,40,491154,20,491134
27145,18,18,678,1213850,18,1213832
27146,11,-12,346,275099,11,275088
27147,10,8,547,887195,10,887185
27148,15,-4,389,525120,15,525105
27149,13,14,852,1092037,13,1092024
27150,14,4,509,776906,14,776892
27151,6,-18,451,72086,6,72080
27152,19,5,364,806448,19,806429
27153,16,-9,299,368766,16,368750
27154,17,3,190,743318,17,743301
27155,7,0,170,629175,7,629168
27156,18,19,260,1242821,18,1242803
27157,20,6,306,838107,20,838087
27158,7,-10,865,331093,7,331086
27159,7,19,29,1218044,7,1218037
27160,15,2,525,714591,15,714576
27161,12,-7,852,434529,12,434517
27162,11,-8,641,402362,11,402351
27163,16,15,968,1123901,16,1123885
27164,10,2,965,708853,10,708843
27165,15,-2,875,591804,15,591789
27166,20,-13,365,243718,20,243698
27167,13,19,429,1244398,13,1244385
27168,17,9,470,932438,17,932421
27169,18,8,594,902624,18,902606
27170,13,-19,943,61102,13,61089
27171,9,17,501,1166042,9,1166033
27172,10,-4,667,513806,10,513796
27173,15,7,434,870280,15,870265
27174,19,2,229,712314,19,712295
27175,10,5,477,791501,10,791491
27176,15,3,220,743524,15,743509
27177,8,-5,55,469062,8,469054
27178,8,5,981,802350,8,802342
27179,13,-16,852,153157,13,153144
27180,9,-4,486,509878,9,509869
27181,6,-5,381,476365,6,476359
27182,7,-10,542,324341,7,324334
27183,19,1,98,680573,19,680554
27184,14,-19,720,59609,14,59595
27185,16,-4,393,525180,16,525164
27186,13,-8,907,404357,13,404344
27187,16,13,396,1056169,16,1056153
27188,18,10,761,965683,18,965665
27189,14,-3,892,560919,14,560905
27190,10,-10,723,328203,10,328193
27191,11,-17,580,119906,11,119895
27192,8,3,559,730591,8,730583
27193,10,-7,616,418935,10,418925
27194,19,-20,311,25284,19,25265
27195,13,6,805,842219,13,842206
27196,18,-4,941,529138,18,529120
27197,15,6,526,840081,15,840066
27198,5,-8,984,396454,5,396449
27199,18,-10,718,340471,18,340453
27200,19,-20,464,26288,19,26269
27201,6,14,490,1072731,6,1072725
27202,9,-15,970,176109,9,176100
27203,10,-19,444,41061,10,41051
27204,10,-9,549,356069,10,356059
27205,15,-5,12,490832,15,490817
27206,20,10,330,962332,20,962312
27207,6,-17,247,98707,6,98701
27208,16,16,525,1150838,16,1150822
27209,11,15,220,1118470,11,1118459
27210,7,-14,429,196104,7,196097
27211,11,19,5,1240679,11,1240668
27212,19,1,590,684529,19,684510
27213,13,11,501,994487,13,994474
27214,17,-9,627,371493,17,371476
27215,8,-7,137,408707,8,408699
27216,6,-2,310,569445,6,569439
27217,20,-11,86,304330,20,304310
27218,9,-8,710,390635,9,390626
27219,15,4,232,774958,15,774943
27220,18,16,79,1147636,18,1147618
27221,13,16,630,1151575,13,1151562
27222,13,-18,496,88929,13,88916
27223,6,-16,634,137741,6,137735
27224,14,-8,534,401614,14,401600
27225,6,-2,67,564327,6,564321
27226,17,13,275,1055197,17,1055180
27227,7,10,961,958112,7,958105
27228,11,8,543,902228,11,902217
27229,13,9,22,929203,13,929190
27230,14,0,626,652958,14,652944
27231,14,14,547,1089745,14,1089731
27232,6,10,560,949466,6,949460
27233,16,10,648,964940,16,964924
27234,8,14,963,1083340,8,1083332
27235,17,10,793,966012,17,965995
27236,11,12,17,1022210,11,1022199
27237,7,2,569,700625,7,700618
27238,18,-17,618,120128,18,120110
27239,10,1,396,665821,10,665811
27240,11,0,307,650371,11,650360
27241,11,-19,43,54192,11,54181
27242,12,10,312,962172,12,962160
27243,15,-6,517,463176,15,463161
27244,18,18,924,1215700,18,1215682
27245,5,-15,540,167051,5,167046
27246,20,7,962,873818,20,873798
27247,12,-18,358,88006,12,87994
27248,7,3,92,720812,7,720805
27249,20,-10,587,339442,20,339422
27250,12,11,354,993447,12,993435
27251,13,-8,326,400193,13,400180
27252,16,-10,527,338937,16,338921
27253,9,6,680,827626,9,827617
27254,9,-11,104,283388,9,283379
27255,16,3,316,744313,16,744297
27256,9,14,243,1067182,9,1067173
27257,8,12,602,1012068,8,1012060
27258,11,-5,803,496808,11,496797
27259,11,-8,388,400619,11,400608
27260,18,-5,684,495998,18,495980
27261,8,-3,1,530641,8,530633
27262,5,1,988,678451,5,678446
27263,7,-14,871,205405,7,205398
27264,12,18,384,1211881,12,1211869
27265,10,-15,650,169490,10,169480
27266,5,-3,61,531766,5,531761
27267,11,-15,26,178003,11,177992
27268,16,-7,357,431056,16,431040
27269,18,3,904,748619,18,748601
27270,10,-9,281,349724,10,349714
27271,10,-12,568,261817,10,261807
27272,9,-20,603,13201,9,13192
27273,9,-9,649,357932,9,357923
27274,10,-4,621,512794,10,512784
27275,18,8,957,905383,18,905365
27276,5,-18,841,80550,5,80545
27277,19,-12,635,277135,19,277116
27278,20,13,252,1055043,20,1055023
27279,17,-18,898,91730,17,91713
27280,5,-13,129,221121,5,221116
27281,8,-5,3,467811,8,467803
27282,9,-17,439,102745,9,102736
27283,10,9,759,922634,10,922624
27284,14,-18,9,85296,14,85282
27285,17,-16,30,146960,17,146943
27286,6,0,564,637491,6,637485
27287,7,-7,916,425462,7,425455
27288,6,-20,882,19593,6,19587
27289,16,2,748,716200,16,716184
27290,9,-11,861,299572,9,299563
27291,16,19,363,1243708,16,1243692
27292,12,14,243,1087309,12,1087297
27293,9,-7,212,410363,9,410354
27294,7,18,162,1190357,7,1190350
27295,5,-13,600,231138,5,231133
27296,13,16,54,1147460,13,1147447
27297,10,6,199,816546,10,816536
27298,13,1,621,684711,13,684698
27299,16,-10,295,337162,16,337146
27300,9,-17,592,106263,9,106254
27301,17,3,469,745355,17,745338
27302,12,-2,877,591840,12,591828
27303,20,10,96,960636,20,960616
27304,17,-5,745,496475,17,496458
27305,7,8,518,886605,7,886598
27306,17,3,765,747632,17,747615
27307,5,-5,441,477542,5,477537
27308,17,1,269,682045,17,682028
27309,19,-17,736,121079,19,121060
27310,20,-4,762,527717,20,527697
27311,5,-1,199,597973,5,597968
27312,6,2,293,694974,6,694968
27313,6,14,726,1078333,6,1078327
27314,8,15,334,1101626,8,1101618
27315,6,-1,602,607001,6,606995
27316,5,-13,822,236163,5,236158
27317,15,-13,240,242823,15,242808
27318,20,-9,180,367831,20,367811
27319,8,14,166,1065489,8,1065481
27320,20,1,116,680726,20,680706
27321,11,-10,5,335155,11,335144
27322,18,1,447,683355,18,683337
27323,14,-7,287,430474,14,430460
27324,14,14,10,1085451,14,1085437
27325,18,7,183,868339,18,868321
27326,12,3,619,746494,12,746482
27327,13,-19,426,57272,13,57259
27328,11,14,570,1089859,11,1089848
27329,15,12,619,1026624,15,1026609
27330,16,-11,248,305646,16,305630
27331,6,10,247,942671,6,942665
27332,5,3,732,734718,5,734713
27333,6,8,129,877840,6,877834
27334,11,9,454,932324,11,932313
27335,18,-6,542,463357,18,463339
27336,6,-8,99,377469,6,377463
27337,7,8,423,884470,7,884463
27338,9,-8,184,379463,9,379454
27339,16,-20,419,25942,16,25926
27340,12,-9,880,373561,12,373549
27341,18,19,667,1246191,18,1246173
27342,9,-7,797,422634,9,422625
27343,6,-20,83,1848,6,1842
27344,15,-4,490,525764,15,525749
27345,17,-14,130,210302,17,210285
27346,10,7,549,856474,10,856464
27347,15,4,903,779941,15,779926
27348,18,9,841,935316,18,935298
27349,16,19,937,1248278,16,1248262
27350,9,15,566,1106492,9,1106483
27351,10,9,795,923627,10,923617
27352,6,-14,760,203251,6,203245
27353,9,2,3,688602,9,688593
27354,11,12,640,1026804,11,1026793
27355,8,11,458,978202,8,978194
27356,5,6,544,824585,5,824580
27357,17,-17,815,121629,17,121612
27358,5,5,931,801223,5,801218
27359,17,19,635,1245940,17,1245923
27360,5,-1,915,613706,5,613701
27361,18,9,175,930364,18,930346
27362,13,-1,969,623906,13,623893
27363,10,-4,739,515258,10,515248
27364,13,14,533,1089631,13,1089618
27365,9,0,319,631992,9,631983
27366,5,17,827,1173091,5,1173086
27367,16,3,125,742794,16,742778
27368,5,-4,935,519435,5,519430
27369,6,-9,484,354564,6,354558
27370,15,2,657,715517,15,715502
27371,19,-8,741,403108,19,403089
27372,15,-3,454,557280,15,557265
27373,19,5,843,809920,19,809901
27374,19,6,806,842248,19,842229
27375,20,-7,127,429216,20,429196
27376,7,-16,531,135587,7,135580
27377,9,-9,591,356882,9,356873
27378,6,16,253,1130591,6,1130585
27379,19,9,437,932237,19,932218
27380,6,13,373,1038745,6,1038739
27381,15,15,543,1120712,15,1120697
27382,17,3,761,747607,17,747590
27383,5,-6,375,444868,5,444863
27384,10,6,686,827749,10,827739
27385,12,15,119,1117682,12,1117670
27386,5,15,866,1112906,5,1112901
27387,19,-18,949,92099,19,92080
27388,19,3,541,745797,19,745778
27389,11,14,548,1089749,11,1089738
27390,18,-5,266,492997,18,492979
27391,5,-20,981,21626,5,21621
27392,10,-14,306,193350,10,193340
27393,6,11,643,982165,6,982159
27394,9,6,680,827635,9,827626
27395,19,11,514,994568,19,994549
27396,9,2,122,691234,9,691225
27397,9,-12,241,254717,9,254708
27398,13,-3,259,555610,13,555597
27399,10,4,881,769987,10,769977
27400,19,19,625,1245878,19,1245859
27401,19,18,183,1210444,19,1210425
27402,19,-19,639,59040,19,59021
27403,9,-20,955,21003,9,20994
27404,10,0,12,625465,10,625455
27405,13,-18,850,91369,13,91356
27406,13,18,207,1210690,13,1210677
27407,14,-14,714,215094,14,215080
27408,14,-8,518,401463,14,401449
27409,11,-3,922,561176,11,561165
27410,16,16,499,1150654,16,1150638
27411,17,15,304,1119041,17,1119024
27412,10,-7,954,426212,10,426202
27413,16,-13,488,244600,16,244584
27414,5,-13,44,219316,5,219311
27415,20,14,683,1090831,20,1090811
27416,17,-3,568,558289,17,558272
27417,13,-19,933,61012,13,60999
27418,9,12,97,1001188,9,1001179
27419,16,-3,740,559651,16,559635
27420,8,8,373,883283,8,883275
27421,18,6,258,837734,18,837716
27422,10,-18,279,68571,10,68561
27423,9,-11,769,297631,9,297622
27424,13,1,408,683090,13,683077
27425,15,-14,32,209572,15,209557
27426,20,0,291,650248,20,650228
27427,17,-10,37,335436,17,335419
27428,5,10,952,957989,5,957984
27429,8,-19,638,45541,8,45533
27430,20,12,943,1029348,20,1029328
27431,13,-13,10,241112,13,241099
27432,15,-3,733,559605,15,559590
27433,18,0,256,650092,18,650074
27434,12,-20,983,30296,12,30284
27435,20,-3,4,553868,20,553848
27436,10,16,503,1135891,10,1135881
27437,20,16,585,1151225,20,1151205
27438,12,9,236,930744,12,930732
27439,19,8,133,898970,19,898951
27440,18,16,456,1150411,18,1150393
27441,18,-8,273,399792,18,399774
27442,11,11,253,992660,11,992649
27443,15,9,12,929114,15,929099
27444,16,-4,688,527284,16,527268
27445,16,11,707,995866,16,995850
27446,5,3,376,726934,5,726929
27447,17,-20,119,23672,17,23655
27448,17,-3,721,559505,17,559488
27449,13,-10,342,337543,13,337530
27450,7,-18,453,72141,7,72134
27451,17,-19,422,57234,17,57217
27452,15,-2,553,589316,15,589301
27453,14,11,434,994029,14,994015
27454,17,-14,994,217225,17,217208
27455,19,-8,593,401996,19,401977
27456,5,2,422,697703,5,697698
27457,5,-7,789,422486,5,422481
27458,17,5,42,804091,17,804074
27459,5,-12,567,261781,5,261776
27460,6,-17,53,94593,6,94587
27461,17,-7,119,429160,17,429143
27462,11,-11,179,305182,11,305171
27463,15,-2,631,589861,15,589846
27464,11,19,696,1246441,11,1246430
27465,6,-5,389,476521,6,476515
27466,10,9,275,912421,10,912411
27467,12,7,177,868285,12,868273
27468,5,17,103,1157385,5,1157380
27469,7,-16,804,141260,7,141253
27470,6,0,439,634841,6,634835
27471,18,13,75,1053780,18,1053762
27472,16,-10,112,335926,16,335910
27473,13,1,363,682765,13,682752
27474,18,-5,77,491444,18,491426
27475,17,-17,977,122640,17,122623
27476,7,-4,33,499992,7,499985
27477,8,7,391,853212,8,853204
27478,14,-7,379,431241,14,431227
27479,15,-2,237,586926,15,586911
27480,8,-18,953,83175,8,83167
27481,12,-6,171,460439,12,460427
27482,5,10,831,955430,5,955425
27483,10,-16,938,144194,10,144184
27484,17,19,320,1243337,17,1243320
27485,14,-11,669,309060,14,309046
27486,10,0,730,641415,10,641405
27487,6,-15,278,161328,6,161322
27488,16,10,345,962428,16,962412
27489,18,18,211,1210712,18,1210694
27490,8,7,179,848593,8,848585
27491,12,11,249,992624,12,992612
27492,20,4,430,776368,20,776348
27493,6,-6,587,449438,6,449432
27494,17,-13,284,243206,17,243189
27495,6,-7,972,426621,6,426615
27496,7,-15,639,169242,7,169235
27497,8,3,484,729178,8,729170
27498,18,-13,289,243244,18,243226
27499,13,-12,366,275255,13,275242
27500,5,14,615,1075548,5,1075543
27501,6,3,596,731516,6,731510
27502,18,1,459,683472,18,683454
27503,15,-3,235,555417,15,555402
27504,20,-18,146,86345,20,86325
27505,7,-16,122,126722,7,126715
27506,18,8,155,899173,18,899155
27507,15,7,730,872327,15,872312
27508,17,-8,743,403127,17,403110
27509,20,9,904,935781,20,935761
27510,14,-10,466,338526,14,338512
27511,20,-11,133,304771,20,304751
27512,5,10,643,951389,5,951384
27513,7,-6,2,436874,7,436867
27514,13,-6,466,462720,13,462707
27515,8,1,776,673890,8,673882
27516,11,-10,96,335845,11,335834
27517,12,-7,879,434748,12,434736
27518,11,-18,509,89009,11,88998
27519,17,-11,154,304959,17,304942
27520,19,11,758,996309,19,996290
27521,8,14,267,1067734,8,1067726
27522,13,-18,796,91027,13,91014
27523,15,4,408,776147,15,776132
27524,12,-4,999,529598,12,529586
27525,18,10,893,966650,18,966632
27526,11,5,959,810849,11,810838
27527,11,3,601,746325,11,746314
27528,13,-4,233,523921,13,523908
27529,5,2,436,697913,5,697908
27530,18,4,235,774995,18,774977
27531,13,-12,203,273934,13,273921
27532,12,-12,894,279213,12,279201
27533,20,18,739,1214266,20,1214246
27534,20,19,489,1244794,20,1244774
27535,20,9,732,934418,20,934398
27536,18,8,449,901551,18,901533
27537,19,-2,324,587547,19,587528
27538,20,-2,828,591420,20,591400
27539,12,-9,85,367276,12,367264
27540,16,3,172,743126,16,743110
27541,13,-9,958,374103,13,374090
27542,7,-19,306,38147,7,38140
27543,6,-19,641,45641,6,45635
27544,11,-18,731,90584,11,90573
27545,19,3,277,743994,19,743975
27546,18,8,7,897955,18,897937
27547,19,8,567,902405,19,902386
27548,16,14,991,1093239,16,1093223
27549,15,-19,449,57429,15,57414
27550,11,-2,408,588154,11,588143
27551,15,5,366,806478,15,806463
27552,15,3,259,743828,15,743813
27553,11,-10,50,335517,11,335506
27554,20,1,721,685445,20,685425
27555,5,0,471,635620,5,635615
27556,19,0,647,653168,19,653149
27557,13,-1,826,622887,13,622874
27558,17,16,49,1147441,17,1147424
27559,7,-18,691,77167,7,77160
27560,9,-17,218,98113,9,98104
27561,7,-12,40,250403,7,250396
27562,5,-12,921,269632,5,269627
27563,7,1,675,671854,7,671847
27564,14,3,530,745716,14,745702
27565,19,0,487,651856,19,651837
27566,10,-12,195,253643,10,253633
27567,19,15,309,1119059,19,1119040
27568,5,16,438,1134617,5,1134612
27569,5,19,191,1221739,5,1221734
27570,17,5,532,807675,17,807658
27571,13,3,192,743340,13,743327
27572,10,-8,208,379918,10,379908
27573,11,1,969,687410,11,687399
27574,9,8,217,879892,9,879883
27575,7,8,358,882985,7,882978
27576,5,-1,414,603010,5,603005
27577,17,0,471,651696,17,651679
27578,12,-19,31,54109,12,54097
27579,17,16,739,1152362,17,1152345
27580,19,19,961,1248510,19,1248491
27581,15,5,863,810052,15,810037
27582,7,-18,291,68790,7,68783
27583,11,6,641,840948,11,840937
27584,16,-20,872,29515,16,29499
27585,14,-1,265,618617,14,618603
27586,19,5,174,805061,19,805042
27587,11,-8,798,403582,11,403571
27588,14,11,31,991101,14,991087
27589,13,-2,686,590291,13,590278
27590,16,9,970,936347,16,936331
27591,17,19,432,1244410,17,1244393
27592,6,7,532,856122,6,856116
27593,8,-12,598,262472,8,262464
27594,6,-5,701,483186,6,483180
27595,8,14,973,1083561,8,1083553
27596,5,-9,340,351091,5,351086
27597,5,19,894,1237390,5,1237385
27598,20,2,192,712025,20,712005
27599,5,5,810,798529,5,798524
27600,17,-9,17,366734,17,366717
27601,5,-9,123,346221,5,346216
27602,15,-8,803,403625,15,403610
27603,12,5,32,803952,12,803940
27604,8,-14,399,195570,8,195562
27605,9,18,749,1202479,9,1202470
27606,14,5,381,806588,14,806574
27607,20,-3,656,559024,20,559004
27608,17,-2,995,592671,17,592654
27609,13,1,296,682199,13,682186
27610,18,-2,498,588910,18,588892
27611,20,-19,178,55451,20,55431
27612,12,13,985,1060499,12,1060487
27613,16,-7,848,434505,16,434489
27614,9,-8,67,376942,9,376933
27615,12,0,585,652693,12,652681
27616,17,-14,209,210948,17,210931
27617,5,9,168,910345,5,910340
27618,15,12,525,1025876,15,1025861
27619,20,-18,972,92291,20,92271
27620,5,-13,436,227500,5,227495
27621,19,7,385,869860,19,869841
27622,20,-8,994,404962,20,404942
27623,15,-16,347,149446,15,149431
27624,10,13,634,1044408,10,1044398
27625,11,-18,660,90081,11,90070
27626,19,-17,505,119284,19,119265
27627,14,-12,110,273327,14,273313
27628,6,3,819,736473,6,736467
27629,12,-18,291,87488,12,87476
27630,20,5,457,807118,20,807098
27631,10,3,660,733022,10,733012
27632,18,-12,235,274234,18,274216
27633,20,17,48,1178249,20,1178229
27634,5,-2,391,570953,5,570948
27635,16,-1,386,619658,16,619642
27636,13,-9,416,369815,13,369802
27637,19,-5,454,494366,19,494347
27638,18,-14,510,213473,18,213455
27639,5,-4,104,501622,5,501617
27640,8,-8,116,377799,8,377791
27641,18,-7,580,432689,18,432671
27642,5,17,508,1166195,5,1166190
27643,19,-18,656,90060,19,90041
27644,6,-3,991,552642,6,552636
27645,14,7,952,873754,14,873740
27646,7,-10,231,317592,7,317585
27647,15,-17,843,121796,15,121781
27648,16,14,128,1086502,16,1086486
27649,15,13,199,1054724,15,1054709
27650,5,-18,216,67083,5,67078
27651,19,7,619,871560,19,871541
27652,8,-3,119,533019,8,533011
27653,19,-2,510,588979,19,588960
27654,12,-14,278,211617,12,211605
27655,17,-5,581,495344,17,495327
27656,5,-20,691,15319,5,15314
27657,18,-15,513,181537,18,181519
27658,10,10,324,944413,10,944403
27659,9,-19,326,38574,9,38565
27660,9,-15,965,176048,9,176039
27661,7,4,960,771535,7,771528
27662,18,-17,650,120365,18,120347
27663,8,2,56,689831,8,689823
27664,17,5,104,804554,17,804537
27665,9,-3,776,547867,9,547858
27666,18,-17,432,118661,18,118643
27667,17,-11,538,308073,17,308056
27668,6,-19,148,34914,6,34908
27669,14,-16,756,152491,14,152477
27670,19,-14,495,213337,19,213318
27671,7,-13,13,218575,7,218568
27672,17,-1,454,620171,17,620154
27673,11,-12,211,274028,11,274017
27674,12,-18,477,88834,12,88822
27675,13,13,318,1055519,13,1055506
27676,16,18,164,1210280,16,1210264
27677,14,4,518,777015,14,777001
27678,19,1,293,682173,19,682154
27679,16,-5,715,496256,16,496240
27680,8,-20,966,21238,8,21230
27681,6,4,920,770812,6,770806
27682,13,-20,133,23758,13,23745
27683,7,14,295,1068358,7,1068351
27684,5,5,912,800790,5,800785
27685,20,1,492,683741,20,683721
27686,12,19,857,1247737,12,1247725
27687,8,-1,306,600652,8,600644
27688,7,-10,889,331633,7,331626
27689,10,-2,262,568427,10,568417
27690,20,-1,30,616762,20,616742
27691,17,-18,266,87366,17,87349
27692,13,6,265,837787,13,837774
27693,10,-18,952,83102,10,83092
27694,13,-19,390,57038,13,57025
27695,9,-15,991,176521,9,176512
27696,9,0,570,637616,9,637607
27697,15,-19,907,60860,15,60845
27698,8,-15,224,160118,8,160110
27699,15,4,916,780029,15,780014
27700,18,19,1,1240607,18,1240589
27701,20,-14,517,213527,20,213507
27702,11,-20,843,29343,11,29332
27703,20,-16,832,153013,20,152993
27704,5,3,222,723616,5,723611
27705,14,-2,482,588785,14,588771
27706,12,8,878,904754,12,904742
27707,13,-7,563,432541,13,432528
27708,5,9,492,917080,5,917075
27709,15,10,515,963819,15,963804
27710,8,5,926,801154,8,801146
27711,13,18,761,1214470,13,1214457
27712,14,10,334,962372,14,962358
27713,17,4,906,779949,17,779932
27714,14,-15,530,181671,14,181657
27715,7,-6,780,453596,7,453589
27716,17,-12,898,279249,17,279232
27717,11,11,692,995742,11,995731
27718,19,1,54,680217,19,680198
27719,14,-6,769,464992,14,464978
27720,6,19,554,1230030,6,1230024
27721,13,-14,702,215011,13,214998
27722,12,-3,542,558108,12,558096
27723,14,12,163,1023222,14,1023208
27724,15,-11,146,304887,15,304872
27725,13,-18,363,88025,13,88012
27726,20,-14,681,214863,20,214843
27727,20,17,157,1179009,20,1178989
27728,19,-18,849,91327,19,91308
27729,15,13,615,1057941,15,1057926
27730,18,-14,150,210445,18,210427
27731,17,8,843,904495,17,904478
27732,10,8,700,890624,10,890614
27733,20,5,560,807857,20,807837
27734,17,-15,446,181069,17,181052
27735,20,8,257,899982,20,899962
27736,18,11,923,997608,18,997590
27737,16,12,41,1022404,16,1022388
27738,6,-7,954,426218,6,426212
27739,15,-4,909,528915,15,528900
27740,13,13,403,1056251,13,1056238
27741,15,-12,847,278776,15,278761
27742,18,14,866,1092192,18,1092174
27743,7,16,710,1139908,7,1139901
27744,8,18,48,1187703,8,1187695
27745,7,-13,761,234731,7,234724
27746,16,19,206,1242403,16,1242387
27747,10,18,116,1189346,10,1189336
27748,15,-1,33,616809,15,616794
27749,19,1,622,684741,19,684722
27750,14,-13,834,247231,14,247217
27751,14,4,801,779124,14,779110
27752,16,-13,532,244966,16,244950
27753,9,17,466,1165292,9,1165283
27754,17,-12,497,276210,17,276193
27755,10,19,818,1235601,10,1235591
27756,14,15,947,1123741,14,1123727
27757,18,10,420,963062,18,963044
27758,19,-13,802,247013,19,246994
27759,19,-20,0,431,19,412
27760,10,17,5,1155386,10,1155376
27761,14,14,918,1092583,14,1092569
27762,20,9,350,931584,20,931564
27763,20,6,3,835758,20,835738
27764,13,9,367,931729,13,931716
27765,15,-14,81,209959,15,209944
27766,5,5,40,782453,5,782448
27767,10,13,168,1034227,10,1034217
27768,15,16,659,1151842,15,1151827
27769,19,7,399,869998,19,869979
27770,17,16,188,1148474,17,1148457
27771,8,0,35,626076,8,626068
27772,19,-20,494,26516,19,26497
27773,16,-4,605,526638,16,526622
27774,7,-18,265,68254,7,68247
27775,5,-3,571,543378,5,543373
27776,14,-7,703,433432,14,433418
27777,14,4,981,780447,14,780433
27778,11,0,33,648498,11,648487
27779,6,17,520,1166480,6,1166474
27780,9,7,387,853163,9,853154
27781,6,-17,176,97106,6,97100
27782,19,-5,129,491942,19,491923
27783,5,4,927,770955,5,770950
27784,5,-1,89,595734,5,595729
27785,5,-16,903,143338,5,143333
27786,17,0,743,653999,17,653982
27787,20,-13,294,243277,20,243257
27788,13,-20,627,27533,13,27520
27789,17,-19,761,59958,17,59941
27790,10,-9,307,350289,10,350279
27791,15,3,551,745867,15,745852
27792,9,-18,550,74285,9,74276
27793,5,9,14,907035,5,907030
27794,7,8,945,895769,7,895762
27795,8,6,1000,834708,8,834700
27796,16,-8,950,404629,16,404613
27797,18,-5,892,497573,18,497555
27798,20,-5,925,497813,20,497793
27799,14,-13,947,248177,14,248163
27800,11,-13,683,245978,11,245967
27801,17,-7,122,429182,17,429165
27802,14,18,870,1215298,14,1215284
27803,8,-17,586,106172,8,106164
27804,7,19,714,1233328,7,1233321
27805,18,-17,78,116098,18,116080
27806,16,13,578,1057661,16,1057645
27807,15,-11,366,306685,15,306670
27808,6,-19,910,51098,6,51092
27809,17,1,383,682913,17,682896
27810,5,7,657,858705,5,858700
27811,8,5,549,793030,8,793022
27812,16,6,634,840878,16,840862
27813,17,-11,447,307347,17,307330
27814,18,12,675,1027143,18,1027125
27815,7,-10,205,317046,7,317039
27816,7,18,149,1190115,7,1190108
27817,8,-17,271,99246,8,99238
27818,11,16,868,1153264,11,1153253
27819,16,11,982,997923,16,997907
27820,14,18,336,1211565,14,1211551
27821,5,-12,734,265302,5,265297
27822,16,14,600,1090067,16,1090051
27823,11,3,624,746496,11,746485
27824,13,12,634,1026736,13,1026723
27825,8,5,400,789818,8,789810
27826,16,5,816,809733,16,809717
27827,20,13,386,1056076,20,1056056
27828,9,8,123,877690,9,877681
27829,11,-20,183,24220,11,24209
27830,19,14,279,1087596,19,1087577
27831,7,-18,868,81113,7,81106
27832,11,-19,365,56828,11,56817
27833,11,10,367,962606,11,962595
27834,6,-11,665,295781,6,295775
27835,20,-17,149,116589,20,116569
27836,20,-16,295,149136,20,149116
27837,13,3,877,748414,13,748401
27838,6,-11,491,292150,6,292144
27839,7,17,909,1174867,7,1174860
27840,13,-9,123,367496,13,367483
27841,5,-8,72,377088,5,377083
27842,14,-16,90,147557,14,147543
27843,7,-16,378,132073,7,132066
27844,8,13,949,1051032,8,1051024
27845,10,4,713,766011,10,766001
27846,20,1,15,679848,20,679828
27847,17,14,683,1090838,17,1090821
27848,14,10,626,964749,14,964735
27849,13,-4,738,527586,13,527573
27850,8,-1,113,596208,8,596200
27851,8,11,142,971430,8,971422
27852,9,-11,233,286092,9,286083
27853,16,-18,235,87171,16,87155
27854,12,-11,453,307400,12,307388
27855,18,-4,829,528127,18,528109
27856,11,-6,505,463053,11,463042
27857,18,-4,651,527010,18,526992
27858,19,4,856,779683,19,779664
27859,13,18,753,1214430,13,1214417
27860,13,4,488,776755,13,776742
27861,13,12,245,1023854,13,1023841
27862,20,-7,109,429088,20,429068
27863,12,-16,908,153611,12,153599
27864,18,-10,797,341081,18,341063
27865,20,-3,64,554220,20,554200
27866,17,-14,312,211818,17,211801
27867,9,-12,905,269302,9,269293
27868,18,13,346,1055765,18,1055747
27869,17,-18,445,88594,17,88577
27870,6,-16,69,125298,6,125292
27871,12,17,158,1179022,12,1179010
27872,10,-2,460,572558,10,572548
27873,11,8,354,900748,11,900737
27874,7,-20,411,8872,7,8865
27875,12,4,123,774126,12,774114
27876,15,17,674,1182882,15,1182867
27877,13,-3,3,553859,13,553846
27878,14,-17,289,117645,14,117631
27879,18,5,32,803960,18,803942
27880,9,-3,39,531365,9,531356
27881,13,0,694,653593,13,653580
27882,18,15,375,1119538,18,1119520
27883,5,-16,423,133135,5,133130
27884,15,8,862,904660,15,904645
27885,15,-10,339,337525,15,337510
27886,11,10,597,964509,11,964498
27887,10,-3,538,542655,10,542645
27888,17,-9,851,373296,17,373279
27889,5,0,648,639509,5,639504
27890,16,10,971,967246,16,967230
27891,13,19,274,1242944,13,1242931
27892,9,-19,993,52693,9,52684
27893,6,-17,701,108512,6,108506
27894,8,-11,297,287563,8,287555
27895,11,-16,772,152574,11,152563
27896,6,-1,561,606145,6,606139
27897,20,-1,973,623939,20,623919
27898,10,16,775,1141173,10,1141163
27899,18,-4,763,527737,18,527719
27900,18,-1,75,617151,18,617133
27901,16,1,381,682908,16,682892
27902,12,-3,190,555119,12,555107
27903,19,-15,201,179194,19,179175
27904,10,17,93,1157245,10,1157235
27905,20,11,218,992379,20,992359
27906,11,18,524,1212833,11,1212822
27907,8,10,920,957314,8,957306
27908,15,-11,897,310720,15,310705
27909,8,-17,698,108427,8,108419
27910,19,10,913,966880,19,966861
27911,19,-12,669,277455,19,277436
27912,15,14,438,1088890,15,1088875
27913,5,6,762,829416,5,829411
27914,9,-9,937,364667,9,364658
27915,10,-1,2,593771,10,593761
27916,14,10,113,960751,14,960737
27917,11,18,801,1214784,11,1214773
27918,11,15,445,1119958,11,1119947
27919,19,2,467,714151,19,714132
27920,7,-14,747,202907,7,202900
27921,19,-9,150,367660,19,367641
27922,17,4,833,779444,17,779427
27923,17,15,12,1116849,17,1116832
27924,5,11,577,980839,5,980834
27925,10,12,380,1007311,10,1007301
27926,15,7,375,869755,15,869740
27927,14,1,448,683371,14,683357
27928,14,-2,57,585598,14,585584
27929,14,-17,772,121381,14,121367
27930,9,13,735,1046518,9,1046509
27931,12,-12,104,273276,12,273264
27932,13,-12,501,276265,13,276252
27933,11,17,437,1181166,11,1181155
27934,7,-5,622,481488,7,481481
27935,13,-14,558,213799,13,213786
27936,5,13,966,1051385,5,1051380
27937,11,-17,67,115993,11,115982
27938,9,19,145,1220680,9,1220671
27939,18,8,313,900420,18,900402
27940,9,-6,980,457696,9,457687
27941,12,-16,933,153807,12,153795
27942,5,5,1000,802766,5,802761
27943,5,8,706,890740,5,890735
27944,14,5,887,810224,14,810210
27945,19,-9,882,373574,19,373555
27946,12,11,308,993114,12,993102
27947,19,-20,191,24345,19,24326
27948,16,-13,46,241406,16,241390
27949,8,-5,572,480392,8,480384
27950,19,-1,499,620542,19,620523
27951,20,-9,53,367035,20,367015
27952,7,-7,297,412283,7,412276
27953,6,13,713,1045970,6,1045964
27954,15,13,601,1057800,15,1057785
27955,20,-10,364,337664,20,337644
27956,11,-7,467,431849,11,431838
27957,17,18,55,1209362,17,1209345
27958,16,-15,298,179947,16,179931
27959,17,10,287,961993,17,961976
27960,12,6,793,842115,12,842103
27961,19,7,92,867679,19,867660
27962,19,6,812,842295,19,842276
27963,10,9,740,922253,10,922243
27964,14,-20,323,25353,14,25339
27965,6,17,37,1156092,6,1156086
27966,10,-3,951,551822,10,551812
27967,17,14,387,1088420,17,1088403
27968,9,-10,236,317694,9,317685
27969,14,11,758,996313,14,996299
27970,16,15,510,1120461,16,1120445
27971,20,-7,723,433574,20,433554
27972,9,-4,636,513110,9,513101
27973,16,2,261,712532,16,712516
27974,12,-13,370,243741,12,243729
27975,12,-10,617,339675,12,339663
27976,13,-18,66,85708,13,85695
27977,10,-1,761,610154,10,610144
27978,18,-14,201,210862,18,210844
27979,12,5,867,810082,12,810070
27980,13,-18,259,87314,13,87301
27981,6,-13,331,225372,6,225366
27982,20,0,560,652467,20,652447
27983,20,1,453,683438,20,683418
27984,8,15,24,1094981,8,1094973
27985,18,4,947,780226,18,780208
27986,17,17,776,1183625,17,1183608
27987,12,-16,395,149781,12,149769
27988,18,1,203,681503,18,681485
27989,18,12,421,1025115,18,1025097
27990,11,6,37,836101,11,836090
27991,10,-9,713,359277,10,359267
27992,14,18,757,1214441,14,1214427
27993,7,14,268,1067765,7,1067758
27994,18,17,622,1182479,18,1182461
27995,8,3,558,730576,8,730568
27996,16,-6,331,461730,16,461714
27997,17,13,112,1054048,17,1054031
27998,19,-3,293,555898,19,555879
27999,8,-3,233,535406,8,535398
28000,8,19,46,1218371,8,1218363
28001,9,-16,161,127489,9,127480
28002,16,-15,977,185193,16,185177
28003,8,5,941,801489,8,801481
28004,19,6,521,840031,19,840012
28005,11,5,900,810334,11,810323
28006,18,11,733,996100,18,996082
28007,8,-9,240,348781,8,348773
28008,19,-16,308,149215,19,149196
28009,17,-12,512,276338,17,276321
28010,19,-16,778,152631,19,152612
28011,15,0,56,648669,15,648654
28012,14,-9,193,367910,14,367896
28013,11,-7,675,433177,11,433166
28014,13,10,805,966134,13,966121
28015,16,-2,549,589248,16,589232
28016,17,2,770,716299,17,716282
28017,20,-2,478,588758,20,588738
28018,14,4,383,775984,14,775970
28019,16,-10,126,336047,16,336031
28020,15,16,218,1148696,15,1148681
28021,12,-15,82,178387,12,178375
28022,6,7,874,863382,6,863376
28023,17,-10,734,340609,17,340592
28024,6,-7,593,418564,6,418558
28025,7,10,979,958446,7,958439
28026,13,18,840,1215058,13,1215045
28027,14,-16,639,151698,14,151684
28028,12,3,250,743769,12,743757
28029,12,19,172,1242128,12,1242116
28030,8,1,535,669094,8,669086
28031,7,-7,881,424635,7,424628
28032,11,-3,771,559980,11,559969
28033,16,-4,481,525687,16,525671
28034,6,16,672,1139286,6,1139280
28035,5,-3,478,541193,5,541188
28036,8,-16,669,138426,8,138418
28037,7,3,691,733847,7,733840
28038,20,-15,80,178349,20,178329
28039,18,-20,718,28270,18,28252
28040,10,-13,283,224507,10,224497
28041,17,0,558,652439,17,652422
28042,15,-9,113,367409,15,367394
28043,18,5,551,807802,18,807784
28044,8,17,282,1161386,8,1161378
28045,16,-20,997,30425,16,30409
28046,10,16,463,1135140,10,1135130
28047,15,5,36,804012,15,803997
28048,16,-17,82,116164,16,116148
28049,12,1,101,680623,12,680611
28050,17,10,445,963203,17,963186
28051,7,-17,509,104481,7,104474
28052,10,19,23,1217948,10,1217938
28053,16,-19,171,55404,16,55388
28054,7,19,241,1222801,7,1222794
28055,7,13,819,1048407,7,1048400
28056,20,2,440,713950,20,713930
28057,11,17,22,1178017,11,1178006
28058,12,-11,702,309224,12,309212
28059,7,4,120,753138,7,753131
28060,15,-1,850,623068,15,623053
28061,17,-12,317,274865,17,274848
28062,15,-20,172,24079,15,24064
28063,9,-11,112,283554,9,283545
28064,7,-13,377,226263,7,226256
28065,16,-2,951,592384,16,592368
28066,5,1,426,666422,5,666417
28067,11,-18,680,90197,11,90186
28068,20,-6,244,461089,20,461069
28069,5,-9,208,347979,5,347974
28070,14,7,332,869443,14,869429
28071,19,3,385,744782,19,744763
28072,19,3,553,745893,19,745874
28073,14,-4,997,529585,14,529571
28074,8,8,835,893344,8,893336
28075,12,0,994,655901,12,655889
28076,18,-16,866,153339,18,153321
28077,8,10,81,939240,8,939232
28078,20,-17,408,118446,20,118426
28079,5,-11,724,296864,5,296859
28080,6,17,324,1162290,6,1162284
28081,16,-4,799,527997,16,527981
28082,5,-20,890,19725,5,19720
28083,5,8,530,886898,5,886893
28084,14,19,154,1242005,14,1241991
28085,11,-10,960,342290,11,342279
28086,9,10,819,955212,9,955203
28087,8,7,535,856162,8,856154
28088,5,-13,625,231750,5,231745
28089,12,-5,154,492143,12,492131
28090,5,15,431,1103559,5,1103554
28091,12,4,932,780126,12,780114
28092,20,-1,504,620568,20,620548
28093,10,-4,742,515330,10,515320
28094,17,-12,949,279676,17,279659
28095,11,7,458,870446,11,870435
28096,7,16,142,1128111,7,1128104
28097,19,-20,595,27323,19,27304
28098,10,-20,871,19352,10,19342
28099,20,6,657,841056,20,841036
28100,19,15,828,1122859,19,1122840
28101,9,-2,42,563755,9,563746
28102,10,13,850,1049037,10,1049027
28103,12,1,251,681882,12,681870
28104,7,13,89,1032651,7,1032644
28105,6,13,171,1034279,6,1034273
28106,19,3,876,748412,19,748393
28107,10,15,891,1113383,10,1113373
28108,7,-1,215,598421,7,598414
28109,14,4,769,778907,14,778893
28110,13,-6,344,461837,13,461824
28111,18,-8,71,398500,18,398482
28112,20,2,583,714939,20,714919
28113,17,-16,209,148477,17,148460
28114,12,-4,178,523431,12,523419
28115,12,-14,846,216096,12,216084
28116,16,-2,540,589170,16,589154
28117,9,-17,559,105517,9,105508
28118,13,13,275,1055200,13,1055187
28119,14,-18,341,87853,14,87839
28120,12,5,880,810182,12,810170
28121,19,-5,36,491102,19,491083
28122,9,16,674,1139315,9,1139306
28123,12,15,234,1118541,12,1118529
28124,17,-11,929,310948,17,310931
28125,9,6,929,833087,9,833078
28126,16,-12,48,272823,16,272807
28127,15,-17,593,119969,15,119954
28128,6,1,167,660812,6,660806
28129,18,-13,59,241520,18,241502
28130,20,16,21,1147240,20,1147220
28131,9,7,67,846268,9,846259
28132,20,2,373,713440,20,713420
28133,7,-4,346,507114,7,507107
28134,15,-12,952,279704,15,279689
28135,10,11,788,985304,10,985294
28136,13,2,366,713357,13,713344
28137,8,-16,767,140527,8,140519
28138,10,1,387,665675,10,665665
28139,17,6,547,840181,17,840164
28140,11,-6,8,459218,11,459207
28141,11,10,375,962629,11,962618
28142,13,-11,920,310891,13,310878
28143,10,5,998,802705,10,802695
28144,16,-12,435,275644,16,275628
28145,16,10,567,964247,16,964231
28146,16,11,248,992615,16,992599
28147,17,-6,915,466081,17,466064
28148,5,16,123,1127604,5,1127599
28149,5,-20,876,19451,5,19446
28150,12,19,791,1247193,12,1247181
28151,5,-12,539,261296,5,261291
28152,11,19,251,1242721,11,1242710
28153,17,-8,952,404639,17,404622
28154,5,11,550,980223,5,980218
28155,13,-7,79,428837,13,428824
28156,18,-7,372,431174,18,431156
28157,16,-20,706,28225,16,28209
28158,9,3,88,720676,9,720667
28159,9,-6,284,443005,9,442996
28160,11,2,341,713176,11,713165
28161,16,9,269,930892,16,930876
28162,8,19,675,1232436,8,1232428
28163,6,12,520,1010218,6,1010212
28164,15,1,183,681317,15,681302
28165,10,-3,676,545739,10,545729
28166,8,11,508,979349,8,979341
28167,7,4,958,771505,7,771498
28168,10,11,386,976759,10,976749
28169,20,-13,163,242220,20,242200
28170,8,-5,841,486167,8,486159
28171,12,-15,109,178585,12,178573
28172,10,-4,324,506594,10,506584
28173,6,19,363,1225641,6,1225635
28174,19,4,341,775690,19,775671
28175,7,-15,411,164352,7,164345
28176,6,-18,123,65198,6,65192
28177,12,6,312,838143,12,838131
28178,5,6,229,817352,5,817347
28179,20,17,808,1184004,20,1183984
28180,6,-20,517,11127,6,11121
28181,9,5,998,802714,9,802705
28182,19,5,407,806741,19,806722
28183,5,-19,196,35908,5,35903
28184,15,7,258,868897,15,868882
28185,7,-2,740,578481,7,578474
28186,6,8,565,887618,6,887612
28187,5,8,773,892221,5,892216
28188,11,10,400,962843,11,962832
28189,8,6,933,833247,8,833239
28190,17,-17,721,120951,17,120934
28191,11,16,261,1148988,11,1148977
28192,10,10,493,947960,10,947950
28193,15,10,813,966183,15,966168
28194,18,10,948,967103,18,967085
28195,9,3,934,739128,9,739119
28196,8,-17,510,104498,8,104490
28197,19,0,681,653487,19,653468
28198,5,-14,291,193056,5,193051
28199,8,-8,236,380514,8,380506
28200,9,14,254,1067468,9,1067459
28201,6,-16,717,139405,6,139399
28202,16,11,713,995940,16,995924
28203,17,9,875,935564,17,935547
28204,10,16,790,1141515,10,1141505
28205,14,-7,980,435563,14,435549
28206,12,0,425,651329,12,651317
28207,13,6,910,843028,13,843015
28208,6,4,737,766651,6,766645
28209,17,4,529,777094,17,777077
28210,11,14,844,1092026,11,1092015
28211,9,9,775,923076,9,923067
28212,9,-12,977,270911,9,270902
28213,8,-16,651,138101,8,138093
28214,11,-13,586,245361,11,245350
28215,13,-11,650,308911,13,308898
28216,10,-12,503,260533,10,260523
28217,14,5,438,806940,14,806926
28218,17,13,122,1054127,17,1054110
28219,8,0,640,639279,8,639271
28220,12,-8,183,399209,12,399197
28221,7,5,308,787968,7,787961
28222,11,0,594,652746,11,652735
28223,20,19,8,1240702,20,1240682
28224,17,15,118,1117677,17,1117660
28225,5,-15,122,158147,5,158142
28226,20,-20,893,29687,20,29667
28227,12,-7,914,435054,12,435042
28228,11,-11,186,305217,11,305206
28229,7,5,430,790457,7,790450
28230,10,8,251,880686,10,880676
28231,7,-8,369,383092,7,383085
28232,18,17,979,1185283,18,1185265
28233,7,-16,356,131572,7,131565
28234,5,3,861,737464,5,737459
28235,12,-9,454,370173,12,370161
28236,5,7,575,857055,5,857050
28237,13,0,510,652025,13,652012
28238,9,-18,291,68809,9,68800
28239,19,1,46,680145,19,680126
28240,18,-7,798,434075,18,434057
28241,19,-12,1000,280116,19,280097
28242,6,3,487,729245,6,729239
28243,15,5,882,810195,15,810180
28244,19,2,607,715114,19,715095
28245,15,-8,197,399303,15,399288
28246,13,-17,540,119527,13,119514
28247,17,5,864,810062,17,810045
28248,13,-13,633,245718,13,245705
28249,11,-6,784,465146,11,465135
28250,14,18,100,1209735,14,1209721
28251,6,-1,625,607418,6,607412
28252,9,6,325,819593,9,819584
28253,17,-14,46,209692,17,209675
28254,14,11,812,996756,14,996742
28255,19,16,273,1149097,19,1149078
28256,10,8,221,879968,10,879958
28257,9,16,589,1137553,9,1137544
28258,19,-14,682,214875,19,214856
28259,19,10,119,960831,19,960812
28260,13,-7,440,431614,13,431601
28261,18,-2,944,592347,18,592329
28262,6,-9,200,347825,6,347819
28263,16,16,738,1152349,16,1152333
28264,12,18,924,1215702,12,1215690
28265,11,-18,14,85312,11,85301
28266,11,0,145,649305,11,649294
28267,20,-1,473,620363,20,620343
28268,7,-11,807,298410,7,298403
28269,15,0,179,649594,15,649579
28270,16,-17,422,118554,16,118538
28271,14,-8,504,401363,14,401349
28272,12,4,313,775425,12,775413
28273,9,16,167,1128627,9,1128618
28274,13,7,88,867652,13,867639
28275,17,16,992,1154223,17,1154206
28276,8,18,932,1206461,8,1206453
28277,18,-6,929,466172,18,466154
28278,8,-1,881,612869,8,612861
28279,18,0,708,653684,18,653666
28280,13,-8,770,403331,13,403318
28281,12,-14,778,215623,12,215611
28282,13,-16,815,152885,13,152872
28283,7,6,273,818371,7,818364
28284,5,-1,861,612362,5,612357
28285,7,-9,487,354649,7,354642
28286,6,-18,672,76821,6,76815
28287,12,0,551,652391,12,652379
28288,14,9,136,930067,14,930053
28289,14,-1,732,622216,14,622202
28290,10,16,124,1127632,10,1127622
28291,10,-8,737,391169,10,391159
28292,11,11,982,997924,11,997913
28293,18,-11,228,305492,18,305474
28294,18,-6,857,465618,18,465600
28295,6,15,436,1103643,6,1103637
28296,5,-13,956,239117,5,239112
28297,13,13,977,1060456,13,1060443
28298,12,0,172,649526,12,649514
28299,19,0,234,650000,19,649981
28300,12,14,954,1092906,12,1092894
28301,18,-9,799,372868,18,372850
28302,15,-9,789,372802,15,372787
28303,7,4,526,761987,7,761980
28304,15,8,111,898816,15,898801
28305,6,17,801,1172479,6,1172473
28306,5,-6,267,442631,5,442626
28307,16,18,195,1210595,16,1210579
28308,9,6,779,829747,9,829738
28309,20,-14,89,210017,20,209997
28310,11,-9,855,373335,11,373324
28311,18,17,455,1181360,18,1181342
28312,6,4,185,754567,6,754561
28313,9,6,429,822051,9,822042
28314,20,-20,50,23180,20,23160
28315,6,5,182,785424,6,785418
28316,7,16,331,1132193,7,1132186
28317,18,8,493,901864,18,901846
28318,19,-6,512,463136,19,463117
28319,9,-8,28,375944,9,375935
28320,14,2,599,715060,14,715046
28321,14,-8,11,397955,14,397941
28322,6,-20,356,7829,6,7823
28323,13,-2,697,590402,13,590389
28324,7,-19,728,47494,7,47487
28325,9,-14,301,193225,9,193216
28326,9,12,826,1017015,9,1017006
28327,18,17,841,1184287,18,1184269
28328,7,16,189,1129200,7,1129193
28329,15,-18,690,90227,15,90212
28330,8,9,521,917767,8,917759
28331,11,-17,811,121596,11,121585
28332,19,-8,629,402264,19,402245
28333,12,15,944,1123688,12,1123676
28334,8,12,503,1009882,8,1009874
28335,8,11,909,988066,8,988058
28336,19,-20,787,28883,19,28864
28337,13,-11,321,306319,13,306306
28338,9,-19,842,49971,9,49962
28339,6,19,433,1227557,6,1227551
28340,20,-19,463,57522,20,57502
28341,7,-11,745,297247,7,297240
28342,13,-19,444,57404,13,57391
28343,13,9,508,932786,13,932773
28344,13,-11,671,309068,13,309055
28345,16,5,726,809071,16,809055
28346,5,3,963,739845,5,739840
28347,14,-18,888,91672,14,91658
28348,9,9,750,922468,9,922459
28349,6,-8,561,387153,6,387147
28350,11,-19,513,57943,11,57932
28351,17,14,221,1087129,17,1087112
28352,8,17,482,1165670,8,1165662
28353,5,5,612,794369,5,794364
28354,15,-11,294,306018,15,306003
28355,14,8,27,898078,14,898064
28356,17,1,566,684369,17,684352
28357,17,-17,637,120270,17,120253
28358,18,-13,147,242091,18,242073
28359,9,16,913,1144151,9,1144142
28360,16,14,601,1090088,16,1090072
28361,11,-3,182,555076,11,555065
28362,11,15,94,1117469,11,1117458
28363,8,-6,934,456705,8,456697
28364,17,9,283,931015,17,930998
28365,10,-11,130,283909,10,283899
28366,6,-9,486,354613,6,354607
28367,9,-16,711,139273,9,139264
28368,5,5,578,793582,5,793577
28369,17,-13,203,242547,17,242530
28370,12,-4,117,522908,12,522896
28371,8,6,354,820243,8,820235
28372,5,-20,995,22018,5,22013
28373,12,6,820,842360,12,842348
28374,12,-9,294,368722,12,368710
28375,19,-9,277,368604,19,368585
28376,20,13,395,1056150,20,1056130
28377,11,17,454,1181337,11,1181326
28378,9,-10,774,329119,9,329110
28379,13,17,858,1184443,13,1184430
28380,16,-6,950,466338,16,466322
28381,12,-20,898,29717,12,29705
28382,10,-16,759,140417,10,140407
28383,11,16,200,1148544,11,1148533
28384,6,10,350,944902,6,944896
28385,18,6,500,839795,18,839777
28386,6,19,886,1237262,6,1237256
28387,10,-6,90,438670,10,438660
28388,9,-2,375,570661,9,570652
28389,15,-13,314,243384,15,243369
28390,15,7,338,869495,15,869480
28391,7,-17,623,106940,7,106933
28392,12,-16,194,148363,12,148351
28393,14,-17,574,119847,14,119833
28394,14,-11,693,309187,14,309173
28395,13,7,490,870674,13,870661
28396,15,-13,132,241957,15,241942
28397,19,15,207,1118365,19,1118346
28398,16,14,670,1090695,16,1090679
28399,17,-5,745,496482,17,496465
28400,13,19,702,1246474,13,1246461
28401,20,4,557,777304,20,777284
28402,14,16,398,1150003,14,1149989
28403,13,-14,428,212867,13,212854
28404,6,-9,781,361013,6,361007
28405,19,-4,68,522552,19,522533
28406,6,-1,780,610642,6,610636
28407,18,-9,522,370821,18,370803
28408,19,-20,904,29771,19,29752
28409,7,8,474,885551,7,885544
28410,20,0,659,653301,20,653281
28411,6,13,649,1044716,6,1044710
28412,13,13,354,1055845,13,1055832
28413,7,14,984,1083856,7,1083849
28414,19,-20,318,25316,19,25297
28415,15,-6,512,463141,15,463126
28416,14,6,62,836222,14,836208
28417,8,1,354,664948,8,664940
28418,15,5,692,808842,15,808827
28419,20,4,843,779549,20,779529
28420,17,10,581,964375,17,964358
28421,18,-4,680,527242,18,527224
28422,7,9,298,912910,7,912903
28423,20,-9,851,373306,20,373286
28424,10,19,677,1232479,10,1232469
28425,5,-19,637,45534,5,45529
28426,15,0,327,650485,15,650470
28427,20,-5,400,493963,20,493943
28428,14,-3,709,559429,14,559415
28429,11,19,255,1242756,11,1242745
28430,19,-10,439,338278,19,338259
28431,8,10,84,939327,8,939319
28432,7,-13,122,221004,7,220997
28433,19,14,329,1088040,19,1088021
28434,11,-16,325,149362,11,149351
28435,19,-17,620,120138,19,120119
28436,17,-4,564,526342,17,526325
28437,20,-11,326,306350,20,306330
28438,13,-15,633,182458,13,182445
28439,10,-16,114,126549,10,126539
28440,10,19,855,1236512,10,1236502
28441,6,-16,50,124889,6,124883
28442,10,12,154,1002506,10,1002496
28443,15,-2,211,586677,15,586662
28444,17,5,126,804698,17,804681
28445,11,-3,828,560401,11,560390
28446,16,-6,461,462701,16,462685
28447,11,4,997,780554,11,780543
28448,13,-17,168,116709,13,116696
28449,8,10,396,945964,8,945956
28450,13,-3,771,559983,13,559970
28451,9,-10,78,314401,9,314392
28452,9,-19,768,48427,9,48418
28453,6,6,84,813958,6,813952
28454,12,11,294,993047,12,993035
28455,6,-18,160,65969,6,65963
28456,14,2,183,711951,14,711937
28457,10,-5,616,481365,10,481355
28458,10,-14,51,187635,10,187625
28459,5,-18,608,75415,5,75410
28460,20,17,49,1178258,20,1178238
28461,16,18,883,1215360,16,1215344
28462,13,8,671,903285,13,903272
28463,18,-4,726,527520,18,527502
28464,11,-18,837,91281,11,91270
28465,9,13,579,1043278,9,1043269
28466,13,-12,659,277386,13,277373
28467,18,-17,265,117437,18,117419
28468,10,6,35,812977,10,812967
28469,18,7,631,871630,18,871612
28470,13,6,127,836732,13,836719
28471,15,14,917,1092579,15,1092564
28472,10,-16,258,129643,10,129633
28473,20,18,676,1213844,20,1213824
28474,17,11,82,991465,17,991448
28475,15,-8,884,404118,15,404103
28476,20,16,81,1147648,20,1147628
28477,14,-11,160,305014,14,305000
28478,6,-17,341,100811,6,100805
28479,7,10,587,950147,7,950140
28480,15,-15,110,178594,15,178579
28481,8,-15,935,175302,8,175294
28482,16,1,975,687437,16,687421
28483,16,0,945,655423,16,655407
28484,5,-6,694,451759,5,451754
28485,11,-16,718,152174,11,152163
28486,18,1,993,687516,18,687498
28487,14,-12,938,279577,14,279563
28488,7,-6,495,447496,7,447489
28489,9,-7,965,426420,9,426411
28490,5,-13,470,228225,5,228220
28491,20,-15,289,179888,20,179868
28492,10,-9,258,349260,10,349250
28493,20,-11,764,309684,20,309664
28494,8,2,724,703911,8,703903
28495,5,12,864,1018016,5,1018011
28496,10,8,358,882995,10,882985
28497,9,2,393,697111,9,697102
28498,14,-20,307,25232,14,25218
28499,5,6,864,831766,5,831761
28500,13,12,97,1022745,13,1022732
28501,18,-3,385,556655,18,556637
28502,13,0,256,650095,13,650082
28503,11,-9,560,371133,11,371122
28504,5,-10,205,317051,5,317046
28505,12,-14,217,211027,12,211015
28506,14,-19,499,57819,14,57805
28507,6,-10,32,313328,6,313322
28508,12,19,643,1245997,12,1245985
28509,12,-4,843,528225,12,528213
28510,8,10,774,954151,8,954143
28511,7,-7,73,407466,7,407459
28512,6,-14,465,196757,6,196751
28513,7,13,891,1049879,7,1049872
28514,14,18,749,1214381,14,1214367
28515,18,-15,241,179495,18,179477
28516,14,-2,639,589923,14,589909
28517,20,-12,877,279043,20,279023
28518,10,-14,178,190298,10,190288
28519,12,-12,635,277137,12,277125
28520,8,18,30,1187203,8,1187195
28521,20,19,83,1241467,20,1241447
28522,17,16,592,1151289,17,1151272
28523,9,12,785,1016092,9,1016083
28524,15,-20,987,30345,15,30330
28525,13,13,297,1055401,13,1055388
28526,10,19,151,1220813,10,1220803
28527,17,17,438,1181189,17,1181172
28528,19,19,241,1242625,19,1242606
28529,13,10,296,962036,13,962023
28530,7,15,54,1095622,7,1095615
28531,7,12,501,1009826,7,1009819
28532,6,-15,173,159107,6,159101
28533,11,-13,891,247701,11,247690
28534,19,16,56,1147493,19,1147474
28535,6,17,326,1162330,6,1162324
28536,8,-10,176,316466,8,316458
28537,6,4,845,769225,6,769219
28538,6,0,387,633767,6,633761
28539,16,-20,111,23591,16,23575
28540,18,18,613,1213350,18,1213332
28541,9,-17,737,109306,9,109297
28542,5,12,777,1015929,5,1015924
28543,11,-4,857,528377,11,528366
28544,11,13,844,1059551,11,1059540
28545,10,-14,439,196263,10,196253
28546,12,4,968,780349,12,780337
28547,20,0,446,651486,20,651466
28548,7,19,833,1235953,7,1235946
28549,5,1,986,678402,5,678397
28550,5,0,914,645162,5,645157
28551,11,-7,828,434299,11,434288
28552,6,3,850,737207,6,737201
28553,5,4,130,753362,5,753357
28554,5,-12,313,256425,5,256420
28555,8,-15,377,163637,8,163629
28556,6,19,156,1220937,6,1220931
28557,19,-4,79,522637,19,522618
28558,12,-18,876,91578,12,91566
28559,20,-17,853,121846,20,121826
28560,8,7,895,863777,8,863769
28561,20,18,835,1215022,20,1215002
28562,8,15,827,1111968,8,1111960
28563,8,-8,426,384146,8,384138
28564,16,-13,612,245588,16,245572
28565,6,-6,116,439178,6,439172
28566,13,7,331,869434,13,869421
28567,12,19,792,1247196,12,1247184
28568,20,1,528,684031,20,684011
28569,9,-1,828,611645,9,611636
28570,20,-10,881,341737,20,341717
28571,13,18,159,1210249,13,1210236
28572,17,8,397,901106,17,901089
28573,13,7,425,870170,13,870157
28574,12,-4,203,523673,12,523661
28575,20,-3,591,558453,20,558433
28576,17,16,664,1151888,17,1151871
28577,10,18,9,1186761,10,1186751
28578,11,-17,645,120298,11,120287
28579,9,10,165,941137,9,941128
28580,10,11,174,972012,10,972002
28581,11,-6,200,460694,11,460683
28582,18,-6,746,464874,18,464856
28583,12,10,261,961784,12,961772
28584,14,-12,200,273910,14,273896
28585,15,13,872,1059764,15,1059749
28586,5,8,625,888857,5,888852
28587,20,-14,268,211523,20,211503
28588,6,10,985,958545,6,958539
28589,17,11,964,997767,17,997750
28590,6,-8,776,391971,6,391965
28591,6,9,636,920287,6,920281
28592,8,-19,996,52766,8,52758
28593,9,-3,71,532041,9,532032
28594,9,5,411,790008,9,789999
28595,11,-9,840,373174,11,373163
28596,7,18,477,1196949,7,1196942
28597,7,13,583,1043341,7,1043334
28598,13,2,229,712317,13,712304
28599,18,-10,654,339980,18,339962
28600,17,-20,778,28829,17,28812
28601,19,19,837,1247559,19,1247540
28602,13,-5,603,495481,13,495468
28603,20,-8,238,399590,20,399570
28604,17,-3,53,554177,17,554160
28605,18,15,817,1122770,18,1122752
28606,15,8,73,898457,15,898442
28607,12,-14,700,214993,12,214981
28608,8,7,201,849032,8,849024
28609,7,-20,831,18427,7,18420
28610,8,-7,872,424399,8,424391
28611,17,-9,907,373778,17,373761
28612,11,4,221,774862,11,774851
28613,11,6,385,838794,11,838783
28614,13,7,681,872008,13,871995
28615,12,-20,59,23235,12,23223
28616,8,19,964,1238802,8,1238794
28617,16,11,755,996300,16,996284
28618,19,-1,602,621257,19,621238
28619,9,11,364,976234,9,976225
28620,12,0,848,654679,12,654667
28621,19,10,573,964305,19,964286
28622,16,2,80,711146,16,711130
28623,11,0,844,654668,11,654657
28624,8,-18,174,66316,8,66308
28625,15,-17,129,116455,15,116440
28626,6,6,329,819687,6,819681
28627,14,5,918,810462,14,810448
28628,13,-5,815,496906,13,496893
28629,19,6,473,839557,19,839538
28630,5,2,200,692995,5,692990
28631,17,4,895,779878,17,779861
28632,15,-7,56,428711,15,428696
28633,16,-9,246,368374,16,368358
28634,7,-15,271,161162,7,161155
28635,20,-20,492,26493,20,26473
28636,20,-16,241,148735,20,148715
28637,11,-6,856,465611,11,465600
28638,7,8,164,878688,7,878681
28639,18,13,197,1054679,18,1054661
28640,19,-10,212,336651,19,336632
28641,7,-11,161,284696,7,284689
28642,20,-8,652,402476,20,402456
28643,9,10,881,956439,9,956430
28644,17,5,597,808160,17,808143
28645,20,7,866,873271,20,873251
28646,20,4,726,778612,20,778592
28647,15,-14,988,217177,15,217162
28648,16,2,805,716478,16,716462
28649,12,13,721,1058593,12,1058581
28650,17,12,763,1027713,17,1027696
28651,5,-16,829,141810,5,141805
28652,9,-13,186,222401,9,222392
28653,7,-13,467,228106,7,228099
28654,6,-11,253,286579,6,286573
28655,5,16,649,1138860,5,1138855
28656,13,-13,72,241567,13,241554
28657,12,5,935,810653,12,810641
28658,10,13,649,1044726,10,1044716
28659,14,0,320,650395,14,650381
28660,13,1,99,680594,13,680581
28661,17,19,85,1241493,17,1241476
28662,8,-19,756,48169,8,48161
28663,18,5,282,805922,18,805904
28664,6,-14,445,196409,6,196403
28665,11,-7,254,430167,11,430156
28666,6,-15,150,158654,6,158648
28667,10,-7,134,408623,10,408613
28668,10,-18,862,81028,10,81018
28669,17,6,221,837374,17,837357
28670,13,16,762,1152487,13,1152474
28671,7,9,97,908766,7,908759
28672,9,8,764,891970,9,891961
28673,11,16,394,1149985,11,1149974
28674,17,5,520,807598,17,807581
28675,17,16,464,1150435,17,1150418
28676,6,4,577,763016,6,763010
28677,11,16,862,1153241,11,1153230
28678,8,-15,734,171182,8,171174
28679,14,0,865,654802,14,654788
28680,11,6,485,839664,11,839653
28681,20,3,147,742935,20,742915
28682,16,-1,927,623654,16,623638
28683,19,-7,133,429255,19,429236
28684,17,9,363,931698,17,931681
28685,19,0,94,648968,19,648949
28686,10,1,144,660327,10,660317
28687,7,-18,696,77313,7,77306
28688,7,-4,897,518659,7,518652
28689,15,3,73,742363,15,742348
28690,14,0,678,653458,14,653444
28691,18,-4,147,523173,18,523155
28692,12,-5,104,491725,12,491713
28693,8,-16,850,142232,8,142224
28694,17,11,892,997357,17,997340
28695,13,-1,40,616893,13,616880
28696,15,-4,124,522994,15,522979
28697,9,6,437,822310,9,822301
28698,10,-11,914,300748,10,300738
28699,7,-16,450,133944,7,133937
28700,16,-10,994,342664,16,342648
28701,20,-6,254,461145,20,461125
28702,11,2,170,711881,11,711870
28703,6,-12,845,267924,6,267918
28704,9,6,68,813664,9,813655
28705,9,14,276,1067967,9,1067958
28706,18,10,316,962203,18,962185
28707,6,18,184,1190939,6,1190933
28708,12,-4,604,526616,12,526604
28709,15,14,983,1093161,15,1093146
28710,7,-8,314,382053,7,382046
28711,7,-9,117,346072,7,346065
28712,19,-9,466,370292,19,370273
28713,16,11,655,995484,16,995468
28714,20,-9,211,368035,20,368015
28715,10,-3,582,543559,10,543549
28716,13,8,105,898750,13,898737
28717,5,-20,400,8659,5,8654
28718,19,-13,550,245072,19,245053
28719,7,16,520,1136299,7,1136292
28720,6,-7,821,423172,6,423166
28721,10,10,82,939269,10,939259
28722,14,13,696,1058449,14,1058435
28723,9,-2,620,575972,9,575963
28724,18,-1,573,621069,18,621051
28725,10,19,409,1226805,10,1226795
28726,6,8,725,891239,6,891233
28727,15,-9,327,369004,15,368989
28728,19,8,540,902217,19,902198
28729,19,3,54,742248,19,742229
28730,6,18,491,1197221,6,1197215
28731,10,2,238,693689,10,693679
28732,19,-2,451,588548,19,588529
28733,14,-20,329,25422,14,25408
28734,5,18,885,1205456,5,1205451
28735,11,-15,941,184953,11,184942
28736,8,-16,573,136485,8,136477
28737,19,0,707,653671,19,653652
28738,5,-9,314,350516,5,350511
28739,6,8,534,886940,6,886934
28740,8,8,822,893062,8,893054
28741,6,0,709,640858,6,640852
28742,12,6,792,842101,12,842089
28743,19,-4,963,529337,19,529318
28744,12,-17,68,115995,12,115983
28745,18,-17,784,121442,18,121424
28746,7,19,14,1217726,7,1217719
28747,20,1,997,687532,20,687512
28748,9,-18,57,63632,9,63623
28749,18,8,221,899714,18,899696
28750,13,-3,839,560496,13,560483
28751,14,-14,70,209850,14,209836
28752,5,-11,161,284701,5,284696
28753,14,-5,651,495765,14,495751
28754,20,-13,292,243252,20,243232
28755,20,-3,709,559439,20,559419
28756,13,-19,127,55026,13,55013
28757,11,13,432,1056444,11,1056433
28758,16,-5,151,492098,16,492082
28759,13,8,181,899343,13,899330
28760,6,-18,873,81281,6,81275
28761,20,12,885,1028733,20,1028713
28762,8,-14,410,195798,8,195790
28763,11,2,500,714407,11,714396
28764,17,4,143,774293,17,774276
28765,7,3,334,726179,7,726172
28766,9,-16,309,130664,9,130655
28767,17,4,948,780238,17,780221
28768,12,2,20,710607,12,710595
28769,10,7,452,854506,10,854496
28770,9,5,877,800066,9,800057
28771,15,-8,60,398385,15,398370
28772,18,9,313,931299,18,931281
28773,12,-16,195,148382,12,148370
28774,7,3,243,724091,7,724084
28775,8,-7,985,426905,8,426897
28776,15,13,905,1059947,15,1059932
28777,18,6,845,842538,18,842520
28778,16,-10,389,337840,16,337824
28779,17,10,40,960146,17,960129
28780,6,-1,587,606709,6,606703
28781,16,17,378,1180763,16,1180747
28782,8,-8,614,388435,8,388427
28783,9,18,535,1198296,9,1198287
28784,19,-11,485,307598,19,307579
28785,7,5,341,788645,7,788638
28786,6,10,707,952802,6,952796
28787,10,-11,237,286162,10,286152
28788,6,-8,688,390208,6,390202
28789,5,9,764,922742,5,922737
28790,9,-12,294,255873,9,255864
28791,6,-1,273,599848,6,599842
28792,17,18,636,1213547,17,1213530
28793,19,13,678,1058320,19,1058301
28794,7,12,522,1010260,7,1010253
28795,13,1,274,682070,13,682057
28796,9,-19,396,40150,9,40141
28797,7,-3,174,534129,7,534122
28798,15,-5,5,490807,15,490792
28799,13,-15,110,178597,13,178584
28800,14,7,352,869584,14,869570
28801,11,5,509,807503,11,807492
28802,13,7,162,868202,13,868189
28803,8,-1,75,595419,8,595411
28804,15,18,137,1210070,15,1210055
28805,12,3,633,746621,12,746609
28806,16,5,453,807095,16,807079
28807,7,-13,510,229175,7,229168
28808,15,17,833,1184216,15,1184201
28809,11,-10,661,340059,11,340048
28810,9,-15,251,160797,9,160788
28811,12,3,241,743693,12,743681
28812,18,5,465,807208,18,807190
28813,8,-19,737,47809,8,47801
28814,9,-14,557,198580,9,198571
28815,17,19,445,1244522,17,1244505
28816,18,18,558,1213029,18,1213011
28817,11,-15,485,181337,11,181326
28818,14,-9,109,367390,14,367376
28819,16,4,529,777100,16,777084
28820,16,-7,29,428554,16,428538
28821,17,2,502,714412,17,714395
28822,7,17,197,1159422,7,1159415
28823,10,-17,883,112156,10,112146
28824,19,-6,752,464903,19,464884
28825,17,-4,168,523355,17,523338
28826,14,16,738,1152353,14,1152339
28827,18,15,231,1118535,18,1118517
28828,20,11,787,996558,20,996538
28829,13,-15,907,184641,13,184628
28830,9,-8,52,376527,9,376518
28831,7,18,260,1192542,7,1192535
28832,11,5,758,809289,11,809278
28833,11,8,763,903990,11,903979
28834,7,10,268,943218,7,943211
28835,5,-11,716,296600,5,296595
28836,11,-19,26,54087,11,54076
28837,5,-15,285,161495,5,161490
28838,7,-5,701,483193,7,483186
28839,10,2,953,708531,10,708521
28840,18,-18,574,89416,18,89398
28841,10,16,421,1134239,10,1134229
28842,9,-15,317,162260,9,162251
28843,6,-15,281,161378,6,161372
28844,13,15,223,1118486,13,1118473
28845,5,-6,563,448948,5,448943
28846,14,-15,272,179744,14,179730
28847,16,-20,784,28862,16,28846
28848,9,-3,552,542897,9,542888
28849,18,-4,47,522381,18,522363
28850,8,-16,291,130287,8,130279
28851,14,-12,257,274401,14,274387
28852,11,-3,421,556932,11,556921
28853,9,12,562,1011123,9,1011114
28854,5,11,207,972615,5,972610
28855,16,-18,602,89597,16,89581
28856,9,12,266,1005117,9,1005108
28857,20,-7,692,433334,20,433314
28858,15,4,807,779199,15,779184
28859,8,6,462,822831,8,822823
28860,15,-13,846,247328,15,247313
28861,17,-3,281,555757,17,555740
28862,10,-11,193,285331,10,285321
28863,12,13,882,1059828,12,1059816
28864,8,7,986,865675,8,865667
28865,6,-9,680,358498,6,358492
28866,20,-15,195,179137,20,179117
28867,15,-4,958,529281,15,529266
28868,8,12,89,1001102,8,1001094
28869,16,3,228,743598,16,743582
28870,7,16,763,1140926,7,1140919
28871,15,3,638,746660,15,746645
28872,8,-18,39,63198,8,63190
28873,17,-3,946,561371,17,561354
28874,14,-19,175,55433,14,55419
28875,10,-16,965,144781,10,144771
28876,14,10,862,966430,14,966416
28877,20,11,28,991085,20,991065
28878,6,-2,427,571867,6,571861
28879,15,-17,650,120370,15,120355
28880,14,13,444,1056579,14,1056565
28881,7,-19,10,31636,7,31629
28882,7,7,795,861609,7,861602
28883,7,-4,163,502891,7,502884
28884,19,-3,24,553989,19,553970
28885,20,-6,71,459608,20,459588
28886,6,0,384,633668,6,633662
28887,8,17,42,1156272,8,1156264
28888,10,-16,650,138083,10,138073
28889,12,-18,757,90795,12,90783
28890,16,-17,255,117350,16,117334
28891,20,17,414,1181008,20,1180988
28892,20,10,820,966232,20,966212
28893,6,-17,527,104778,6,104772
28894,11,-9,705,371999,11,371988
28895,16,-4,390,525132,16,525116
28896,11,-9,773,372661,11,372650
28897,17,3,833,748069,17,748052
28898,9,11,757,984640,9,984631
28899,8,-14,693,201899,8,201891
28900,9,4,185,754576,9,754567
28901,17,1,481,683663,17,683646
28902,20,-6,979,466584,20,466564
28903,20,-11,676,309106,20,309086
28904,8,-10,741,328552,8,328544
28905,18,-2,464,588630,18,588612
28906,15,-14,229,211196,15,211181
28907,9,9,922,926349,9,926340
28908,16,16,35,1147319,16,1147303
28909,11,-14,984,217152,11,217141
28910,8,-9,713,359285,8,359277
28911,20,-9,8,366723,20,366703
28912,20,-13,478,244512,20,244492
28913,8,-2,4,562845,8,562837
28914,13,-20,213,24449,13,24436
28915,17,-14,719,215121,17,215104
28916,11,-1,304,618992,11,618981
28917,5,-6,164,440338,5,440333
28918,5,11,483,978754,5,978749
28919,14,-1,530,620804,14,620790
28920,13,5,315,806063,13,806050
28921,18,2,682,715742,18,715724
28922,17,14,594,1090016,17,1089999
28923,19,-20,568,27142,19,27123
28924,13,-5,219,492576,13,492563
28925,8,-9,721,359470,8,359462
28926,5,-4,532,510980,5,510975
28927,17,3,761,747614,17,747597
28928,8,-11,917,300763,8,300755
28929,5,-17,858,111595,5,111590
28930,13,13,39,1053522,13,1053509
28931,5,13,954,1051181,5,1051176
28932,20,-18,913,91877,20,91857
28933,11,-19,216,55784,11,55773
28934,13,14,806,1091769,13,1091756
28935,12,16,83,1147664,12,1147652
28936,18,-18,211,86908,18,86890
28937,8,19,864,1236815,8,1236807
28938,6,7,262,850414,6,850408
28939,13,19,43,1241044,13,1241031
28940,15,-4,906,528872,15,528857
28941,12,18,309,1211314,12,1211302
28942,15,-15,552,181862,15,181847
28943,19,19,293,1243105,19,1243086
28944,16,19,519,1245076,16,1245060
28945,12,9,508,932788,12,932776
28946,15,19,693,1246388,15,1246373
28947,8,-20,699,15409,8,15401
28948,10,-18,26,63004,10,62994
28949,20,14,418,1088731,20,1088711
28950,19,13,544,1057311,19,1057292
28951,17,0,947,655436,17,655419
28952,7,19,808,1235401,7,1235394
28953,20,-3,808,560277,20,560257
28954,12,-19,253,55998,12,55986
28955,20,-17,544,119584,20,119564
28956,18,-19,288,56251,18,56233
28957,17,-17,703,120777,17,120760
28958,7,14,341,1069349,7,1069342
28959,15,-6,146,460245,15,460230
28960,14,-18,170,86572,14,86558
28961,11,19,643,1245998,11,1245987
28962,18,-20,969,30119,18,30101
28963,19,1,787,685972,19,685953
28964,19,-19,297,56311,19,56292
28965,10,-15,409,164294,10,164284
28966,8,-7,653,419616,8,419608
28967,20,0,723,653867,20,653847
28968,17,14,961,1092949,17,1092932
28969,11,-12,374,275296,11,275285
28970,5,-16,848,142180,5,142175
28971,15,9,900,935741,15,935726
28972,9,8,394,883812,9,883803
28973,6,-16,56,125048,6,125042
28974,5,8,168,878766,5,878761
28975,9,13,964,1051325,9,1051316
28976,13,14,563,1089836,13,1089823
28977,8,14,335,1069211,8,1069203
28978,8,-20,347,7642,8,7634
28979,11,8,377,900909,11,900898
28980,8,-14,963,207474,8,207466
28981,11,8,942,905276,11,905265
28982,5,-16,464,134259,5,134254
28983,11,-12,745,277955,11,277944
28984,8,17,907,1174842,8,1174834
28985,16,-14,111,210178,16,210162
28986,12,15,507,1120432,12,1120420
28987,19,-20,431,26030,19,26011
28988,8,-6,445,446213,8,446205
28989,13,10,663,965025,13,965012
28990,7,15,345,1101890,7,1101883
28991,5,8,1000,896883,5,896878
28992,12,3,697,747179,12,747167
28993,11,0,374,650906,11,650895
28994,10,-12,740,265478,10,265468
28995,6,13,495,1041372,6,1041366
28996,7,17,791,1172201,7,1172194
28997,7,17,225,1159963,7,1159956
28998,15,-11,227,305485,15,305470
28999,17,-7,990,435639,17,435622
29000,16,-1,293,618886,16,618870
29001,8,4,437,760035,8,760027
29002,10,-6,595,449602,10,449592
29003,13,-4,61,522503,13,522490
29004,9,-16,903,143347,9,143338
29005,14,7,64,867481,14,867467
29006,15,16,69,1147587,15,1147572
29007,12,-4,68,522554,12,522542
29008,8,-19,390,39959,8,39951
29009,6,15,619,1107595,6,1107589
29010,14,-8,66,398446,14,398432
29011,18,-15,598,182177,18,182159
29012,16,8,493,901870,16,901854
29013,13,16,997,1154278,13,1154265
29014,12,-6,738,464798,12,464786
29015,5,19,299,1224214,5,1224209
29016,14,-20,974,30208,14,30194
29017,15,-16,9,146780,15,146765
29018,8,-5,524,479405,8,479397
29019,19,-1,773,622509,19,622490
29020,11,19,166,1242074,11,1242063
29021,19,-3,700,559345,19,559326
29022,5,16,496,1135693,5,1135688
29023,8,13,561,1042834,8,1042826
29024,14,-13,10,241116,14,241102
29025,11,-18,642,89905,11,89894
29026,11,4,664,778092,11,778081
29027,19,4,496,776803,19,776784
29028,5,6,530,824372,5,824367
29029,16,-5,452,494324,16,494308
29030,8,18,96,1188835,8,1188827
29031,8,-14,753,203090,8,203082
29032,9,-6,80,438409,9,438400
29033,17,-16,478,150542,17,150525
29034,16,4,22,773407,16,773391
29035,6,-12,380,257858,6,257852
29036,19,1,858,686493,19,686474
29037,9,17,456,1165126,9,1165117
29038,11,-16,272,148974,11,148963
29039,13,12,420,1025107,13,1025094
29040,11,-15,340,180260,11,180249
29041,15,-2,661,590094,15,590079
29042,19,10,309,962135,19,962116
29043,10,15,2,1094385,10,1094375
29044,19,19,573,1245473,19,1245454
29045,6,1,610,670556,6,670550
29046,5,-10,550,324526,5,324521
29047,11,5,414,806762,11,806751
29048,11,-8,175,399164,11,399153
29049,20,13,401,1056228,20,1056208
29050,6,-7,96,407883,6,407877
29051,10,10,273,943328,10,943318
29052,11,18,117,1209898,11,1209887
29053,14,3,35,742076,14,742062
29054,19,-12,109,273324,19,273305
29055,14,-3,962,561490,14,561476
29056,16,3,435,745101,16,745085
29057,19,-6,310,461562,19,461543
29058,18,-4,704,527381,18,527363
29059,9,19,938,1238226,9,1238217
29060,14,-15,720,183159,14,183145
29061,16,-15,611,182249,16,182233
29062,16,-17,740,121102,16,121086
29063,14,19,118,1241748,14,1241734
29064,20,17,360,1180663,20,1180643
29065,12,12,796,1027994,12,1027982
29066,6,8,884,894323,6,894317
29067,16,18,974,1216141,16,1216125
29068,7,10,66,938938,7,938931
29069,14,-18,101,85999,14,85985
29070,16,4,358,775814,16,775798
29071,5,13,926,1050559,5,1050554
29072,14,-3,852,560587,14,560573
29073,7,-3,886,550235,7,550228
29074,14,5,999,811130,14,811116
29075,12,-13,502,244720,12,244708
29076,15,-3,484,557521,15,557506
29077,6,2,659,702589,6,702583
29078,6,-3,504,541756,6,541750
29079,16,6,378,838728,16,838712
29080,9,-15,752,171537,9,171528
29081,12,13,27,1053402,12,1053390
29082,14,-10,349,337589,14,337575
29083,9,-2,213,567255,9,567246
29084,5,-9,436,353248,5,353243
29085,18,14,865,1092185,18,1092167
29086,20,-11,770,309748,20,309728
29087,16,-19,172,55419,16,55403
29088,7,-19,7,31613,7,31606
29089,17,15,683,1121786,17,1121769
29090,9,8,717,891074,9,891065
29091,6,-15,936,175324,6,175318
29092,10,-17,917,112898,10,112888
29093,19,19,176,1242144,19,1242125
29094,14,-6,403,462200,14,462186
29095,18,-16,891,153513,18,153495
29096,9,-14,804,204181,9,204172
29097,19,-11,308,306241,19,306222
29098,11,6,190,837185,11,837174
29099,15,-1,440,620036,15,620021
29100,6,-15,104,157710,6,157704
29101,10,-10,636,326380,10,326370
29102,18,12,479,1025578,18,1025560
29103,10,-7,289,412073,10,412063
29104,15,18,173,1210331,15,1210316
29105,20,15,944,1123698,20,1123678
29106,9,-4,507,510459,9,510450
29107,6,-14,446,196424,6,196418
29108,5,2,364,696551,5,696546
29109,6,5,658,795192,6,795186
29110,10,15,690,1109069,10,1109059
29111,8,-1,144,596891,8,596883
29112,12,7,518,870899,12,870887
29113,20,-8,705,402885,20,402865
29114,14,11,162,992002,14,991988
29115,5,-20,267,5893,5,5888
29116,5,8,4,875226,5,875221
29117,8,-14,16,186856,8,186848
29118,12,-7,29,428556,12,428544
29119,8,19,281,1223715,8,1223707
29120,6,18,734,1202014,6,1202008
29121,9,4,47,751575,9,751566
29122,9,9,892,925627,9,925618
29123,14,19,200,1242317,14,1242303
29124,17,-17,23,115732,17,115715
29125,14,7,906,873475,14,873461
29126,13,5,917,810459,13,810446
29127,5,-12,424,258756,5,258751
29128,18,-7,767,433892,18,433874
29129,9,-19,324,38555,9,38546
29130,12,-17,17,115697,12,115685
29131,19,-16,991,154240,19,154221
29132,8,-17,335,100696,8,100688
29133,9,9,883,925443,9,925434
29134,11,-11,665,309017,11,309006
29135,17,4,837,779478,17,779461
29136,20,19,406,1244140,20,1244120
29137,10,8,542,887036,10,887026
29138,9,-19,319,38422,9,38413
29139,17,14,643,1090449,17,1090432
29140,19,3,563,745985,19,745966
29141,12,-4,304,524452,12,524440
29142,7,9,553,918412,7,918405
29143,8,-6,677,451253,8,451245
29144,12,8,107,898772,12,898760
29145,11,12,432,1025216,11,1025205
29146,17,1,919,687033,17,687016
29147,20,-7,838,434410,20,434390
29148,6,0,641,639284,6,639278
29149,11,-14,541,213649,11,213638
29150,8,0,448,635115,8,635107
29151,5,10,264,943061,5,943056
29152,6,-10,611,325853,6,325847
29153,18,5,828,809812,18,809794
29154,9,9,694,921364,9,921355
29155,18,1,132,680887,18,680869
29156,13,9,392,931868,13,931855
29157,5,10,888,956564,5,956559
29158,14,15,244,1118598,14,1118584
29159,10,4,398,759210,10,759200
29160,12,0,669,653363,12,653351
29161,7,-9,508,355117,7,355110
29162,10,-3,555,542997,10,542987
29163,13,11,395,993770,13,993757
29164,18,6,563,840316,18,840298
29165,8,2,921,707758,8,707750
29166,17,4,451,776491,17,776474
29167,19,-10,627,339735,19,339716
29168,13,-13,432,244190,13,244177
29169,5,-13,623,231698,5,231693
29170,17,-19,616,58837,17,58820
29171,19,3,168,743087,19,743068
29172,9,7,593,857379,9,857370
29173,8,13,627,1044273,8,1044265
29174,7,3,471,728904,7,728897
29175,5,4,621,764065,5,764060
29176,11,6,734,841720,11,841709
29177,17,7,28,867206,17,867189
29178,16,-2,365,587809,16,587793
29179,17,13,310,1055477,17,1055460
29180,11,-17,61,115958,11,115947
29181,10,-17,621,106894,10,106884
29182,12,3,50,742199,12,742187
29183,9,18,432,1195952,9,1195943
29184,19,9,721,934376,19,934357
29185,20,-8,792,403554,20,403534
29186,8,7,648,858475,8,858467
29187,11,-17,637,120271,11,120260
29188,18,-17,77,116077,18,116059
29189,10,-1,818,611427,10,611417
29190,13,7,154,868148,13,868135
29191,13,-10,868,341598,13,341585
29192,7,14,548,1074067,7,1074060
29193,11,8,231,899857,11,899846
29194,8,11,361,976158,8,976150
29195,15,-14,238,211267,15,211252
29196,11,18,402,1212018,11,1212007
29197,19,12,584,1026357,19,1026338
29198,20,-20,274,24869,20,24849
29199,11,-2,23,585314,11,585303
29200,15,-18,578,89443,15,89428
29201,17,18,920,1215660,17,1215643
29202,8,3,684,733620,8,733612
29203,16,-19,468,57575,16,57559
29204,7,-14,740,202795,7,202788
29205,9,8,483,885752,9,885743
29206,9,-19,814,49181,9,49172
29207,19,14,983,1093170,19,1093151
29208,13,5,221,805508,13,805495
29209,6,-18,957,83294,6,83288
29210,5,-1,858,612283,5,612278
29211,8,-16,273,129941,8,129933
29212,14,17,949,1185010,14,1184996
29213,7,-2,217,567401,7,567394
29214,12,-8,94,398616,12,398604
29215,10,5,654,795076,10,795066
29216,19,-1,984,624062,19,624043
29217,7,-20,35,837,7,830
29218,6,-10,242,317812,6,317806
29219,17,-8,227,399522,17,399505
29220,11,-7,173,429613,11,429602
29221,14,-3,940,561327,14,561313
29222,9,1,836,675096,9,675087
29223,6,13,18,1031187,6,1031181
29224,18,-10,615,339672,18,339654
29225,9,-9,298,350069,9,350060
29226,17,-15,597,182163,17,182146
29227,11,7,461,870464,11,870453
29228,17,9,313,931306,17,931289
29229,13,14,812,1091828,13,1091815
29230,11,-1,656,621647,11,621636
29231,14,1,495,683799,14,683785
29232,15,14,998,1093332,15,1093317
29233,17,9,340,931493,17,931476
29234,7,-3,232,535380,7,535373
29235,11,-7,745,433681,11,433670
29236,10,-8,308,381904,10,381894
29237,14,17,593,1182236,14,1182222
29238,19,-9,920,373872,19,373853
29239,19,-9,765,372573,19,372554
29240,11,-3,459,557306,11,557295
29241,13,13,508,1057013,13,1057000
29242,8,-6,174,440614,8,440606
29243,10,15,975,1115252,10,1115242
29244,19,6,88,836389,19,836370
29245,14,16,246,1148847,14,1148833
29246,11,-15,231,179423,11,179412
29247,20,3,923,748825,20,748805
29248,10,9,253,912030,10,912020
29249,10,0,351,632810,10,632800
29250,20,18,541,1212936,20,1212916
29251,20,6,507,839905,20,839885
29252,10,-10,269,318347,10,318337
29253,7,-8,824,392978,7,392971
29254,16,9,934,936044,16,936028
29255,7,16,790,1141522,7,1141515
29256,6,-5,105,470428,6,470422
29257,14,-14,862,216257,14,216243
29258,9,4,138,753570,9,753561
29259,16,-19,39,54154,16,54138
29260,17,8,694,903466,17,903449
29261,6,-19,223,36455,6,36449
29262,9,-3,136,533370,9,533361
29263,11,-19,923,60978,11,60967
29264,19,4,459,776550,19,776531
29265,6,6,773,829643,6,829637
29266,8,13,998,1052156,8,1052148
29267,8,1,612,670577,8,670569
29268,20,-2,638,589920,20,589900
29269,6,-12,668,264027,6,264021
29270,18,1,220,681631,18,681613
29271,7,4,189,754641,7,754634
29272,10,-17,868,111797,10,111787
29273,18,-8,840,403858,18,403840
29274,18,-17,992,122724,18,122706
29275,20,-19,255,56006,20,55986
29276,18,-14,353,212151,18,212133
29277,14,10,691,965237,14,965223
29278,15,-15,185,179105,15,179090
29279,19,-10,190,336487,19,336468
29280,12,14,287,1087617,12,1087605
29281,12,3,679,747006,12,746994
29282,19,-1,108,617377,19,617358
29283,5,-18,787,79501,5,79496
29284,16,-10,959,342290,16,342274
29285,18,-8,874,404071,18,404053
29286,8,7,382,853063,8,853055
29287,18,19,503,1244917,18,1244899
29288,16,12,81,1022647,16,1022631
29289,18,13,242,1054997,18,1054979
29290,10,-5,566,480298,10,480288
29291,20,18,876,1215340,20,1215320
29292,17,14,760,1091431,17,1091414
29293,19,-20,134,23770,19,23751
29294,9,-17,184,97264,9,97255
29295,11,-1,295,618885,11,618874
29296,7,-15,324,162430,7,162423
29297,9,8,445,884953,9,884944
29298,18,8,388,901052,18,901034
29299,7,8,598,888236,7,888229
29300,15,18,728,1214157,15,1214142
29301,11,15,235,1118541,11,1118530
29302,10,5,440,790674,10,790664
29303,17,16,695,1152060,17,1152043
29304,6,17,25,1155819,6,1155813
29305,16,-15,38,178068,16,178052
29306,18,-17,403,118432,18,118414
29307,7,-14,179,190354,7,190347
29308,13,-19,197,55609,13,55596
29309,18,-1,527,620765,18,620747
29310,10,-11,828,298850,10,298840
29311,12,-17,753,121220,12,121208
29312,19,-17,113,116402,19,116383
29313,14,14,415,1088704,14,1088690
29314,8,-12,515,260817,8,260809
29315,5,-18,797,79628,5,79623
29316,12,-7,490,431992,12,431980
29317,16,-12,974,279900,16,279884
29318,16,0,943,655409,16,655393
29319,9,-19,922,51348,9,51339
29320,5,19,185,1221622,5,1221617
29321,8,3,113,721291,8,721283
29322,11,9,28,929261,11,929250
29323,16,-20,426,25975,16,25959
29324,8,11,688,983068,8,983060
29325,16,-14,304,211770,16,211754
29326,17,-10,725,340539,17,340522
29327,18,3,906,748641,18,748623
29328,12,0,235,650005,12,649993
29329,7,18,515,1197819,7,1197812
29330,12,-17,490,119133,12,119121
29331,11,17,927,1184838,11,1184827
29332,10,-6,865,455246,10,455236
29333,14,-3,744,559701,14,559687
29334,13,-13,264,243021,13,243008
29335,11,-8,113,398669,11,398658
29336,11,-19,905,60843,11,60832
29337,13,-8,932,404450,13,404437
29338,20,5,901,810352,20,810332
29339,8,2,194,692837,8,692829
29340,15,3,741,747432,15,747417
29341,20,-11,350,306547,20,306527
29342,5,-17,1000,114526,5,114521
29343,11,-9,383,369508,11,369497
29344,10,8,610,888497,10,888487
29345,17,8,861,904653,17,904636
29346,16,2,344,713194,16,713178
29347,20,13,919,1060001,20,1059981
29348,13,2,424,713831,13,713818
29349,7,5,913,800814,7,800807
29350,11,-13,145,242075,11,242064
29351,6,2,563,700485,6,700479
29352,16,-1,240,618466,16,618450
29353,10,-1,871,612542,10,612532
29354,7,-9,670,358301,7,358294
29355,17,-16,754,152458,17,152441
29356,18,-18,174,86654,18,86636
29357,7,0,424,634537,7,634530
29358,16,17,21,1178017,16,1178001
29359,16,-16,448,150338,16,150322
29360,14,5,682,808774,14,808760
29361,19,2,506,714434,19,714415
29362,15,-9,490,370530,15,370515
29363,12,-6,143,460212,12,460200
29364,8,8,561,887488,8,887480
29365,10,1,274,663163,10,663153
29366,20,17,795,1183864,20,1183844
29367,10,3,802,736118,10,736108
29368,12,11,854,997054,12,997042
29369,14,-7,788,434002,14,433988
29370,17,-17,52,115916,17,115899
29371,6,-18,388,70730,6,70724
29372,18,19,404,1244097,18,1244079
29373,18,-12,239,274282,18,274264
29374,19,-16,58,147224,19,147205
29375,16,19,480,1244728,16,1244712
29376,10,3,145,721956,10,721946
29377,17,7,743,872414,17,872397
29378,8,-9,512,355217,8,355209
29379,9,-11,608,294633,9,294624
29380,8,0,861,644038,8,644030
29381,16,10,870,966501,16,966485
29382,13,-4,493,525781,13,525768
29383,18,-17,932,122364,18,122346
29384,17,7,248,868802,17,868785
29385,18,-7,900,434984,18,434966
29386,10,19,250,1223001,10,1222991
29387,13,11,843,996973,13,996960
29388,15,-15,757,183402,15,183387
29389,19,-7,440,431623,19,431604
29390,18,15,732,1122230,18,1122212
29391,16,-16,909,153633,16,153617
29392,15,12,473,1025511,15,1025496
29393,17,-11,710,309284,17,309267
29394,6,6,926,833037,6,833031
29395,9,17,800,1172444,9,1172435
29396,10,-10,284,318657,10,318647
29397,6,18,490,1197216,6,1197210
29398,15,-15,795,183654,15,183639
29399,11,-15,251,179589,11,179578
29400,11,7,390,869889,11,869878
29401,13,-5,25,491003,13,490990
29402,9,-6,884,455636,9,455627
29403,19,18,723,1214103,19,1214084
29404,17,18,183,1210451,17,1210434
29405,10,8,745,891610,10,891600
29406,12,-18,900,91748,12,91736
29407,8,-3,535,542567,8,542559
29408,16,13,207,1054762,16,1054746
29409,7,16,301,1131532,7,1131525
29410,9,9,411,915301,9,915292
29411,13,14,983,1093173,13,1093160
29412,5,6,782,829833,5,829828
29413,7,-14,127,189216,7,189209
29414,8,10,793,954700,8,954692
29415,19,-14,423,212849,19,212830
29416,14,1,4,679776,14,679762
29417,16,11,59,991306,16,991290
29418,6,1,522,668730,6,668724
29419,8,-1,978,614937,8,614929
29420,19,-16,984,154166,19,154147
29421,19,0,230,649971,19,649952
29422,13,-15,317,180066,13,180053
29423,17,7,759,872485,17,872468
29424,15,18,818,1214873,15,1214858
29425,18,-16,501,150685,18,150667
29426,6,1,292,663496,6,663490
29427,7,-15,81,157050,7,157043
29428,8,7,895,863785,8,863777
29429,17,-5,702,496166,17,496149
29430,10,12,159,1002638,10,1002628
29431,6,5,750,797281,6,797275
29432,13,6,951,843315,13,843302
29433,5,14,218,1066521,5,1066516
29434,13,14,623,1090256,13,1090243
29435,17,-6,554,463472,17,463455
29436,13,-18,886,91633,13,91620
29437,15,-15,604,182201,15,182186
29438,19,6,947,843309,19,843290
29439,13,3,786,747750,13,747737
29440,11,-4,575,526453,11,526442
29441,20,-18,217,86955,20,86935
29442,10,9,484,916936,10,916926
29443,7,-12,234,254540,7,254533
29444,17,5,686,808807,17,808790
29445,20,-7,208,429875,20,429855
29446,8,9,748,922414,8,922406
29447,19,6,258,837743,19,837724
29448,11,7,114,867848,11,867837
29449,15,-19,318,56426,15,56411
29450,17,-18,371,88075,17,88058
29451,15,-19,198,55639,15,55624
29452,7,-1,254,599372,7,599365
29453,6,-15,455,165228,6,165222
29454,12,-4,503,525893,12,525881
29455,15,17,197,1179362,15,1179347
29456,14,6,240,837555,14,837541
29457,9,-11,417,290401,9,290392
29458,19,7,121,867871,19,867852
29459,6,14,802,1079871,6,1079865
29460,8,7,470,854883,8,854875
29461,14,-18,564,89348,14,89334
29462,16,7,553,871098,16,871082
29463,11,9,6,929079,11,929068
29464,14,17,77,1178447,14,1178433
29465,19,1,790,685987,19,685968
29466,18,0,761,654127,18,654109
29467,15,-8,479,401168,15,401153
29468,17,-2,839,591531,17,591514
29469,11,3,184,743251,11,743240
29470,6,15,283,1100596,6,1100590
29471,15,12,447,1025316,15,1025301
29472,16,-18,167,86544,16,86528
29473,14,-12,395,275408,14,275394
29474,5,6,679,827593,5,827588
29475,9,6,174,815949,9,815940
29476,5,-16,682,138626,5,138621
29477,5,-7,289,412078,5,412073
29478,12,-20,26,15011,12,14999
29479,20,-2,189,586480,20,586460
29480,15,-15,773,183544,15,183529
29481,6,-13,575,230596,6,230590
29482,17,-2,792,591091,17,591074
29483,15,-11,179,305187,15,305172
29484,16,-16,270,148969,16,148953
29485,5,9,782,923240,5,923235
29486,16,4,451,776497,16,776481
29487,12,10,446,963215,12,963203
29488,20,12,264,1024056,20,1024036
29489,13,-17,493,119184,13,119171
29490,16,11,96,991567,16,991551
29491,7,-18,311,69337,7,69330
29492,20,3,727,747359,20,747339
29493,16,-13,151,242123,16,242107
29494,12,6,540,840132,12,840120
29495,17,-15,804,183771,17,183754
29496,5,-5,435,477404,5,477399
29497,11,14,202,1086979,11,1086968
29498,7,14,96,1063958,7,1063951
29499,17,13,107,1054019,17,1054002
29500,7,19,837,1236101,7,1236094
29501,6,-16,160,127464,6,127458
29502,17,16,569,1151123,17,1151106
29503,13,6,666,841127,13,841114
29504,20,-13,855,247412,20,247392
29505,6,-20,560,12238,6,12232
29506,19,3,118,742718,19,742699
29507,18,-14,889,216427,18,216409
29508,11,-3,481,557461,11,557450
29509,8,-16,154,127361,8,127353
29510,14,15,366,1119444,14,1119430
29511,5,-18,452,72125,5,72120
29512,9,16,661,1139062,9,1139053
29513,18,14,680,1090806,18,1090788
29514,13,2,825,716631,13,716618
29515,12,7,295,869126,12,869114
29516,12,8,995,905675,12,905663
29517,6,2,775,704849,6,704843
29518,17,17,165,1179102,17,1179085
29519,11,19,79,1241427,11,1241416
29520,5,16,585,1137419,5,1137414
29521,15,-14,161,210544,15,210529
29522,19,-12,760,278104,19,278085
29523,20,-17,79,116130,20,116110
29524,15,-11,70,304242,15,304227
29525,20,11,814,996767,20,996747
29526,20,-15,929,184834,20,184814
29527,17,-16,353,149513,17,149496
29528,14,16,361,1149738,14,1149724
29529,19,11,383,993668,19,993649
29530,15,19,17,1240798,15,1240783
29531,13,12,208,1023543,13,1023530
29532,7,-6,374,444838,7,444831
29533,6,18,997,1207832,6,1207826
29534,12,-3,840,560498,12,560486
29535,11,14,336,1088069,11,1088058
29536,7,15,656,1108350,7,1108343
29537,11,4,495,776778,11,776767
29538,15,-1,963,623861,15,623846
29539,7,17,171,1158884,7,1158877
29540,9,17,725,1170743,9,1170734
29541,14,7,39,867314,14,867300
29542,6,-6,748,452899,6,452893
29543,17,-9,874,373502,17,373485
29544,5,13,751,1046846,5,1046841
29545,6,11,654,982392,6,982386
29546,8,12,453,1008750,8,1008742
29547,20,-12,297,274722,20,274702
29548,16,7,602,871484,16,871468
29549,9,4,240,755913,9,755904
29550,12,2,463,714131,12,714119
29551,10,14,544,1073936,10,1073926
29552,10,-8,136,378306,10,378296
29553,17,-14,635,214512,17,214495
29554,20,-6,734,464768,20,464748
29555,13,9,568,933243,13,933230
29556,19,6,902,842956,19,842937
29557,6,18,728,1201874,6,1201868
29558,6,-9,188,347582,6,347576
29559,10,15,786,1111132,10,1111122
29560,14,0,405,651136,14,651122
29561,19,17,502,1181649,19,1181630
29562,19,3,629,746582,19,746563
29563,13,-8,515,401456,13,401443
29564,10,-19,541,43255,10,43245
29565,6,-2,980,583797,6,583791
29566,19,6,223,837425,19,837406
29567,10,8,154,878384,10,878374
29568,20,-17,206,116973,20,116953
29569,5,11,748,984429,5,984424
29570,9,-6,262,442536,9,442527
29571,5,-19,350,39103,5,39098
29572,18,-17,721,120959,18,120941
29573,15,7,309,869261,15,869246
29574,10,5,107,783817,10,783807
29575,10,-18,889,81684,10,81674
29576,19,19,356,1243649,19,1243630
29577,16,18,99,1209719,16,1209703
29578,13,-20,792,28952,13,28939
29579,16,-8,521,401492,16,401476
29580,10,2,583,700866,10,700856
29581,15,6,252,837663,15,837648
29582,8,-7,260,411299,8,411291
29583,7,-20,997,22080,7,22073
29584,8,16,378,1133211,8,1133203
29585,16,13,937,1060192,16,1060176
29586,12,5,537,807705,12,807693
29587,20,-8,15,397993,20,397973
29588,15,18,509,1212691,15,1212676
29589,12,9,541,933000,12,932988
29590,9,-5,397,476690,9,476681
29591,17,-3,778,560079,17,560062
29592,8,1,769,673756,8,673748
29593,6,4,496,761213,6,761207
29594,5,17,995,1176718,5,1176713
29595,8,4,180,754471,8,754463
29596,7,19,799,1235169,7,1235162
29597,5,-3,872,549904,5,549899
29598,12,-20,531,26810,12,26798
29599,17,-13,426,244130,17,244113
29600,16,4,845,779564,16,779548
29601,20,13,752,1058822,20,1058802
29602,5,2,818,705622,5,705617
29603,19,11,265,992746,19,992727
29604,7,6,702,828248,7,828241
29605,5,5,973,802184,5,802179
29606,9,-12,864,268423,9,268414
29607,9,17,368,1163200,9,1163191
29608,16,4,939,780167,16,780151
29609,6,-15,477,165812,6,165806
29610,15,-11,188,305229,15,305214
29611,17,7,489,870661,17,870644
29612,5,1,908,676758,5,676753
29613,20,7,8,867088,20,867068
29614,10,-19,248,37060,10,37050
29615,9,2,911,707546,9,707537
29616,13,16,382,1149884,13,1149871
29617,20,-10,414,338101,20,338081
29618,18,18,444,1212292,18,1212274
29619,14,-7,625,432894,14,432880
29620,5,-13,233,223323,5,223318
29621,18,-19,997,61437,18,61419
29622,11,11,459,994192,11,994181
29623,5,-1,713,609279,5,609274
29624,9,-2,715,578105,9,578096
29625,12,5,400,806706,12,806694
29626,15,15,185,1118198,15,1118183
29627,16,11,849,997025,16,997009
29628,18,-10,246,336851,18,336833
29629,14,-9,136,367564,14,367550
29630,10,-11,485,291985,10,291975
29631,10,6,764,829480,10,829470
29632,12,13,271,1055164,12,1055152
29633,13,10,149,961006,13,960993
29634,20,10,110,960724,20,960704
29635,13,0,13,648280,13,648267
29636,16,-7,174,429619,16,429603
29637,20,7,316,869318,20,869298
29638,19,-4,180,523451,19,523432
29639,14,12,820,1028128,14,1028114
29640,15,16,551,1151011,15,1150996
29641,10,15,699,1109314,10,1109304
29642,19,12,37,1022367,19,1022348
29643,7,-18,987,83891,7,83884
29644,19,-20,11,6746,19,6727
29645,12,6,587,840515,12,840503
29646,19,-12,156,273678,19,273659
29647,11,10,211,961418,11,961407
29648,7,8,865,893957,7,893950
29649,18,-9,193,367918,18,367900
29650,16,-8,481,401180,16,401164
29651,7,8,158,878531,7,878524
29652,17,6,594,840580,17,840563
29653,5,-13,711,233498,5,233493
29654,11,-11,490,307650,11,307639
29655,10,18,225,1191679,10,1191669
29656,8,-7,926,425632,8,425624
29657,19,10,411,962976,19,962957
29658,14,-11,434,307250,14,307236
29659,13,-9,936,374005,13,373992
29660,18,-7,103,429035,18,429017
29661,14,7,522,870921,14,870907
29662,10,-13,589,230949,10,230939
29663,19,-20,651,27767,19,27748
29664,15,-11,258,305733,15,305718
29665,15,-9,376,369474,15,369459
29666,9,-17,492,104043,9,104034
29667,18,-20,956,30032,18,30014
29668,18,-7,220,429947,18,429929
29669,16,-16,593,151374,16,151358
29670,13,-5,404,493978,13,493965
29671,11,-14,725,215156,11,215145
29672,6,7,803,861769,6,861763
29673,16,-12,468,275951,16,275935
29674,18,-12,39,272766,18,272748
29675,16,0,508,652019,16,652003
29676,20,-6,294,461477,20,461457
29677,9,-4,58,500575,9,500566
29678,20,2,240,712368,20,712348
29679,5,17,815,1172809,5,1172804
29680,18,-12,640,277208,18,277190
29681,12,11,732,996087,12,996075
29682,9,-7,735,421388,9,421379
29683,16,-20,68,23294,16,23278
29684,20,8,267,900056,20,900036
29685,7,9,494,917141,7,917134
29686,9,-20,318,7109,9,7100
29687,5,6,102,814368,5,814363
29688,8,-12,279,255597,8,255589
29689,6,-18,948,83007,6,83001
29690,15,-8,332,400240,15,400225
29691,7,-9,623,357411,7,357404
29692,15,-7,757,433792,15,433777
29693,11,-14,892,216455,11,216444
29694,15,-5,868,497355,15,497340
29695,16,15,897,1123339,16,1123323
29696,6,3,36,719624,6,719618
29697,10,-20,211,4837,10,4827
29698,8,-11,179,285053,8,285045
29699,13,3,749,747491,13,747478
29700,11,7,243,868754,11,868743
29701,8,-5,911,487877,8,487869
29702,15,-17,152,116606,15,116591
29703,8,17,262,1160800,8,1160792
29704,11,6,281,837929,11,837918
29705,20,-5,697,496111,20,496091
29706,7,-1,265,599634,7,599627
29707,8,3,273,724752,8,724744
29708,11,12,402,1024994,11,1024983
29709,8,-17,792,110379,8,110371
29710,19,-6,769,465001,19,464982
29711,16,-20,437,26119,16,26103
29712,9,0,491,636053,9,636044
29713,15,-9,635,371569,15,371554
29714,10,4,752,766973,10,766963
29715,15,-9,495,370596,15,370581
29716,9,-20,549,12006,9,11997
29717,13,0,83,648823,13,648810
29718,13,-20,270,24839,13,24826
29719,20,-4,649,526976,20,526956
29720,17,-11,64,304185,17,304168
29721,8,-5,807,485345,8,485337
29722,14,10,661,965018,14,965004
29723,6,14,531,1073665,6,1073659
29724,15,14,985,1093183,15,1093168
29725,10,-9,416,352722,10,352712
29726,5,17,915,1174980,5,1174975
29727,5,-17,146,96480,5,96475
29728,13,-8,819,403756,13,403743
29729,15,2,197,712085,15,712070
29730,11,-12,92,273213,11,273202
29731,14,-3,124,554684,14,554670
29732,5,7,827,862364,5,862359
29733,5,1,170,660883,5,660878
29734,9,-4,109,501732,9,501723
29735,11,9,622,933697,11,933686
29736,10,3,975,740229,10,740219
29737,16,-10,72,335735,16,335719
29738,8,-5,375,476260,8,476252
29739,20,-10,828,341313,20,341293
29740,12,19,415,1244251,12,1244239
29741,5,-3,644,544958,5,544953
29742,9,13,36,1031533,9,1031524
29743,10,18,720,1201705,10,1201695
29744,15,-8,885,404135,15,404120
29745,18,-10,649,339916,18,339898
29746,8,-4,917,519106,8,519098
29747,20,-5,207,492473,20,492453
29748,18,13,652,1058168,18,1058150
29749,16,-7,751,433714,16,433698
29750,18,-17,379,118284,18,118266
29751,10,-7,295,412238,10,412228
29752,19,-2,130,586095,19,586076
29753,11,4,112,774077,11,774066
29754,5,-3,931,551336,5,551331
29755,15,-9,239,368316,15,368301
29756,6,1,211,661848,6,661842
29757,17,0,788,654246,17,654229
29758,19,17,207,1179446,19,1179427
29759,18,-4,5,522076,18,522058
29760,9,-6,137,439646,9,439637
29761,9,3,115,721323,9,721314
29762,15,-2,412,588185,15,588170
29763,6,7,880,863496,6,863490
29764,10,7,156,848125,10,848115
29765,5,-18,475,72637,5,72632
29766,11,-13,873,247567,11,247556
29767,10,-9,172,347213,10,347203
29768,13,-6,708,464544,13,464531
29769,7,9,85,908505,7,908498
29770,17,0,163,649462,17,649445
29771,6,-9,972,365193,6,365187
29772,16,-18,565,89353,16,89337
29773,10,-6,231,441963,10,441953
29774,7,-16,628,137667,7,137660
29775,19,-10,217,336688,19,336669
29776,18,17,397,1180895,18,1180877
29777,19,0,436,651383,19,651364
29778,16,-8,202,399344,16,399328
29779,11,-19,849,60505,11,60494
29780,6,-12,549,261450,6,261444
29781,9,-6,39,437660,9,437651
29782,6,-3,930,551314,6,551308
29783,6,4,778,767579,6,767573
29784,20,-5,306,493348,20,493328
29785,16,-1,113,617417,16,617401
29786,12,10,80,960452,12,960440
29787,14,-20,637,27622,14,27608
29788,5,5,219,786277,5,786272
29789,7,-2,31,563440,7,563433
29790,7,4,108,752961,7,752954
29791,14,9,766,934640,14,934626
29792,17,4,949,780257,17,780240
29793,7,-20,628,13728,7,13721
29794,8,13,744,1046692,8,1046684
29795,19,1,562,684343,19,684324
29796,11,-5,382,493830,11,493819
29797,8,12,870,1018178,8,1018170
29798,17,-9,13,366729,17,366712
29799,11,2,610,715138,11,715127
29800,11,-5,545,495066,11,495055
29801,20,-13,185,242425,20,242405
29802,18,-14,376,212437,18,212419
29803,14,-1,124,617497,14,617483
29804,18,11,586,995093,18,995075
29805,16,1,31,680014,16,679998
29806,8,-11,279,287149,8,287141
29807,6,18,493,1197271,6,1197265
29808,15,5,67,804304,15,804289
29809,8,-11,560,293580,8,293572
29810,5,-18,573,74736,5,74731
29811,14,-5,668,495843,14,495829
29812,8,2,96,690717,8,690709
29813,18,-13,364,243709,18,243691
29814,12,13,770,1058991,12,1058979
29815,17,18,546,1212965,17,1212948
29816,14,15,218,1118455,14,1118441
29817,18,4,58,773657,18,773639
29818,11,17,320,1180365,11,1180354
29819,19,1,18,679888,19,679869
29820,17,16,164,1148247,17,1148230
29821,16,7,860,873221,16,873205
29822,5,3,491,729347,5,729342
29823,9,16,663,1139128,9,1139119
29824,16,3,595,746276,16,746260
29825,20,-5,577,495292,20,495272
29826,10,-12,963,270600,10,270590
29827,19,16,65,1147550,19,1147531
29828,14,11,34,991130,14,991116
29829,13,-11,242,305579,13,305566
29830,11,-6,783,465136,11,465125
29831,13,18,976,1216160,13,1216147
29832,6,-12,352,257305,6,257299
29833,8,1,534,669067,8,669059
29834,6,19,96,1219595,6,1219589
29835,18,-16,928,153759,18,153741
29836,7,-14,88,188491,7,188484
29837,20,-16,111,147750,20,147730
29838,11,-9,724,372087,11,372076
29839,15,5,436,806934,15,806919
29840,6,-16,613,137348,6,137342
29841,9,-9,670,358310,9,358301
29842,10,-6,120,439263,10,439253
29843,12,17,436,1181158,12,1181146
29844,19,10,138,960958,19,960939
29845,8,-10,691,327585,8,327577
29846,15,7,685,872010,15,871995
29847,15,1,2,679755,15,679740
29848,12,-5,525,494932,12,494920
29849,15,12,959,1029497,15,1029482
29850,8,3,273,724760,8,724752
29851,19,17,689,1183001,19,1182982
29852,10,9,451,916159,10,916149
29853,18,9,682,934079,18,934061
29854,10,-17,802,110597,10,110587
29855,17,2,311,712926,17,712909
29856,11,13,698,1058481,11,1058470
29857,16,4,530,777109,16,777093
29858,12,-18,932,91993,12,91981
29859,16,-16,111,147756,16,147740
29860,11,-11,450,307371,11,307360
29861,15,19,440,1244469,15,1244454
29862,6,-16,358,131613,6,131607
29863,18,-15,910,184677,18,184659
29864,6,1,165,660766,6,660760
29865,8,13,118,1033255,8,1033247
29866,7,13,686,1045510,7,1045503
29867,7,-3,158,533768,7,533761
29868,17,-7,982,435586,17,435569
29869,17,-16,161,148105,17,148088
29870,16,11,168,992029,16,992013
29871,12,12,111,1022876,12,1022864
29872,12,7,541,871021,12,871009
29873,18,-16,810,152842,18,152824
29874,14,-12,577,276770,14,276756
29875,11,-9,120,367478,11,367467
29876,6,14,127,1064720,6,1064714
29877,19,19,225,1242538,19,1242519
29878,6,1,464,667346,6,667340
29879,12,-14,494,213327,12,213315
29880,14,-1,991,624104,14,624090
29881,13,-5,684,496001,13,495988
29882,8,-5,581,480638,8,480630
29883,18,-20,126,23710,18,23692
29884,13,12,833,1028282,13,1028269
29885,18,0,990,655843,18,655825
29886,19,-12,591,276827,19,276808
29887,11,6,932,843182,11,843171
29888,18,-8,170,399108,18,399090
29889,9,-4,348,507179,9,507170
29890,16,-18,344,87911,16,87895
29891,11,9,652,933866,11,933855
29892,9,6,783,829871,9,829862
29893,20,18,323,1211444,20,1211424
29894,17,11,102,991599,17,991582
29895,16,8,514,902047,16,902031
29896,19,-16,125,147864,19,147845
29897,11,-15,321,180103,11,180092
29898,7,-20,549,12013,7,12006
29899,10,-20,865,19223,10,19213
29900,8,-10,118,315128,8,315120
29901,11,-10,661,340060,11,340049
29902,9,3,929,739027,9,739018
29903,12,12,981,1029697,12,1029685
29904,5,-4,568,511677,5,511672
29905,6,18,902,1205836,6,1205830
29906,19,-18,385,88193,19,88174
29907,14,-10,141,336192,14,336178
29908,13,-16,584,151310,13,151297
29909,6,19,84,1219371,6,1219365
29910,18,-20,547,26981,18,26963
29911,12,-16,103,147685,12,147673
29912,9,4,367,758463,9,758454
29913,5,1,351,664898,5,664893
29914,5,19,283,1223770,5,1223765
29915,7,-15,813,172795,7,172788
29916,10,-10,748,328722,10,328712
29917,14,-10,857,341533,14,341519
29918,16,0,632,653027,16,653011
29919,14,2,994,717825,14,717811
29920,8,9,236,911721,8,911713
29921,6,2,81,690317,6,690311
29922,16,-10,354,337614,16,337598
29923,11,9,400,931940,11,931929
29924,8,8,435,884703,8,884695
29925,20,19,785,1247157,20,1247137
29926,8,5,769,797705,8,797697
29927,15,10,558,964153,15,964138
29928,5,-8,210,379968,5,379963
29929,12,-4,389,525122,12,525110
29930,19,0,803,654417,19,654398
29931,16,0,993,655880,16,655864
29932,20,-9,394,369658,20,369638
29933,15,0,726,653896,15,653881
29934,20,-12,257,274411,20,274391
29935,11,10,122,960852,11,960841
29936,17,-14,410,212770,17,212753
29937,7,-11,919,300803,7,300796
29938,10,-10,973,333418,10,333408
29939,13,8,453,901563,13,901550
29940,17,-4,623,526784,17,526767
29941,16,11,254,992665,16,992649
29942,13,12,639,1026796,13,1026783
29943,17,-18,306,87619,17,87602
29944,5,-15,94,157434,5,157429
29945,16,7,132,867976,16,867960
29946,7,-17,65,94742,7,94735
29947,13,-4,512,525995,13,525982
29948,6,-8,296,381649,6,381643
29949,5,-4,876,518208,5,518203
29950,8,-14,446,196432,8,196424
29951,13,13,395,1056153,13,1056140
29952,16,-20,629,27556,16,27540
29953,17,0,755,654068,17,654051
29954,20,12,698,1027327,20,1027307
29955,6,-1,265,599640,6,599634
29956,16,-15,98,178534,16,178518
29957,20,5,642,808478,20,808458
29958,18,8,219,899698,18,899680
29959,17,-10,805,341184,17,341167
29960,13,14,376,1088372,13,1088359
29961,6,3,189,722955,6,722949
29962,19,-12,843,278747,19,278728
29963,8,11,575,980807,8,980799
29964,5,12,801,1016444,5,1016439
29965,19,-5,904,497676,19,497657
29966,10,-8,98,377441,10,377431
29967,11,10,857,966396,11,966385
29968,5,-10,721,328110,5,328105
29969,18,-19,372,56894,18,56876
29970,14,7,869,873291,14,873277
29971,11,17,158,1179023,11,1179012
29972,6,6,266,818199,6,818193
29973,12,14,372,1088332,12,1088320
29974,7,0,429,634653,7,634646
29975,8,-20,725,15939,8,15931
29976,20,-6,536,463280,20,463260
29977,8,-18,729,78116,8,78108
29978,13,19,463,1244616,13,1244603
29979,8,-8,624,388648,8,388640
29980,14,13,497,1056908,14,1056894
29981,13,-10,67,335676,13,335663
29982,10,-13,630,231828,10,231818
29983,20,-6,331,461740,20,461720
29984,17,-11,988,311452,17,311435
29985,6,-5,323,475277,6,475271
29986,8,13,713,1045978,8,1045970
29987,15,-3,560,558189,15,558174
29988,12,7,895,873420,12,873408
29989,16,7,437,870288,16,870272
29990,14,-12,83,273136,14,273122
29991,10,-8,221,380237,10,380227
29992,20,-16,404,149868,20,149848
29993,14,2,47,710855,14,710841
29994,9,-14,182,190388,9,190379
29995,12,9,858,935433,12,935421
29996,13,-1,420,619899,13,619886
29997,8,14,36,1062630,8,1062622
29998,8,5,259,787075,8,787067
29999,16,-11,808,310020,16,310004
30000,6,15,850,1112561,6,1112555
30001,12,7,122,867873,12,867861
30002,7,5,283,787628,7,787621
30003,10,-14,367,194735,10,194725
30004,18,-20,789,28897,18,28879
30005,8,11,425,977557,8,977549
30006,8,-20,362,7944,8,7936
30007,6,3,137,721795,6,721789
30008,12,10,761,965685,12,965673
30009,8,17,236,1160230,8,1160222
30010,18,-20,193,24364,18,24346
30011,13,-19,742,59867,13,59854
30012,10,2,503,699310,10,699300
30013,5,-5,438,477436,5,477431
30014,20,-4,196,523586,20,523566
30015,16,-15,627,182409,16,182393
30016,6,-3,367,538434,6,538428
30017,15,-12,815,278486,15,278471
30018,13,7,964,873827,13,873814
30019,13,-19,666,59170,13,59157
30020,6,-16,18,124314,6,124308
30021,12,-18,516,89052,12,89040
30022,5,8,854,893706,5,893701
30023,20,-10,599,339538,20,339518
30024,5,-4,214,504180,5,504175
30025,7,-9,201,347851,7,347844
30026,8,-12,395,258179,8,258171
30027,6,8,296,881652,6,881646
30028,7,0,962,646270,7,646263
30029,11,2,337,713134,11,713123
30030,8,16,616,1138090,8,1138082
30031,5,-17,36,94321,5,94316
30032,8,-4,102,501570,8,501562
30033,10,15,925,1114124,10,1114114
30034,8,4,939,771149,8,771141
30035,9,6,422,821895,9,821886
30036,12,10,501,963647,12,963635
30037,10,-12,759,265947,10,265937
30038,16,0,906,655167,16,655151
30039,10,-6,284,443015,10,443005
30040,16,-5,742,496463,16,496447
30041,19,17,548,1181960,19,1181941
30042,7,6,388,821056,7,821049
30043,11,-4,339,524725,11,524714
30044,12,-10,739,340640,12,340628
30045,17,11,907,997469,17,997452
30046,6,3,433,728130,6,728124
30047,9,14,792,1079661,9,1079652
30048,6,16,636,1138585,6,1138579
30049,20,-20,874,29541,20,29521
30050,6,-12,759,265953,6,265947
30051,8,-17,947,113460,8,113452
30052,8,-14,670,201409,8,201401
30053,11,-11,101,304482,11,304471
30054,5,-16,924,143822,5,143817
30055,20,10,4,959852,20,959832
30056,15,-3,507,557702,15,557687
30057,9,-6,259,442470,9,442461
30058,11,-13,510,244807,11,244796
30059,6,-16,609,137271,6,137265
30060,12,-12,260,274419,12,274407
30061,11,18,237,1210881,11,1210870
30062,18,-18,910,91834,18,91816
30063,19,10,413,962993,19,962974
30064,19,4,363,775840,19,775821
30065,7,-17,623,106947,7,106940
30066,7,-14,234,191864,7,191857
30067,13,-5,432,494177,13,494164
30068,9,-19,350,39112,9,39103
30069,13,1,327,682507,13,682494
30070,14,-10,161,336283,14,336269
30071,20,-11,870,310528,20,310508
30072,10,-9,544,355936,10,355926
30073,8,5,157,784803,8,784795
30074,15,13,573,1057594,15,1057579
30075,18,15,886,1123252,18,1123234
30076,20,12,938,1029279,20,1029259
30077,11,-12,426,275590,11,275579
30078,8,18,611,1199641,8,1199633
30079,5,-6,502,447658,5,447653
30080,17,-16,380,149683,17,149666
30081,11,-20,275,24891,11,24880
30082,7,15,22,1094937,7,1094930
30083,17,-16,430,150143,17,150126
30084,10,13,801,1047993,10,1047983
30085,20,9,671,934000,20,933980
30086,12,-10,618,339676,12,339664
30087,5,-18,813,79980,5,79975
30088,11,8,194,899477,11,899466
30089,11,12,650,1026885,11,1026874
30090,10,-16,444,133798,10,133788
30091,20,-13,132,241967,20,241947
30092,10,-20,617,13472,10,13462
30093,18,-8,436,400907,18,400889
30094,10,2,774,704834,10,704824
30095,17,1,134,680911,17,680894
30096,20,12,101,1022773,20,1022753
30097,9,-19,149,34962,9,34953
30098,17,-7,799,434094,17,434077
30099,14,19,620,1245853,14,1245839
30100,8,-15,672,169806,8,169798
30101,8,-5,0,467735,8,467727
30102,20,9,242,930776,20,930756
30103,10,12,84,1001004,10,1000994
30104,19,-2,402,588095,19,588076
30105,17,-2,452,588557,17,588540
30106,10,10,137,940632,10,940622
30107,5,-2,654,576685,5,576680
30108,14,1,494,683772,14,683758
30109,17,1,160,681134,17,681117
30110,20,-10,74,335764,20,335744
30111,14,0,155,649398,14,649384
30112,9,-13,437,227525,9,227516
30113,9,-1,214,598392,9,598383
30114,16,0,80,648790,16,648774
30115,14,-13,320,243452,14,243438
30116,14,18,190,1210564,14,1210550
30117,10,15,716,1109739,10,1109729
30118,13,3,94,742518,13,742505
30119,13,6,433,839218,13,839205
30120,7,-7,143,408833,7,408826
30121,6,12,697,1014396,6,1014390
30122,17,-13,928,248040,17,248023
30123,11,-20,371,25656,11,25645
30124,7,8,541,887027,7,887020
30125,12,-2,479,588766,12,588754
30126,6,6,127,814917,6,814911
30127,19,4,853,779659,19,779640
30128,6,16,668,1139214,6,1139208
30129,19,-9,551,371097,19,371078
30130,13,-6,422,462390,13,462377
30131,15,17,97,1178535,15,1178520
30132,16,8,824,904382,16,904366
30133,13,-2,811,591220,13,591207
30134,6,11,265,973906,6,973900
30135,20,-18,400,88294,20,88274
30136,19,-5,874,497441,19,497422
30137,8,-3,883,550174,8,550166
30138,9,-20,413,8906,9,8897
30139,10,7,451,854472,10,854462
30140,15,-6,191,460639,15,460624
30141,11,8,154,899151,11,899140
30142,19,12,921,1029148,19,1029129
30143,7,-18,389,70764,7,70757
30144,9,-13,760,234715,9,234706
30145,8,-3,187,534361,8,534353
30146,13,5,396,806678,13,806665
30147,12,3,65,742297,12,742285
30148,17,-18,320,87720,17,87703
30149,19,-7,437,431604,19,431585
30150,7,1,807,674540,7,674533
30151,17,17,116,1178691,17,1178674
30152,9,-19,600,44677,9,44668
30153,15,3,308,744255,15,744240
30154,19,-11,114,304613,19,304594
30155,15,15,38,1117070,15,1117055
30156,19,-15,375,180548,19,180529
30157,17,-20,235,24555,17,24538
30158,20,5,390,806668,20,806648
30159,18,16,521,1150826,18,1150808
30160,13,-1,754,622350,13,622337
30161,16,14,200,1086980,16,1086964
30162,11,-8,776,403389,11,403378
30163,18,-14,712,215083,18,215065
30164,12,6,909,843013,12,843001
30165,7,14,843,1080726,7,1080719
30166,6,15,152,1097747,6,1097741
30167,15,-8,1,397833,15,397818
30168,14,1,661,685075,14,685061
30169,9,7,48,845864,9,845855
30170,16,6,550,840201,16,840185
30171,5,-18,720,77955,5,77950
30172,6,-19,987,52641,6,52635
30173,14,10,929,966995,14,966981
30174,17,7,851,873146,17,873129
30175,20,11,994,998000,20,997980
30176,8,-8,500,385770,8,385762
30177,15,-20,208,24430,15,24415
30178,15,7,701,872141,15,872126
30179,20,4,681,778255,20,778235
30180,17,5,921,810500,17,810483
30181,20,17,755,1183501,20,1183481
30182,8,4,669,765018,8,765010
30183,13,19,839,1247567,13,1247554
30184,5,3,970,740067,5,740062
30185,10,15,466,1104320,10,1104310
30186,13,1,935,687175,13,687162
30187,17,1,932,687159,17,687142
30188,13,-18,84,85852,13,85839
30189,9,14,477,1072417,9,1072408
30190,19,-16,645,151748,19,151729
30191,5,15,895,1113480,5,1113475
30192,10,10,388,945793,10,945783
30193,14,1,492,683745,14,683731
30194,16,-2,549,589254,16,589238
30195,6,-12,70,251123,6,251117
30196,14,-12,909,279414,14,279400
30197,13,-16,38,147010,13,146997
30198,19,-2,298,587392,19,587373
30199,17,-19,305,56353,17,56336
30200,11,4,44,773578,11,773567
30201,11,-7,813,434224,11,434213
30202,15,1,762,685799,15,685784
30203,17,7,494,870693,17,870676
30204,17,-7,525,432308,17,432291
30205,9,0,734,641517,9,641508
30206,20,15,38,1117080,20,1117060
30207,14,3,301,744176,14,744162
30208,6,6,50,813272,6,813266
30209,13,-17,597,120003,13,119990
30210,15,-13,503,244742,15,244727
30211,13,17,463,1181389,13,1181376
30212,14,-9,58,367083,14,367069
30213,7,-8,584,387621,7,387614
30214,20,-14,735,215235,20,215215
30215,16,-2,968,592498,16,592482
30216,12,-3,490,557580,12,557568
30217,14,-18,420,88440,14,88426
30218,9,-10,832,330398,9,330389
30219,8,-9,95,345644,8,345636
30220,20,-10,650,339925,20,339905
30221,12,-15,464,181218,12,181206
30222,14,-11,220,305432,14,305418
30223,20,-14,214,210994,20,210974
30224,7,17,635,1168890,7,1168883
30225,6,16,848,1142706,6,1142700
30226,8,8,185,879066,8,879058
30227,20,11,125,991718,20,991698
30228,17,1,604,684604,17,684587
30229,18,1,201,681467,18,681449
30230,17,7,833,873028,17,873011
30231,9,-16,228,129081,9,129072
30232,7,-7,33,406850,7,406843
30233,10,15,17,1094839,10,1094829
30234,13,-8,976,404858,13,404845
30235,12,-13,876,247583,12,247571
30236,17,4,303,775376,17,775359
30237,5,13,49,1031814,5,1031809
30238,12,-1,163,617753,12,617741
30239,7,3,479,729082,7,729075
30240,19,-3,327,556170,19,556151
30241,11,13,326,1055613,11,1055602
30242,20,-4,234,523950,20,523930
30243,10,1,465,667361,10,667351
30244,15,13,88,1053881,15,1053866
30245,8,11,838,986366,8,986358
30246,9,-18,950,83084,9,83075
30247,5,-6,856,455082,5,455077
30248,16,3,200,743424,16,743408
30249,16,12,22,1022259,16,1022243
30250,10,-12,193,253569,10,253559
30251,12,-9,201,367973,12,367961
30252,5,-7,320,412833,5,412828
30253,16,-2,742,590684,16,590668
30254,20,6,693,841363,20,841343
30255,5,-5,990,489510,5,489505
30256,6,-4,453,509286,6,509280
30257,15,-9,441,370075,15,370060
30258,19,16,622,1151483,19,1151464
30259,10,18,662,1200686,10,1200676
30260,13,1,891,686756,13,686743
30261,17,13,504,1056964,17,1056947
30262,11,-18,968,92248,11,92237
30263,5,-2,52,564006,5,564001
30264,16,5,340,806278,16,806262
30265,14,-20,178,24160,14,24146
30266,12,19,734,1246755,12,1246743
30267,19,17,350,1180591,19,1180572
30268,19,8,434,901418,19,901399
30269,17,9,135,930064,17,930047
30270,15,-5,993,498292,15,498277
30271,20,11,589,995119,20,995099
30272,17,18,547,1212975,17,1212958
30273,7,14,212,1066389,7,1066382
30274,16,8,949,905339,16,905323
30275,14,-7,28,428531,14,428517
30276,19,-5,208,492485,19,492466
30277,12,-18,262,87341,12,87329
30278,10,-5,413,476967,10,476957
30279,7,10,98,939757,7,939750
30280,7,-3,1,530648,7,530641
30281,11,-6,686,464389,11,464378
30282,18,7,423,870150,18,870132
30283,20,-2,973,592535,20,592515
30284,20,-7,202,429796,20,429776
30285,17,0,368,650837,17,650820
30286,19,2,627,715258,19,715239
30287,5,-16,272,129924,5,129919
30288,16,-6,467,462736,16,462720
30289,16,-2,745,590705,16,590689
30290,9,-20,461,9818,9,9809
30291,16,9,498,932665,16,932649
30292,13,4,863,779709,13,779696
30293,7,-1,640,607711,7,607704
30294,20,8,710,903607,20,903587
30295,11,18,851,1215183,11,1215172
30296,12,4,840,779510,12,779498
30297,9,3,688,733743,9,733734
30298,16,13,876,1059793,16,1059777
30299,10,1,385,665624,10,665614
30300,13,9,115,929886,13,929873
30301,17,-16,430,150150,17,150133
30302,5,-3,663,545398,5,545393
30303,9,-20,743,16316,9,16307
30304,15,-10,879,341717,15,341702
30305,11,-2,339,587632,11,587621
30306,14,-5,305,493336,14,493322
30307,9,-12,877,268600,9,268591
30308,7,4,555,762495,7,762488
30309,10,-14,713,202340,10,202330
30310,10,-8,110,377668,10,377658
30311,15,-5,902,497622,15,497607
30312,16,-1,677,621778,16,621762
30313,13,-8,589,401957,13,401944
30314,20,-7,360,431097,20,431077
30315,10,18,623,1199893,10,1199883
30316,14,-4,522,526070,14,526056
30317,15,4,378,775968,15,775953
30318,18,4,424,776307,18,776289
30319,10,-7,140,408774,10,408764
30320,15,-18,886,91638,15,91623
30321,9,7,136,847755,9,847746
30322,10,19,730,1233689,10,1233679
30323,8,13,476,1040931,8,1040923
30324,14,1,932,687163,14,687149
30325,7,-16,576,136516,7,136509
30326,12,-13,96,241728,12,241716
30327,8,16,569,1137196,8,1137188
30328,18,-8,790,403526,18,403508
30329,17,-19,432,57328,17,57311
30330,19,-17,246,117296,19,117277
30331,16,-13,566,245234,16,245218
30332,13,-17,968,122589,13,122576
30333,12,10,857,966398,12,966386
30334,5,-9,350,351294,5,351289
30335,14,13,846,1059576,14,1059562
30336,9,19,962,1238782,9,1238773
30337,16,-5,512,494811,16,494795
30338,6,5,88,783467,6,783461
30339,15,16,687,1152007,15,1151992
30340,14,-3,656,559028,14,559014
30341,14,-17,958,122527,14,122513
30342,11,-8,161,399043,11,399032
30343,7,-5,955,488775,7,488768
30344,15,16,508,1150712,15,1150697
30345,19,-10,764,340834,19,340815
30346,14,13,572,1057571,14,1057557
30347,17,-1,409,619826,17,619809
30348,20,15,123,1117743,20,1117723
30349,18,19,727,1246708,18,1246690
30350,11,0,745,654023,11,654012
30351,16,17,868,1184514,16,1184498
30352,6,-4,978,520441,6,520435
30353,9,5,12,781847,9,781838
30354,6,-20,919,20332,6,20326
30355,12,-14,63,209789,12,209777
30356,10,-2,958,583367,10,583357
30357,8,7,465,854763,8,854755
30358,12,14,454,1089017,12,1089005
30359,7,5,6,781709,7,781702
30360,19,-16,805,152825,19,152806
30361,19,10,406,962912,19,962893
30362,9,11,619,981712,9,981703
30363,17,-11,482,307584,17,307567
30364,18,9,458,932368,18,932350
30365,9,8,603,888354,9,888345
30366,8,-4,501,510265,8,510257
30367,14,1,108,680666,14,680652
30368,9,-4,340,506921,9,506912
30369,12,15,125,1117755,12,1117743
30370,18,17,564,1182032,18,1182014
30371,15,-7,47,428654,15,428639
30372,16,-8,157,399023,16,399007
30373,10,0,852,643835,10,643825
30374,17,16,244,1148837,17,1148820
30375,15,-8,481,401185,15,401170
30376,11,11,766,996379,11,996368
30377,19,-9,870,373483,19,373464
30378,18,-20,572,27163,18,27145
30379,14,-13,236,242771,14,242757
30380,15,-11,627,308716,15,308701
30381,14,7,62,867474,14,867460
30382,17,-2,551,589283,17,589266
30383,17,-16,825,152971,17,152954
30384,5,14,516,1073315,5,1073310
30385,17,-16,435,150192,17,150175
30386,17,2,165,711846,17,711829
30387,8,-5,358,475949,8,475941
30388,7,-12,270,255363,7,255356
30389,5,7,523,856007,5,856002
30390,12,-20,532,26811,12,26799
30391,18,3,673,746958,18,746940
30392,11,11,43,991170,11,991159
30393,6,-12,782,266412,6,266406
30394,11,-15,701,182951,11,182940
30395,8,-16,493,134828,8,134820
30396,7,-6,837,454695,7,454688
30397,20,5,479,807339,20,807319
30398,19,7,251,868842,19,868823
30399,14,-18,373,88082,14,88068
30400,7,-7,359,413653,7,413646
30401,10,-7,349,413460,10,413450
30402,14,13,616,1057952,14,1057938
30403,10,-2,292,569105,10,569095
30404,12,-9,25,366782,12,366770
30405,11,-14,250,211371,11,211360
30406,17,11,909,997477,17,997460
30407,17,-18,447,88619,17,88602
30408,20,10,370,962613,20,962593
30409,6,19,543,1229787,6,1229781
30410,13,2,56,710940,13,710927
30411,16,2,241,712381,16,712365
30412,12,-13,235,242763,12,242751
30413,18,18,45,1209257,18,1209239
30414,20,-2,827,591399,20,591379
30415,8,-3,872,549912,8,549904
30416,11,7,88,867653,11,867642
30417,6,-17,968,113856,6,113850
30418,5,-2,842,580813,5,580808
30419,10,16,227,1130058,10,1130048
30420,18,4,67,773749,18,773731
30421,10,18,53,1187843,10,1187833
30422,11,7,654,871804,11,871793
30423,13,5,221,805511,13,805498
30424,6,-1,128,596567,6,596561
30425,20,4,806,779184,20,779164
30426,13,-4,528,526116,13,526103
30427,17,-6,280,461377,17,461360
30428,19,10,936,967035,19,967016
30429,5,0,220,630269,5,630264
30430,8,-12,277,255534,8,255526
30431,7,1,355,664971,7,664964
30432,11,5,897,810292,11,810281
30433,17,-3,217,555298,17,555281
30434,6,-6,119,439234,6,439228
30435,18,16,450,1150383,18,1150365
30436,11,-19,845,60505,11,60494
30437,5,-1,637,607604,5,607599
30438,5,9,97,908771,5,908766
30439,7,15,533,1105876,7,1105869
30440,18,5,5,803832,18,803814
30441,14,7,222,868553,14,868539
30442,13,2,837,716748,13,716735
30443,18,-4,654,527041,18,527023
30444,18,15,973,1123968,18,1123950
30445,5,-11,918,300777,5,300772
30446,16,6,550,840207,16,840191
30447,7,12,86,1001036,7,1001029
30448,10,11,576,980835,10,980825
30449,16,13,130,1054170,16,1054154
30450,15,9,718,934349,15,934334
30451,8,17,396,1163758,8,1163750
30452,9,5,686,795904,9,795895
30453,17,-5,365,493778,17,493761
30454,13,-16,356,149520,13,149507
30455,6,-18,876,81369,6,81363
30456,16,2,557,714798,16,714782
30457,5,16,312,1131801,5,1131796
30458,20,18,632,1213507,20,1213487
30459,9,7,397,853368,9,853359
30460,8,9,604,919560,8,919552
30461,6,-13,471,228240,6,228234
30462,20,9,803,934997,20,934977
30463,6,7,129,847554,6,847548
30464,11,-15,232,179423,11,179412
30465,12,-20,123,23673,12,23661
30466,13,-17,210,117004,13,116991
30467,10,10,652,951645,10,951635
30468,16,0,998,655941,16,655925
30469,7,-19,536,43129,7,43122
30470,11,4,793,779087,11,779076
30471,17,6,222,837392,17,837375
30472,19,19,587,1245571,19,1245552
30473,15,3,939,748974,15,748959
30474,19,1,723,685486,19,685467
30475,5,10,659,951763,5,951758
30476,14,-6,163,460387,14,460373
30477,18,-7,335,430875,18,430857
30478,18,17,469,1181443,18,1181425
30479,6,15,55,1095647,6,1095641
30480,13,-14,242,211302,13,211289
30481,5,15,953,1114774,5,1114769
30482,6,11,17,968784,6,968778
30483,18,-19,543,58212,18,58194
30484,16,5,766,809359,16,809343
30485,17,16,987,1154158,17,1154141
30486,7,-18,565,74528,7,74521
30487,13,-3,379,556604,13,556591
30488,8,-17,748,109537,8,109529
30489,11,3,214,743494,11,743483
30490,17,12,239,1023816,17,1023799
30491,14,8,55,898294,14,898280
30492,17,13,571,1057544,17,1057527
30493,14,8,516,902070,14,902056
30494,5,19,585,1230693,5,1230688
30495,19,13,193,1054630,19,1054611
30496,12,-18,772,90879,12,90867
30497,19,1,462,683491,19,683472
30498,14,-17,872,121962,14,121948
30499,9,9,737,922209,9,922200
30500,12,2,880,717059,12,717047
30501,15,5,438,806945,15,806930
30502,8,-13,565,230371,8,230363
30503,9,-3,436,540104,9,540095
30504,10,11,111,970831,10,970821
30505,11,0,918,655251,11,655240
30506,15,18,506,1212651,15,1212636
30507,14,-15,639,182527,14,182513
30508,19,-12,290,274654,19,274635
30509,14,9,520,932877,14,932863
30510,6,13,102,1032900,6,1032894
30511,10,-12,560,261662,10,261652
30512,17,-19,864,60643,17,60626
30513,8,-9,27,344185,8,344177
30514,11,-15,16,177945,11,177934
30515,20,-16,996,154284,20,154264
30516,20,-1,399,619749,20,619729
30517,11,3,861,748340,11,748329
30518,20,14,612,1090171,20,1090151
30519,20,-20,299,25137,20,25117
30520,13,-2,402,588098,13,588085
30521,17,19,505,1244939,17,1244922
30522,8,7,488,855314,8,855306
30523,12,-13,577,245313,12,245301
30524,13,6,559,840254,13,840241
30525,5,8,645,889343,5,889338
30526,16,-1,699,621929,16,621913
30527,17,19,881,1247920,17,1247903
30528,12,5,673,808679,12,808667
30529,12,14,674,1090738,12,1090726
30530,12,-17,429,118621,12,118609
30531,11,13,539,1057250,11,1057239
30532,17,2,885,717093,17,717076
30533,15,11,445,994082,15,994067
30534,8,17,725,1170751,8,1170743
30535,16,16,479,1150556,16,1150540
30536,12,-3,438,557110,12,557098
30537,11,-6,581,463600,11,463589
30538,13,-10,510,338876,13,338863
30539,16,15,692,1121850,16,1121834
30540,5,7,63,846162,5,846157
30541,11,-9,16,366728,11,366717
30542,19,11,222,992402,19,992383
30543,15,18,114,1209887,15,1209872
30544,7,3,186,722897,7,722890
30545,17,-18,456,88701,17,88684
30546,18,-12,899,279270,18,279252
30547,5,7,214,849326,5,849321
30548,17,-17,842,121789,17,121772
30549,13,-15,866,184351,13,184338
30550,10,-18,430,71665,10,71655
30551,10,5,801,798370,10,798360
30552,10,10,733,953272,10,953262
30553,15,-11,622,308688,15,308673
30554,16,-2,733,590622,16,590606
30555,20,-11,355,306605,20,306585
30556,11,10,982,967321,11,967310
30557,20,-18,716,90456,20,90436
30558,13,-19,853,60541,13,60528
30559,9,-2,421,571698,9,571689
30560,5,-5,651,482097,5,482092
30561,16,-7,776,433954,16,433938
30562,16,-2,20,585299,16,585283
30563,20,-14,801,215821,20,215801
30564,20,-10,797,341091,20,341071
30565,8,10,36,938297,8,938289
30566,18,-7,896,434955,18,434937
30567,15,-20,396,25821,15,25806
30568,14,-3,977,561600,14,561586
30569,15,14,826,1091924,15,1091909
30570,9,-5,132,470944,9,470935
30571,9,1,179,661093,9,661084
30572,5,-16,693,138872,5,138867
30573,13,-18,207,86902,13,86889
30574,16,-4,969,529400,16,529384
30575,17,16,629,1151561,17,1151544
30576,8,-6,218,441642,8,441634
30577,13,-4,20,522196,13,522183
30578,5,18,125,1189541,5,1189536
30579,16,-11,679,309119,16,309103
30580,19,-18,368,88060,19,88041
30581,7,16,398,1133698,7,1133691
30582,18,3,57,742262,18,742244
30583,16,-12,955,279743,16,279727
30584,7,18,42,1187487,7,1187480
30585,17,12,455,1025381,17,1025364
30586,12,7,700,872137,12,872125
30587,15,-1,149,617678,15,617663
30588,20,-2,204,586631,20,586611
30589,7,13,691,1045561,7,1045554
30590,13,-10,347,337576,13,337563
30591,15,7,762,872506,15,872491
30592,5,19,918,1237844,5,1237839
30593,6,-1,966,614684,6,614678
30594,15,0,373,650887,15,650872
30595,16,-16,614,151552,16,151536
30596,12,-6,39,459429,12,459417
30597,14,3,360,744591,14,744577
30598,9,-7,666,419848,9,419839
30599,8,-2,788,579551,8,579543
30600,16,-16,524,150862,16,150846
30601,15,-19,181,55472,15,55457
30602,13,18,114,1209890,13,1209877
30603,12,-4,60,522498,12,522486
30604,19,12,69,1022563,19,1022544
30605,20,4,646,777969,20,777949
30606,10,-3,888,550278,10,550268
30607,17,-12,638,277189,17,277172
30608,12,5,105,804555,12,804543
30609,6,-15,988,176469,6,176463
30610,18,4,420,776259,18,776241
30611,8,-1,14,593980,8,593972
30612,8,19,858,1236687,8,1236679
30613,15,-15,467,181235,15,181220
30614,7,0,725,641318,7,641311
30615,5,4,396,759165,5,759160
30616,16,-7,955,435406,16,435390
30617,14,-5,613,495542,14,495528
30618,16,0,588,652728,16,652712
30619,16,-13,882,247637,16,247621
30620,14,6,131,836741,14,836727
30621,5,17,69,1156795,5,1156790
30622,11,1,371,682842,11,682831
30623,13,1,950,687294,13,687281
30624,10,16,140,1128057,10,1128047
30625,20,-3,5,553886,20,553866
30626,13,-20,446,26185,13,26172
30627,12,-4,117,522910,12,522898
30628,7,-6,644,450661,7,450654
30629,15,-2,811,591225,15,591210
30630,17,-8,570,401882,17,401865
30631,12,9,811,935033,12,935021
30632,10,-7,838,423591,10,423581
30633,10,16,306,1131636,10,1131626
30634,7,-4,287,505758,7,505751
30635,16,13,827,1059430,16,1059414
30636,7,1,820,674784,7,674777
30637,16,3,755,747528,16,747512
30638,9,-8,278,381345,9,381336
30639,17,-14,775,215595,17,215578
30640,13,14,761,1091443,13,1091430
30641,14,-4,515,526022,14,526008
30642,15,-17,695,120717,15,120702
30643,20,16,516,1150775,20,1150755
30644,16,15,116,1117660,16,1117644
30645,17,11,128,991741,17,991724
30646,9,-20,43,968,9,959
30647,13,-11,459,307431,13,307418
30648,5,13,256,1036049,5,1036044
30649,13,15,14,1116856,13,1116843
30650,10,7,777,861203,10,861193
30651,18,5,190,805238,18,805220
30652,18,-7,185,429683,18,429665
30653,9,-19,83,33223,9,33214
30654,11,11,885,997285,11,997274
30655,16,-2,81,585719,16,585703
30656,11,-16,846,153108,11,153097
30657,10,-1,448,603783,10,603773
30658,17,0,110,649105,17,649088
30659,8,-15,484,165938,8,165930
30660,19,-19,945,61142,19,61123
30661,14,2,147,711715,14,711701
30662,5,-12,424,258761,5,258756
30663,6,-19,131,34470,6,34464
30664,19,-4,275,524221,19,524202
30665,14,13,544,1057315,14,1057301
30666,11,18,915,1215620,11,1215609
30667,5,4,27,751146,5,751141
30668,15,13,283,1055269,15,1055254
30669,10,-4,207,504054,10,504044
30670,14,-2,510,588983,14,588969
30671,9,-15,97,157504,9,157495
30672,7,-6,524,448130,7,448123
30673,15,5,912,810433,15,810418
30674,12,4,223,774877,12,774865
30675,19,-7,514,432217,19,432198
30676,11,11,119,991688,11,991677
30677,5,-11,29,281682,5,281677
30678,13,10,842,966283,13,966270
30679,18,14,94,1086215,18,1086197
30680,6,-19,253,37122,6,37116
30681,20,-20,737,28460,20,28440
30682,10,16,861,1142969,10,1142959
30683,20,-2,973,592545,20,592525
30684,19,4,53,773623,19,773604
30685,10,7,652,858553,10,858543
30686,18,-14,402,212709,18,212691
30687,6,6,266,818205,6,818199
30688,14,2,167,711868,14,711854
30689,13,7,650,871760,13,871747
30690,5,10,359,945132,5,945127
30691,10,4,186,754595,10,754585
30692,18,-2,99,585868,18,585850
30693,15,1,330,682532,15,682517
30694,13,-1,527,620768,13,620755
30695,6,7,778,861213,6,861207
30696,5,18,540,1198356,5,1198351
30697,5,-19,977,52442,5,52437
30698,12,-3,445,557163,12,557151
30699,19,13,429,1056425,19,1056406
30700,19,6,137,836813,19,836794
30701,10,-10,124,315300,10,315290
30702,14,16,664,1151892,14,1151878
30703,12,-18,115,86077,12,86065
30704,19,13,483,1056801,19,1056782
30705,13,-7,911,435037,13,435024
30706,8,-14,940,206924,8,206916
30707,11,14,637,1090399,11,1090388
30708,12,13,405,1056255,12,1056243
30709,11,12,915,1029049,11,1029038
30710,13,11,332,993291,13,993278
30711,5,-19,540,43240,5,43235
30712,11,-19,247,55984,11,55973
30713,10,-10,456,322519,10,322509
30714,20,5,558,807849,20,807829
30715,5,-2,646,576492,5,576487
30716,10,-9,454,353666,10,353656
30717,11,-12,161,273727,11,273716
30718,10,4,286,756707,10,756697
30719,18,3,858,748301,18,748283
30720,16,-3,918,561130,16,561114
30721,20,-4,953,529236,20,529216
30722,10,-6,684,451479,10,451469
30723,12,-2,441,588447,12,588435
30724,6,8,637,889182,6,889176
30725,17,6,371,838680,17,838663
30726,14,-7,583,432718,14,432704
30727,7,-2,588,575220,7,575213
30728,12,3,575,746129,12,746117
30729,5,18,36,1187348,5,1187343
30730,11,14,780,1091592,11,1091581
30731,17,10,266,961832,17,961815
30732,16,17,512,1181749,16,1181733
30733,15,10,381,962672,15,962657
30734,16,-11,149,304912,16,304896
30735,14,-2,623,589819,14,589805
30736,12,1,961,687339,12,687327
30737,6,-1,550,605955,6,605949
30738,10,-11,52,282194,10,282184
30739,18,-10,152,336218,18,336200
30740,19,5,197,805309,19,805290
30741,9,2,252,694051,9,694042
30742,6,-12,867,268486,6,268480
30743,9,4,633,764365,9,764356
30744,17,16,43,1147387,17,1147370
30745,8,3,226,723731,8,723723
30746,8,15,273,1100350,8,1100342
30747,13,9,525,932900,13,932887
30748,7,9,743,922321,7,922314
30749,13,18,545,1212959,13,1212946
30750,16,-2,818,591307,16,591291
30751,18,18,536,1212914,18,1212896
30752,5,-13,314,225024,5,225019
30753,8,15,594,1106992,8,1106984
30754,20,12,992,1029747,20,1029727
30755,19,3,541,745806,19,745787
30756,17,-7,560,432528,17,432511
30757,9,4,812,768296,9,768287
30758,18,-20,657,27810,18,27792
30759,14,-11,786,309867,14,309853
30760,16,-3,698,559327,16,559311
30761,20,-19,69,54419,20,54399
30762,8,9,123,909375,8,909367
30763,17,-8,504,401370,17,401353
30764,8,-14,8,186582,8,186574
30765,14,19,573,1245477,14,1245463
30766,20,17,112,1178651,20,1178631
30767,16,-13,833,247210,16,247194
30768,13,-9,323,368965,13,368952
30769,11,-1,680,621789,11,621778
30770,14,12,232,1023743,14,1023729
30771,9,0,861,644047,9,644038
30772,16,5,47,804136,16,804120
30773,9,5,1,781614,9,781605
30774,7,-13,881,237429,7,237422
30775,14,8,498,901903,14,901889
30776,20,7,241,868738,20,868718
30777,10,-8,418,383971,10,383961
30778,5,18,77,1188450,5,1188445
30779,7,3,160,722211,7,722204
30780,11,9,691,934144,11,934133
30781,12,4,908,779955,12,779943
30782,6,18,462,1196669,6,1196663
30783,16,-12,124,273484,16,273468
30784,6,-16,551,136016,6,136010
30785,14,-13,447,244277,14,244263
30786,19,4,330,775604,19,775585
30787,9,-15,290,161631,9,161622
30788,17,-16,13,146850,17,146833
30789,16,-18,960,92207,16,92191
30790,20,5,625,808370,20,808350
30791,13,-19,346,56707,13,56694
30792,18,-18,45,85533,18,85515
30793,9,-5,346,475730,9,475721
30794,11,-20,83,23401,11,23390
30795,13,0,832,654576,13,654563
30796,6,-7,242,410906,6,410900
30797,15,0,425,651334,15,651319
30798,7,-5,957,488800,7,488793
30799,16,-3,444,557153,16,557137
30800,9,-10,896,331756,9,331747
30801,7,4,506,761455,7,761448
30802,6,6,653,827012,6,827006
30803,10,-14,125,189176,10,189166
30804,16,-14,780,215631,16,215615
30805,16,15,173,1118091,16,1118075
30806,9,10,178,941363,9,941354
30807,15,-18,638,89886,15,89871
30808,9,5,420,790192,9,790183
30809,9,0,782,642457,9,642448
30810,7,2,136,691494,7,691487
30811,8,-8,485,385383,8,385375
30812,15,11,80,991448,15,991433
30813,10,7,421,853843,10,853833
30814,20,-11,302,306152,20,306132
30815,20,-1,259,618563,20,618543
30816,10,-4,196,503705,10,503695
30817,5,-14,449,196474,5,196469
30818,13,12,197,1023445,13,1023432
30819,10,5,479,791597,10,791587
30820,16,-6,543,463370,16,463354
30821,10,-15,540,167061,10,167051
30822,14,-17,727,121023,14,121009
30823,10,-19,28,32108,10,32098
30824,5,12,361,1007009,5,1007004
30825,7,-13,839,236546,7,236539
30826,17,-20,188,24291,17,24274
30827,18,7,537,870980,18,870962
30828,12,-5,577,495294,12,495282
30829,6,13,637,1044439,6,1044433
30830,10,-12,324,256699,10,256689
30831,12,4,877,779806,12,779794
30832,16,17,112,1178657,16,1178641
30833,17,-18,585,89497,17,89480
30834,13,18,611,1213332,13,1213319
30835,17,9,702,934245,17,934228
30836,20,-2,519,589051,20,589031
30837,18,-7,836,434384,18,434366
30838,15,7,515,870839,15,870824
30839,14,9,965,936316,14,936302
30840,8,8,829,893212,8,893204
30841,17,9,246,930803,17,930786
30842,13,19,159,1242045,13,1242032
30843,19,14,689,1090892,19,1090873
30844,15,10,431,963119,15,963104
30845,5,-10,602,325646,5,325641
30846,5,-6,832,454607,5,454602
30847,17,5,37,804036,17,804019
30848,7,5,469,791352,7,791345
30849,9,19,560,1230157,9,1230148
30850,7,-17,301,100016,7,100009
30851,5,-17,750,109565,5,109560
30852,11,-13,185,242426,11,242415
30853,18,11,524,994644,18,994626
30854,10,12,466,1009092,10,1009082
30855,19,14,83,1086082,19,1086063
30856,19,19,738,1246787,19,1246768
30857,20,-11,938,311013,20,310993
30858,19,-9,187,367882,19,367863
30859,19,0,883,654981,19,654962
30860,5,12,426,1008180,5,1008175
30861,12,-14,867,216279,12,216267
30862,8,-20,688,15258,8,15250
30863,17,9,469,932432,17,932415
30864,10,-15,331,162589,10,162579
30865,16,-3,445,557169,16,557153
30866,8,-15,568,167635,8,167627
30867,13,-10,559,339230,13,339217
30868,15,8,63,898369,15,898354
30869,12,-19,598,58725,12,58713
30870,5,14,488,1072677,5,1072672
30871,18,4,397,776067,18,776049
30872,20,11,557,994841,20,994821
30873,16,8,877,904747,16,904731
30874,11,-10,289,337123,11,337112
30875,6,17,290,1161599,6,1161593
30876,16,-18,462,88757,16,88741
30877,8,8,762,891928,8,891920
30878,13,-10,591,339472,13,339459
30879,11,1,799,686091,11,686080
30880,10,17,82,1157053,10,1157043
30881,9,4,493,761140,9,761131
30882,20,3,613,746402,20,746382
30883,6,-5,179,472019,6,472013
30884,15,16,423,1150166,15,1150151
30885,9,-14,314,193510,9,193501
30886,18,9,571,933262,18,933244
30887,6,15,412,1103045,6,1103039
30888,20,-18,924,91921,20,91901
30889,16,-18,778,90915,16,90899
30890,13,10,881,966564,13,966551
30891,8,-20,180,4128,8,4120
30892,7,-1,396,602632,7,602625
30893,8,8,935,895509,8,895501
30894,6,-5,872,487010,6,487004
30895,14,8,340,900662,14,900648
30896,12,3,234,743646,12,743634
30897,8,-19,689,46666,8,46658
30898,7,3,219,723528,7,723521
30899,11,2,120,711491,11,711480
30900,5,-14,930,206686,5,206681
30901,9,8,833,893289,9,893280
30902,11,7,557,871113,11,871102
30903,10,-9,435,353214,10,353204
30904,8,-11,495,292243,8,292235
30905,15,-8,809,403675,15,403660
30906,18,7,28,867214,18,867196
30907,9,15,338,1101712,9,1101703
30908,5,8,676,890053,5,890048
30909,10,-8,631,388812,10,388802
30910,16,-18,595,89549,16,89533
30911,11,-6,590,463642,11,463631
30912,7,-2,881,581723,7,581716
30913,8,16,513,1136116,8,1136108
30914,15,1,809,686150,15,686135
30915,17,-18,769,90848,17,90831
30916,5,9,254,912034,5,912029
30917,9,-12,574,261987,9,261978
30918,15,6,769,841924,15,841909
30919,12,10,709,965337,12,965325
30920,10,1,435,666625,10,666615
30921,16,-20,719,28284,16,28268
30922,13,14,722,1091143,13,1091130
30923,14,-4,987,529545,14,529531
30924,15,-12,780,278228,15,278213
30925,16,3,32,742033,16,742017
30926,12,8,92,898626,12,898614
30927,6,1,970,678134,6,678128
30928,14,1,827,686251,14,686237
30929,5,-1,325,601082,5,601077
30930,10,0,654,639689,10,639679
30931,12,-18,766,90830,12,90818
30932,13,-3,200,555182,13,555169
30933,9,-8,273,381222,9,381213
30934,16,7,27,867200,16,867184
30935,17,8,403,901176,17,901159
30936,10,18,734,1202024,10,1202014
30937,17,-9,961,374111,17,374094
30938,19,-20,703,28206,19,28187
30939,17,-6,978,466565,17,466548
30940,7,-18,201,66843,7,66836
30941,19,11,896,997385,19,997366
30942,11,-4,397,525204,11,525193
30943,17,9,183,930419,17,930402
30944,14,0,935,655359,14,655345
30945,6,-2,115,565351,6,565345
30946,9,-9,309,350353,9,350344
30947,13,4,410,776163,13,776150
30948,13,19,113,1241702,13,1241689
30949,15,-16,881,153465,15,153450
30950,10,8,850,893646,10,893636
30951,5,-15,608,168466,5,168461
30952,17,-7,168,429572,17,429555
30953,13,0,248,650059,13,650046
30954,14,-17,336,117983,14,117969
30955,18,14,76,1086044,18,1086026
30956,6,-4,160,502795,6,502789
30957,16,10,263,961798,16,961782
30958,11,-16,662,151799,11,151788
30959,18,-10,300,337231,18,337213
30960,9,-12,396,258212,9,258203
30961,20,17,306,1180283,20,1180263
30962,15,3,758,747567,15,747552
30963,20,5,341,806289,20,806269
30964,13,14,636,1090391,13,1090378
30965,19,14,214,1087081,19,1087062
30966,5,17,562,1167223,5,1167218
30967,20,-7,79,428847,20,428827
30968,13,6,968,843485,13,843472
30969,18,18,742,1214310,18,1214292
30970,10,-11,20,281496,10,281486
30971,14,5,712,808976,14,808962
30972,18,8,518,902090,18,902072
30973,15,-1,454,620176,15,620161
30974,15,-17,631,120225,15,120210
30975,15,-19,338,56654,15,56639
30976,16,16,491,1150606,16,1150590
30977,19,-1,280,618742,19,618723
30978,5,-3,768,547643,5,547638
30979,7,6,855,831519,7,831512
30980,6,-7,87,407695,6,407689
30981,12,2,366,713359,12,713347
30982,17,-11,414,307053,17,307036
30983,5,-2,362,570376,5,570371
30984,6,-9,693,358828,6,358822
30985,6,-16,990,145410,6,145404
30986,9,3,904,738284,9,738275
30987,18,-16,568,151194,18,151176
30988,8,-12,265,255238,8,255230
30989,6,8,305,881919,6,881913
30990,5,5,180,785369,5,785364
30991,13,13,778,1059050,13,1059037
30992,18,10,722,965415,18,965397
30993,8,-15,810,172731,8,172723
30994,5,-7,603,418698,5,418693
30995,13,-10,800,341144,13,341131
30996,7,9,678,920981,7,920974
30997,17,12,116,1022901,17,1022884
30998,17,18,623,1213404,17,1213387
30999,6,0,835,643478,6,643472
31000,16,-18,451,88649,16,88633
31001,14,-15,903,184621,14,184607
31002,19,12,638,1026776,19,1026757
31003,8,16,944,1144815,8,1144807
31004,12,-10,106,335890,12,335878
31005,5,14,687,1077474,5,1077469
31006,19,16,951,1153866,19,1153847
31007,10,2,278,694582,10,694572
31008,15,-2,854,591633,15,591618
31009,15,-15,8,177871,15,177856
31010,6,-12,982,271065,6,271059
31011,16,12,52,1022451,16,1022435
31012,16,-14,349,212123,16,212107
31013,13,12,753,1027648,13,1027635
31014,12,-7,973,435517,12,435505
31015,7,-14,1,186446,7,186439
31016,15,0,83,648828,15,648813
31017,12,5,340,806280,12,806268
31018,14,15,118,1117681,14,1117667
31019,10,2,480,698896,10,698886
31020,6,17,909,1174873,6,1174867
31021,8,-8,13,375610,8,375602
31022,10,19,604,1231015,10,1231005
31023,19,-15,463,181183,19,181164
31024,15,17,795,1183869,15,1183854
31025,6,4,114,753069,6,753063
31026,9,15,431,1103568,9,1103559
31027,16,-17,369,118223,16,118207
31028,9,-11,354,288995,9,288986
31029,16,-17,979,122679,16,122663
31030,12,-15,423,180928,12,180916
31031,9,-3,663,545407,9,545398
31032,11,18,776,1214603,11,1214592
31033,9,1,884,676198,9,676189
31034,7,-18,932,82710,7,82703
31035,20,17,56,1178308,20,1178288
31036,8,-2,960,583393,8,583385
31037,17,4,160,774414,17,774397
31038,11,13,380,1056015,11,1056004
31039,19,10,675,965124,19,965105
31040,6,-18,839,80501,6,80495
31041,9,19,527,1229518,9,1229509
31042,17,5,13,803867,17,803850
31043,18,-20,275,24899,18,24881
31044,6,9,389,914873,6,914867
31045,20,10,665,965053,20,965033
31046,12,-6,728,464726,12,464714
31047,14,6,969,843496,14,843482
31048,16,11,634,995365,16,995349
31049,7,14,970,1083481,7,1083474
31050,10,12,512,1010039,10,1010029
31051,20,1,688,685225,20,685205
31052,6,-5,174,471904,6,471898
31053,20,-9,678,371784,20,371764
31054,10,9,623,920040,10,920030
31055,9,19,34,1218164,9,1218155
31056,14,6,970,843523,14,843509
31057,20,12,77,1022600,20,1022580
31058,9,17,567,1167342,9,1167333
31059,11,13,474,1056727,11,1056716
31060,19,-2,707,590467,19,590448
31061,11,-10,98,335853,11,335842
31062,5,-17,763,109806,5,109801
31063,20,5,461,807164,20,807144
31064,9,11,17,968793,9,968784
31065,15,8,695,903472,15,903457
31066,11,-6,615,463849,11,463838
31067,10,7,345,852286,10,852276
31068,16,-2,467,588653,16,588637
31069,11,-7,690,433295,11,433284
31070,18,12,484,1025641,18,1025623
31071,14,10,886,966585,14,966571
31072,15,1,996,687523,15,687508
31073,16,-20,927,29875,16,29859
31074,12,-13,243,242830,12,242818
31075,16,-13,783,246883,16,246867
31076,16,14,107,1086331,16,1086315
31077,6,15,223,1099294,6,1099288
31078,18,-6,63,459555,18,459537
31079,14,-20,239,24611,14,24597
31080,6,-2,896,581952,6,581946
31081,15,-1,541,620849,15,620834
31082,5,3,496,729477,5,729472
31083,9,5,354,788838,9,788829
31084,16,-4,446,525484,16,525468
31085,17,13,272,1055175,17,1055158
31086,8,-16,283,130167,8,130159
31087,8,5,251,786882,8,786874
31088,18,-12,22,272661,18,272643
31089,18,10,644,964886,18,964868
31090,10,19,952,1238586,10,1238576
31091,17,17,851,1184390,17,1184373
31092,9,-8,662,389607,9,389598
31093,19,-13,98,241751,19,241732
31094,17,17,375,1180738,17,1180721
31095,18,13,304,1055432,18,1055414
31096,9,-18,946,82941,9,82932
31097,10,-6,527,448180,10,448170
31098,5,17,971,1176233,5,1176228
31099,18,-5,947,497988,18,497970
31100,14,6,880,842778,14,842764
31101,7,3,866,737586,7,737579
31102,19,-17,293,117669,19,117650
31103,7,5,521,792442,7,792435
31104,19,4,789,779032,19,779013
31105,5,-1,937,614184,5,614179
31106,16,-3,914,561123,16,561107
31107,18,0,453,651546,18,651528
31108,9,-1,119,596391,9,596382
31109,20,17,409,1180946,20,1180926
31110,12,12,507,1025765,12,1025753
31111,10,4,201,754987,10,754977
31112,8,-20,654,14361,8,14353
31113,8,-16,211,128647,8,128639
31114,7,-14,232,191842,7,191835
31115,17,2,254,712497,17,712480
31116,20,-14,963,216953,20,216933
31117,20,8,865,904684,20,904664
31118,16,-11,803,309953,16,309937
31119,16,-17,156,116633,16,116617
31120,11,-3,336,556258,11,556247
31121,20,-17,193,116874,20,116854
31122,17,8,186,899394,17,899377
31123,16,3,281,744019,16,744003
31124,11,-15,25,177986,11,177975
31125,19,-17,2,115553,19,115534
31126,18,15,240,1118560,18,1118542
31127,8,17,566,1167314,8,1167306
31128,7,17,848,1173607,7,1173600
31129,14,-1,897,623416,14,623402
31130,19,-16,320,149337,19,149318
31131,15,7,504,870748,15,870733
31132,6,9,41,907630,6,907624
31133,7,-9,648,357906,7,357899
31134,19,10,587,964430,19,964411
31135,8,12,723,1014935,8,1014927
31136,20,13,543,1057286,20,1057266
31137,16,-5,241,492790,16,492774
31138,7,-12,317,256488,7,256481
31139,5,1,683,671991,5,671986
31140,19,-1,550,620922,19,620903
31141,15,-17,163,116676,15,116661
31142,18,-14,292,211689,18,211671
31143,19,2,331,713082,19,713063
31144,6,16,7,1125357,6,1125351
31145,5,-17,691,108294,5,108289
31146,16,19,840,1247578,16,1247562
31147,5,-20,299,6704,5,6699
31148,7,11,30,969098,7,969091
31149,17,0,486,651843,17,651826
31150,5,-12,132,252425,5,252420
31151,12,-14,651,214596,12,214584
31152,14,14,807,1091783,14,1091769
31153,13,-10,985,342518,13,342505
31154,15,3,996,749501,15,749486
31155,7,1,354,664955,7,664948
31156,15,2,927,717353,15,717338
31157,5,-8,894,394448,5,394443
31158,10,3,640,732560,10,732550
31159,13,14,898,1092497,13,1092484
31160,6,17,449,1164923,6,1164917
31161,20,-17,584,119926,20,119906
31162,7,4,199,754903,7,754896
31163,9,14,326,1069028,9,1069019
31164,11,17,772,1183588,11,1183577
31165,18,-13,955,248272,18,248254
31166,7,1,441,666766,7,666759
31167,14,13,282,1055260,14,1055246
31168,10,-4,340,506931,10,506921
31169,5,12,36,999848,5,999843
31170,19,1,856,686480,19,686461
31171,16,14,891,1092442,16,1092426
31172,11,15,634,1121438,11,1121427
31173,7,-15,200,159577,7,159570
31174,8,-8,55,376602,8,376594
31175,16,-5,646,495749,16,495733
31176,5,-2,642,576394,5,576389
31177,7,7,238,849856,7,849849
31178,8,-8,400,383762,8,383754
31179,20,-9,7,366685,20,366665
31180,15,14,460,1089048,15,1089033
31181,15,12,974,1029616,15,1029601
31182,13,2,15,710560,13,710547
31183,16,0,694,653599,16,653583
31184,18,16,423,1150174,18,1150156
31185,19,14,83,1086091,19,1086072
31186,15,-11,786,309872,15,309857
31187,18,18,696,1213995,18,1213977
31188,13,7,173,868242,13,868229
31189,13,-11,538,308076,13,308063
31190,11,-17,999,122755,11,122744
31191,5,14,464,1072162,5,1072157
31192,17,13,922,1060064,17,1060047
31193,18,-15,776,183572,18,183554
31194,13,-17,193,116877,13,116864
31195,19,-3,288,555845,19,555826
31196,19,3,857,748288,19,748269
31197,18,-7,890,434873,18,434855
31198,15,-20,789,28902,15,28887
31199,18,13,440,1056537,18,1056519
31200,9,15,422,1103293,9,1103284
31201,7,15,282,1100561,7,1100554
31202,13,-1,150,617680,13,617667
31203,20,-18,885,91622,20,91602
31204,20,5,645,808485,20,808465
31205,11,9,995,936498,11,936487
31206,12,10,395,962794,12,962782
31207,7,9,261,912087,7,912080
31208,14,6,689,841310,14,841296
31209,14,-17,786,121459,14,121445
31210,13,14,507,1089418,13,1089405
31211,18,8,378,900916,18,900898
31212,11,-18,441,88542,11,88531
31213,19,-14,345,212079,19,212060
31214,19,9,554,933128,19,933109
31215,5,-13,350,225735,5,225730
31216,8,16,973,1145568,8,1145560
31217,20,17,479,1181511,20,1181491
31218,13,13,766,1058978,13,1058965
31219,9,17,863,1173972,9,1173963
31220,9,-18,868,81122,9,81113
31221,17,-4,498,525825,17,525808
31222,15,-10,312,337336,15,337321
31223,5,2,939,708192,5,708187
31224,13,-9,377,369489,13,369476
31225,19,-12,266,274505,19,274486
31226,10,-15,452,165183,10,165173
31227,15,19,2,1240637,15,1240622
31228,10,3,973,740184,10,740174
31229,20,-17,647,120320,20,120300
31230,10,13,996,1052043,10,1052033
31231,19,-3,172,554992,19,554973
31232,7,-2,709,577959,7,577952
31233,8,-16,648,138055,8,138047
31234,17,17,448,1181287,17,1181270
31235,19,8,94,898672,19,898653
31236,11,-17,313,117833,11,117822
31237,14,-12,147,273634,14,273620
31238,8,-12,189,253494,8,253486
31239,20,11,859,997082,20,997062
31240,11,-10,496,338753,11,338742
31241,16,3,965,749238,16,749222
31242,12,-13,247,242858,12,242846
31243,6,-19,750,48042,6,48036
31244,9,-17,258,98991,9,98982
31245,17,-8,384,400589,17,400572
31246,14,-12,500,276238,14,276224
31247,8,-14,437,196235,8,196227
31248,19,-16,887,153476,19,153457
31249,9,-16,422,133115,9,133106
31250,6,17,951,1175669,6,1175663
31251,20,7,814,872900,20,872880
31252,9,14,951,1083123,9,1083114
31253,19,-7,675,433186,19,433167
31254,10,12,308,1005991,10,1005981
31255,9,-6,593,449557,9,449548
31256,11,19,737,1246774,11,1246763
31257,20,4,702,778376,20,778356
31258,19,16,591,1151274,19,1151255
31259,17,12,619,1026631,17,1026614
31260,17,18,56,1209376,17,1209359
31261,16,4,420,776265,16,776249
31262,13,15,893,1123282,13,1123269
31263,12,-4,695,527322,12,527310
31264,8,-11,523,292781,8,292773
31265,7,-8,596,387953,7,387946
31266,11,-1,272,618682,11,618671
31267,20,11,611,995245,20,995225
31268,15,-8,884,404123,15,404108
31269,16,-9,573,371250,16,371234
31270,5,-18,655,76451,5,76446
31271,11,-16,63,147265,11,147254
31272,11,-5,509,494768,11,494757
31273,18,-16,928,153767,18,153749
31274,10,5,963,802042,10,802032
31275,9,16,965,1145370,9,1145361
31276,10,-9,572,356580,10,356570
31277,16,12,426,1025154,16,1025138
31278,13,-3,101,554498,13,554485
31279,7,-11,769,297638,7,297631
31280,11,-15,642,182569,11,182558
31281,19,-19,127,55035,19,55016
31282,11,9,810,935032,11,935021
31283,9,6,63,813504,9,813495
31284,13,-3,448,557222,13,557209
31285,6,-4,212,504157,6,504151
31286,17,12,673,1027127,17,1027110
31287,20,-4,135,523100,20,523080
31288,12,-9,209,368014,12,368002
31289,16,-3,652,558989,16,558973
31290,14,6,291,837972,14,837958
31291,11,4,996,780540,11,780529
31292,6,-15,303,161910,6,161904
31293,18,-18,118,86103,18,86085
31294,7,-13,554,230140,7,230133
31295,16,-12,683,277529,16,277513
31296,18,-6,839,465506,18,465488
31297,5,4,501,761346,5,761341
31298,11,17,121,1178746,11,1178735
31299,18,18,412,1212100,18,1212082
31300,13,19,254,1242745,13,1242732
31301,7,-1,389,602503,7,602496
31302,13,4,835,779467,13,779454
31303,14,-13,301,243325,14,243311
31304,7,-3,221,535124,7,535117
31305,11,-20,895,29696,11,29685
31306,8,7,579,857129,8,857121
31307,18,6,708,841508,18,841490
31308,5,7,980,865543,5,865538
31309,17,-3,129,554718,17,554701
31310,6,-8,780,392067,6,392061
31311,16,3,575,746135,16,746119
31312,5,6,732,828902,5,828897
31313,13,11,870,997193,13,997180
31314,17,-2,302,587402,17,587385
31315,20,2,194,712048,20,712028
31316,5,11,854,986795,5,986790
31317,9,-4,930,519318,9,519309
31318,14,-19,377,56942,14,56928
31319,12,8,889,904826,12,904814
31320,9,18,703,1201472,9,1201463
31321,7,-2,472,572867,7,572860
31322,8,3,336,726240,8,726232
31323,11,-8,877,404085,11,404074
31324,8,19,87,1219464,8,1219456
31325,8,-16,210,128594,8,128586
31326,7,8,677,890095,7,890088
31327,7,15,906,1113713,7,1113706
31328,5,9,107,909034,5,909029
31329,20,11,890,997346,20,997326
31330,19,0,865,654811,19,654792
31331,6,19,625,1231491,6,1231485
31332,14,11,374,993596,14,993582
31333,13,-15,4,177855,13,177842
31334,11,-18,514,89031,11,89020
31335,14,-9,628,371505,14,371491
31336,11,-12,716,277779,11,277768
31337,9,3,790,735853,9,735844
31338,13,-12,218,274101,13,274088
31339,16,10,362,962544,16,962528
31340,5,3,157,722187,5,722182
31341,11,9,746,934505,11,934494
31342,5,-7,161,409170,5,409165
31343,13,-10,542,339118,13,339105
31344,17,11,564,994916,17,994899
31345,5,-20,474,10137,5,10132
31346,9,-8,383,383361,9,383352
31347,13,11,310,993138,13,993125
31348,20,16,775,1152599,20,1152579
31349,6,11,142,971436,6,971430
31350,20,15,562,1120848,20,1120828
31351,9,-17,328,100535,9,100526
31352,17,-19,943,61109,17,61092
31353,11,-3,194,555123,11,555112
31354,6,-7,136,408672,6,408666
31355,7,-20,298,6670,7,6663
31356,11,0,516,652062,11,652051
31357,13,-17,724,120998,13,120985
31358,9,1,459,667215,9,667206
31359,15,-14,268,211528,15,211513
31360,13,13,661,1058229,13,1058216
31361,10,-10,925,332302,10,332292
31362,16,-20,25,14529,16,14513
31363,16,14,60,1085889,16,1085873
31364,14,-11,949,311107,14,311093
31365,16,-8,744,403155,16,403139
31366,18,0,391,651042,18,651024
31367,6,-3,464,540856,6,540850
31368,17,17,979,1185290,17,1185273
31369,18,-5,121,491882,18,491864
31370,17,-14,190,210750,17,210733
31371,17,-6,19,459290,17,459273
31372,19,18,764,1214486,19,1214467
31373,12,0,462,651626,12,651614
31374,16,-16,49,147148,16,147132
31375,5,-15,502,166343,5,166338
31376,15,19,643,1246003,15,1245988
31377,10,-8,76,377150,10,377140
31378,17,12,724,1027495,17,1027478
31379,17,-17,229,117127,17,117110
31380,16,-4,177,523419,16,523403
31381,5,6,77,813788,5,813783
31382,19,9,44,929392,19,929373
31383,15,-7,812,434211,15,434196
31384,8,-6,87,438576,8,438568
31385,9,-7,408,414731,9,414722
31386,5,-14,305,193324,5,193319
31387,10,-5,637,481789,10,481779
31388,10,-16,881,142957,10,142947
31389,7,12,12,999281,7,999274
31390,11,17,12,1177919,11,1177908
31391,20,19,705,1246492,20,1246472
31392,19,3,813,747960,19,747941
31393,8,8,116,877530,8,877522
31394,18,-18,341,87861,18,87843
31395,7,-5,599,481036,7,481029
31396,13,2,38,710817,13,710804
31397,13,-12,798,278340,13,278327
31398,20,-9,604,371378,20,371358
31399,8,7,334,852047,8,852039
31400,13,-10,346,337566,13,337553
31401,9,-12,435,258983,9,258974
31402,20,-5,371,493798,20,493778
31403,11,13,910,1059959,11,1059948
31404,7,17,320,1162220,7,1162213
31405,15,16,243,1148830,15,1148815
31406,11,14,821,1091889,11,1091878
31407,11,-16,998,154289,11,154278
31408,20,12,388,1024904,20,1024884
31409,8,-12,28,250202,8,250194
31410,17,5,4,803817,17,803800
31411,8,11,403,977185,8,977177
31412,17,-14,19,209474,17,209457
31413,20,9,538,932991,20,932971
31414,17,-2,380,587919,17,587902
31415,18,-3,920,561154,18,561136
31416,20,-4,858,528406,20,528386
31417,17,-14,566,213947,17,213930
31418,20,-19,79,54499,20,54479
31419,15,12,331,1024552,15,1024537
31420,6,-12,29,250217,6,250211
31421,6,-7,31,406788,6,406782
31422,14,-1,837,622969,14,622955
31423,20,18,117,1209908,20,1209888
31424,17,-13,985,248468,17,248451
31425,11,3,815,747980,11,747969
31426,16,6,628,840834,16,840818
31427,15,3,910,748689,15,748674
31428,15,-16,417,150000,15,149985
31429,20,-11,55,304093,20,304073
31430,15,-3,999,561756,15,561741
31431,10,-2,704,577864,10,577854
31432,12,-7,304,430605,12,430593
31433,11,10,26,960030,11,960019
31434,13,-9,73,367166,13,367153
31435,14,11,340,993345,14,993331
31436,9,-18,105,64809,9,64800
31437,5,15,448,1103947,5,1103942
31438,5,1,645,671272,5,671267
31439,18,-11,608,308597,18,308579
31440,5,16,857,1142882,5,1142877
31441,14,15,661,1121652,14,1121638
31442,13,14,216,1087089,13,1087076
31443,13,11,473,994314,13,994301
31444,9,15,546,1106088,9,1106079
31445,14,-8,38,398200,14,398186
31446,12,-3,30,554023,12,554011
31447,7,-16,754,140275,7,140268
31448,20,-7,469,431863,20,431843
31449,10,6,963,833859,10,833849
31450,6,9,922,926355,6,926349
31451,6,-12,133,252460,6,252454
31452,20,-6,23,459327,20,459307
31453,17,9,386,931830,17,931813
31454,5,-16,188,128117,5,128112
31455,11,-19,153,55280,11,55269
31456,9,-11,359,289112,9,289103
31457,18,10,154,961051,18,961033
31458,18,5,146,804860,18,804842
31459,16,8,65,898373,16,898357
31460,16,-18,709,90400,16,90384
31461,19,-12,326,274977,19,274958
31462,17,-13,177,242341,17,242324
31463,10,11,577,980849,10,980839
31464,9,5,907,800722,9,800713
31465,20,-8,634,402344,20,402324
31466,10,-7,172,409449,10,409439
31467,14,14,898,1092501,14,1092487
31468,16,0,563,652488,16,652472
31469,7,11,176,972069,7,972062
31470,20,18,788,1214731,20,1214711
31471,18,-20,575,27186,18,27168
31472,11,-4,956,529265,11,529254
31473,8,-7,334,413144,8,413136
31474,15,17,442,1181238,15,1181223
31475,17,13,858,1059654,17,1059637
31476,17,12,214,1023651,17,1023634
31477,11,16,547,1150967,11,1150956
31478,10,-10,922,332228,10,332218
31479,8,17,563,1167250,8,1167242
31480,9,1,300,663689,9,663680
31481,14,-7,602,432783,14,432769
31482,19,4,846,779594,19,779575
31483,17,16,430,1150238,17,1150221
31484,11,-12,847,278777,11,278766
31485,20,12,284,1024234,20,1024214
31486,7,15,512,1105379,7,1105372
31487,17,-15,434,181004,17,180987
31488,5,16,963,1145274,5,1145269
31489,18,-13,578,245322,18,245304
31490,9,-20,622,13581,9,13572
31491,5,5,591,793866,5,793861
31492,17,-19,129,55054,17,55037
31493,15,13,536,1057211,15,1057196
31494,17,-11,840,310264,17,310247
31495,14,8,325,900547,14,900533
31496,13,18,596,1213191,13,1213178
31497,11,2,32,710743,11,710732
31498,16,-18,41,85504,16,85488
31499,5,-13,584,230820,5,230815
31500,13,-6,251,461109,13,461096
31501,5,-18,52,63495,5,63490
31502,15,6,814,842316,15,842301
31503,20,10,354,962464,20,962444
31504,6,12,884,1018500,6,1018494
31505,14,-17,525,119417,14,119403
31506,7,-1,700,608921,7,608914
31507,19,-6,935,466216,19,466197
31508,11,-11,233,305524,11,305513
31509,10,7,325,851813,10,851803
31510,7,16,520,1136306,7,1136299
31511,11,6,783,842030,11,842019
31512,14,9,643,933819,14,933805
31513,6,-11,882,300083,6,300077
31514,17,11,848,997006,17,996989
31515,14,16,477,1150533,14,1150519
31516,19,15,597,1121123,19,1121104
31517,11,12,667,1027047,11,1027036
31518,18,0,733,653937,18,653919
31519,8,0,402,634044,8,634036
31520,16,-8,776,403395,16,403379
31521,6,-14,208,191114,6,191108
31522,6,9,212,911291,6,911285
31523,7,-15,807,172661,7,172654
31524,19,8,487,901812,19,901793
31525,13,13,715,1058561,13,1058548
31526,5,8,663,889640,5,889635
31527,10,18,892,1205674,10,1205664
31528,15,4,777,778975,15,778960
31529,10,15,946,1114615,10,1114605
31530,16,17,193,1179344,16,1179328
31531,10,6,880,832080,10,832070
31532,9,12,229,1004115,9,1004106
31533,16,-11,329,306384,16,306368
31534,19,18,503,1212630,19,1212611
31535,8,16,392,1133544,8,1133536
31536,7,-8,695,390345,7,390338
31537,20,11,78,991439,20,991419
31538,12,-11,144,304857,12,304845
31539,9,-9,490,354700,9,354691
31540,13,3,600,746308,13,746295
31541,12,-8,299,399969,12,399957
31542,9,14,61,1063186,9,1063177
31543,12,-8,353,400378,12,400366
31544,14,3,387,744797,14,744783
31545,12,-10,35,335425,12,335413
31546,15,-10,597,339523,15,339508
31547,12,19,868,1247825,12,1247813
31548,12,-5,191,492376,12,492364
31549,14,19,120,1241760,14,1241746
31550,12,-5,352,493710,12,493698
31551,7,-8,192,379598,7,379591
31552,13,6,198,837215,13,837202
31553,16,16,32,1147303,16,1147287
31554,19,-15,848,184165,19,184146
31555,19,-13,843,247314,19,247295
31556,18,-6,340,461808,18,461790
31557,14,-8,620,402227,14,402213
31558,13,10,868,966479,13,966466
31559,5,3,156,722173,5,722168
31560,9,-9,423,352904,9,352895
31561,18,16,340,1149586,18,1149568
31562,7,-10,3,312562,7,312555
31563,9,-4,584,512017,9,512008
31564,18,-13,94,241714,18,241696
31565,6,0,571,637651,6,637645
31566,13,2,91,711250,13,711237
31567,11,13,7,1053308,11,1053297
31568,13,-19,90,54625,13,54612
31569,12,9,457,932361,12,932349
31570,12,-17,691,120687,12,120675
31571,17,-7,152,429409,17,429392
31572,17,-6,605,463772,17,463755
31573,19,2,865,716959,19,716940
31574,9,15,98,1096560,9,1096551
31575,19,-12,231,274216,19,274197
31576,16,-13,660,245826,16,245810
31577,11,5,260,805741,11,805730
31578,5,10,265,943092,5,943087
31579,5,5,335,788525,5,788520
31580,12,17,246,1179719,12,1179707
31581,6,-5,481,478393,6,478387
31582,7,11,271,974046,7,974039
31583,17,5,55,804248,17,804231
31584,19,8,854,904617,19,904598
31585,9,16,828,1142381,9,1142372
31586,17,-12,805,278390,17,278373
31587,6,-18,92,64543,6,64537
31588,14,-19,13,53971,14,53957
31589,20,-11,527,307944,20,307924
31590,13,-13,388,243880,13,243867
31591,19,14,827,1091932,19,1091913
31592,10,-17,828,111036,10,111026
31593,7,11,1000,989818,7,989811
31594,11,-3,298,555950,11,555939
31595,15,-18,738,90654,15,90639
31596,11,-8,185,399222,11,399211
31597,15,-8,512,401446,15,401431
31598,17,-9,405,369717,17,369700
31599,17,15,532,1120662,17,1120645
31600,17,18,11,1209001,17,1208984
31601,8,-18,513,73479,8,73471
31602,10,18,727,1201851,10,1201841
31603,11,-15,146,178888,11,178877
31604,5,9,888,925509,5,925504
31605,17,-7,528,432321,17,432304
31606,6,10,75,939108,6,939102
31607,8,2,847,706239,8,706231
31608,5,17,659,1169429,5,1169424
31609,14,-2,675,590196,14,590182
31610,13,12,530,1025917,13,1025904
31611,18,6,385,838802,18,838784
31612,16,-15,649,182625,16,182609
31613,6,-13,791,235543,6,235537
31614,14,-13,753,246601,14,246587
31615,13,10,394,962784,13,962771
31616,11,-7,723,433575,11,433564
31617,20,10,851,966356,20,966336
31618,17,-4,31,522264,17,522247
31619,13,-2,174,586324,13,586311
31620,9,-11,857,299507,9,299498
31621,15,-1,833,622949,15,622934
31622,12,12,488,1025661,12,1025649
31623,13,19,655,1246084,13,1246071
31624,12,-4,239,523992,12,523980
31625,16,13,247,1055022,16,1055006
31626,7,12,639,1013051,7,1013044
31627,19,17,121,1178755,19,1178736
31628,10,-13,94,220431,10,220421
31629,9,-17,638,107255,9,107246
31630,10,7,931,864469,10,864459
31631,20,14,206,1087010,20,1086990
31632,19,14,593,1089996,19,1089977
31633,15,-17,8,115629,15,115614
31634,14,-5,289,493198,14,493184
31635,5,3,902,738227,5,738222
31636,14,14,206,1087014,14,1087000
31637,6,19,783,1234817,6,1234811
31638,16,3,999,749537,16,749521
31639,13,-16,783,152665,13,152652
31640,16,18,774,1214586,16,1214570
31641,7,16,723,1140133,7,1140126
31642,14,12,249,1023894,14,1023880
31643,18,-7,931,435175,18,435157
31644,14,16,81,1147652,14,1147638
31645,19,10,840,966282,19,966263
31646,17,3,829,748050,17,748033
31647,6,-6,875,455471,6,455465
31648,6,-19,676,46324,6,46318
31649,20,10,981,967312,20,967292
31650,10,-12,216,254150,10,254140
31651,14,-10,564,339297,14,339283
31652,19,18,661,1213754,19,1213735
31653,6,3,897,738141,6,738135
31654,11,2,589,715002,11,714991
31655,12,10,457,963305,12,963293
31656,8,14,458,1072018,8,1072010
31657,10,1,462,667296,10,667286
31658,7,-9,114,345986,7,345979
31659,12,16,602,1151347,12,1151335
31660,9,7,817,862089,9,862080
31661,9,2,42,689520,9,689511
31662,16,-3,851,560580,16,560564
31663,20,-11,346,306510,20,306490
31664,14,4,120,774111,14,774097
31665,6,11,232,973072,6,973066
31666,13,3,825,748020,13,748007
31667,15,-6,792,465183,15,465168
31668,19,-7,975,435542,19,435523
31669,18,2,395,713607,18,713589
31670,20,-4,199,523613,20,523593
31671,10,15,82,1096191,10,1096181
31672,19,7,417,870134,19,870115
31673,7,10,204,941855,7,941848
31674,11,-13,778,246839,11,246828
31675,16,13,276,1055225,16,1055209
31676,5,0,107,627786,5,627781
31677,18,17,957,1185055,18,1185037
31678,18,2,398,713641,18,713623
31679,9,1,866,675852,9,675843
31680,14,9,528,932930,14,932916
31681,15,-17,387,118353,15,118338
31682,20,11,101,991590,20,991570
31683,18,4,737,778688,18,778670
31684,17,8,528,902160,17,902143
31685,6,11,990,989664,6,989658
31686,6,15,527,1105683,6,1105677
31687,12,-19,232,55856,12,55844
31688,7,-19,856,50251,7,50244
31689,8,15,710,1109560,8,1109552
31690,5,5,640,794862,5,794857
31691,9,-11,628,295052,9,295043
31692,15,-16,265,148927,15,148912
31693,5,-10,442,322173,5,322168
31694,6,7,113,847277,6,847271
31695,8,-16,804,141268,8,141260
31696,9,-13,589,230958,9,230949
31697,5,5,385,789556,5,789551
31698,8,-17,682,108092,8,108084
31699,14,18,239,1210893,14,1210879
31700,6,10,741,953446,6,953440
31701,18,-7,581,432700,18,432682
31702,17,3,682,747023,17,747006
31703,9,5,800,798344,9,798335
31704,19,-6,639,464063,19,464044
31705,8,13,839,1048798,8,1048790
31706,7,-10,438,322083,7,322076
31707,16,10,192,961316,16,961300
31708,18,-18,153,86430,18,86412
31709,12,-12,397,275414,12,275402
31710,9,8,921,895169,9,895160
31711,9,-18,822,80231,9,80222
31712,12,19,461,1244606,12,1244594
31713,7,12,751,1015441,7,1015434
31714,6,-7,821,423178,6,423172
31715,13,-19,762,59960,13,59947
31716,13,3,441,745136,13,745123
31717,6,13,201,1035062,6,1035056
31718,9,18,759,1202707,9,1202698
31719,14,-3,316,556083,14,556069
31720,6,12,16,999424,6,999418
31721,19,-18,968,92257,19,92238
31722,19,18,833,1214994,19,1214975
31723,10,2,681,703000,10,702990
31724,5,14,804,1079952,5,1079947
31725,7,10,110,939988,7,939981
31726,18,-6,325,461682,18,461664
31727,14,-2,807,591189,14,591175
31728,8,-3,145,533529,8,533521
31729,9,0,347,632708,9,632699
31730,13,17,879,1184551,13,1184538
31731,15,-9,851,373311,15,373296
31732,20,-1,799,622701,20,622681
31733,9,-20,377,8302,9,8293
31734,13,-9,476,370410,13,370397
31735,20,-12,730,277839,20,277819
31736,19,14,478,1089164,19,1089145
31737,19,-17,943,122442,19,122423
31738,6,10,600,950471,6,950465
31739,5,-7,157,409099,5,409094
31740,14,0,337,650559,14,650545
31741,19,-12,317,274874,19,274855
31742,5,-17,650,107514,5,107509
31743,5,-12,657,263815,5,263810
31744,20,5,111,804614,20,804594
31745,15,4,996,780545,15,780530
31746,18,4,20,773393,18,773375
31747,10,-8,306,381866,10,381856
31748,19,-14,138,210399,19,210380
31749,19,-10,811,341220,19,341201
31750,13,-8,272,399777,13,399764
31751,17,4,676,778212,17,778195
31752,11,13,334,1055707,11,1055696
31753,13,-13,549,245064,13,245051
31754,9,-8,692,390306,9,390297
31755,20,-8,979,404872,20,404852
31756,16,17,346,1180561,16,1180545
31757,16,12,272,1024144,16,1024128
31758,6,3,940,739259,6,739253
31759,11,-5,53,491237,11,491226
31760,14,-3,267,555668,14,555654
31761,20,9,779,934821,20,934801
31762,9,-10,866,331117,9,331108
31763,19,-11,412,307020,19,307001
31764,19,-8,666,402605,19,402586
31765,10,-19,66,32869,10,32859
31766,10,16,373,1133085,10,1133075
31767,11,-18,368,88061,11,88050
31768,10,-15,807,172671,10,172661
31769,10,-20,975,21529,10,21519
31770,20,-18,723,90534,20,90514
31771,11,2,904,717217,11,717206
31772,8,14,526,1073563,8,1073555
31773,8,-9,438,353314,8,353306
31774,7,-4,470,509599,7,509592
31775,18,15,453,1119997,18,1119979
31776,20,-6,141,460173,20,460153
31777,16,-1,842,623020,16,623004
31778,9,12,822,1016973,9,1016964
31779,6,16,838,1142580,6,1142574
31780,13,-9,902,373753,13,373740
31781,10,-7,361,413753,10,413743
31782,14,11,527,994681,14,994667
31783,12,1,294,682178,12,682166
31784,5,-20,195,4578,5,4573
31785,18,5,478,807330,18,807312
31786,15,3,672,746927,15,746912
31787,5,-9,947,364834,5,364829
31788,11,14,802,1091729,11,1091718
31789,9,-15,784,172136,9,172127
31790,5,-18,448,72027,5,72022
31791,18,-11,952,311165,18,311147
31792,15,-13,550,245077,15,245062
31793,19,18,292,1211237,19,1211218
31794,5,6,830,830991,5,830986
31795,18,-8,909,404368,18,404350
31796,15,-2,197,586564,15,586549
31797,6,10,369,945357,6,945351
31798,6,-11,132,283972,6,283966
31799,14,-19,176,55440,14,55426
31800,17,1,350,682667,17,682650
31801,9,-7,558,417886,9,417877
31802,15,-13,89,241676,15,241661
31803,17,-8,379,400568,17,400551
31804,12,-9,61,367107,12,367095
31805,20,3,968,749273,20,749253
31806,18,10,678,965148,18,965130
31807,13,-8,370,400492,13,400479
31808,19,-20,219,24477,19,24458
31809,5,8,60,876350,5,876345
31810,7,8,846,893555,7,893548
31811,19,-8,372,400512,19,400493
31812,11,-2,853,591620,11,591609
31813,14,-9,434,370011,14,369997
31814,8,-15,921,175036,8,175028
31815,19,-13,52,241449,19,241430
31816,10,-6,911,456266,10,456256
31817,20,-18,309,87649,20,87629
31818,15,10,676,965142,15,965127
31819,10,6,687,827787,10,827777
31820,19,7,374,869744,19,869725
31821,5,-3,179,534227,5,534222
31822,15,-20,233,24541,15,24526
31823,18,1,886,686713,18,686695
31824,7,-10,82,314448,7,314441
31825,12,7,472,870535,12,870523
31826,16,15,339,1119272,16,1119256
31827,8,14,452,1071862,8,1071854
31828,18,-3,922,561184,18,561166
31829,5,13,779,1047476,5,1047471
31830,16,19,766,1246992,16,1246976
31831,11,10,795,966053,11,966042
31832,15,-4,676,527177,15,527162
31833,19,-3,561,558217,19,558198
31834,17,-1,91,617275,17,617258
31835,16,3,466,745331,16,745315
31836,11,6,112,836631,11,836620
31837,5,9,845,924778,5,924773
31838,14,3,880,748438,14,748424
31839,11,-10,839,341394,11,341383
31840,19,-9,509,370694,19,370675
31841,12,9,585,933366,12,933354
31842,9,-12,90,251515,9,251506
31843,17,0,637,653065,17,653048
31844,11,-5,79,491453,11,491442
31845,20,15,563,1120857,20,1120837
31846,17,-10,320,337376,17,337359
31847,10,13,677,1045310,10,1045300
31848,6,-4,909,518953,6,518947
31849,5,1,437,666657,5,666652
31850,13,-18,11,85301,13,85288
31851,20,-6,316,461621,20,461601
31852,18,-17,98,116327,18,116309
31853,8,15,7,1094569,8,1094561
31854,6,9,663,920700,6,920694
31855,17,5,361,806419,17,806402
31856,7,13,623,1044153,7,1044146
31857,13,8,684,903404,13,903391
31858,6,-11,113,283579,6,283573
31859,14,15,795,1122607,14,1122593
31860,8,-14,94,188616,8,188608
31861,15,4,653,778025,15,778010
31862,15,19,249,1242720,15,1242705
31863,14,16,545,1150947,14,1150933
31864,6,7,725,860080,6,860074
31865,8,-18,39,63206,8,63198
31866,6,15,513,1105424,6,1105418
31867,9,6,712,828475,9,828466
31868,16,5,34,803992,16,803976
31869,18,-2,847,591574,18,591556
31870,7,-16,33,124503,7,124496
31871,5,6,302,819065,5,819060
31872,6,-15,451,165157,6,165151
31873,18,-9,197,367956,18,367938
31874,20,-19,829,60367,20,60347
31875,14,11,19,990994,14,990980
31876,10,-1,125,596510,10,596500
31877,10,-7,867,424256,10,424246
31878,13,-3,990,561690,13,561677
31879,18,-9,882,373582,18,373564
31880,12,19,677,1246246,12,1246234
31881,11,0,95,648982,11,648971
31882,9,1,516,668577,9,668568
31883,18,-9,452,370166,18,370148
31884,14,-15,624,182349,14,182335
31885,19,11,263,992724,19,992705
31886,18,-2,623,589827,18,589809
31887,7,13,393,1039171,7,1039164
31888,10,-16,320,130944,10,130934
31889,8,1,474,667543,8,667535
31890,12,5,619,808356,12,808344
31891,10,12,891,1018651,10,1018641
31892,6,19,860,1236700,6,1236694
31893,10,3,288,725172,10,725162
31894,18,-12,729,277826,18,277808
31895,13,-12,271,274526,13,274513
31896,15,-5,300,493299,15,493284
31897,14,9,610,933578,14,933564
31898,11,-1,397,619724,11,619713
31899,10,3,841,736916,10,736906
31900,7,3,288,725179,7,725172
31901,5,-1,236,599103,5,599098
31902,18,-15,613,182271,18,182253
31903,6,18,658,1200578,6,1200572
31904,19,-12,789,278289,19,278270
31905,14,-2,940,592310,14,592296
31906,5,-11,510,292538,5,292533
31907,9,-3,919,551053,9,551044
31908,16,-2,676,590208,16,590192
31909,15,-1,755,622355,15,622340
31910,16,-17,715,120870,16,120854
31911,16,-12,98,273246,16,273230
31912,20,8,208,899627,20,899607
31913,17,19,439,1244458,17,1244441
31914,5,2,571,700646,5,700641
31915,13,-20,523,26736,13,26723
31916,16,-2,183,586408,16,586392
31917,18,-18,329,87765,18,87747
31918,15,2,735,716108,15,716093
31919,18,19,645,1246033,18,1246015
31920,9,-9,162,347025,9,347016
31921,19,-1,899,623439,19,623420
31922,12,-12,953,279719,12,279707
31923,13,-4,490,525767,13,525754
31924,11,-9,39,366902,11,366891
31925,20,-7,268,430299,20,430279
31926,11,-8,532,401570,11,401559
31927,5,12,483,1009457,5,1009452
31928,14,11,933,997647,14,997633
31929,8,-3,825,548789,8,548781
31930,10,1,501,668241,10,668231
31931,17,13,556,1057423,17,1057406
31932,7,-18,891,81716,7,81709
31933,10,-11,538,293163,10,293153
31934,6,16,883,1143447,6,1143441
31935,8,-16,996,145565,8,145557
31936,14,0,222,649908,14,649894
31937,17,3,629,746589,17,746572
31938,7,17,537,1166768,7,1166761
31939,11,3,12,741905,11,741894
31940,14,-14,829,215956,14,215942
31941,9,-4,821,516850,9,516841
31942,17,-3,893,560933,17,560916
31943,18,-16,482,150571,18,150553
31944,19,15,337,1119244,19,1119225
31945,7,-4,984,520623,7,520616
31946,18,-8,335,400277,18,400259
31947,7,-17,661,107733,7,107726
31948,12,13,798,1059226,12,1059214
31949,18,-11,529,307974,18,307956
31950,16,19,134,1241826,16,1241810
31951,10,-12,161,253054,10,253044
31952,6,-2,581,575066,6,575060
31953,8,13,657,1044900,8,1044892
31954,7,-11,433,290780,7,290773
31955,12,10,712,965350,12,965338
31956,11,-19,369,56854,11,56843
31957,19,18,171,1210321,19,1210302
31958,15,-2,850,591599,15,591584
31959,16,3,602,746330,16,746314
31960,11,10,156,961063,11,961052
31961,20,13,308,1055459,20,1055439
31962,12,13,783,1059080,12,1059068
31963,13,-7,842,434424,13,434411
31964,20,-15,776,183582,20,183562
31965,9,9,30,907443,9,907434
31966,20,12,422,1025130,20,1025110
31967,20,18,416,1212126,20,1212106
31968,18,3,340,744462,18,744444
31969,17,-5,769,496612,17,496595
31970,6,-8,369,383098,6,383092
31971,13,-8,638,402351,13,402338
31972,6,-19,33,32224,6,32218
31973,5,6,291,818748,5,818743
31974,8,10,747,953570,8,953562
31975,7,1,559,669574,7,669567
31976,18,-20,319,25333,18,25315
31977,11,4,762,778877,11,778866
31978,5,2,251,694033,5,694028
31979,11,13,262,1055114,11,1055103
31980,8,1,489,667943,8,667935
31981,7,5,595,793933,7,793926
31982,12,13,381,1056030,12,1056018
31983,20,-2,402,588108,20,588088
31984,7,16,12,1125450,7,1125443
31985,7,-12,104,251777,7,251770
31986,8,-1,78,595478,8,595470
31987,13,18,64,1209482,13,1209469
31988,10,-13,63,219729,10,219719
31989,12,18,1,1208910,12,1208898
31990,10,2,654,702419,10,702409
31991,13,13,13,1053319,13,1053306
31992,7,14,621,1075738,7,1075731
31993,5,-10,668,327198,5,327193
31994,11,-17,901,122184,11,122173
31995,7,-12,805,266898,7,266891
31996,7,18,447,1196304,7,1196297
31997,11,8,240,899924,11,899913
31998,11,-4,254,524096,11,524085
31999,6,-10,212,317258,6,317252
32000,10,-9,229,348526,10,348516
32001,18,12,357,1024701,18,1024683
32002,10,5,617,794494,10,794484
32003,6,-15,940,175456,6,175450
32004,6,3,765,735395,6,735389
32005,19,-4,595,526557,19,526538
32006,16,3,458,745267,16,745251
32007,20,-1,340,619303,20,619283
32008,12,-13,168,242268,12,242256
32009,20,-15,338,180235,20,180215
32010,9,7,790,861542,9,861533
32011,16,2,831,716694,16,716678
32012,18,-7,952,435369,18,435351
32013,12,14,664,1090638,12,1090626
32014,6,3,971,740112,6,740106
32015,13,-3,919,561144,13,561131
32016,18,16,603,1151354,18,1151336
32017,5,2,160,692035,5,692030
32018,9,-2,234,567753,9,567744
32019,7,6,192,816384,7,816377
32020,15,9,257,930839,15,930824
32021,11,-5,540,495039,11,495028
32022,5,-14,22,186946,5,186941
32023,19,-5,724,496321,19,496302
32024,5,1,573,669888,5,669883
32025,13,17,846,1184343,13,1184330
32026,14,0,763,654151,14,654137
32027,17,7,454,870419,17,870402
32028,20,1,292,682159,20,682139
32029,13,8,943,905292,13,905279
32030,10,15,225,1099342,10,1099332
32031,7,-6,742,452766,7,452759
32032,10,12,324,1006287,10,1006277
32033,6,0,1000,647188,6,647182
32034,5,5,205,785992,5,785987
32035,14,16,264,1149016,14,1149002
32036,18,15,84,1117413,18,1117395
32037,18,9,937,936072,18,936054
32038,17,-18,165,86524,17,86507
32039,9,-2,533,574040,9,574031
32040,17,1,510,683877,17,683860
32041,14,-11,605,308569,14,308555
32042,10,12,381,1007335,10,1007325
32043,6,-10,484,323193,6,323187
32044,19,9,115,929895,19,929876
32045,11,-11,837,310248,11,310237
32046,13,5,484,807359,13,807346
32047,7,10,401,946112,7,946105
32048,18,-13,905,247776,18,247758
32049,12,6,569,840400,12,840388
32050,10,-13,72,219916,10,219906
32051,5,-6,357,444411,5,444406
32052,13,10,949,967115,13,967102
32053,11,-12,269,274514,11,274503
32054,5,12,334,1006484,5,1006479
32055,11,13,900,1059922,11,1059911
32056,13,7,474,870557,13,870544
32057,10,-20,554,12135,10,12125
32058,13,-18,204,86878,13,86865
32059,18,18,489,1212557,18,1212539
32060,15,-13,232,242759,15,242744
32061,12,-3,303,555991,12,555979
32062,8,-8,489,385470,8,385462
32063,17,-10,129,336070,17,336053
32064,15,-6,325,461687,15,461672
32065,16,11,917,997553,16,997537
32066,12,6,394,838903,12,838891
32067,19,17,688,1182983,19,1182964
32068,11,-2,14,585228,11,585217
32069,11,13,449,1056592,11,1056581
32070,15,7,509,870800,15,870785
32071,16,-17,570,119800,16,119784
32072,12,-10,772,340879,12,340867
32073,20,-17,456,118893,20,118873
32074,15,-14,673,214792,15,214777
32075,18,-4,83,522664,18,522646
32076,15,-10,662,340080,15,340065
32077,8,14,815,1080275,8,1080267
32078,19,-11,200,305313,19,305294
32079,13,-14,2,209360,13,209347
32080,20,-3,105,554538,20,554518
32081,17,13,432,1056451,17,1056434
32082,7,14,710,1077952,7,1077945
32083,16,-6,708,464550,16,464534
32084,16,-4,458,525538,16,525522
32085,5,2,501,699286,5,699281
32086,11,-20,556,27046,11,27035
32087,14,-15,289,179892,14,179878
32088,12,-11,534,308028,12,308016
32089,20,9,584,933365,20,933345
32090,16,7,811,872866,16,872850
32091,6,13,815,1048345,6,1048339
32092,16,-4,298,524385,16,524369
32093,12,-6,850,465560,12,465548
32094,5,-18,202,66877,5,66872
32095,11,-12,221,274137,11,274126
32096,12,16,721,1152235,12,1152223
32097,13,-7,89,428912,13,428899
32098,10,-8,725,390913,10,390903
32099,15,-5,48,491206,15,491191
32100,8,8,300,881773,8,881765
32101,19,0,528,652203,19,652184
32102,16,-9,842,373217,16,373201
32103,12,11,559,994870,12,994858
32104,15,-5,79,491458,15,491443
32105,6,-20,663,14604,6,14598
32106,13,-16,738,152302,13,152289
32107,9,9,134,909639,9,909630
32108,11,-2,633,589883,11,589872
32109,8,-4,166,503026,8,503018
32110,14,9,375,931780,14,931766
32111,17,6,272,837836,17,837819
32112,16,-11,673,309072,16,309056
32113,5,-16,318,130856,5,130851
32114,7,-5,281,474206,7,474199
32115,19,-2,483,588793,19,588774
32116,20,7,96,867712,20,867692
32117,18,-16,274,148989,18,148971
32118,7,-12,890,268932,7,268925
32119,16,-18,387,88201,16,88185
32120,14,12,76,1022584,14,1022570
32121,8,17,571,1167410,8,1167402
32122,7,-7,476,416005,7,415998
32123,16,-1,343,619346,16,619330
32124,16,10,740,965563,16,965547
32125,14,19,838,1247565,14,1247551
32126,16,-7,231,430016,16,430000
32127,16,4,924,780083,16,780067
32128,16,17,690,1183023,16,1183007
32129,17,-15,260,179637,17,179620
32130,10,-4,758,515566,10,515556
32131,19,7,391,869897,19,869878
32132,10,15,518,1105512,10,1105502
32133,5,-2,24,563290,5,563285
32134,11,-11,706,309251,11,309240
32135,8,3,33,719552,8,719544
32136,19,8,336,900636,19,900617
32137,13,16,58,1147510,13,1147497
32138,13,-10,450,338412,13,338399
32139,15,-8,252,399697,15,399682
32140,14,-3,686,559251,14,559237
32141,19,-10,936,342140,19,342121
32142,8,-7,494,416414,8,416406
32143,7,11,466,978402,7,978395
32144,12,13,99,1053949,12,1053937
32145,6,-7,863,424148,6,424142
32146,13,-10,257,336976,13,336963
32147,15,-9,272,368560,15,368545
32148,13,-11,305,306185,13,306172
32149,12,-15,714,183084,12,183072
32150,14,1,80,680377,14,680363
32151,11,8,950,905340,11,905329
32152,10,5,707,796370,10,796360
32153,6,12,29,999710,6,999704
32154,17,9,378,931800,17,931783
32155,19,-15,801,183715,19,183696
32156,5,-17,187,97326,5,97321
32157,6,12,666,1013640,6,1013634
32158,19,2,999,717858,19,717839
32159,20,-7,995,435704,20,435684
32160,18,10,646,964929,18,964911
32161,10,8,910,894968,10,894958
32162,20,19,990,1248723,20,1248703
32163,11,3,647,746725,11,746714
32164,9,3,966,739952,9,739943
32165,16,10,309,962141,16,962125
32166,17,1,362,682753,17,682736
32167,11,-13,193,242480,11,242469
32168,16,3,79,742419,16,742403
32169,17,15,46,1117132,17,1117115
32170,8,16,110,1127368,8,1127360
32171,11,-7,282,430432,11,430421
32172,11,-2,890,591945,11,591934
32173,14,-11,52,304059,14,304045
32174,17,1,804,686108,17,686091
32175,5,-1,660,608113,5,608108
32176,14,6,243,837589,14,837575
32177,13,-15,490,181384,13,181371
32178,5,4,521,761864,5,761859
32179,14,-15,360,180388,14,180374
32180,9,-11,242,286323,9,286314
32181,5,-17,457,103208,5,103203
32182,16,-5,397,493950,16,493934
32183,7,7,128,847549,7,847542
32184,16,-14,77,209911,16,209895
32185,11,1,625,684767,11,684756
32186,10,12,450,1008691,10,1008681
32187,19,11,717,995984,19,995965
32188,11,2,351,713251,11,713240
32189,17,13,713,1058543,17,1058526
32190,19,-9,962,374125,19,374106
32191,11,10,903,966702,11,966691
32192,5,-17,517,104644,5,104639
32193,15,-2,835,591494,15,591479
32194,11,-10,765,340843,11,340832
32195,17,10,583,964400,17,964383
32196,19,0,484,651813,19,651794
32197,11,12,176,1023315,11,1023304
32198,7,-2,110,565199,7,565192
32199,19,2,970,717713,19,717694
32200,9,5,205,786001,9,785992
32201,8,12,212,1003781,8,1003773
32202,11,-5,25,491004,11,490993
32203,20,3,979,749359,20,749339
32204,6,-19,315,38299,6,38293
32205,19,4,472,776649,19,776630
32206,16,-20,581,27224,16,27208
32207,9,15,609,1107380,9,1107371
32208,13,-13,934,248096,13,248083
32209,20,-17,243,117277,20,117257
32210,12,7,146,868083,12,868071
32211,17,-7,397,431348,17,431331
32212,7,11,262,973820,7,973813
32213,15,6,984,843598,15,843583
32214,19,-1,623,621391,19,621372
32215,12,16,519,1150798,12,1150786
32216,6,16,955,1145017,6,1145011
32217,6,-16,930,143999,6,143993
32218,14,-17,200,116935,14,116921
32219,8,-1,906,613497,8,613489
32220,8,4,370,758596,8,758588
32221,14,19,407,1244145,14,1244131
32222,16,10,178,961219,16,961203
32223,20,14,769,1091503,20,1091483
32224,10,-19,463,41476,10,41466
32225,14,-8,378,400554,14,400540
32226,13,5,439,806948,13,806935
32227,11,4,812,779235,11,779224
32228,15,-6,600,463726,15,463711
32229,7,9,942,926758,7,926751
32230,9,-12,509,260674,9,260665
32231,16,13,948,1060267,16,1060251
32232,17,-9,636,371575,17,371558
32233,11,9,715,934345,11,934334
32234,18,10,466,963418,18,963400
32235,11,9,155,930204,11,930193
32236,6,-19,837,49772,6,49766
32237,15,-20,634,27593,15,27578
32238,6,0,110,627852,6,627846
32239,7,10,56,938744,7,938737
32240,8,-10,740,328525,8,328517
32241,15,10,60,960283,15,960268
32242,19,11,345,993384,19,993365
32243,16,6,929,843152,16,843136
32244,19,9,621,933677,19,933658
32245,13,1,728,685518,13,685505
32246,12,11,601,995179,12,995167
32247,12,-13,462,244348,12,244336
32248,6,-4,431,508934,6,508928
32249,16,6,966,843461,16,843445
32250,19,2,290,712804,19,712785
32251,9,-17,256,98916,9,98907
32252,15,16,752,1152419,15,1152404
32253,15,-19,859,60614,15,60599
32254,14,-1,336,619259,14,619245
32255,11,12,950,1029417,11,1029406
32256,11,-1,594,621200,11,621189
32257,13,6,374,838694,13,838681
32258,18,-14,265,211495,18,211477
32259,20,10,401,962877,20,962857
32260,20,-11,575,308298,20,308278
32261,18,12,411,1025033,18,1025015
32262,14,-6,729,464738,14,464724
32263,18,-13,189,242455,18,242437
32264,5,-19,37,32275,5,32270
32265,15,-7,53,428677,15,428662
32266,7,8,461,885311,7,885304
32267,16,-2,317,587505,16,587489
32268,12,12,554,1026098,12,1026086
32269,10,-11,113,283589,10,283579
32270,14,-13,150,242118,14,242104
32271,11,9,689,934121,11,934110
32272,19,-10,904,341887,19,341868
32273,5,-13,271,224209,5,224204
32274,19,-12,340,275055,19,275036
32275,9,7,760,860877,9,860868
32276,7,-17,618,106816,7,106809
32277,14,-4,553,526276,14,526262
32278,5,-7,261,411343,5,411338
32279,17,-8,697,402826,17,402809
32280,6,-17,969,113883,6,113877
32281,13,-7,249,430134,13,430121
32282,5,-4,325,506628,5,506623
32283,10,17,936,1175339,10,1175329
32284,6,-16,841,142019,6,142013
32285,19,16,466,1150461,19,1150442
32286,13,0,823,654496,13,654483
32287,13,-17,250,117319,13,117306
32288,7,10,484,947815,7,947808
32289,13,18,823,1214893,13,1214880
32290,9,8,728,891317,9,891308
32291,6,16,630,1138417,6,1138411
32292,16,-9,149,367652,16,367636
32293,11,8,970,905490,11,905479
32294,19,-11,691,309181,19,309162
32295,5,-16,812,141455,5,141450
32296,9,-12,851,268114,9,268105
32297,17,-17,231,117160,17,117143
32298,10,-15,900,174529,10,174519
32299,6,-1,669,608241,6,608235
32300,8,17,109,1157571,8,1157563
32301,12,7,623,871576,12,871564
32302,17,-9,735,372215,17,372198
32303,5,-19,437,40923,5,40918
32304,9,6,790,830066,9,830057
32305,8,8,360,883075,8,883067
32306,7,-2,673,577080,7,577073
32307,5,-5,34,468561,5,468556
32308,10,-4,218,504292,10,504282
32309,7,6,832,831080,7,831073
32310,15,-8,55,398352,15,398337
32311,7,16,858,1142918,7,1142911
32312,9,2,14,688831,9,688822
32313,6,18,182,1190885,6,1190879
32314,8,-16,393,132406,8,132398
32315,10,-19,804,49024,10,49014
32316,18,0,792,654289,18,654271
32317,9,-20,594,12965,9,12956
32318,11,-16,680,151895,11,151884
32319,12,16,648,1151781,12,1151769
32320,14,10,568,964257,14,964243
32321,6,-2,176,566425,6,566419
32322,17,7,909,873506,17,873489
32323,15,-7,26,428515,15,428500
32324,17,19,82,1241444,17,1241427
32325,7,17,342,1162735,7,1162728
32326,11,-20,68,23295,11,23284
32327,16,-8,940,404525,16,404509
32328,11,-4,361,524939,11,524928
32329,13,-20,265,24795,13,24782
32330,20,-10,754,340769,20,340749
32331,11,16,165,1148258,11,1148247
32332,7,2,757,704600,7,704593
32333,6,-11,543,293278,6,293272
32334,20,4,753,778800,20,778780
32335,17,-12,344,275099,17,275082
32336,17,-6,874,465718,17,465701
32337,7,3,911,738508,7,738501
32338,5,-11,661,295719,5,295714
32339,10,0,760,642048,10,642038
32340,15,10,797,966077,15,966062
32341,18,5,32,803968,18,803950
32342,7,-14,337,194043,7,194036
32343,11,-2,82,585736,11,585725
32344,18,-15,649,182633,18,182615
32345,5,12,638,1012988,5,1012983
32346,5,9,718,921866,5,921861
32347,12,-16,343,149411,12,149399
32348,6,11,855,986806,6,986800
32349,13,-5,255,492921,13,492908
32350,10,-5,225,472930,10,472920
32351,18,2,519,714571,18,714553
32352,19,-20,432,26048,19,26029
32353,20,8,384,900996,20,900976
32354,8,-20,481,10309,8,10301
32355,14,-14,761,215421,14,215407
32356,11,0,258,650097,11,650086
32357,5,4,107,752945,5,752940
32358,15,14,425,1088801,15,1088786
32359,19,2,960,717653,19,717634
32360,6,9,165,910287,6,910281
32361,11,11,580,995019,11,995008
32362,15,16,305,1149330,15,1149315
32363,18,12,775,1027804,18,1027786
32364,7,10,976,958397,7,958390
32365,8,5,323,788260,8,788252
32366,17,15,281,1118862,17,1118845
32367,14,-3,857,560635,14,560621
32368,6,7,360,852599,6,852593
32369,13,6,525,840077,13,840064
32370,10,17,210,1159689,10,1159679
32371,15,2,98,711328,15,711313
32372,16,7,538,871001,16,870985
32373,17,19,575,1245510,17,1245493
32374,6,-17,199,97621,6,97615
32375,7,-4,604,512395,7,512388
32376,10,8,393,883789,10,883779
32377,5,4,1,750592,5,750587
32378,7,-5,596,480975,7,480968
32379,6,13,970,1051474,6,1051468
32380,17,-4,202,523659,17,523642
32381,18,-20,36,20627,18,20609
32382,6,-18,399,70993,6,70987
32383,11,-15,680,182831,11,182820
32384,18,-1,360,619491,18,619473
32385,7,-13,835,236448,7,236441
32386,13,10,123,960860,13,960847
32387,13,-5,563,495189,13,495176
32388,13,-18,404,88307,13,88294
32389,15,16,937,1153806,15,1153791
32390,9,15,678,1108852,9,1108843
32391,19,-1,73,617145,19,617126
32392,20,1,820,686216,20,686196
32393,15,-9,568,371191,15,371176
32394,16,-6,883,465778,16,465762
32395,8,-19,515,42654,8,42646
32396,15,-8,995,404991,15,404976
32397,12,-18,756,90789,12,90777
32398,16,-17,633,120240,16,120224
32399,13,5,195,805294,13,805281
32400,8,11,830,986143,8,986135
32401,5,-6,949,457010,5,457005
32402,12,5,766,809361,12,809349
32403,17,-6,279,461361,17,461344
32404,12,17,601,1182337,12,1182325
32405,13,-10,823,341290,13,341277
32406,14,8,493,901874,14,901860
32407,10,10,597,950400,10,950390
32408,5,-15,610,168536,5,168531
32409,9,-20,690,15315,9,15306
32410,7,10,259,942922,7,942915
32411,18,-17,946,122474,18,122456
32412,7,-7,359,413660,7,413653
32413,8,3,990,740537,8,740529
32414,6,6,573,825223,6,825217
32415,11,5,920,810484,11,810473
32416,10,-20,817,18148,10,18138
32417,18,16,315,1149415,18,1149397
32418,8,13,607,1043858,8,1043850
32419,20,-19,955,61188,20,61168
32420,19,14,1,1085352,19,1085333
32421,20,-8,644,402384,20,402364
32422,13,2,750,716224,13,716211
32423,15,-9,305,368811,15,368796
32424,9,9,327,913645,9,913636
32425,9,-7,517,416964,9,416955
32426,8,9,223,911550,8,911542
32427,9,9,731,922084,9,922075
32428,14,13,929,1060117,14,1060103
32429,15,14,308,1087839,15,1087824
32430,19,10,168,961174,19,961155
32431,15,3,347,744508,15,744493
32432,18,-7,372,431182,18,431164
32433,15,9,621,933682,15,933667
32434,12,18,257,1211046,12,1211034
32435,17,0,794,654305,17,654288
32436,16,15,429,1119803,16,1119787
32437,20,16,639,1151697,20,1151677
32438,20,0,543,652322,20,652302
32439,17,19,298,1243144,17,1243127
32440,16,-10,957,342274,16,342258
32441,5,5,411,790013,5,790008
32442,18,4,498,776835,18,776817
32443,11,-15,944,184974,11,184963
32444,9,4,597,763519,9,763510
32445,9,-20,678,14985,9,14976
32446,13,-9,464,370237,13,370224
32447,16,4,673,778169,16,778153
32448,14,4,898,779881,14,779867
32449,10,18,867,1205045,10,1205035
32450,13,7,509,870803,13,870790
32451,13,-5,813,496905,13,496892
32452,14,12,792,1027954,14,1027940
32453,19,12,918,1029098,19,1029079
32454,13,12,929,1029203,13,1029190
32455,16,-6,604,463760,16,463744
32456,8,-13,301,224848,8,224840
32457,16,15,387,1119610,16,1119594
32458,14,0,316,650394,14,650380
32459,8,-12,588,262235,8,262227
32460,9,-15,718,170815,9,170806
32461,12,13,924,1060095,12,1060083
32462,17,-9,345,369228,17,369211
32463,11,-10,574,339337,11,339326
32464,13,9,991,936458,13,936445
32465,14,-8,716,402952,14,402938
32466,12,17,761,1183529,12,1183517
32467,8,-3,386,538896,8,538888
32468,20,17,191,1179328,20,1179308
32469,7,9,710,921705,7,921698
32470,20,14,940,1092824,20,1092804
32471,14,-15,512,181530,14,181516
32472,9,-1,504,605007,9,604998
32473,13,11,89,991492,13,991479
32474,11,-2,648,589980,11,589969
32475,19,-5,745,496491,19,496472
32476,7,18,559,1198664,7,1198657
32477,13,-13,490,244625,13,244612
32478,19,-2,498,588919,19,588900
32479,13,12,345,1024621,13,1024608
32480,19,-4,864,528459,19,528440
32481,16,2,233,712327,16,712311
32482,9,-4,826,516918,9,516909
32483,16,-2,641,589928,16,589912
32484,9,-15,153,158713,9,158704
32485,5,1,427,666450,5,666445
32486,11,-15,673,182769,11,182758
32487,11,-20,92,23466,11,23455
32488,10,15,684,1108978,10,1108968
32489,9,-11,138,284163,9,284154
32490,14,3,108,742659,14,742645
32491,15,5,682,808779,15,808764
32492,10,2,374,696776,10,696766
32493,14,-20,108,23579,14,23565
32494,15,2,791,716412,15,716397
32495,7,17,84,1157078,7,1157071
32496,12,0,287,650220,12,650208
32497,13,14,616,1090212,13,1090199
32498,12,-15,872,184381,12,184369
32499,11,-4,245,524026,11,524015
32500,19,-18,339,87844,19,87825
32501,10,-10,634,326332,10,326322
32502,7,9,290,912708,7,912701
32503,12,16,595,1151298,12,1151286
32504,11,0,445,651477,11,651466
32505,8,-1,475,604430,8,604422
32506,6,-8,786,392154,6,392148
32507,18,-1,354,619424,18,619406
32508,15,3,81,742424,15,742409
32509,8,-18,487,72895,8,72887
32510,10,-5,868,486845,10,486835
32511,20,-13,689,246027,20,246007
32512,7,-12,880,268689,7,268682
32513,16,1,579,684471,16,684455
32514,16,5,178,805114,16,805098
32515,10,-8,618,388501,10,388491
32516,14,-9,835,373147,14,373133
32517,14,-18,340,87847,14,87833
32518,19,-9,348,369248,19,369229
32519,8,-11,273,287015,8,287007
32520,12,-4,24,522222,12,522210
32521,18,-15,72,178307,18,178289
32522,5,-2,117,565394,5,565389
32523,19,-4,653,527031,19,527012
32524,20,-15,93,178484,20,178464
32525,19,18,367,1211795,19,1211776
32526,7,-8,34,376073,7,376066
32527,19,7,869,873300,19,873281
32528,15,13,186,1054571,15,1054556
32529,7,-19,209,36242,7,36235
32530,6,-19,436,40904,6,40898
32531,19,-7,957,435428,19,435409
32532,14,9,239,930761,14,930747
32533,9,-14,310,193415,9,193406
32534,20,7,698,872122,20,872102
32535,19,4,228,774940,19,774921
32536,12,1,289,682143,12,682131
32537,9,15,513,1105433,9,1105424
32538,6,9,448,916113,6,916107
32539,5,8,748,891640,5,891635
32540,14,12,870,1028631,14,1028617
32541,13,-7,741,433671,13,433658
32542,11,4,496,776804,11,776793
32543,10,-8,235,380490,10,380480
32544,6,-1,67,595197,6,595191
32545,8,-16,432,133423,8,133415
32546,8,19,324,1224831,8,1224823
32547,11,1,268,682021,11,682010
32548,11,-17,231,117161,11,117150
32549,15,-12,863,278975,15,278960
32550,11,8,931,905200,11,905189
32551,10,-16,655,138171,10,138161
32552,5,13,423,1039888,5,1039883
32553,19,15,925,1123530,19,1123511
32554,7,-8,178,379319,7,379312
32555,13,10,863,966439,13,966426
32556,20,-17,509,119309,20,119289
32557,19,-3,866,560712,19,560693
32558,10,7,656,858674,10,858664
32559,7,-12,156,252908,7,252901
32560,12,18,523,1212833,12,1212821
32561,5,-9,905,363982,5,363977
32562,6,-10,960,333059,6,333053
32563,14,-20,610,27430,14,27416
32564,20,2,253,712484,20,712464
32565,10,15,204,1098835,10,1098825
32566,17,3,168,743094,17,743077
32567,7,-12,895,269082,7,269075
32568,14,-1,695,621912,14,621898
32569,19,-10,117,335961,19,335942
32570,5,-10,8,312701,5,312696
32571,7,-1,446,603750,7,603743
32572,6,15,346,1101924,6,1101918
32573,8,-15,769,171859,8,171851
32574,15,9,825,935147,15,935132
32575,6,-20,850,18882,6,18876
32576,15,-19,579,58610,15,58595
32577,16,-2,932,592228,16,592212
32578,17,-7,927,435164,17,435147
32579,14,3,350,744535,14,744521
32580,6,8,146,878229,6,878223
32581,17,-8,389,400634,17,400617
32582,5,-13,132,221197,5,221192
32583,5,-11,590,294251,5,294246
32584,13,5,152,804894,13,804881
32585,6,15,250,1099895,6,1099889
32586,13,-1,308,619037,13,619024
32587,9,-19,393,40022,9,40013
32588,15,8,789,904178,15,904163
32589,15,-11,766,309700,15,309685
32590,13,-6,936,466227,13,466214
32591,19,15,185,1118207,19,1118188
32592,16,12,191,1023404,16,1023388
32593,11,-5,287,493169,11,493158
32594,18,-12,674,277488,18,277470
32595,6,-5,145,471222,6,471216
32596,13,-4,567,526364,13,526351
32597,6,3,67,720229,6,720223
32598,15,14,470,1089093,15,1089078
32599,8,5,48,782645,8,782637
32600,9,16,468,1135226,9,1135217
32601,17,0,648,653199,17,653182
32602,20,-4,140,523122,20,523102
32603,7,-20,507,10893,7,10886
32604,20,-15,129,178769,20,178749
32605,13,-18,664,90125,13,90112
32606,7,-8,438,384410,7,384403
32607,20,7,90,867670,20,867650
32608,18,17,289,1180102,18,1180084
32609,16,-16,710,152107,16,152091
32610,9,-19,58,32659,9,32650
32611,5,16,653,1138924,5,1138919
32612,16,7,821,872949,16,872933
32613,13,6,289,837970,13,837957
32614,10,17,746,1171153,10,1171143
32615,20,13,415,1056330,20,1056310
32616,19,8,718,903688,19,903669
32617,7,-3,194,534539,7,534532
32618,14,-2,225,586841,14,586827
32619,10,5,783,798008,10,797998
32620,13,-8,904,404308,13,404295
32621,14,14,739,1091224,14,1091210
32622,9,5,269,787304,9,787295
32623,9,16,26,1125730,9,1125721
32624,12,11,750,996236,12,996224
32625,6,0,985,646737,6,646731
32626,20,16,451,1150392,20,1150372
32627,16,-4,333,524673,16,524657
32628,16,-13,505,244751,16,244735
32629,16,-19,587,58656,16,58640
32630,11,-20,973,30189,11,30178
32631,5,6,614,826177,5,826172
32632,5,-19,17,31828,5,31823
32633,9,19,193,1221799,9,1221790
32634,5,4,7,750690,5,750685
32635,15,-4,546,526246,15,526231
32636,18,3,387,744805,18,744787
32637,20,18,28,1209105,20,1209085
32638,20,-8,895,404252,20,404232
32639,16,13,214,1054830,16,1054814
32640,9,18,508,1197613,9,1197604
32641,10,16,946,1144842,10,1144832
32642,18,4,214,774812,18,774794
32643,16,-16,119,147805,16,147789
32644,19,-10,856,341530,19,341511
32645,8,-1,561,606153,8,606145
32646,13,3,455,745244,13,745231
32647,14,1,904,686885,14,686871
32648,15,-15,222,179333,15,179318
32649,5,4,80,752328,5,752323
32650,18,0,846,654674,18,654656
32651,16,16,179,1148391,16,1148375
32652,18,-7,735,433632,18,433614
32653,10,-6,36,437634,10,437624
32654,10,9,471,916578,10,916568
32655,11,-18,952,92115,11,92104
32656,6,-11,902,300544,6,300538
32657,16,18,365,1211764,16,1211748
32658,6,5,955,801874,6,801868
32659,7,-1,73,595398,7,595391
32660,18,-11,569,308259,18,308241
32661,9,-2,907,582258,9,582249
32662,5,-4,341,506945,5,506940
32663,5,-15,646,169388,5,169383
32664,18,6,862,842643,18,842625
32665,7,15,597,1107095,7,1107088
32666,7,0,756,641938,7,641931
32667,6,1,831,674961,6,674955
32668,17,11,344,993366,17,993349
32669,13,-8,287,399892,13,399879
32670,20,19,194,1242298,20,1242278
32671,16,-19,836,60419,16,60403
32672,15,-7,520,432284,15,432269
32673,18,8,938,905250,18,905232
32674,5,10,33,938243,5,938238
32675,5,-2,91,564747,5,564742
32676,13,14,64,1085952,13,1085939
32677,8,15,975,1115260,8,1115252
32678,15,7,201,868420,15,868405
32679,20,18,341,1211586,20,1211566
32680,5,16,445,1134764,5,1134759
32681,7,-18,95,64605,7,64598
32682,15,-9,651,371657,15,371642
32683,20,8,67,898389,20,898369
32684,18,4,631,777852,18,777834
32685,7,-11,954,301719,7,301712
32686,10,9,859,925010,10,925000
32687,9,3,641,732588,9,732579
32688,15,-3,860,560664,15,560649
32689,18,4,623,777811,18,777793
32690,17,7,734,872384,17,872367
32691,16,12,89,1022714,16,1022698
32692,10,-20,619,13529,10,13519
32693,18,17,55,1178296,18,1178278
32694,7,-16,26,124399,7,124392
32695,6,12,924,1019478,6,1019472
32696,13,6,29,836043,13,836030
32697,15,-16,121,147822,15,147807
32698,18,7,137,868040,18,868022
32699,19,-14,753,215352,19,215333
32700,13,2,705,715936,13,715923
32701,17,11,384,993684,17,993667
32702,5,12,387,1007434,5,1007429
32703,15,13,531,1057130,15,1057115
32704,6,8,67,876455,6,876449
32705,14,1,670,685129,14,685115
32706,20,-14,57,209757,20,209737
32707,12,-14,947,216836,12,216824
32708,13,10,353,962447,13,962434
32709,12,-9,694,371927,12,371915
32710,12,13,3,1053274,12,1053262
32711,19,-8,127,398774,19,398755
32712,5,19,175,1221391,5,1221386
32713,14,3,879,748430,14,748416
32714,20,11,794,996613,20,996593
32715,13,-13,52,241452,13,241439
32716,9,11,382,976620,9,976611
32717,9,5,188,785554,9,785545
32718,18,12,138,1023045,18,1023027
32719,12,-1,195,618012,12,618000
32720,10,-18,526,73732,10,73722
32721,20,18,251,1211024,20,1211004
32722,17,10,530,963925,17,963908
32723,17,6,247,837608,17,837591
32724,10,-19,978,52471,10,52461
32725,12,-14,705,215020,12,215008
32726,14,6,467,839523,14,839509
32727,13,-8,523,401524,13,401511
32728,13,18,969,1216113,13,1216100
32729,10,-3,320,537375,10,537365
32730,17,-9,957,374101,17,374084
32731,15,-15,593,182135,15,182120
32732,18,-4,422,525381,18,525363
32733,14,17,562,1182022,14,1182008
32734,20,-19,197,55619,20,55599
32735,18,8,961,905426,18,905408
32736,16,11,737,996112,16,996096
32737,15,3,183,743241,15,743226
32738,12,-1,875,623253,12,623241
32739,5,19,67,1218952,5,1218947
32740,9,-6,59,438042,9,438033
32741,9,-19,562,43770,9,43761
32742,5,-12,104,251782,5,251777
32743,11,8,203,899586,11,899575
32744,14,-2,422,588277,14,588263
32745,9,-20,377,8311,9,8302
32746,5,6,359,820340,5,820335
32747,10,-4,872,518075,10,518065
32748,16,9,210,930613,16,930597
32749,6,6,669,827391,6,827385
32750,7,-16,668,138390,7,138383
32751,8,18,542,1198382,8,1198374
32752,15,-9,536,370972,15,370957
32753,10,18,862,1204925,10,1204915
32754,7,12,804,1016539,7,1016532
32755,6,6,901,832524,6,832518
32756,15,7,174,868252,15,868237
32757,12,16,128,1147976,12,1147964
32758,17,18,913,1215617,17,1215600
32759,7,-12,354,257330,7,257323
32760,8,-11,430,290731,8,290723
32761,6,5,477,791507,6,791501
32762,18,12,163,1023230,18,1023212
32763,7,9,990,927853,7,927846
32764,12,-17,608,120066,12,120054
32765,13,-18,900,91751,13,91738
32766,9,-15,989,176477,9,176468
32767,14,-20,926,29847,14,29833
32768,7,-8,762,391671,7,391664
32769,10,-3,233,535416,10,535406
32770,20,10,78,960442,20,960422
32771,16,13,779,1059070,16,1059054
32772,15,11,297,993075,15,993060
32773,17,-2,378,587904,17,587887
32774,14,-1,137,617597,14,617583
32775,5,-13,168,221936,5,221931
32776,17,3,261,743867,17,743850
32777,19,-8,769,403322,19,403303
32778,10,-17,169,97009,10,96999
32779,10,-17,887,112292,10,112282
32780,9,10,268,943227,9,943218
32781,12,-9,478,370428,12,370416
32782,8,-9,991,365404,8,365396
32783,7,5,842,799236,7,799229
32784,12,-17,708,120820,12,120808
32785,8,-6,867,455280,8,455272
32786,20,-16,804,152813,20,152793
32787,18,1,663,685086,18,685068
32788,15,-17,488,119106,15,119091
32789,17,-6,311,461572,17,461555
32790,6,0,585,638043,6,638037
32791,6,-5,868,486851,6,486845
32792,19,15,992,1124072,19,1124053
32793,16,16,314,1149399,16,1149383
32794,6,4,127,753302,6,753296
32795,9,-7,74,407484,9,407475
32796,18,-7,113,429106,18,429088
32797,12,5,679,808731,12,808719
32798,17,6,215,837316,17,837299
32799,15,0,698,653633,15,653618
32800,10,16,2,1125216,10,1125206
32801,6,-17,453,103076,6,103070
32802,11,13,836,1059495,11,1059484
32803,19,4,229,774948,19,774929
32804,20,14,435,1088878,20,1088858
32805,11,9,695,934171,11,934160
32806,15,-12,4,272533,15,272518
32807,16,1,414,683110,16,683094
32808,19,13,43,1053542,19,1053523
32809,13,13,614,1057931,13,1057918
32810,12,10,45,960201,12,960189
32811,9,-11,657,295607,9,295598
32812,15,-10,374,337767,15,337752
32813,7,-1,395,602626,7,602619
32814,19,11,455,994160,19,994141
32815,19,6,475,839587,19,839568
32816,18,1,33,680049,18,680031
32817,10,-7,696,420630,10,420620
32818,5,-8,932,395253,5,395248
32819,6,-20,508,10918,6,10912
32820,6,-5,726,483692,6,483686
32821,20,14,569,1089858,20,1089838
32822,10,16,910,1144056,10,1144046
32823,15,5,620,808360,15,808345
32824,15,-6,386,462096,15,462081
32825,6,12,320,1006186,6,1006180
32826,13,9,42,929370,13,929357
32827,8,-10,388,320910,8,320902
32828,16,14,652,1090549,16,1090533
32829,8,-8,486,385421,8,385413
32830,5,-13,164,221842,5,221837
32831,8,-17,275,99320,8,99312
32832,6,-16,90,125931,6,125925
32833,9,18,455,1196491,9,1196482
32834,18,10,197,961346,18,961328
32835,11,19,509,1244981,11,1244970
32836,14,7,62,867478,14,867464
32837,16,-19,733,59771,16,59755
32838,9,-18,457,72255,9,72246
32839,5,-6,590,449490,5,449485
32840,16,0,526,652175,16,652159
32841,14,8,275,900116,14,900102
32842,13,-1,114,617419,13,617406
32843,6,-16,950,144410,6,144404
32844,8,18,856,1204858,8,1204850
32845,5,7,611,857740,5,857735
32846,17,-11,669,309067,17,309050
32847,7,-9,949,364903,7,364896
32848,7,2,679,702954,7,702947
32849,18,16,666,1151908,18,1151890
32850,19,-11,939,311030,19,311011
32851,11,12,747,1027630,11,1027619
32852,11,-3,538,558086,11,558075
32853,13,15,41,1117102,13,1117089
32854,17,-6,0,459136,17,459119
32855,11,1,556,684282,11,684271
32856,12,16,851,1153180,12,1153168
32857,15,5,675,808689,15,808674
32858,17,8,224,899746,17,899729
32859,19,-12,605,276902,19,276883
32860,20,-7,121,429176,20,429156
32861,10,-14,776,203637,10,203627
32862,12,-14,596,214225,12,214213
32863,5,14,1,1061697,5,1061692
32864,10,12,97,1001208,10,1001198
32865,12,17,186,1179304,12,1179292
32866,20,-2,719,590571,20,590551
32867,15,-18,61,85668,15,85653
32868,11,7,985,874020,11,874009
32869,14,-13,745,246537,14,246523
32870,11,4,25,773430,11,773419
32871,16,2,565,714841,16,714825
32872,14,-9,47,366988,14,366974
32873,13,0,380,650967,13,650954
32874,10,-6,128,439393,10,439383
32875,16,15,864,1123090,16,1123074
32876,16,5,883,810207,16,810191
32877,8,-11,843,299154,8,299146
32878,14,-14,370,212394,14,212380
32879,13,8,169,899286,13,899273
32880,12,-4,940,529113,12,529101
32881,11,-13,441,244228,11,244217
32882,6,17,70,1156820,6,1156814
32883,13,12,599,1026441,13,1026428
32884,19,-11,161,305036,19,305017
32885,11,6,196,837203,11,837192
32886,17,17,751,1183476,17,1183459
32887,12,6,203,837238,12,837226
32888,13,9,283,931018,13,931005
32889,7,-4,70,500867,7,500860
32890,10,-5,714,483410,10,483400
32891,13,-14,966,216993,13,216980
32892,11,4,452,776497,11,776486
32893,17,6,132,836768,17,836751
32894,12,16,1,1147108,12,1147096
32895,14,11,501,994491,14,994477
32896,13,10,77,960433,13,960420
32897,7,-16,358,131620,7,131613
32898,6,3,228,723775,6,723769
32899,14,6,224,837438,14,837424
32900,13,2,437,713900,13,713887
32901,19,-2,936,592265,19,592246
32902,16,-19,814,60243,16,60227
32903,14,-4,287,524294,14,524280
32904,19,-1,809,622772,19,622753
32905,8,-19,81,33176,8,33168
32906,9,-20,818,18174,9,18165
32907,19,-5,870,497374,19,497355
32908,15,10,251,961696,15,961681
32909,16,18,906,1215558,16,1215542
32910,14,-8,648,402425,14,402411
32911,8,-10,911,331994,8,331986
32912,7,-4,929,519280,7,519273
32913,12,-19,293,56259,12,56247
32914,7,-14,823,204504,7,204497
32915,14,-20,106,23567,14,23553
32916,9,-12,241,254726,9,254717
32917,17,-2,340,587644,17,587627
32918,8,9,100,908869,8,908861
32919,5,-16,291,130292,5,130287
32920,13,-3,145,554799,13,554786
32921,12,-19,513,57945,12,57933
32922,11,-12,936,279554,11,279543
32923,13,-15,42,178095,13,178082
32924,13,-10,146,336193,13,336180
32925,11,-15,882,184453,11,184442
32926,12,-5,522,494910,12,494898
32927,5,-2,157,566126,5,566121
32928,12,7,653,871795,12,871783
32929,17,-16,853,153163,17,153146
32930,20,16,447,1150368,20,1150348
32931,19,10,421,963070,19,963051
32932,14,12,153,1023135,14,1023121
32933,18,-15,387,180599,18,180581
32934,20,-6,302,461530,20,461510
32935,7,11,939,988645,7,988638
32936,11,-10,7,335170,11,335159
32937,10,-10,352,320241,10,320231
32938,14,-10,401,337947,14,337933
32939,11,2,964,717685,11,717674
32940,13,-19,668,59187,13,59174
32941,20,-17,331,117943,20,117923
32942,10,-11,774,297836,10,297826
32943,12,-8,310,400066,12,400054
32944,15,16,14,1147187,15,1147172
32945,9,-6,413,445608,9,445599
32946,8,14,199,1066113,8,1066105
32947,9,-18,544,74119,9,74110
32948,5,-6,366,444563,5,444558
32949,15,-1,967,623889,15,623874
32950,12,-10,168,336358,12,336346
32951,5,19,543,1229792,5,1229787
32952,7,2,280,694612,7,694605
32953,14,5,827,809805,14,809791
32954,6,19,89,1219514,6,1219508
32955,5,-10,400,321260,5,321255
32956,12,-7,160,429468,12,429456
32957,14,-19,919,60927,14,60913
32958,19,12,904,1028968,19,1028949
32959,12,-10,349,337591,12,337579
32960,14,9,139,930076,14,930062
32961,20,18,136,1210051,20,1210031
32962,15,-19,770,60000,15,59985
32963,9,-19,980,52518,9,52509
32964,11,2,404,713710,11,713699
32965,5,6,932,833230,5,833225
32966,8,-1,949,614468,8,614460
32967,17,2,577,714898,17,714881
32968,11,13,690,1058403,11,1058392
32969,16,12,467,1025461,16,1025445
32970,17,-1,934,623724,17,623707
32971,9,-1,918,613768,9,613759
32972,6,19,486,1228620,6,1228614
32973,13,-13,391,243894,13,243881
32974,10,19,34,1218174,10,1218164
32975,20,-16,718,152184,20,152164
32976,12,-7,766,433869,12,433857
32977,20,-3,592,558475,20,558455
32978,13,-13,293,243260,13,243247
32979,18,-13,591,245399,18,245381
32980,16,12,598,1026434,16,1026418
32981,17,-9,181,367837,17,367820
32982,11,15,509,1120455,11,1120444
32983,11,-19,624,58929,11,58918
32984,10,15,108,1096805,10,1096795
32985,10,-18,947,82985,10,82975
32986,18,-6,24,459339,18,459321
32987,7,17,703,1170309,7,1170302
32988,8,10,876,956326,8,956318
32989,8,15,101,1096663,8,1096655
32990,14,-6,85,459687,14,459673
32991,11,11,945,997669,11,997658
32992,6,-18,581,74938,6,74932
32993,16,0,511,652047,16,652031
32994,18,-8,906,404350,18,404332
32995,16,-14,911,216621,16,216605
32996,10,-6,172,440517,10,440507
32997,10,17,377,1163390,10,1163380
32998,8,-8,131,378189,8,378181
32999,7,2,556,700377,7,700370
33000,16,-8,345,400322,16,400306
33001,15,8,682,903378,15,903363
33002,18,-5,227,492660,18,492642
33003,10,-1,11,593915,10,593905
33004,17,0,371,650867,17,650850
33005,7,14,769,1079197,7,1079190
33006,14,-1,730,622200,14,622186
33007,20,-9,443,370095,20,370075
33008,15,-16,405,149892,15,149877
33009,18,2,200,712115,18,712097
33010,20,11,396,993796,20,993776
33011,15,4,301,775360,15,775345
33012,14,-18,224,87019,14,87005
33013,20,-1,477,620388,20,620368
33014,13,-2,409,588174,13,588161
33015,16,-5,265,492990,16,492974
33016,16,5,687,808816,16,808800
33017,11,11,915,997530,11,997519
33018,17,18,433,1212236,17,1212219
33019,19,-6,238,461029,19,461010
33020,5,-20,615,13420,5,13415
33021,8,-5,402,476770,8,476762
33022,15,-8,790,403531,15,403516
33023,15,2,187,711992,15,711977
33024,5,9,32,907494,5,907489
33025,19,-17,22,115717,19,115698
33026,12,18,418,1212139,12,1212127
33027,14,19,323,1243356,14,1243342
33028,10,6,765,829499,10,829489
33029,20,-18,395,88266,20,88246
33030,11,3,663,746845,11,746834
33031,7,-2,985,583875,7,583868
33032,14,-9,151,367667,14,367653
33033,6,-14,73,188173,6,188167
33034,15,11,439,994076,15,994061
33035,16,-9,171,367778,16,367762
33036,6,-7,545,417610,6,417604
33037,6,-19,772,48519,6,48513
33038,16,-2,572,589440,16,589424
33039,14,16,787,1152712,14,1152698
33040,5,14,897,1081927,5,1081922
33041,18,-2,578,589468,18,589450
33042,20,6,501,839827,20,839807
33043,9,-5,273,474058,9,474049
33044,15,-12,114,273377,15,273362
33045,15,-5,250,492851,15,492836
33046,5,18,511,1197743,5,1197738
33047,19,6,412,839087,19,839068
33048,18,13,13,1053327,18,1053309
33049,16,1,827,686257,16,686241
33050,6,13,310,1037356,6,1037350
33051,18,8,392,901072,18,901054
33052,19,-20,561,27073,19,27054
33053,10,12,84,1001014,10,1001004
33054,13,15,224,1118494,13,1118481
33055,17,0,519,652101,17,652084
33056,20,-3,966,561517,20,561497
33057,20,16,763,1152510,20,1152490
33058,11,19,363,1243709,11,1243698
33059,7,0,249,630796,7,630789
33060,17,3,632,746611,17,746594
33061,6,8,617,888656,6,888650
33062,7,16,956,1145059,7,1145052
33063,10,-17,487,103893,10,103883
33064,15,-18,624,89763,15,89748
33065,19,-9,479,370453,19,370434
33066,9,-1,574,606409,9,606400
33067,19,-2,859,591665,19,591646
33068,7,-18,683,77024,7,77017
33069,12,1,94,680520,12,680508
33070,14,-6,775,465075,14,465061
33071,20,-6,883,465788,20,465768
33072,12,1,762,685801,12,685789
33073,17,1,225,681677,17,681660
33074,10,-3,470,540997,10,540987
33075,12,-7,607,432783,12,432771
33076,6,-15,382,163667,6,163661
33077,14,-1,245,618480,14,618466
33078,8,18,792,1203571,8,1203563
33079,20,14,513,1089453,20,1089433
33080,10,-3,852,549455,10,549445
33081,18,3,759,747574,18,747556
33082,12,-20,91,23459,12,23447
33083,8,16,769,1141021,8,1141013
33084,11,10,630,964772,11,964761
33085,20,18,70,1209519,20,1209499
33086,17,19,686,1246330,17,1246313
33087,11,3,788,747771,11,747760
33088,19,-19,991,61385,19,61366
33089,15,3,403,744912,15,744897
33090,19,-19,731,59721,19,59702
33091,7,-6,281,442953,7,442946
33092,8,4,697,765555,8,765547
33093,10,0,606,638476,10,638466
33094,10,-9,340,351101,10,351091
33095,20,8,670,903270,20,903250
33096,15,8,822,904365,15,904350
33097,8,0,490,636035,8,636027
33098,19,14,138,1086545,19,1086526
33099,17,1,612,684665,17,684648
33100,18,-9,805,372924,18,372906
33101,12,-9,227,368217,12,368205
33102,5,4,844,769204,5,769199
33103,7,12,846,1017587,7,1017580
33104,9,-9,438,353323,9,353314
33105,11,-18,534,89157,11,89146
33106,15,14,687,1090882,15,1090867
33107,13,-5,787,496710,13,496697
33108,14,14,26,1085563,14,1085549
33109,14,-20,806,29071,14,29057
33110,9,16,712,1139945,9,1139936
33111,13,-5,592,495416,13,495403
33112,7,18,953,1206959,7,1206952
33113,13,17,583,1182151,13,1182138
33114,14,-15,224,179357,14,179343
33115,19,-20,31,17527,19,17508
33116,13,-9,456,370186,13,370173
33117,8,-5,130,470907,8,470899
33118,16,18,300,1211278,16,1211262
33119,15,-3,591,558458,15,558443
33120,9,1,150,660498,9,660489
33121,14,-10,983,342492,14,342478
33122,8,17,888,1174366,8,1174358
33123,16,3,993,749479,16,749463
33124,14,-6,148,460256,14,460242
33125,10,10,787,954487,10,954477
33126,14,13,584,1057698,14,1057684
33127,13,15,907,1123391,13,1123378
33128,11,15,837,1122908,11,1122897
33129,16,-9,642,371615,16,371599
33130,18,13,704,1058525,18,1058507
33131,15,-5,456,494396,15,494381
33132,10,5,443,790766,10,790756
33133,8,6,31,812895,8,812887
33134,12,2,370,713397,12,713385
33135,12,12,178,1023348,12,1023336
33136,10,-16,438,133630,10,133620
33137,6,-19,321,38484,6,38478
33138,14,11,390,993751,14,993737
33139,20,9,268,930882,20,930862
33140,7,-10,72,314209,7,314202
33141,14,-12,569,276713,14,276699
33142,5,-13,834,236432,5,236427
33143,8,-10,883,331534,8,331526
33144,18,9,76,929616,18,929598
33145,17,-10,332,337459,17,337442
33146,12,10,900,966685,12,966673
33147,18,-6,838,465490,18,465472
33148,17,19,629,1245897,17,1245880
33149,18,-10,163,336300,18,336282
33150,8,19,438,1227694,8,1227686
33151,9,14,226,1066773,9,1066764
33152,15,-17,846,121802,15,121787
33153,9,10,192,941668,9,941659
33154,13,-19,848,60505,13,60492
33155,9,-5,812,485505,9,485496
33156,13,-8,808,403662,13,403649
33157,10,12,923,1019443,10,1019433
33158,10,-7,244,410983,10,410973
33159,6,-11,660,295688,6,295682
33160,11,-15,43,178102,11,178091
33161,20,4,139,774274,20,774254
33162,13,2,504,714413,13,714400
33163,17,-16,97,147639,17,147622
33164,20,-16,866,153349,20,153329
33165,18,-14,508,213426,18,213408
33166,17,1,474,683576,17,683559
33167,14,15,821,1122798,14,1122784
33168,19,7,598,871440,19,871421
33169,9,-5,179,472028,9,472019
33170,10,18,352,1194279,10,1194269
33171,19,-10,181,336424,19,336405
33172,20,8,778,904143,20,904123
33173,15,-12,833,278644,15,278629
33174,16,-1,478,620406,16,620390
33175,18,9,29,929268,18,929250
33176,13,-13,853,247387,13,247374
33177,9,-17,144,96457,9,96448
33178,7,3,801,736101,7,736094
33179,15,-3,437,557104,15,557089
33180,16,-17,298,117743,16,117727
33181,12,-7,949,435328,12,435316
33182,10,17,891,1174495,10,1174485
33183,18,-19,64,54336,18,54318
33184,20,9,303,931180,20,931160
33185,5,-15,46,156285,5,156280
33186,8,0,254,630900,8,630892
33187,8,18,624,1199945,8,1199937
33188,20,6,180,837096,20,837076
33189,18,4,373,775919,18,775901
33190,12,-2,212,586692,12,586680
33191,18,-12,227,274196,18,274178
33192,16,-17,131,116459,16,116443
33193,16,-8,990,404934,16,404918
33194,17,-18,700,90286,17,90269
33195,17,1,833,686282,17,686265
33196,13,17,386,1180784,13,1180771
33197,5,-15,162,158888,5,158883
33198,17,12,168,1023293,17,1023276
33199,9,-14,784,203789,9,203780
33200,11,-18,130,86206,11,86195
33201,17,-4,985,529532,17,529515
33202,9,-16,374,132020,9,132011
33203,11,1,73,680315,11,680304
33204,17,7,69,867517,17,867500
33205,18,5,281,805903,18,805885
33206,19,8,123,898909,19,898890
33207,18,14,503,1089397,18,1089379
33208,6,-20,811,18072,6,18066
33209,13,17,813,1184044,13,1184031
33210,16,-10,667,340133,16,340117
33211,13,18,878,1215347,13,1215334
33212,18,-9,390,369619,18,369601
33213,12,-2,290,587321,12,587309
33214,19,-11,840,310273,19,310254
33215,18,-7,589,432755,18,432737
33216,19,-18,547,89277,19,89258
33217,11,2,491,714308,11,714297
33218,9,-4,37,500110,9,500101
33219,17,-6,457,462643,17,462626
33220,18,-20,280,24945,18,24927
33221,8,11,413,977320,8,977312
33222,13,-20,450,26229,13,26216
33223,15,-17,593,119974,15,119959
33224,5,6,434,822188,5,822183
33225,14,-19,906,60847,14,60833
33226,20,-6,293,461464,20,461444
33227,13,-1,730,622203,13,622190
33228,13,3,134,742846,13,742833
33229,16,-20,280,24951,16,24935
33230,9,12,459,1008925,9,1008916
33231,6,-8,525,386424,6,386418
33232,11,11,897,997387,11,997376
33233,11,-14,887,216410,11,216399
33234,15,-13,612,245593,15,245578
33235,8,-8,34,376081,8,376073
33236,19,5,930,810609,19,810590
33237,19,-14,76,209906,19,209887
33238,5,-17,988,114284,5,114279
33239,17,-15,642,182576,17,182559
33240,12,-4,875,528629,12,528617
33241,8,1,945,677527,8,677519
33242,20,8,404,901208,20,901188
33243,13,-8,337,400285,13,400272
33244,7,-15,986,176465,7,176458
33245,11,-20,14,7594,11,7583
33246,10,9,903,925926,10,925916
33247,20,11,22,991039,20,991019
33248,17,9,689,934128,17,934111
33249,18,-10,368,337704,18,337686
33250,19,-12,135,273550,19,273531
33251,15,14,4,1085376,15,1085361
33252,13,13,526,1057107,13,1057094
33253,14,17,890,1184614,14,1184600
33254,12,0,138,649278,12,649266
33255,18,2,938,717459,18,717441
33256,10,-10,212,317268,10,317258
33257,20,4,411,776188,20,776168
33258,9,-12,437,259045,9,259036
33259,14,-20,269,24832,14,24818
33260,14,-11,175,305145,14,305131
33261,18,3,858,748309,18,748291
33262,16,16,988,1154169,16,1154153
33263,17,-5,558,495155,17,495138
33264,9,-11,337,288534,9,288525
33265,5,-20,437,9349,5,9344
33266,19,-13,887,247660,19,247641
33267,12,-5,461,494459,12,494447
33268,7,0,718,641133,7,641126
33269,19,-8,745,403173,19,403154
33270,10,-6,876,455495,10,455485
33271,14,-14,54,209723,14,209709
33272,17,-5,636,495682,17,495665
33273,19,9,686,934098,19,934079
33274,20,-10,792,341035,20,341015
33275,17,5,277,805851,17,805834
33276,19,7,381,869814,19,869795
33277,17,-3,610,558612,17,558595
33278,7,-3,402,539246,7,539239
33279,19,-4,686,527270,19,527251
33280,13,-1,847,623047,13,623034
33281,10,-8,423,384055,10,384045
33282,7,-11,641,295299,7,295292
33283,6,2,856,706385,6,706379
33284,17,1,169,681208,17,681191
33285,15,-11,341,306462,15,306447
33286,8,19,691,1232775,8,1232767
33287,9,7,48,845873,9,845864
33288,13,-17,754,121230,13,121217
33289,16,-1,603,621262,16,621246
33290,14,-17,71,116020,14,116006
33291,18,17,626,1182507,18,1182489
33292,8,-4,730,515090,8,515082
33293,13,18,509,1212694,13,1212681
33294,18,-17,876,122006,18,121988
33295,13,6,594,840583,13,840570
33296,7,-12,164,253084,7,253077
33297,6,-11,816,298547,6,298541
33298,5,2,610,701511,5,701506
33299,7,-12,931,269800,7,269793
33300,8,-12,618,262863,8,262855
33301,18,5,922,810507,18,810489
33302,17,15,107,1117582,17,1117565
33303,5,2,696,703347,5,703342
33304,7,8,580,887909,7,887902
33305,20,-17,669,120565,20,120545
33306,15,-13,491,244635,15,244620
33307,10,-17,600,106480,10,106470
33308,16,15,652,1121590,16,1121574
33309,20,-14,591,214181,20,214161
33310,10,-15,995,176630,10,176620
33311,12,18,790,1214744,12,1214732
33312,13,-9,687,371854,13,371841
33313,11,-20,648,27727,11,27716
33314,12,-9,653,371666,12,371654
33315,7,-10,145,315819,7,315812
33316,13,3,9,741862,13,741849
33317,16,-19,327,56505,16,56489
33318,8,-14,882,205675,8,205667
33319,12,8,557,902321,12,902309
33320,17,9,524,932887,17,932870
33321,5,-7,682,420234,5,420229
33322,5,5,856,799472,5,799467
33323,20,2,797,716425,20,716405
33324,20,14,541,1089695,20,1089675
33325,12,7,122,867875,12,867863
33326,16,-5,699,496149,16,496133
33327,5,-6,810,454230,5,454225
33328,15,-20,958,30039,15,30024
33329,17,-15,373,180522,17,180505
33330,15,-16,397,149784,15,149769
33331,10,8,492,885972,10,885962
33332,8,-11,553,293452,8,293444
33333,13,14,5,1085378,13,1085365
33334,17,-14,879,216374,17,216357
33335,5,-12,709,264858,5,264853
33336,18,-4,637,526877,18,526859
33337,16,-4,695,527328,16,527312
33338,16,-17,93,116271,16,116255
33339,7,-4,503,510325,7,510318
33340,7,5,46,782574,7,782567
33341,19,11,292,993001,19,992982
33342,16,5,735,809147,16,809131
33343,5,-9,793,361335,5,361330
33344,7,-2,581,575073,7,575066
33345,5,-17,399,101911,5,101906
33346,11,15,797,1122611,11,1122600
33347,20,-13,180,242379,20,242359
33348,19,16,515,1150759,19,1150740
33349,12,8,561,902339,12,902327
33350,15,-20,448,26213,15,26198
33351,16,15,210,1118374,16,1118358
33352,12,5,997,811106,12,811094
33353,5,-16,397,132511,5,132506
33354,16,-7,598,432782,16,432766
33355,17,-8,506,401384,17,401367
33356,12,6,530,840088,12,840076
33357,5,15,563,1106430,5,1106425
33358,7,12,639,1013058,7,1013051
33359,17,-8,778,403420,17,403403
33360,7,17,144,1158309,7,1158302
33361,11,12,195,1023403,11,1023392
33362,15,19,303,1243183,15,1243168
33363,14,6,244,837592,14,837578
33364,15,-15,761,183414,15,183399
33365,20,-19,267,56108,20,56088
33366,12,-11,196,305298,12,305286
33367,9,-20,754,16617,9,16608
33368,20,14,117,1086391,20,1086371
33369,9,1,958,677819,9,677810
33370,15,-20,387,25769,15,25754
33371,9,3,676,733421,9,733412
33372,17,18,162,1210276,17,1210259
33373,11,-9,749,372365,11,372354
33374,12,2,21,710630,12,710618
33375,6,0,540,637004,6,636998
33376,7,4,683,765323,7,765316
33377,12,-13,168,242270,12,242258
33378,18,14,503,1089405,18,1089387
33379,10,-16,747,140029,10,140019
33380,13,-7,964,435445,13,435432
33381,15,7,825,872987,15,872972
33382,7,16,326,1132093,7,1132086
33383,20,-15,803,183760,20,183740
33384,11,10,23,960009,11,959998
33385,5,5,178,785319,5,785314
33386,14,-18,654,90021,14,90007
33387,16,-9,788,372797,16,372781
33388,5,-15,625,168837,5,168832
33389,7,4,269,756374,7,756367
33390,6,12,26,999631,6,999625
33391,5,0,124,628143,5,628138
33392,7,11,696,983225,7,983218
33393,8,-9,661,358142,8,358134
33394,17,12,416,1025072,17,1025055
33395,15,1,213,681571,15,681556
33396,16,-2,338,587627,16,587611
33397,20,-12,21,272651,20,272631
33398,6,-8,393,383653,6,383647
33399,17,0,417,651294,17,651277
33400,7,-9,787,361177,7,361170
33401,5,2,149,691779,5,691774
33402,11,0,472,651702,11,651691
33403,6,-12,389,258021,6,258015
33404,6,10,775,954201,6,954195
33405,11,-17,628,120185,11,120174
33406,20,7,980,873995,20,873975
33407,13,12,374,1024813,13,1024800
33408,12,9,120,929923,12,929911
33409,19,-4,927,529008,19,528989
33410,9,2,644,702199,9,702190
33411,6,-18,877,81374,6,81368
33412,6,-3,299,536927,6,536921
33413,20,10,863,966449,20,966429
33414,14,4,952,780276,14,780262
33415,9,-13,787,235484,9,235475
33416,9,11,571,980717,9,980708
33417,13,-5,272,493046,13,493033
33418,20,-18,36,85485,20,85465
33419,18,-3,785,560116,18,560098
33420,14,10,772,965785,14,965771
33421,9,2,84,690390,9,690381
33422,20,-17,41,115856,20,115836
33423,17,-17,688,120666,17,120649
33424,19,-9,526,370845,19,370826
33425,11,0,90,648891,11,648880
33426,19,8,631,902990,19,902971
33427,17,1,374,682853,17,682836
33428,15,-3,226,555341,15,555326
33429,10,2,615,701584,10,701574
33430,13,3,184,743254,13,743241
33431,15,16,832,1153111,15,1153096
33432,20,-4,227,523883,20,523863
33433,18,-5,279,493081,18,493063
33434,5,-8,677,389936,5,389931
33435,6,2,894,707219,6,707213
33436,7,-10,832,330405,7,330398
33437,16,10,774,965799,16,965783
33438,8,14,781,1079455,8,1079447
33439,7,19,558,1230096,7,1230089
33440,9,16,713,1139963,9,1139954
33441,18,11,690,995732,18,995714
33442,7,4,636,764399,7,764392
33443,5,-12,571,261874,5,261869
33444,7,18,967,1207247,7,1207240
33445,15,-6,609,463788,15,463773
33446,17,15,371,1119500,17,1119483
33447,19,-7,456,431773,19,431754
33448,5,7,487,855285,5,855280
33449,9,10,843,955627,9,955618
33450,17,-2,158,586243,17,586226
33451,13,14,663,1090623,13,1090610
33452,12,3,698,747180,12,747168
33453,8,1,123,659818,8,659810
33454,10,-16,648,138065,10,138055
33455,13,-4,506,525931,13,525918
33456,17,17,698,1183095,17,1183078
33457,16,-17,995,122730,16,122714
33458,13,9,701,934220,13,934207
33459,19,-16,272,148983,19,148964
33460,15,-6,79,459631,15,459616
33461,17,-5,787,496717,17,496700
33462,20,-7,56,428721,20,428701
33463,6,17,970,1176179,6,1176173
33464,11,-2,145,586182,11,586171
33465,14,9,636,933797,14,933783
33466,17,-14,371,212414,17,212397
33467,8,-20,353,7785,8,7777
33468,9,-1,25,594229,9,594220
33469,11,-5,928,497840,11,497829
33470,13,14,768,1091488,13,1091475
33471,15,-12,263,274451,15,274436
33472,15,-5,257,492936,15,492921
33473,18,14,89,1086149,18,1086131
33474,11,-20,651,27768,11,27757
33475,12,16,939,1153810,12,1153798
33476,5,11,937,988640,5,988635
33477,7,-7,911,425360,7,425353
33478,13,12,857,1028511,13,1028498
33479,12,15,428,1119790,12,1119778
33480,12,10,143,960979,12,960967
33481,15,-5,857,497265,15,497250
33482,18,0,467,651657,18,651639
33483,15,8,966,905467,15,905452
33484,19,-5,843,497130,19,497111
33485,19,-11,984,311417,19,311398
33486,8,-14,758,203227,8,203219
33487,17,-19,786,60094,17,60077
33488,16,-7,950,435362,16,435346
33489,14,-8,973,404819,14,404805
33490,7,10,377,945525,7,945518
33491,8,-16,898,143215,8,143207
33492,7,-1,789,610827,7,610820
33493,10,4,687,765398,10,765388
33494,6,-9,316,350550,6,350544
33495,18,-9,80,367249,18,367231
33496,20,-15,286,179839,20,179819
33497,10,-3,349,538034,10,538024
33498,6,-14,112,188944,6,188938
33499,14,-10,723,340520,14,340506
33500,10,-13,823,236172,10,236162
33501,5,18,227,1191753,5,1191748
33502,8,3,703,734080,8,734072
33503,6,-17,20,93976,6,93970
33504,9,-20,629,13756,9,13747
33505,15,0,952,655517,15,655502
33506,7,14,566,1074402,7,1074395
33507,11,18,873,1215316,11,1215305
33508,5,-4,160,502800,5,502795
33509,14,19,543,1245261,14,1245247
33510,7,-12,578,262065,7,262058
33511,12,16,566,1151117,12,1151105
33512,15,3,173,743135,15,743120
33513,11,16,798,1152829,11,1152818
33514,14,-20,956,30036,14,30022
33515,15,10,326,962283,15,962268
33516,6,-1,770,610369,6,610363
33517,9,-1,845,612016,9,612007
33518,19,-19,32,54120,19,54101
33519,12,14,730,1091176,12,1091164
33520,20,5,188,805217,20,805197
33521,16,17,210,1179449,16,1179433
33522,16,18,621,1213387,16,1213371
33523,15,-11,951,311158,15,311143
33524,20,-7,357,431066,20,431046
33525,17,18,833,1215001,17,1214984
33526,19,7,359,869624,19,869605
33527,14,8,977,905551,14,905537
33528,17,-19,187,55537,17,55520
33529,9,19,707,1233119,9,1233110
33530,17,8,882,904778,17,904761
33531,10,-6,261,442528,10,442518
33532,6,-13,579,230719,6,230713
33533,8,12,20,999508,8,999500
33534,6,-9,402,352382,6,352376
33535,13,5,546,807772,13,807759
33536,18,19,453,1244558,18,1244540
33537,14,14,647,1090490,14,1090476
33538,10,7,337,852119,10,852109
33539,9,-17,233,98354,9,98345
33540,18,-3,259,555618,18,555600
33541,13,-15,972,185156,13,185143
33542,19,-2,508,588972,19,588953
33543,18,6,287,837964,18,837946
33544,13,-13,334,243508,13,243495
33545,5,-4,862,517831,5,517826
33546,9,-12,45,250492,9,250483
33547,12,-1,579,621110,12,621098
33548,15,17,721,1183279,15,1183264
33549,19,-7,179,429658,19,429639
33550,19,-15,870,184370,19,184351
33551,19,-5,174,492297,19,492278
33552,5,-1,718,609328,5,609323
33553,13,-16,859,153229,13,153216
33554,15,-20,264,24790,15,24775
33555,15,-11,204,305336,15,305321
33556,17,-19,924,60984,17,60967
33557,15,-20,806,29076,15,29061
33558,13,-10,328,337394,13,337381
33559,8,-5,599,481044,8,481036
33560,9,17,554,1167099,9,1167090
33561,16,-6,158,460335,16,460319
33562,8,-2,755,578825,8,578817
33563,8,-19,204,36131,8,36123
33564,7,10,524,948713,7,948706
33565,14,-16,539,150970,14,150956
33566,11,1,89,680468,11,680457
33567,14,5,106,804568,14,804554
33568,10,7,456,854597,10,854587
33569,8,10,559,949451,8,949443
33570,13,4,42,773573,13,773560
33571,18,-1,686,621846,18,621828
33572,5,-17,207,97787,5,97782
33573,10,2,531,699862,10,699852
33574,20,-10,935,342109,20,342089
33575,15,-11,466,307480,15,307465
33576,20,5,473,807288,20,807268
33577,6,-18,952,83118,6,83112
33578,11,-4,357,524909,11,524898
33579,16,-1,750,622334,16,622318
33580,13,0,783,654218,13,654205
33581,16,-20,826,29211,16,29195
33582,15,7,293,869126,15,869111
33583,19,14,486,1089237,19,1089218
33584,12,-17,926,122337,12,122325
33585,6,3,699,734047,6,734041
33586,8,17,926,1175162,8,1175154
33587,6,-5,420,477082,6,477076
33588,9,-6,476,446973,9,446964
33589,14,-11,219,305421,14,305407
33590,6,17,222,1159876,6,1159870
33591,7,18,788,1203465,7,1203458
33592,8,-13,821,236150,8,236142
33593,20,13,320,1055537,20,1055517
33594,6,0,658,639741,6,639735
33595,12,7,69,867519,12,867507
33596,12,14,113,1086359,12,1086347
33597,13,-7,965,435461,13,435448
33598,9,-16,380,132149,9,132140
33599,18,0,994,655909,18,655891
33600,19,0,110,649114,19,649095
33601,10,-6,109,439042,10,439032
33602,5,12,497,1009756,5,1009751
33603,10,16,396,1133632,10,1133622
33604,14,10,610,964611,14,964597
33605,6,13,131,1033516,6,1033510
33606,10,-8,593,387857,10,387847
33607,15,-8,168,399088,15,399073
33608,12,-10,700,340377,12,340365
33609,11,-5,831,497053,11,497042
33610,10,-19,993,52703,10,52693
33611,17,0,831,654574,17,654557
33612,5,-11,671,295953,5,295948
33613,19,0,230,649980,19,649961
33614,20,10,416,963023,20,963003
33615,19,1,183,681326,19,681307
33616,6,-5,981,489397,6,489391
33617,8,18,931,1206428,8,1206420
33618,19,16,878,1153330,19,1153311
33619,18,10,791,965963,18,965945
33620,15,11,842,996966,15,996951
33621,14,-18,242,87222,14,87208
33622,10,15,170,1098074,10,1098064
33623,6,10,53,938676,6,938670
33624,20,-3,848,560559,20,560539
33625,10,-15,869,173946,10,173936
33626,17,14,994,1093265,17,1093248
33627,8,-11,570,293762,8,293754
33628,17,8,274,900103,17,900086
33629,5,-17,776,110080,5,110075
33630,11,2,746,716176,11,716165
33631,18,12,848,1028451,18,1028433
33632,19,2,82,711159,19,711140
33633,11,12,679,1027175,11,1027164
33634,14,18,945,1215900,14,1215886
33635,7,17,458,1165161,7,1165154
33636,13,16,82,1147662,13,1147649
33637,15,-20,888,29629,15,29614
33638,10,-17,101,95643,10,95633
33639,10,-2,45,563847,10,563837
33640,12,13,260,1055112,12,1055100
33641,13,-15,721,183168,13,183155
33642,19,6,445,839311,19,839292
33643,16,-19,493,57761,16,57745
33644,16,-1,589,621165,16,621149
33645,6,-7,637,419359,6,419353
33646,11,18,237,1210882,11,1210871
33647,8,17,60,1156624,8,1156616
33648,18,4,771,778921,18,778903
33649,6,8,374,883288,6,883282
33650,13,-13,138,242002,13,241989
33651,7,16,367,1132980,7,1132973
33652,6,-18,1,62463,6,62457
33653,18,1,904,686893,18,686875
33654,14,-10,388,337833,14,337819
33655,7,-17,626,106972,7,106965
33656,16,10,570,964277,16,964261
33657,16,17,723,1183305,16,1183289
33658,6,4,90,752562,6,752556
33659,12,5,832,809845,12,809833
33660,13,4,847,779603,13,779590
33661,8,-5,489,478591,8,478583
33662,16,0,404,651125,16,651109
33663,11,-17,481,119053,11,119042
33664,8,7,821,862239,8,862231
33665,12,16,911,1153626,12,1153614
33666,10,12,519,1010164,10,1010154
33667,16,17,36,1178136,16,1178120
33668,20,18,846,1215131,20,1215111
33669,20,-2,122,586035,20,586015
33670,18,-4,494,525795,18,525777
33671,12,-15,826,183971,12,183959
33672,16,1,128,680852,16,680836
33673,20,1,66,680273,20,680253
33674,8,-15,619,168715,8,168707
33675,13,-15,693,182890,13,182877
33676,18,-3,315,556080,18,556062
33677,9,-8,991,396556,9,396547
33678,10,-20,497,10657,10,10647
33679,19,-12,269,274523,19,274504
33680,15,5,887,810229,15,810214
33681,14,1,232,681722,14,681708
33682,7,15,387,1102690,7,1102683
33683,15,-17,470,118969,15,118954
33684,15,-4,389,525127,15,525112
33685,8,-13,429,227346,8,227338
33686,16,-6,492,462969,16,462953
33687,14,18,965,1216067,14,1216053
33688,18,-7,959,435434,18,435416
33689,5,4,837,768958,5,768953
33690,18,-16,154,148075,18,148057
33691,10,1,956,677777,10,677767
33692,7,-4,515,510664,7,510657
33693,6,-4,848,517475,6,517469
33694,7,18,524,1198042,7,1198035
33695,20,-3,732,559595,20,559575
33696,11,-8,913,404383,11,404372
33697,16,-19,276,56155,16,56139
33698,19,-4,233,523930,19,523911
33699,13,13,313,1055485,13,1055472
33700,8,7,477,855121,8,855113
33701,20,-7,752,433736,20,433716
33702,12,1,266,682012,12,682000
33703,15,19,513,1245007,15,1244992
33704,9,2,252,694060,9,694051
33705,16,-5,824,496975,16,496959
33706,19,-20,935,29912,19,29893
33707,9,14,241,1067147,9,1067138
33708,20,7,573,871248,20,871228
33709,15,16,145,1148109,15,1148094
33710,12,1,964,687347,12,687335
33711,17,4,780,778991,17,778974
33712,7,14,255,1067499,7,1067492
33713,6,-11,966,301951,6,301945
33714,10,-19,137,34623,10,34613
33715,15,-17,65,115967,15,115952
33716,19,-4,57,522459,19,522440
33717,14,-15,701,182955,14,182941
33718,16,18,415,1212117,16,1212101
33719,18,-2,758,590799,18,590781
33720,10,-15,482,165916,10,165906
33721,8,15,666,1108573,8,1108565
33722,9,0,241,630621,9,630612
33723,19,13,540,1057258,19,1057239
33724,20,1,121,680772,20,680752
33725,20,-20,900,29752,20,29732
33726,17,-10,476,338656,17,338639
33727,19,6,32,836072,19,836053
33728,19,-13,805,247042,19,247023
33729,8,-6,721,452324,8,452316
33730,17,-20,27,15571,17,15554
33731,6,17,111,1157622,6,1157616
33732,19,4,425,776332,19,776313
33733,6,11,50,969543,6,969537
33734,7,-16,634,137748,7,137741
33735,11,9,484,932595,11,932584
33736,5,-6,26,437445,5,437440
33737,17,8,695,903479,17,903462
33738,11,19,98,1241543,11,1241532
33739,16,-17,575,119862,16,119846
33740,17,6,182,837132,17,837115
33741,17,-5,16,490883,17,490866
33742,17,-7,287,430481,17,430464
33743,11,-13,411,243998,11,243987
33744,20,-10,684,340237,20,340217
33745,13,-16,277,149016,13,149003
33746,6,16,817,1142139,6,1142133
33747,5,6,736,828957,5,828952
33748,7,-19,733,47690,7,47683
33749,17,9,6,929086,17,929069
33750,8,10,744,953513,8,953505
33751,13,14,985,1093186,13,1093173
33752,11,13,459,1056636,11,1056625
33753,18,19,287,1243044,18,1243026
33754,19,8,633,902997,19,902978
33755,8,11,837,986339,8,986331
33756,7,17,50,1156446,7,1156439
33757,16,-12,748,278001,16,277985
33758,9,0,816,643131,9,643122
33759,13,2,97,711323,13,711310
33760,16,-6,158,460341,16,460325
33761,20,-5,910,497713,20,497693
33762,5,15,986,1115454,5,1115449
33763,11,-20,973,30190,11,30179
33764,6,-15,761,171649,6,171643
33765,9,17,424,1164302,9,1164293
33766,17,9,334,931451,17,931434
33767,14,15,711,1122051,14,1122037
33768,8,-7,895,425085,8,425077
33769,13,-4,549,526254,13,526241
33770,7,-2,754,578770,7,578763
33771,12,1,44,680123,12,680111
33772,5,3,571,730939,5,730934
33773,15,-6,328,461719,15,461704
33774,15,-15,768,183493,15,183478
33775,10,19,73,1219090,10,1219080
33776,5,-14,520,197866,5,197861
33777,8,-13,93,220402,8,220394
33778,17,-2,166,586280,17,586263
33779,11,-19,329,56515,11,56504
33780,9,-12,230,254487,9,254478
33781,10,13,887,1049813,10,1049803
33782,18,14,168,1086768,18,1086750
33783,11,-16,811,152849,11,152838
33784,10,18,978,1207514,10,1207504
33785,13,10,167,961162,13,961149
33786,6,12,455,1008826,6,1008820
33787,8,7,712,859803,8,859795
33788,15,18,266,1211115,15,1211100
33789,5,-10,193,316815,5,316810
33790,17,19,401,1244067,17,1244050
33791,7,5,880,800162,7,800155
33792,8,-7,92,407791,8,407783
33793,19,-20,718,28279,19,28260
33794,12,12,222,1023689,12,1023677
33795,14,-1,424,619918,14,619904
33796,15,-8,360,400399,15,400384
33797,12,12,957,1029461,12,1029449
33798,18,11,423,993965,18,993947
33799,17,-1,360,619498,17,619481
33800,19,0,303,650351,19,650332
33801,19,16,861,1153241,19,1153222
33802,17,16,137,1148067,17,1148050
33803,15,12,169,1023303,15,1023288
33804,17,9,474,932460,17,932443
33805,20,4,335,775621,20,775601
33806,18,-12,64,273004,18,272986
33807,18,-11,213,305396,18,305378
33808,18,4,53,773631,18,773613
33809,16,-7,332,430853,16,430837
33810,14,12,168,1023297,14,1023283
33811,5,13,343,1038195,5,1038190
33812,15,-5,379,493816,15,493801
33813,15,-4,651,527015,15,527000
33814,18,10,327,962300,18,962282
33815,9,-5,438,477445,9,477436
33816,5,-1,671,608278,5,608273
33817,11,-7,158,429459,11,429448
33818,10,3,380,727015,10,727005
33819,7,3,705,734153,7,734146
33820,12,-2,562,589352,12,589340
33821,16,3,628,746566,16,746550
33822,19,-11,112,304590,19,304571
33823,17,1,506,683852,17,683835
33824,5,3,862,737493,5,737488
33825,20,-9,365,369394,20,369374
33826,10,14,77,1063548,10,1063538
33827,10,6,903,832572,10,832562
33828,11,-3,247,555513,11,555502
33829,13,-11,261,305767,13,305754
33830,10,-4,226,504492,10,504482
33831,10,-19,836,49747,10,49737
33832,17,-4,800,528007,17,527990
33833,19,-17,720,120945,19,120926
33834,9,-12,677,264159,9,264150
33835,13,-18,220,86979,13,86966
33836,5,0,395,633937,5,633932
33837,15,-14,373,212417,15,212402
33838,8,-10,57,313871,8,313863
33839,15,7,300,869181,15,869166
33840,15,-19,717,59592,15,59577
33841,7,-19,656,45948,7,45941
33842,10,-18,636,76064,10,76054
33843,15,-15,510,181528,15,181513
33844,20,3,615,746435,20,746415
33845,7,-19,837,49779,7,49772
33846,16,12,281,1024202,16,1024186
33847,18,13,435,1056491,18,1056473
33848,6,6,958,833741,6,833735
33849,20,10,899,966684,20,966664
33850,19,-2,336,587614,19,587595
33851,7,-8,865,393826,7,393819
33852,16,2,455,714063,16,714047
33853,16,11,315,993162,16,993146
33854,10,3,50,719927,10,719917
33855,10,0,349,632746,10,632736
33856,7,12,114,1001613,7,1001606
33857,18,-11,659,308982,18,308964
33858,5,19,840,1236190,5,1236185
33859,19,-18,545,89255,19,89236
33860,17,13,596,1057774,17,1057757
33861,15,2,429,713872,15,713857
33862,9,-5,932,488331,9,488322
33863,17,-11,904,310817,17,310800
33864,9,-3,648,545048,9,545039
33865,15,-8,611,402158,15,402143
33866,9,2,926,707860,9,707851
33867,8,3,669,733198,8,733190
33868,7,-1,813,611325,7,611318
33869,14,-18,65,85694,14,85680
33870,14,-5,19,490912,14,490898
33871,6,-3,850,549408,6,549402
33872,14,-2,27,585342,14,585328
33873,18,-11,80,304284,18,304266
33874,5,5,820,798758,5,798753
33875,6,-15,367,163351,6,163345
33876,13,2,176,711916,13,711903
33877,6,-3,632,544706,6,544700
33878,14,16,910,1153609,14,1153595
33879,20,-19,72,54430,20,54410
33880,8,-15,924,175077,8,175069
33881,5,3,502,729571,5,729566
33882,17,7,622,871570,17,871553
33883,5,-2,492,573282,5,573277
33884,15,-14,134,210346,15,210331
33885,7,-18,172,66250,7,66243
33886,16,17,982,1185323,16,1185307
33887,15,-5,847,497176,15,497161
33888,10,-5,454,477778,10,477768
33889,12,-13,188,242441,12,242429
33890,9,-1,897,613220,9,613211
33891,7,15,98,1096567,7,1096560
33892,16,-5,48,491212,16,491196
33893,10,6,844,831306,10,831296
33894,13,-18,45,85536,13,85523
33895,15,-1,414,619849,15,619834
33896,14,-11,890,310678,14,310664
33897,20,-2,837,591510,20,591490
33898,17,8,588,902579,17,902562
33899,16,-17,438,118717,16,118701
33900,8,8,860,893824,8,893816
33901,18,-12,293,274677,18,274659
33902,7,-7,134,408630,7,408623
33903,8,-17,593,106310,8,106302
33904,16,10,791,965969,16,965953
33905,19,0,836,654613,19,654594
33906,14,17,816,1184062,14,1184048
33907,16,-13,707,246225,16,246209
33908,7,-8,782,392102,7,392095
33909,5,-8,368,383046,5,383041
33910,14,10,834,966265,14,966251
33911,20,-16,90,147567,20,147547
33912,9,-7,299,412297,9,412288
33913,11,-2,748,590716,11,590705
33914,7,-10,856,330947,7,330940
33915,18,5,172,805025,18,805007
33916,16,-4,101,522796,16,522780
33917,9,-13,550,230052,9,230043
33918,20,13,762,1058945,20,1058925
33919,6,-10,204,317010,6,317004
33920,12,13,248,1055026,12,1055014
33921,7,18,512,1197789,7,1197782
33922,14,-15,918,184749,14,184735
33923,14,6,636,840909,14,840895
33924,18,-8,354,400391,18,400373
33925,18,-5,889,497558,18,497540
33926,14,-15,692,182883,14,182869
33927,6,1,735,673003,6,672997
33928,15,4,311,775425,15,775410
33929,9,-8,726,390965,9,390956
33930,9,5,332,788473,9,788464
33931,14,0,443,651436,14,651422
33932,9,-6,39,437679,9,437670
33933,11,-11,469,307496,11,307485
33934,18,-2,874,591799,18,591781
33935,18,3,787,747757,18,747739
33936,14,-15,545,181778,14,181764
33937,19,-18,730,90584,19,90565
33938,5,-8,461,384856,5,384851
33939,11,-10,315,337353,11,337342
33940,20,-9,527,370870,20,370850
33941,9,17,519,1166443,9,1166434
33942,13,-4,188,523524,13,523511
33943,9,-12,39,250357,9,250348
33944,19,5,458,807145,19,807126
33945,13,3,220,743527,13,743514
33946,7,10,995,958743,7,958736
33947,17,12,584,1026364,17,1026347
33948,10,2,934,708040,10,708030
33949,17,-6,983,466609,17,466592
33950,7,-10,192,316803,7,316796
33951,15,15,607,1121225,15,1121210
33952,18,-9,994,374221,18,374203
33953,12,-10,651,339936,12,339924
33954,20,16,584,1151216,20,1151196
33955,15,-13,607,245548,15,245533
33956,20,-1,924,623643,20,623623
33957,16,-18,107,86050,16,86034
33958,9,-10,145,315828,9,315819
33959,15,-8,634,402349,15,402334
33960,17,9,692,934152,17,934135
33961,9,8,727,891281,9,891272
33962,20,16,376,1149863,20,1149843
33963,14,-10,812,341223,14,341209
33964,11,-7,138,429300,11,429289
33965,7,-7,579,418342,7,418335
33966,11,-12,776,278205,11,278194
33967,15,3,520,745659,15,745644
33968,17,3,908,748673,17,748656
33969,11,-7,236,430033,11,430022
33970,5,-13,58,219661,5,219656
33971,17,-10,569,339324,17,339307
33972,20,6,910,843038,20,843018
33973,20,4,707,778427,20,778407
33974,11,15,538,1120684,11,1120673
33975,11,14,208,1087013,11,1087002
33976,16,-12,740,277931,16,277915
33977,10,1,727,672802,10,672792
33978,11,-1,436,620007,11,619996
33979,17,-7,694,433356,17,433339
33980,9,-9,172,347222,9,347213
33981,18,-9,605,371385,18,371367
33982,20,18,68,1209500,20,1209480
33983,8,4,33,751253,8,751245
33984,20,-19,996,61421,20,61401
33985,16,5,321,806104,16,806088
33986,13,-6,619,463894,13,463881
33987,17,-18,4,85219,17,85202
33988,18,-14,799,215803,18,215785
33989,10,-19,557,43622,10,43612
33990,13,-14,944,216817,13,216804
33991,17,-20,524,26751,17,26734
33992,10,11,390,976887,10,976877
33993,20,-2,21,585308,20,585288
33994,9,-3,235,535532,9,535523
33995,13,-5,304,493333,13,493320
33996,20,-9,333,369087,20,369067
33997,19,-3,530,558014,19,557995
33998,11,-18,63,85680,11,85669
33999,15,-5,700,496153,15,496138
34000,10,-18,979,83734,10,83724
34001,7,4,887,770157,7,770150
34002,7,8,362,883100,7,883093
34003,14,10,215,961476,14,961462
34004,9,-19,669,46179,9,46170
34005,20,3,964,749229,20,749209
34006,13,-8,310,400069,13,400056
34007,12,4,157,774400,12,774388
34008,6,-16,726,139616,6,139610
34009,17,-8,723,403003,17,402986
34010,16,-2,936,592271,16,592255
34011,17,12,183,1023378,17,1023361
34012,11,10,50,960234,11,960223
34013,5,-8,955,395778,5,395773
34014,15,-9,676,371765,15,371750
34015,6,0,485,635900,6,635894
34016,17,-2,80,585714,17,585697
34017,6,-14,773,203570,6,203564
34018,19,-19,561,58402,19,58383
34019,8,-18,959,83315,8,83307
34020,8,10,111,940025,8,940017
34021,7,9,4,906786,7,906779
34022,6,-4,933,519384,6,519378
34023,16,17,354,1180612,16,1180596
34024,9,-9,332,350880,9,350871
34025,9,16,141,1128075,9,1128066
34026,7,-2,136,565747,7,565740
34027,7,-11,196,285425,7,285418
34028,13,-20,917,29814,13,29801
34029,9,6,693,827965,9,827956
34030,5,18,547,1198499,5,1198494
34031,13,-7,921,435131,13,435118
34032,20,11,839,996926,20,996906
34033,12,-9,305,368813,12,368801
34034,8,10,742,953468,8,953460
34035,18,-18,292,87509,18,87491
34036,5,5,948,801722,5,801717
34037,13,12,761,1027684,13,1027671
34038,17,-12,757,278084,17,278067
34039,15,15,24,1116959,15,1116944
34040,16,-6,812,465371,16,465355
34041,14,-15,808,183808,14,183794
34042,14,-19,506,57882,14,57868
34043,10,13,700,1045784,10,1045774
34044,15,-14,679,214835,15,214820
34045,20,15,192,1118242,20,1118222
34046,11,3,605,746355,11,746344
34047,19,17,679,1182915,19,1182896
34048,17,17,258,1179828,17,1179811
34049,16,1,111,680686,16,680670
34050,8,-12,447,259226,8,259218
34051,14,3,75,742386,14,742372
34052,7,0,455,635259,7,635252
34053,6,-18,100,64671,6,64665
34054,20,-7,427,431521,20,431501
34055,17,-10,844,341428,17,341411
34056,18,-15,927,184816,18,184798
34057,13,-13,790,246905,13,246892
34058,15,-14,253,211415,15,211400
34059,9,-14,698,201968,9,201959
34060,6,19,724,1233575,6,1233569
34061,7,-12,554,261543,7,261536
34062,14,3,341,744470,14,744456
34063,11,-6,579,463577,11,463566
34064,18,-13,930,248061,18,248043
34065,6,18,828,1204245,6,1204239
34066,19,14,319,1087910,19,1087891
34067,5,16,221,1129910,5,1129905
34068,10,3,918,738726,10,738716
34069,5,-10,816,330069,5,330064
34070,11,-19,877,60733,11,60722
34071,10,-13,617,231609,10,231599
34072,12,-11,282,305926,12,305914
34073,15,-19,771,60009,15,59994
34074,20,-7,116,429131,20,429111
34075,16,18,950,1215961,16,1215945
34076,17,-1,90,617269,17,617252
34077,10,-12,317,256508,10,256498
34078,20,4,685,778271,20,778251
34079,5,7,599,857528,5,857523
34080,15,12,785,1027894,15,1027879
34081,11,-16,773,152576,11,152565
34082,19,19,470,1244654,19,1244635
34083,7,16,122,1127584,7,1127577
34084,8,-19,448,41123,8,41115
34085,19,-7,444,431660,19,431641
34086,19,-12,586,276815,19,276796
34087,10,-9,148,346769,10,346759
34088,16,-6,139,460150,16,460134
34089,16,-12,57,272929,16,272913
34090,8,15,762,1110665,8,1110657
34091,5,-14,780,203708,5,203703
34092,13,-18,979,92328,13,92315
34093,7,-19,960,52107,7,52100
34094,12,-8,36,398174,12,398162
34095,12,18,722,1214095,12,1214083
34096,20,18,36,1209167,20,1209147
34097,19,-9,544,371018,19,370999
34098,7,15,253,1099963,7,1099956
34099,8,4,79,752300,8,752292
34100,10,-1,198,597949,10,597939
34101,15,-11,5,303701,15,303686
34102,15,9,106,929823,15,929808
34103,17,13,9,1053318,17,1053301
34104,19,7,959,873795,19,873776
34105,12,0,302,650332,12,650320
34106,18,15,986,1124036,18,1124018
34107,9,3,467,728834,9,728825
34108,10,-1,657,608053,10,608043
34109,9,18,413,1195558,9,1195549
34110,7,6,716,828548,7,828541
34111,10,3,986,740456,10,740446
34112,13,14,498,1089357,13,1089344
34113,9,9,605,919591,9,919582
34114,16,4,412,776193,16,776177
34115,9,19,354,1225428,9,1225419
34116,15,-13,736,246450,15,246435
34117,20,-5,300,493309,20,493289
34118,13,-16,318,149297,13,149284
34119,13,-14,673,214795,13,214782
34120,12,-17,12,115652,12,115640
34121,5,1,605,670452,5,670447
34122,11,-3,993,561692,11,561681
34123,15,3,667,746867,15,746852
34124,5,12,796,1016367,5,1016362
34125,20,10,44,960188,20,960168
34126,12,-5,198,492401,12,492389
34127,20,-14,780,215641,20,215621
34128,14,-11,140,304833,14,304819
34129,17,-13,880,247625,17,247608
34130,8,13,502,1041488,8,1041480
34131,13,-9,787,372782,13,372769
34132,19,1,326,682505,19,682486
34133,6,10,968,958190,6,958184
34134,11,-17,321,117869,11,117858
34135,12,-5,460,494440,12,494428
34136,12,-17,946,122476,12,122464
34137,19,-9,775,372668,19,372649
34138,16,6,711,841539,16,841523
34139,20,3,144,742917,20,742897
34140,13,-3,667,559085,13,559072
34141,10,10,759,953799,10,953789
34142,20,-13,669,245865,20,245845
34143,6,-18,96,64610,6,64604
34144,16,-9,758,372508,16,372492
34145,7,-19,511,42528,7,42521
34146,13,15,102,1117566,13,1117553
34147,8,11,56,969711,8,969703
34148,7,-10,180,316538,7,316531
34149,10,2,705,703528,10,703518
34150,9,6,516,824016,9,824007
34151,6,-17,519,104713,6,104707
34152,12,14,65,1085980,12,1085968
34153,16,-13,575,245297,16,245281
34154,5,-19,843,49994,5,49989
34155,16,-13,751,246579,16,246563
34156,9,-17,476,103606,9,103597
34157,14,19,362,1243699,14,1243685
34158,7,-20,605,13256,7,13249
34159,8,-14,14,186773,8,186765
34160,11,-11,900,310781,11,310770
34161,12,-9,624,371488,12,371476
34162,18,-18,134,86233,18,86215
34163,10,16,360,1132794,10,1132784
34164,15,-11,422,307116,15,307101
34165,12,-16,329,149368,12,149356
34166,15,-7,856,434554,15,434539
34167,7,-7,182,409719,7,409712
34168,20,-14,842,216069,20,216049
34169,20,-14,410,212780,20,212760
34170,9,-14,318,193601,9,193592
34171,6,-6,456,446514,6,446508
34172,14,7,470,870515,14,870501
34173,5,-13,314,225029,5,225024
34174,15,12,900,1028895,15,1028880
34175,13,-10,263,337024,13,337011
34176,9,7,99,846947,9,846938
34177,6,2,887,707115,6,707109
34178,11,-18,460,88745,11,88734
34179,11,-15,583,182067,11,182056
34180,7,-17,511,104544,7,104537
34181,14,16,254,1148934,14,1148920
34182,18,-19,549,58277,18,58259
34183,19,-16,421,150049,19,150030
34184,9,-17,211,97954,9,97945
34185,6,-9,685,358594,6,358588
34186,15,-16,697,152022,15,152007
34187,19,-11,83,304298,19,304279
34188,8,-3,925,551196,8,551188
34189,10,-2,27,563372,10,563362
34190,7,14,759,1078996,7,1078989
34191,19,15,947,1123750,19,1123731
34192,12,-7,296,430565,12,430553
34193,11,-6,0,459137,11,459126
34194,18,-7,869,434659,18,434641
34195,18,-20,145,23874,18,23856
34196,18,-16,958,153981,18,153963
34197,6,-4,614,512651,6,512645
34198,10,-19,220,36417,10,36407
34199,12,-8,952,404641,12,404629
34200,18,3,534,745733,18,745715
34201,12,-18,786,90975,12,90963
34202,7,-13,674,232502,7,232495
34203,12,10,119,960833,12,960821
34204,14,-5,882,497505,14,497491
34205,7,-10,681,327354,7,327347
34206,18,-10,204,336547,18,336529
34207,7,16,786,1141392,7,1141385
34208,14,12,575,1026245,14,1026231
34209,13,-17,736,121082,13,121069
34210,20,-18,982,92352,20,92332
34211,11,19,790,1247190,11,1247179
34212,14,1,551,684247,14,684233
34213,13,-1,512,620639,13,620626
34214,8,-7,434,415216,8,415208
34215,16,19,874,1247858,16,1247842
34216,15,-17,478,119029,15,119014
34217,8,0,333,632381,8,632373
34218,7,-14,416,195950,7,195943
34219,8,17,139,1158228,8,1158220
34220,9,-20,956,21064,9,21055
34221,8,-18,965,83433,8,83425
34222,11,-13,445,244257,11,244246
34223,19,-2,236,586922,19,586903
34224,15,-14,485,213240,15,213225
34225,13,-17,853,121849,13,121836
34226,16,-6,685,464389,16,464373
34227,11,3,1000,749546,11,749535
34228,7,-8,129,378116,7,378109
34229,8,-16,846,142147,8,142139
34230,7,6,324,819575,7,819568
34231,6,9,336,913803,6,913797
34232,11,-9,274,368578,11,368567
34233,18,19,717,1246589,18,1246571
34234,9,-11,102,283310,9,283301
34235,13,-7,484,431967,13,431954
34236,19,-1,933,623718,19,623699
34237,14,-13,559,245147,14,245133
34238,7,-5,658,482273,7,482266
34239,18,0,334,650549,18,650531
34240,5,5,805,798453,5,798448
34241,7,-11,448,291105,7,291098
34242,5,-2,9,562944,5,562939
34243,12,-11,102,304486,12,304474
34244,7,4,378,758820,7,758813
34245,5,-10,52,313750,5,313745
34246,13,-3,338,556279,13,556266
34247,7,-9,846,362436,7,362429
34248,5,-17,282,99549,5,99544
34249,10,0,343,632666,10,632656
34250,6,17,649,1169191,6,1169185
34251,13,-20,204,24419,13,24406
34252,19,1,283,682112,19,682093
34253,5,-12,614,262713,5,262708
34254,12,4,354,775784,12,775772
34255,13,-16,125,147867,13,147854
34256,6,-13,113,220845,6,220839
34257,8,6,882,832096,8,832088
34258,16,18,825,1214924,16,1214908
34259,19,7,308,869247,19,869228
34260,8,5,973,802192,8,802184
34261,10,-17,920,112963,10,112953
34262,6,9,238,911733,6,911727
34263,11,2,239,712344,11,712333
34264,20,19,448,1244534,20,1244514
34265,5,-11,309,288000,5,287995
34266,13,0,578,652629,13,652616
34267,12,-1,593,621200,12,621188
34268,11,4,33,773499,11,773488
34269,11,19,455,1244572,11,1244561
34270,8,-15,920,175029,8,175021
34271,15,-12,490,276112,15,276097
34272,11,-9,287,368684,11,368673
34273,16,2,686,715758,16,715742
34274,8,0,278,631325,8,631317
34275,15,0,754,654061,15,654046
34276,20,-20,972,30159,20,30139
34277,14,18,747,1214366,14,1214352
34278,14,-20,438,26126,14,26112
34279,17,-1,475,620374,17,620357
34280,15,17,665,1182805,15,1182790
34281,20,-11,956,311195,20,311175
34282,6,5,127,784197,6,784191
34283,12,-2,257,587052,12,587040
34284,8,12,485,1009540,8,1009532
34285,17,-8,898,404290,17,404273
34286,10,14,915,1082214,10,1082204
34287,9,-4,673,513885,9,513876
34288,9,-5,855,486542,9,486533
34289,7,-13,264,224020,7,224013
34290,5,-4,733,515155,5,515150
34291,14,2,216,712211,14,712197
34292,11,7,270,868955,11,868944
34293,16,8,198,899510,16,899494
34294,20,7,3,867038,20,867018
34295,8,-10,424,321832,8,321824
34296,18,14,804,1091750,18,1091732
34297,11,16,845,1153160,11,1153149
34298,6,-10,933,332473,6,332467
34299,18,10,144,960986,18,960968
34300,20,-10,60,335648,20,335628
34301,12,-12,933,279529,12,279517
34302,18,5,261,805755,18,805737
34303,8,4,100,752819,8,752811
34304,15,8,99,898704,15,898689
34305,18,-18,170,86580,18,86562
34306,5,19,312,1224547,5,1224542
34307,8,5,945,801618,8,801610
34308,20,-12,463,275891,20,275871
34309,10,-10,73,314265,10,314255
34310,10,15,496,1104908,10,1104898
34311,16,17,880,1184568,16,1184552
34312,19,-18,434,88517,19,88498
34313,9,-13,187,222409,9,222400
34314,12,-9,313,368906,12,368894
34315,15,-11,23,303832,15,303817
34316,16,9,299,931148,16,931132
34317,15,-9,736,372242,15,372227
34318,7,-12,174,253252,7,253245
34319,20,-5,326,493556,20,493536
34320,8,4,773,767474,8,767466
34321,17,-6,476,462808,17,462791
34322,9,-19,589,44440,9,44431
34323,17,-16,413,149972,17,149955
34324,20,-2,306,587444,20,587424
34325,8,-10,2,312536,8,312528
34326,7,0,1,625181,7,625174
34327,8,-3,363,538342,8,538334
34328,6,-8,598,387997,6,387991
34329,10,10,1000,958837,10,958827
34330,8,-2,973,583632,8,583624
34331,13,-4,231,523898,13,523885
34332,9,8,523,886754,9,886745
34333,10,12,836,1017258,10,1017248
34334,8,3,957,739685,8,739677
34335,17,-12,954,279735,17,279718
34336,9,-8,153,378757,9,378748
34337,18,-13,903,247755,18,247737
34338,13,19,172,1242131,13,1242118
34339,10,-7,433,415175,10,415165
34340,19,4,257,775077,19,775058
34341,7,-12,290,255791,7,255784
34342,18,-12,564,276685,18,276667
34343,6,0,695,640608,6,640602
34344,19,-7,137,429286,19,429267
34345,14,-2,662,590102,14,590088
34346,16,-2,581,589500,16,589484
34347,13,-3,529,557997,13,557984
34348,13,-5,998,498322,13,498309
34349,10,5,122,784106,10,784096
34350,13,-14,325,211930,13,211917
34351,12,-8,594,402008,12,401996
34352,19,-5,999,498338,19,498319
34353,11,5,578,807994,11,807983
34354,8,-14,521,197891,8,197883
34355,9,-9,239,348768,9,348759
34356,11,16,885,1153359,11,1153348
34357,10,16,376,1133176,10,1133166
34358,8,-14,542,198207,8,198199
34359,11,15,381,1119577,11,1119566
34360,15,-3,477,557446,15,557431
34361,19,8,925,905147,19,905128
34362,14,18,658,1213728,14,1213714
34363,20,-4,568,526389,20,526369
34364,15,-5,755,496539,15,496524
34365,16,19,839,1247573,16,1247557
34366,10,9,858,924991,10,924981
34367,11,-3,482,557466,11,557455
34368,9,3,701,734064,9,734055
34369,9,12,716,1014781,9,1014772
34370,9,3,974,740212,9,740203
34371,14,-20,102,23528,14,23514
34372,16,10,329,962323,16,962307
34373,13,1,847,686413,13,686400
34374,12,17,831,1184192,12,1184180
34375,11,5,330,806199,11,806188
34376,9,-12,680,264235,9,264226
34377,6,-16,331,131082,6,131076
34378,10,17,821,1172939,10,1172929
34379,19,-12,183,273824,19,273805
34380,6,-1,474,604413,6,604407
34381,13,-5,556,495135,13,495122
34382,19,4,394,776044,19,776025
34383,19,-20,285,25015,19,24996
34384,18,19,327,1243411,18,1243393
34385,9,-18,626,75835,9,75826
34386,19,5,770,809381,19,809362
34387,17,-18,727,90551,17,90534
34388,19,5,672,808672,19,808653
34389,16,-15,947,185014,16,184998
34390,6,-12,82,251352,6,251346
34391,10,-13,57,219629,10,219619
34392,14,-7,915,435064,14,435050
34393,18,2,595,715038,18,715020
34394,7,6,594,825754,7,825747
34395,14,-11,690,309173,14,309159
34396,20,-19,471,57602,20,57582
34397,16,18,270,1211143,16,1211127
34398,17,-6,155,460321,17,460304
34399,7,7,196,848921,7,848914
34400,9,9,389,914882,9,914873
34401,17,-9,602,371363,17,371346
34402,12,6,81,836314,12,836302
34403,19,-6,625,463932,19,463913
34404,11,-9,198,367958,11,367947
34405,20,1,193,681394,20,681374
34406,8,9,877,925333,8,925325
34407,15,15,524,1120577,15,1120562
34408,7,-18,593,75191,7,75184
34409,16,-7,576,432646,16,432630
34410,6,5,573,793437,6,793431
34411,9,-1,400,602737,9,602728
34412,16,7,255,868885,16,868869
34413,13,7,60,867457,13,867444
34414,7,5,371,789281,7,789274
34415,15,-20,179,24169,15,24154
34416,16,-15,886,184472,16,184456
34417,14,5,323,806131,14,806117
34418,11,-12,29,272709,11,272698
34419,6,18,912,1206025,6,1206019
34420,9,2,444,698118,9,698109
34421,7,14,578,1074677,7,1074670
34422,10,-12,996,271352,10,271342
34423,16,-8,210,399384,16,399368
34424,10,0,55,626450,10,626440
34425,18,-19,434,57351,18,57333
34426,20,-13,311,243370,20,243350
34427,14,8,321,900482,14,900468
34428,17,5,484,807366,17,807349
34429,9,-5,38,468690,9,468681
34430,11,14,520,1089506,11,1089495
34431,10,-12,906,269361,10,269351
34432,14,-7,805,434142,14,434128
34433,14,10,903,966706,14,966692
34434,10,6,105,814483,10,814473
34435,18,-9,791,372842,18,372824
34436,5,-20,930,20495,5,20490
34437,15,16,764,1152514,15,1152499
34438,19,9,219,930683,19,930664
34439,18,16,256,1148955,18,1148937
34440,18,5,615,808331,18,808313
34441,13,15,29,1117004,13,1116991
34442,16,12,839,1028330,16,1028314
34443,9,12,136,1002063,9,1002054
34444,18,-6,799,465280,18,465262
34445,6,11,515,979489,6,979483
34446,14,14,667,1090658,14,1090644
34447,10,2,269,694427,10,694417
34448,11,-20,710,28252,11,28241
34449,8,-14,950,207117,8,207109
34450,6,2,886,707074,6,707068
34451,9,-9,615,357323,9,357314
34452,20,-3,743,559677,20,559657
34453,20,-19,775,60037,20,60017
34454,8,-7,504,416618,8,416610
34455,17,-3,522,557857,17,557840
34456,20,-10,619,339693,20,339673
34457,20,0,258,650107,20,650087
34458,20,12,616,1026589,20,1026569
34459,9,16,872,1143202,9,1143193
34460,12,19,9,1240716,12,1240704
34461,7,9,445,916027,7,916020
34462,7,5,880,800169,7,800162
34463,15,0,61,648691,15,648676
34464,19,19,190,1242255,19,1242236
34465,19,-20,701,28193,19,28174
34466,5,-19,75,33084,5,33079
34467,7,6,392,821119,7,821112
34468,5,-12,236,254592,5,254587
34469,6,2,753,704540,6,704534
34470,9,-17,184,97273,9,97264
34471,6,-18,482,72798,6,72792
34472,9,1,241,662475,9,662466
34473,15,0,965,655657,15,655642
34474,7,-10,501,323551,7,323544
34475,14,11,858,997073,14,997059
34476,7,10,671,952020,7,952013
34477,14,1,560,684322,14,684308
34478,16,4,62,773708,16,773692
34479,17,-7,448,431706,17,431689
34480,6,-7,279,411798,6,411792
34481,18,-9,654,371686,18,371668
34482,5,9,157,910077,5,910072
34483,17,-7,347,430974,17,430957
34484,6,-12,672,264080,6,264074
34485,15,-14,900,216501,15,216486
34486,5,-2,92,564781,5,564776
34487,13,-4,767,527773,13,527760
34488,20,-9,531,370923,20,370903
34489,11,11,538,994725,11,994714
34490,12,-9,865,373433,12,373421
34491,17,11,51,991236,17,991219
34492,5,-3,461,540793,5,540788
34493,9,12,398,1007694,9,1007685
34494,16,-15,730,183222,16,183206
34495,5,1,957,677801,5,677796
34496,17,-15,395,180652,17,180635
34497,9,-14,661,201143,9,201134
34498,6,-10,272,318412,6,318406
34499,9,-20,913,20213,9,20204
34500,18,4,328,775582,18,775564
34501,14,-7,494,432031,14,432017
34502,13,-9,384,369532,13,369519
34503,20,0,443,651446,20,651426
34504,5,1,538,669141,5,669136
34505,14,-16,150,148048,14,148034
34506,18,9,276,930960,18,930942
34507,13,-20,803,29037,13,29024
34508,17,-20,97,23484,17,23467
34509,18,-11,757,309612,18,309594
34510,10,0,248,630763,10,630753
34511,6,19,468,1228180,6,1228174
34512,10,-13,538,229771,10,229761
34513,5,18,403,1195321,5,1195316
34514,16,9,148,930144,16,930128
34515,7,15,215,1099059,7,1099052
34516,8,-6,668,451137,8,451129
34517,19,12,285,1024249,19,1024230
34518,9,1,161,660708,9,660699
34519,17,7,267,868934,17,868917
34520,18,-6,476,462816,18,462798
34521,12,15,169,1118035,12,1118023
34522,17,0,407,651154,17,651137
34523,10,6,649,826937,10,826927
34524,11,-11,979,311371,11,311360
34525,17,13,783,1059087,17,1059070
34526,6,-4,930,519324,6,519318
34527,11,17,119,1178733,11,1178722
34528,14,0,711,653719,14,653705
34529,14,-10,94,335837,14,335823
34530,19,-3,305,556011,19,555992
34531,13,-3,357,556401,13,556388
34532,8,-12,589,262242,8,262234
34533,7,9,992,927908,7,927901
34534,9,1,405,666031,9,666022
34535,5,6,241,817542,5,817537
34536,14,-10,800,341148,14,341134
34537,14,13,28,1053405,14,1053391
34538,13,-16,41,147040,13,147027
34539,16,14,905,1092530,16,1092514
34540,15,16,39,1147346,15,1147331
34541,13,-3,859,560643,13,560630
34542,9,-7,95,407852,9,407843
34543,18,16,905,1153558,18,1153540
34544,9,11,489,978881,9,978872
34545,9,-4,249,505082,9,505073
34546,11,0,704,653651,11,653640
34547,6,-6,374,444844,6,444838
34548,13,-6,831,465450,13,465437
34549,9,-6,228,441879,9,441870
34550,5,-17,111,95783,5,95778
34551,5,13,489,1041173,5,1041168
34552,14,3,2,741842,14,741828
34553,19,-1,794,622667,19,622648
34554,7,5,946,801678,7,801671
34555,6,-5,54,469035,6,469029
34556,18,-14,252,211389,18,211371
34557,6,-6,989,457923,6,457917
34558,5,-2,550,574430,5,574425
34559,17,-14,217,211034,17,211017
34560,5,15,39,1095342,5,1095337
34561,8,4,673,765113,8,765105
34562,11,8,310,900396,11,900385
34563,8,-2,66,564312,8,564304
34564,6,2,575,700738,6,700732
34565,9,19,424,1227352,9,1227343
34566,5,-13,54,219582,5,219577
34567,6,-1,647,607834,6,607828
34568,15,-14,272,211543,15,211528
34569,18,-13,986,248475,18,248457
34570,13,14,36,1085693,13,1085680
34571,18,14,294,1087708,18,1087690
34572,11,7,183,868340,11,868329
34573,15,-5,151,492103,15,492088
34574,6,-16,698,138983,6,138977
34575,9,-19,388,39895,9,39886
34576,14,-8,790,403535,14,403521
34577,11,9,388,931840,11,931829
34578,19,-3,658,559041,19,559022
34579,5,-6,525,448152,5,448147
34580,15,8,257,899987,15,899972
34581,18,-8,463,401070,18,401052
34582,7,-15,317,162277,7,162270
34583,6,3,315,725837,6,725831
34584,19,-10,757,340804,19,340785
34585,15,17,973,1185234,15,1185219
34586,15,-16,874,153413,15,153398
34587,10,17,187,1159272,10,1159262
34588,6,9,182,910601,6,910595
34589,15,0,310,650374,15,650359
34590,13,16,361,1149741,13,1149728
34591,20,14,463,1089070,20,1089050
34592,11,9,944,936121,11,936110
34593,11,-9,662,371708,11,371697
34594,8,14,928,1082516,8,1082508
34595,8,-9,936,364624,8,364616
34596,15,-3,522,557862,15,557847
34597,11,-15,525,181589,11,181578
34598,18,2,537,714655,18,714637
34599,14,17,984,1185337,14,1185323
34600,8,4,522,761900,8,761892
34601,20,-6,5,459188,20,459168
34602,8,-4,763,515702,8,515694
34603,20,5,427,806861,20,806841
34604,15,-1,419,619892,15,619877
34605,12,-12,365,275253,12,275241
34606,13,19,266,1242888,13,1242875
34607,7,-3,928,551260,7,551253
34608,7,0,589,638142,7,638135
34609,16,1,903,686872,16,686856
34610,9,19,279,1223672,9,1223663
34611,20,-12,97,273231,20,273211
34612,18,14,268,1087502,18,1087484
34613,13,-19,31,54112,13,54099
34614,8,6,819,830770,8,830762
34615,16,0,666,653344,16,653328
34616,5,-15,852,173591,5,173586
34617,18,-1,92,617288,18,617270
34618,6,16,952,1144959,6,1144953
34619,11,-11,370,306717,11,306706
34620,19,-13,996,248570,19,248551
34621,9,1,143,660308,9,660299
34622,15,-11,521,307875,15,307860
34623,10,9,586,919144,10,919134
34624,9,-1,714,609297,9,609288
34625,11,-11,421,307090,11,307079
34626,8,-10,940,332701,8,332693
34627,9,12,99,1001257,9,1001248
34628,14,3,834,748072,14,748058
34629,16,8,930,905193,16,905177
34630,5,-1,863,612407,5,612402
34631,18,-10,71,335717,18,335699
34632,11,13,408,1056285,11,1056274
34633,5,-18,606,75397,5,75392
34634,20,15,163,1117977,20,1117957
34635,5,15,68,1095889,5,1095884
34636,12,-13,676,245899,12,245887
34637,15,-11,970,311304,15,311289
34638,20,-19,851,60525,20,60505
34639,8,-9,268,349451,8,349443
34640,5,19,587,1230745,5,1230740
34641,10,17,382,1163501,10,1163491
34642,11,19,107,1241623,11,1241612
34643,20,16,893,1153446,20,1153426
34644,12,5,868,810092,12,810080
34645,6,-18,271,68414,6,68408
34646,5,7,981,865557,5,865552
34647,5,-14,427,196072,5,196067
34648,20,-8,496,401280,20,401260
34649,17,13,800,1059266,17,1059249
34650,6,-12,527,261055,6,261049
34651,6,-8,715,390729,6,390723
34652,9,7,702,859679,9,859670
34653,19,-20,818,29154,19,29135
34654,19,17,594,1182263,19,1182244
34655,16,-18,269,87373,16,87357
34656,10,-8,244,380681,10,380671
34657,13,15,953,1123782,13,1123769
34658,17,-3,647,558943,17,558926
34659,7,14,617,1075621,7,1075614
34660,15,-13,278,243141,15,243126
34661,18,12,905,1028976,18,1028958
34662,10,-17,21,94011,10,94001
34663,13,19,182,1242191,13,1242178
34664,20,-15,120,178684,20,178664
34665,5,-19,106,33801,5,33796
34666,18,0,719,653807,18,653789
34667,8,12,762,1015587,8,1015579
34668,15,4,313,775430,15,775415
34669,6,15,480,1104613,6,1104607
34670,14,-14,676,214825,14,214811
34671,20,-17,322,117888,20,117868
34672,16,0,907,655172,16,655156
34673,14,5,737,809173,14,809159
34674,18,19,12,1240755,18,1240737
34675,6,0,349,632752,6,632746
34676,7,-6,609,449918,7,449911
34677,9,-19,833,49651,9,49642
34678,11,-19,175,55434,11,55423
34679,6,-16,721,139514,6,139508
34680,18,-2,998,592693,18,592675
34681,6,-1,166,597301,6,597295
34682,9,3,247,724201,9,724192
34683,15,-20,982,30275,15,30260
34684,10,-10,487,323259,10,323249
34685,11,-1,431,619985,11,619974
34686,8,1,488,667911,8,667903
34687,6,-13,119,220960,6,220954
34688,17,-18,798,91055,17,91038
34689,20,12,366,1024790,20,1024770
34690,10,-3,969,552203,10,552193
34691,10,-16,856,142393,10,142383
34692,8,11,732,984088,8,984080
34693,9,17,79,1157031,9,1157022
34694,8,-13,913,238080,8,238072
34695,9,-5,297,474613,9,474604
34696,11,-10,339,337526,11,337515
34697,16,12,112,1022886,16,1022870
34698,5,12,560,1011106,5,1011101
34699,12,-2,805,591186,12,591174
34700,14,-2,549,589258,14,589244
34701,8,-18,533,73865,8,73857
34702,17,-1,463,620264,17,620247
34703,10,-8,122,377907,10,377897
34704,6,-11,693,296282,6,296276
34705,9,-8,971,396160,9,396151
34706,13,2,891,717135,13,717122
34707,14,19,343,1243521,14,1243507
34708,10,-13,586,230897,10,230887
34709,11,-3,715,559451,11,559440
34710,15,-5,320,493485,15,493470
34711,10,-18,901,81993,10,81983
34712,12,-7,876,434708,12,434696
34713,18,11,217,992356,18,992338
34714,9,-12,895,269091,9,269082
34715,7,18,783,1203292,7,1203285
34716,12,18,447,1212306,12,1212294
34717,20,-1,258,618553,20,618533
34718,11,-16,905,153586,11,153575
34719,16,4,624,777823,16,777807
34720,6,-6,761,453183,6,453177
34721,7,-13,418,227029,7,227022
34722,12,-17,593,119976,12,119964
34723,19,-20,484,26424,19,26405
34724,9,-19,917,51217,9,51208
34725,15,-2,291,587330,15,587315
34726,13,-19,587,58659,13,58646
34727,8,-14,741,202802,8,202794
34728,5,18,287,1193073,5,1193068
34729,6,3,111,721250,6,721244
34730,14,11,888,997309,14,997295
34731,8,9,216,911361,8,911353
34732,16,-11,698,309204,16,309188
34733,20,-3,423,556984,20,556964
34734,19,8,188,899401,19,899382
34735,18,2,937,717433,18,717415
34736,20,-16,854,153178,20,153158
34737,20,2,51,710906,20,710886
34738,18,5,665,808632,18,808614
34739,20,-15,996,185334,20,185314
34740,7,19,288,1223884,7,1223877
34741,20,-3,564,558264,20,558244
34742,9,-6,500,447578,9,447569
34743,11,-16,601,151437,11,151426
34744,7,1,970,678141,7,678134
34745,15,12,882,1028700,15,1028685
34746,19,11,118,991688,19,991669
34747,17,16,934,1153784,17,1153767
34748,6,11,50,969549,6,969543
34749,13,-18,202,86868,13,86855
34750,6,18,337,1194051,6,1194045
34751,8,10,797,954829,8,954821
34752,9,2,963,708805,9,708796
34753,18,-3,762,559899,18,559881
34754,18,3,199,743390,18,743372
34755,10,-12,197,253733,10,253723
34756,5,13,273,1036449,5,1036444
34757,8,7,840,862649,8,862641
34758,12,-9,798,372852,12,372840
34759,10,-5,893,487467,10,487457
34760,6,-17,684,108162,6,108156
34761,19,17,889,1184611,19,1184592
34762,11,-2,621,589817,11,589806
34763,6,-15,664,169703,6,169697
34764,8,8,882,894280,8,894272
34765,20,-7,681,433256,20,433236
34766,5,-8,489,385475,5,385470
34767,9,7,270,850566,9,850557
34768,9,14,439,1071643,9,1071634
34769,20,-5,291,493230,20,493210
34770,14,-7,267,430286,14,430272
34771,19,-13,623,245679,19,245660
34772,5,-3,251,535909,5,535904
34773,18,-9,372,369439,18,369421
34774,12,-20,668,27930,12,27918
34775,14,0,211,649837,14,649823
34776,5,13,416,1039750,5,1039745
34777,13,7,919,873577,13,873564
34778,11,-20,778,28830,11,28819
34779,19,-3,445,557178,19,557159
34780,5,-17,315,100290,5,100285
34781,14,2,658,715529,14,715515
34782,13,3,684,747044,13,747031
34783,16,-12,396,275413,16,275397
34784,13,1,43,680119,13,680106
34785,18,-11,389,306854,18,306836
34786,12,-2,406,588147,12,588135
34787,17,11,739,996120,17,996103
34788,11,11,332,993292,11,993281
34789,11,8,958,905391,11,905380
34790,5,-1,658,608076,5,608071
34791,19,-20,356,25576,19,25557
34792,18,-10,146,336201,18,336183
34793,15,-6,906,465989,15,465974
34794,14,-14,695,214963,14,214949
34795,20,3,952,749119,20,749099
34796,18,-9,934,373977,18,373959
34797,6,3,323,725971,6,725965
34798,8,-7,57,407218,8,407210
34799,8,-6,633,450385,8,450377
34800,8,-18,437,71781,8,71773
34801,5,-13,736,234072,5,234067
34802,12,-19,817,60268,12,60256
34803,13,8,420,901334,13,901321
34804,10,-12,129,252383,10,252373
34805,19,14,709,1091037,19,1091018
34806,13,-20,819,29156,13,29143
34807,11,-4,828,528118,11,528107
34808,19,12,32,1022336,19,1022317
34809,19,5,162,804986,19,804967
34810,9,19,317,1224624,9,1224615
34811,15,-4,745,527625,15,527610
34812,10,15,736,1110162,10,1110152
34813,12,-13,981,248436,12,248424
34814,15,-3,896,560967,15,560952
34815,12,19,182,1242193,12,1242181
34816,11,-12,209,274002,11,273991
34817,6,-10,630,326165,6,326159
34818,9,-20,375,8226,9,8217
34819,16,2,825,716637,16,716621
34820,20,-15,490,181394,20,181374
34821,20,-3,73,554302,20,554282
34822,15,-13,629,245709,15,245694
34823,10,9,264,912164,10,912154
34824,6,19,525,1229471,6,1229465
34825,15,-14,639,214547,15,214532
34826,5,10,777,954252,5,954247
34827,6,14,844,1080770,6,1080764
34828,16,-9,78,367231,16,367215
34829,17,17,262,1179841,17,1179824
34830,13,17,539,1181865,13,1181852
34831,16,15,427,1119789,16,1119773
34832,17,12,951,1029426,17,1029409
34833,18,16,497,1150638,18,1150620
34834,16,-18,872,91559,16,91543
34835,8,-8,742,391242,8,391234
34836,17,-12,333,275009,17,274992
34837,5,1,595,670204,5,670199
34838,5,9,260,912081,5,912076
34839,10,-7,289,412088,10,412078
34840,12,13,640,1058072,12,1058060
34841,12,-1,384,619636,12,619624
34842,20,8,793,904251,20,904231
34843,6,-15,297,161801,6,161795
34844,16,10,356,962506,16,962490
34845,10,-18,30,63048,10,63038
34846,20,-18,501,88959,20,88939
34847,19,0,950,655474,19,655455
34848,5,-16,104,126252,5,126247
34849,15,-12,853,278838,15,278823
34850,16,11,847,996998,16,996982
34851,6,17,410,1164027,6,1164021
34852,15,-17,124,116443,15,116428
34853,15,1,492,683750,15,683735
34854,13,-17,706,120794,13,120781
34855,7,10,809,955065,7,955058
34856,12,-7,793,434029,12,434017
34857,13,1,498,683802,13,683789
34858,13,3,789,747790,13,747777
34859,20,3,927,748855,20,748835
34860,13,-5,746,496493,13,496480
34861,19,-15,737,183301,19,183282
34862,7,5,137,784382,7,784375
34863,14,-15,640,182547,14,182533
34864,14,-6,893,465895,14,465881
34865,13,10,78,960445,13,960432
34866,7,19,597,1230913,7,1230906
34867,7,8,770,892127,7,892120
34868,7,14,480,1072495,7,1072488
34869,14,18,128,1209961,14,1209947
34870,11,15,362,1119417,11,1119406
34871,7,-10,558,324707,7,324700
34872,7,-17,533,104901,7,104894
34873,10,-1,577,606508,10,606498
34874,14,-10,129,336074,14,336060
34875,15,7,298,869152,15,869137
34876,7,-6,468,446830,7,446823
34877,18,10,880,966554,18,966536
34878,15,5,727,809079,15,809064
34879,19,-3,34,554052,19,554033
34880,7,10,627,951030,7,951023
34881,9,0,549,637220,9,637211
34882,6,-14,901,206068,6,206062
34883,8,-17,767,109920,8,109912
34884,5,-15,139,158461,5,158456
34885,5,17,260,1160771,5,1160766
34886,10,3,192,723049,10,723039
34887,18,-13,569,245254,18,245236
34888,16,9,553,933103,16,933087
34889,6,-16,800,141174,6,141168
34890,6,-12,120,252171,6,252165
34891,18,12,54,1022478,18,1022460
34892,15,-15,216,179290,15,179275
34893,11,-20,535,26849,11,26838
34894,16,6,888,842859,16,842843
34895,16,14,395,1088487,16,1088471
34896,16,-12,311,274835,16,274819
34897,9,8,625,888866,9,888857
34898,14,-8,13,397968,14,397954
34899,20,5,268,805816,20,805796
34900,16,3,218,743505,16,743489
34901,18,-1,885,623365,18,623347
34902,19,-6,286,461424,19,461405
34903,17,0,790,654271,17,654254
34904,19,1,743,685663,19,685644
34905,14,18,386,1211904,14,1211890
34906,15,-13,480,244515,15,244500
34907,9,-20,367,8032,9,8023
34908,14,6,546,840167,14,840153
34909,9,0,1,625190,9,625181
34910,10,-19,364,39351,10,39341
34911,5,14,130,1064785,5,1064780
34912,13,-4,882,528697,13,528684
34913,9,-14,899,206011,9,206002
34914,5,14,926,1082462,5,1082457
34915,18,9,731,934409,18,934391
34916,8,0,237,630548,8,630540
34917,5,9,80,908394,5,908389
34918,7,-11,545,293314,7,293307
34919,13,-10,745,340708,13,340695
34920,16,-10,604,339592,16,339576
34921,8,18,778,1203182,8,1203174
34922,18,-17,98,116335,18,116317
34923,17,-18,172,86615,17,86598
34924,12,11,873,997198,12,997186
34925,9,13,946,1050966,9,1050957
34926,11,-18,375,88093,11,88082
34927,11,13,638,1058070,11,1058059
34928,11,14,609,1090148,11,1090137
34929,17,9,125,929993,17,929976
34930,17,19,528,1245170,17,1245153
34931,19,6,436,839259,19,839240
34932,19,-14,983,217152,19,217133
34933,15,-4,679,527235,15,527220
34934,19,-18,980,92344,19,92325
34935,13,-20,218,24469,13,24456
34936,15,19,863,1247778,15,1247763
34937,5,12,121,1001777,5,1001772
34938,5,-6,289,443112,5,443107
34939,11,-13,370,243742,11,243731
34940,8,10,96,939704,8,939696
34941,8,-14,520,197874,8,197866
34942,8,10,509,948375,8,948367
34943,5,-17,344,100871,5,100866
34944,7,6,215,816899,7,816892
34945,15,9,969,936339,15,936324
34946,7,10,721,953040,7,953033
34947,8,-18,130,65358,8,65350
34948,16,13,599,1057797,16,1057781
34949,8,-13,711,233506,8,233498
34950,8,-16,723,139550,8,139542
34951,14,15,174,1118114,14,1118100
34952,17,8,388,901059,17,901042
34953,16,2,963,717674,16,717658
34954,6,12,29,999716,6,999710
34955,18,-18,376,88134,18,88116
34956,15,16,736,1152338,15,1152323
34957,11,-5,804,496825,11,496814
34958,14,16,352,1149693,14,1149679
34959,5,-18,795,79588,5,79583
34960,10,-8,635,388972,10,388962
34961,18,-3,676,559184,18,559166
34962,8,9,56,907969,8,907961
34963,11,6,135,836799,11,836788
34964,15,-11,423,307128,15,307113
34965,18,12,536,1025978,18,1025960
34966,12,-9,748,372364,12,372352
34967,13,0,922,655281,13,655268
34968,12,-3,809,560301,12,560289
34969,6,12,59,1000418,6,1000412
34970,7,-8,298,381685,7,381678
34971,18,7,395,869946,18,869928
34972,10,19,304,1224322,10,1224312
34973,12,5,576,807988,12,807976
34974,8,2,790,705120,8,705112
34975,17,17,962,1185137,17,1185120
34976,8,-6,304,443433,8,443425
34977,15,6,133,836776,15,836761
34978,13,-11,733,309409,13,309396
34979,10,1,784,674048,10,674038
34980,12,-13,73,241581,12,241569
34981,5,-13,863,237026,5,237021
34982,5,7,901,863923,5,863918
34983,6,18,68,1188285,6,1188279
34984,19,15,597,1121132,19,1121113
34985,10,-20,203,4756,10,4746
34986,12,-18,641,89900,12,89888
34987,12,-1,349,619374,12,619362
34988,11,8,7,897956,11,897945
34989,8,-13,716,233665,8,233657
34990,12,-3,534,558046,12,558034
34991,9,-16,643,137950,9,137941
34992,19,3,199,743399,19,743380
34993,18,-15,368,180483,18,180465
34994,9,-9,471,354151,9,354142
34995,20,11,386,993714,20,993694
34996,14,0,627,652973,14,652959
34997,11,-5,835,497078,11,497067
34998,17,8,443,901536,17,901519
34999,17,-19,779,60054,17,60037
35000,8,3,337,726257,8,726249
35001,7,-19,843,50001,7,49994
35002,8,10,963,958138,8,958130
35003,5,-19,948,51885,5,51880
35004,14,-4,15,522152,14,522138
35005,12,-13,423,244080,12,244068
35006,17,-8,823,403760,17,403743
35007,19,13,881,1059827,19,1059808
35008,18,-4,182,523487,18,523469
35009,13,-4,914,528933,13,528920
35010,5,-11,697,296345,5,296340
35011,10,11,144,971460,10,971450
35012,6,-8,670,389781,6,389775
35013,9,-18,262,68164,9,68155
35014,5,0,992,646919,5,646914
35015,19,0,903,655147,19,655128
35016,20,6,686,841284,20,841264
35017,6,11,918,988310,6,988304
35018,12,-9,873,373492,12,373480
35019,6,-5,930,488265,6,488259
35020,20,-17,650,120380,20,120360
35021,11,12,734,1027541,11,1027530
35022,16,-7,166,429533,16,429517
35023,10,9,313,913368,10,913358
35024,16,7,259,868910,16,868894
35025,6,-2,137,565772,6,565766
35026,10,10,693,952457,10,952447
35027,7,-2,377,570716,7,570709
35028,7,-5,150,471339,7,471332
35029,6,1,341,664729,6,664723
35030,10,2,582,700827,10,700817
35031,13,-5,716,496268,13,496255
35032,10,-15,456,165270,10,165260
35033,5,12,286,1005524,5,1005519
35034,14,-5,147,492080,14,492066
35035,17,-15,545,181785,17,181768
35036,13,-19,779,60057,13,60044
35037,5,-19,597,44609,5,44604
35038,16,5,908,810401,16,810385
35039,15,-10,729,340555,15,340540
35040,16,-4,532,526130,16,526114
35041,20,-19,146,55171,20,55151
35042,13,9,741,934473,13,934460
35043,17,-1,515,620669,17,620652
35044,10,11,443,977869,10,977859
35045,11,-3,254,555569,11,555558
35046,6,-7,891,424962,6,424956
35047,16,1,918,687016,16,687000
35048,14,8,329,900565,14,900551
35049,14,18,390,1211917,14,1211903
35050,13,-20,260,24766,13,24753
35051,16,6,557,840250,16,840234
35052,11,-19,705,59478,11,59467
35053,12,15,714,1122081,12,1122069
35054,5,-2,649,576564,5,576559
35055,20,2,368,713371,20,713351
35056,14,-4,127,523015,14,523001
35057,7,-10,709,327915,7,327908
35058,12,-2,135,586109,12,586097
35059,14,-10,635,339841,14,339827
35060,10,4,390,759041,10,759031
35061,9,19,356,1225499,9,1225490
35062,15,-6,923,466127,15,466112
35063,20,-1,709,622046,20,622026
35064,20,8,592,902604,20,902584
35065,5,18,865,1204999,5,1204994
35066,11,14,99,1086253,11,1086242
35067,6,-17,31,94195,6,94189
35068,18,8,178,899327,18,899309
35069,12,14,703,1090965,12,1090953
35070,9,0,395,633946,9,633937
35071,14,13,278,1055237,14,1055223
35072,5,2,339,695954,5,695949
35073,18,-12,705,277702,18,277684
35074,20,-12,471,275975,20,275955
35075,19,5,719,809029,19,809010
35076,6,11,331,975519,6,975513
35077,11,11,422,993938,11,993927
35078,10,15,780,1111015,10,1111005
35079,7,19,865,1236838,7,1236831
35080,19,12,880,1028680,19,1028661
35081,5,15,668,1108599,5,1108594
35082,13,19,203,1242382,13,1242369
35083,13,-5,578,495296,13,495283
35084,9,2,261,694263,9,694254
35085,16,8,777,904122,16,904106
35086,20,-2,372,587858,20,587838
35087,20,0,24,648399,20,648379
35088,9,0,25,625810,9,625801
35089,18,-20,263,24786,18,24768
35090,20,4,449,776475,20,776455
35091,15,6,885,842836,15,842821
35092,9,-4,49,500353,9,500344
35093,10,-12,337,256927,10,256917
35094,17,4,380,775981,17,775964
35095,19,-8,542,401688,19,401669
35096,10,-6,480,447076,10,447066
35097,12,16,793,1152760,12,1152748
35098,10,17,47,1156358,10,1156348
35099,13,-19,696,59417,13,59404
35100,16,7,174,868258,16,868242
35101,18,1,321,682440,18,682422
35102,12,-8,41,398212,12,398200
35103,15,19,19,1240834,15,1240819
35104,17,13,435,1056498,17,1056481
35105,17,-14,509,213456,17,213439
35106,15,12,655,1026908,15,1026893
35107,13,14,375,1088363,13,1088350
35108,8,7,573,857005,8,856997
35109,14,-4,71,522583,14,522569
35110,8,1,92,659009,8,659001
35111,16,9,387,931839,16,931823
35112,17,2,378,713468,17,713451
35113,8,5,964,802059,8,802051
35114,14,-10,33,335405,14,335391
35115,15,-3,497,557619,15,557604
35116,16,0,351,650708,16,650692
35117,16,-4,96,522780,16,522764
35118,14,8,232,899880,14,899866
35119,14,0,179,649598,14,649584
35120,15,13,254,1055058,15,1055043
35121,8,4,153,753866,8,753858
35122,14,-13,544,245034,14,245020
35123,14,15,137,1117828,14,1117814
35124,15,-7,11,428362,15,428347
35125,11,-3,6,553898,11,553887
35126,15,5,550,807795,15,807780
35127,17,-11,874,310558,17,310541
35128,13,-6,204,460729,13,460716
35129,11,-9,99,367356,11,367345
35130,5,-17,33,94244,5,94239
35131,10,12,832,1017190,10,1017180
35132,15,1,82,680409,15,680394
35133,12,-16,362,149554,12,149542
35134,14,-7,67,428774,14,428760
35135,6,-19,160,35244,6,35238
35136,17,5,577,807994,17,807977
35137,5,-19,688,46649,5,46644
35138,13,10,28,960050,13,960037
35139,12,11,358,993458,12,993446
35140,9,13,555,1042682,9,1042673
35141,14,10,563,964189,14,964175
35142,14,-14,801,215825,14,215811
35143,6,13,307,1037280,6,1037274
35144,11,2,733,716097,11,716086
35145,20,17,107,1178617,20,1178597
35146,18,14,767,1091480,18,1091462
35147,17,-11,488,307634,17,307617
35148,12,11,208,992293,12,992281
35149,9,-6,210,441464,9,441455
35150,9,5,94,783578,9,783569
35151,10,9,890,925546,10,925536
35152,6,1,126,659934,6,659928
35153,13,0,583,652673,13,652660
35154,12,16,473,1150484,12,1150472
35155,11,1,489,683710,11,683699
35156,19,-4,873,528599,19,528580
35157,17,-3,881,560826,17,560809
35158,11,-6,108,459867,11,459856
35159,9,-2,45,563856,9,563847
35160,10,0,718,641143,10,641133
35161,14,-5,832,497057,14,497043
35162,7,8,179,878969,7,878962
35163,13,-18,304,87598,13,87585
35164,15,-5,399,493953,15,493938
35165,9,15,409,1103004,9,1102995
35166,9,7,608,857706,9,857697
35167,9,9,930,926508,9,926499
35168,5,-8,505,385910,5,385905
35169,10,14,470,1072297,10,1072287
35170,19,5,89,804470,19,804451
35171,16,-5,947,497994,16,497978
35172,14,11,832,996849,14,996835
35173,6,-7,644,419496,6,419490
35174,12,-16,434,150186,12,150174
35175,19,-3,127,554713,19,554694
35176,14,-20,382,25759,14,25745
35177,5,-9,309,350358,5,350353
35178,10,9,614,919827,10,919817
35179,12,-2,712,590508,12,590496
35180,19,8,433,901404,19,901385
35181,12,0,495,651947,12,651935
35182,16,-1,762,622394,16,622378
35183,16,-13,343,243594,16,243578
35184,15,-7,676,433201,15,433186
35185,11,-5,832,497058,11,497047
35186,20,-10,559,339240,20,339220
35187,5,-4,995,520866,5,520861
35188,15,-19,645,59077,15,59062
35189,18,-1,554,620942,18,620924
35190,19,11,739,996129,19,996110
35191,17,16,102,1147788,17,1147771
35192,16,-18,988,92399,16,92383
35193,13,19,717,1246592,13,1246579
35194,10,-2,695,577685,10,577675
35195,5,11,983,989528,5,989523
35196,12,7,891,873402,12,873390
35197,12,-6,573,463528,12,463516
35198,6,-1,910,613585,6,613579
35199,19,16,548,1150975,19,1150956
35200,13,15,779,1122511,13,1122498
35201,20,12,109,1022851,20,1022831
35202,14,-8,278,399845,14,399831
35203,20,-5,852,497215,20,497195
35204,20,-7,833,434350,20,434330
35205,13,3,824,748018,13,748005
35206,6,-11,887,300162,6,300156
35207,19,17,293,1180167,19,1180148
35208,6,-3,252,535934,6,535928
35209,12,-10,809,341201,12,341189
35210,8,15,66,1095858,8,1095850
35211,16,10,364,962591,16,962575
35212,6,-19,639,45582,6,45576
35213,20,-19,674,59217,20,59197
35214,16,-6,774,465062,16,465046
35215,16,12,682,1027195,16,1027179
35216,19,13,623,1057964,19,1057945
35217,6,9,378,914671,6,914665
35218,8,-8,161,378911,8,378903
35219,5,-9,695,358895,5,358890
35220,12,-10,147,336206,12,336194
35221,19,-19,531,58118,19,58099
35222,10,8,388,883692,10,883682
35223,8,4,980,771887,8,771879
35224,11,8,547,902251,11,902240
35225,5,-14,254,192311,5,192306
35226,11,13,172,1054465,11,1054454
35227,8,19,953,1238632,8,1238624
35228,20,-8,74,398545,20,398525
35229,13,-4,86,522683,13,522670
35230,19,19,43,1241053,19,1241034
35231,17,-4,503,525900,17,525883
35232,17,9,556,933151,17,933134
35233,8,15,47,1095487,8,1095479
35234,18,-6,367,461968,18,461950
35235,12,-19,736,59808,12,59796
35236,13,-10,543,339125,13,339112
35237,7,-14,921,206583,7,206576
35238,10,-20,899,19930,10,19920
35239,11,19,184,1242209,11,1242198
35240,16,-9,856,373342,16,373326
35241,19,14,873,1092259,19,1092240
35242,10,9,846,924797,10,924787
35243,12,-12,318,274879,12,274867
35244,9,11,284,974383,9,974374
35245,14,0,237,650009,14,649995
35246,9,-14,18,186889,9,186880
35247,8,1,200,661555,8,661547
35248,16,18,4,1208938,16,1208922
35249,15,-2,39,585413,15,585398
35250,10,13,112,1033125,10,1033115
35251,20,-10,722,340507,20,340487
35252,7,6,462,822838,7,822831
35253,17,15,38,1117087,17,1117070
35254,13,2,342,713181,13,713168
35255,19,15,571,1120932,19,1120913
35256,18,16,212,1148659,18,1148641
35257,10,-6,757,453054,10,453044
35258,12,-5,161,492195,12,492183
35259,8,15,100,1096607,8,1096599
35260,7,-18,102,64743,7,64736
35261,17,-1,503,620549,17,620532
35262,16,-12,853,278844,16,278828
35263,5,8,331,882504,5,882499
35264,7,-4,550,511336,7,511329
35265,11,14,24,1085547,11,1085536
35266,20,-12,311,274845,20,274825
35267,9,-9,579,356706,9,356697
35268,15,16,829,1153084,15,1153069
35269,12,7,91,867671,12,867659
35270,17,14,384,1088409,17,1088392
35271,11,11,283,992912,11,992901
35272,12,12,959,1029499,12,1029487
35273,8,13,259,1036134,8,1036126
35274,7,1,98,659192,7,659185
35275,20,-4,537,526170,20,526150
35276,8,-8,16,375707,8,375699
35277,10,19,967,1238891,10,1238881
35278,10,-12,306,256289,10,256279
35279,11,11,701,995802,11,995791
35280,10,2,815,705558,10,705548
35281,13,3,417,745003,13,744990
35282,13,-18,117,86084,13,86071
35283,12,15,782,1122522,12,1122510
35284,17,12,258,1024018,17,1024001
35285,10,-20,834,18490,10,18480
35286,10,12,397,1007666,10,1007656
35287,13,-19,546,58248,13,58235
35288,7,-12,556,261602,7,261595
35289,7,9,601,919516,7,919509
35290,19,-6,173,460453,19,460434
35291,8,15,375,1102416,8,1102408
35292,18,1,916,687005,18,686987
35293,10,2,941,708220,10,708210
35294,14,19,882,1247926,14,1247912
35295,7,17,582,1167649,7,1167642
35296,10,3,629,732324,10,732314
35297,7,18,174,1190623,7,1190616
35298,17,14,240,1087302,17,1087285
35299,18,-10,822,341284,18,341266
35300,19,-9,110,367398,19,367379
35301,15,-10,852,341482,15,341467
35302,16,0,338,650580,16,650564
35303,9,-14,207,191079,9,191070
35304,17,-16,719,152201,17,152184
35305,12,13,529,1057121,12,1057109
35306,17,-17,765,121318,17,121301
35307,12,14,467,1089086,12,1089074
35308,18,3,165,743073,18,743055
35309,7,5,706,796331,7,796324
35310,12,-9,707,372009,12,371997
35311,17,-19,105,54762,17,54745
35312,19,10,386,962725,19,962706
35313,15,-15,406,180763,15,180748
35314,17,-14,127,210270,17,210253
35315,8,-6,450,446367,8,446359
35316,13,3,554,745895,13,745882
35317,8,0,65,626705,8,626697
35318,20,-14,505,213388,20,213368
35319,16,-3,211,555255,16,555239
35320,5,-3,11,530837,5,530832
35321,8,16,91,1127054,8,1127046
35322,12,18,888,1215486,12,1215474
35323,14,7,386,869875,14,869861
35324,12,-15,304,179984,12,179972
35325,13,-9,81,367263,13,367250
35326,17,-18,142,86274,17,86257
35327,12,-20,574,27179,12,27167
35328,8,-16,15,124221,8,124213
35329,11,-15,850,184193,11,184182
35330,5,17,948,1175608,5,1175603
35331,11,-13,387,243869,11,243858
35332,9,11,912,988122,9,988113
35333,20,-6,302,461540,20,461520
35334,5,19,618,1231324,5,1231319
35335,15,-3,290,555856,15,555841
35336,15,10,889,966603,15,966588
35337,14,-19,601,58736,14,58722
35338,14,-5,580,495338,14,495324
35339,8,-1,893,613114,8,613106
35340,9,7,330,851888,9,851879
35341,5,-8,630,388773,5,388768
35342,12,16,99,1147760,12,1147748
35343,13,15,909,1123398,13,1123385
35344,10,-9,173,347231,10,347221
35345,7,5,8,781779,7,781772
35346,17,-1,386,619665,17,619648
35347,13,-11,615,308638,13,308625
35348,13,12,460,1025414,13,1025401
35349,7,-19,674,46263,7,46256
35350,15,-6,494,462974,15,462959
35351,17,19,427,1244382,17,1244365
35352,16,-17,961,122562,16,122546
35353,17,15,609,1121232,17,1121215
35354,16,16,634,1151638,16,1151622
35355,14,-6,845,465531,14,465517
35356,17,-20,291,25062,17,25045
35357,13,-12,826,278576,13,278563
35358,15,-20,607,27420,15,27405
35359,17,-4,105,522841,17,522824
35360,9,-4,959,520028,9,520019
35361,13,-14,933,216735,13,216722
35362,18,1,398,683029,18,683011
35363,11,-3,649,558971,11,558960
35364,9,-5,620,481429,9,481420
35365,9,-5,415,477014,9,477005
35366,8,3,170,722431,8,722423
35367,20,17,717,1183249,20,1183229
35368,18,11,90,991499,18,991481
35369,13,-17,185,116812,13,116799
35370,8,-19,998,52846,8,52838
35371,7,-11,376,289542,7,289535
35372,18,-17,20,115706,18,115688
35373,5,-12,665,263984,5,263979
35374,13,4,909,779963,13,779950
35375,5,-3,763,547547,5,547542
35376,20,-15,594,182144,20,182124
35377,15,-4,51,522404,15,522389
35378,14,3,261,743871,14,743857
35379,11,-11,98,304468,11,304457
35380,9,-8,253,380865,9,380856
35381,6,8,487,885872,6,885866
35382,16,-6,89,459732,16,459716
35383,7,14,450,1071831,7,1071824
35384,15,-7,28,428536,15,428521
35385,15,8,761,903975,15,903960
35386,14,2,209,712157,14,712143
35387,19,-1,193,617996,19,617977
35388,13,-17,290,117647,13,117634
35389,20,14,935,1092740,20,1092720
35390,14,15,2,1116734,14,1116720
35391,8,16,59,1126457,8,1126449
35392,11,11,296,993071,11,993060
35393,7,10,127,940458,7,940451
35394,19,-9,701,371979,19,371960
35395,6,-2,174,566396,6,566390
35396,11,14,554,1089770,11,1089759
35397,13,12,539,1026011,13,1025998
35398,16,1,154,681082,16,681066
35399,5,-2,428,571881,5,571876
35400,5,15,10,1094673,5,1094668
35401,19,2,674,715683,19,715664
35402,5,1,87,658900,5,658895
35403,5,5,25,782114,5,782109
35404,6,-13,302,224853,6,224847
35405,15,0,959,655602,15,655587
35406,6,-19,47,32521,6,32515
35407,8,5,772,797765,8,797757
35408,12,-2,866,591740,12,591728
35409,5,-12,738,265372,5,265367
35410,6,0,496,636168,6,636162
35411,6,-12,80,251310,6,251304
35412,6,-4,896,518617,6,518611
35413,18,-19,854,60555,18,60537
35414,12,-10,239,336814,12,336802
35415,16,-16,535,150914,16,150898
35416,16,11,332,993298,16,993282
35417,7,13,973,1051572,7,1051565
35418,20,3,904,748629,20,748609
35419,5,-19,385,39801,5,39796
35420,14,-7,338,430911,14,430897
35421,15,3,840,748126,15,748111
35422,6,-15,353,163053,6,163047
35423,19,-11,548,308142,19,308123
35424,13,-7,138,429303,13,429290
35425,19,-5,603,495490,19,495471
35426,10,19,186,1221651,10,1221641
35427,14,5,648,808527,14,808513
35428,7,-5,410,476895,7,476888
35429,13,-1,693,621898,13,621885
35430,20,14,495,1089328,20,1089308
35431,15,-18,454,88673,15,88658
35432,10,-10,560,324800,10,324790
35433,13,12,586,1026370,13,1026357
35434,13,6,190,837188,13,837175
35435,20,-4,397,525214,20,525194
35436,7,9,690,921287,7,921280
35437,5,18,363,1194546,5,1194541
35438,6,-19,538,43179,6,43173
35439,16,19,525,1245145,16,1245129
35440,16,-17,441,118735,16,118719
35441,19,2,805,716487,19,716468
35442,19,13,770,1059000,19,1058981
35443,9,16,91,1127063,9,1127054
35444,20,-19,911,60882,20,60862
35445,18,-7,225,429987,18,429969
35446,9,7,11,845003,9,844994
35447,8,-8,206,379852,8,379844
35448,12,12,430,1025214,12,1025202
35449,7,19,267,1223394,7,1223387
35450,11,-20,98,23499,11,23488
35451,17,19,553,1245313,17,1245296
35452,10,-17,401,101990,10,101980
35453,12,-9,101,367365,12,367353
35454,9,-2,876,581546,9,581537
35455,7,-4,884,518431,7,518424
35456,8,-10,489,323282,8,323274
35457,6,3,606,731756,6,731750
35458,19,-5,826,496990,19,496971
35459,10,-20,438,9393,10,9383
35460,7,-1,48,594838,7,594831
35461,11,-7,823,434272,11,434261
35462,11,-13,116,241886,11,241875
35463,13,-8,21,398043,13,398030
35464,12,18,435,1212257,12,1212245
35465,20,18,303,1211289,20,1211269
35466,5,-13,707,233414,5,233409
35467,13,-12,648,277272,13,277259
35468,7,3,642,732600,7,732593
35469,7,-14,495,197396,7,197389
35470,17,15,422,1119757,17,1119740
35471,11,17,970,1185206,11,1185195
35472,15,17,104,1178588,15,1178573
35473,7,-6,52,437943,7,437936
35474,18,-6,894,465912,18,465894
35475,8,15,674,1108715,8,1108707
35476,18,10,358,962526,18,962508
35477,8,-20,905,20070,8,20062
35478,9,-17,250,98770,9,98761
35479,11,2,880,717060,11,717049
35480,10,14,182,1065787,10,1065777
35481,11,3,182,743237,11,743226
35482,20,-7,272,430344,20,430324
35483,16,-12,481,276050,16,276034
35484,7,-9,619,357366,7,357359
35485,18,-13,795,246939,18,246921
35486,15,-14,772,215567,15,215552
35487,9,11,442,977853,9,977844
35488,7,5,93,783559,7,783552
35489,17,-14,382,212521,17,212504
35490,15,-20,427,25991,15,25976
35491,12,6,503,839850,12,839838
35492,16,-19,833,60396,16,60380
35493,17,-12,775,278201,17,278184
35494,20,13,864,1059705,20,1059685
35495,7,-4,274,505542,7,505535
35496,8,-8,574,387503,8,387495
35497,14,-9,850,373275,14,373261
35498,16,-13,438,244216,16,244200
35499,6,-3,343,537963,6,537957
35500,9,8,219,879940,9,879931
35501,9,11,428,977627,9,977618
35502,7,7,627,858045,7,858038
35503,17,15,498,1120304,17,1120287
35504,13,-1,890,623378,13,623365
35505,13,-2,489,588836,13,588823
35506,11,-2,826,591390,11,591379
35507,16,-1,143,617604,16,617588
35508,20,9,99,929805,20,929785
35509,18,-5,159,492187,18,492169
35510,19,-19,252,55997,19,55978
35511,8,16,162,1128445,8,1128437
35512,18,-11,380,306791,18,306773
35513,10,19,432,1227535,10,1227525
35514,8,14,224,1066733,8,1066725
35515,14,7,741,872409,14,872395
35516,20,-17,649,120353,20,120333
35517,10,-6,793,453801,10,453791
35518,15,10,776,965830,15,965815
35519,19,-12,891,279177,19,279158
35520,13,3,948,749075,13,749062
35521,19,10,778,965850,19,965831
35522,9,-20,35,846,9,837
35523,12,-9,158,367724,12,367712
35524,6,-5,29,468481,6,468475
35525,5,8,268,881011,5,881006
35526,18,-11,171,305073,18,305055
35527,9,19,999,1239553,9,1239544
35528,7,-11,651,295463,7,295456
35529,15,10,214,961463,15,961448
35530,11,-15,931,184863,11,184852
35531,8,-9,451,353593,8,353585
35532,15,10,922,966939,15,966924
35533,12,-18,892,91695,12,91683
35534,8,-2,899,582026,8,582018
35535,14,5,665,808636,14,808622
35536,6,8,260,880809,6,880803
35537,13,-3,165,554929,13,554916
35538,16,-3,525,557982,16,557966
35539,18,-8,757,403258,18,403240
35540,18,-10,418,338135,18,338117
35541,15,-5,359,493719,15,493704
35542,18,-20,583,27236,18,27218
35543,20,-3,695,559305,20,559285
35544,13,-20,118,23666,13,23653
35545,9,-14,896,205975,9,205966
35546,7,18,666,1200774,7,1200767
35547,9,-20,215,4902,9,4893
35548,16,-9,287,368690,16,368674
35549,11,16,616,1151444,11,1151433
35550,18,-11,961,311250,18,311232
35551,11,18,764,1214487,11,1214476
35552,20,0,390,651035,20,651015
35553,8,6,347,820169,8,820161
35554,12,-8,229,399536,12,399524
35555,15,-17,90,116255,15,116240
35556,5,-11,936,301191,5,301186
35557,13,-4,93,522757,13,522744
35558,15,-7,160,429473,15,429458
35559,9,-12,241,254735,9,254726
35560,12,-4,174,523389,12,523377
35561,17,-13,905,247783,17,247766
35562,19,15,644,1121490,19,1121471
35563,6,-10,290,318796,6,318790
35564,19,13,35,1053477,19,1053458
35565,16,-20,164,24011,16,23995
35566,9,2,99,690793,9,690784
35567,17,-1,268,618651,17,618634
35568,16,-17,376,118265,16,118249
35569,19,0,992,655856,19,655837
35570,9,-20,570,12437,9,12428
35571,16,18,597,1213207,16,1213191
35572,19,-3,995,561713,19,561694
35573,5,7,467,854786,5,854781
35574,14,-9,435,370014,14,370000
35575,10,-2,376,570705,10,570695
35576,8,11,371,976387,8,976379
35577,7,-2,476,572947,7,572940
35578,6,-1,831,611708,6,611702
35579,20,-9,310,368857,20,368837
35580,18,8,909,905069,18,905051
35581,12,5,337,806262,12,806250
35582,5,19,953,1238637,5,1238632
35583,6,16,781,1141319,6,1141313
35584,14,11,462,994216,14,994202
35585,9,15,79,1096125,9,1096116
35586,5,7,673,859102,5,859097
35587,20,-1,511,620618,20,620598
35588,17,16,476,1150530,17,1150513
35589,9,4,948,771339,9,771330
35590,17,16,329,1149496,17,1149479
35591,19,2,937,717442,19,717423
35592,11,8,82,898528,11,898517
35593,5,-4,942,519671,5,519666
35594,10,-7,656,419668,10,419658
35595,14,13,271,1055168,14,1055154
35596,8,8,88,876902,8,876894
35597,5,-11,483,291931,5,291926
35598,8,-14,299,193198,8,193190
35599,9,-9,50,344729,9,344720
35600,18,-14,755,215381,18,215363
35601,11,-18,577,89439,11,89428
35602,11,-8,709,402903,11,402892
35603,15,1,109,680670,15,680655
35604,16,17,735,1183367,16,1183351
35605,20,15,113,1117628,20,1117608
35606,14,11,282,992906,14,992892
35607,7,-3,947,551727,7,551720
35608,17,17,116,1178698,17,1178681
35609,11,1,371,682843,11,682832
35610,20,-7,662,433077,20,433057
35611,5,-7,212,410368,5,410363
35612,7,11,341,975735,7,975728
35613,12,-5,92,491635,12,491623
35614,14,-15,945,184987,14,184973
35615,19,2,103,711365,19,711346
35616,14,-19,23,54054,14,54040
35617,15,17,515,1181768,15,1181753
35618,16,1,51,680189,16,680173
35619,19,9,403,931983,19,931964
35620,10,13,134,1033571,10,1033561
35621,12,19,110,1241642,12,1241630
35622,9,8,17,875520,9,875511
35623,11,-7,797,434058,11,434047
35624,7,5,614,794404,7,794397
35625,6,-1,576,606479,6,606473
35626,16,6,86,836379,16,836363
35627,10,-10,16,312927,10,312917
35628,12,2,255,712509,12,712497
35629,18,-2,397,588063,18,588045
35630,8,19,700,1233022,8,1233014
35631,15,5,299,806006,15,805991
35632,13,15,752,1122403,13,1122390
35633,8,-8,689,390248,8,390240
35634,17,-4,952,529217,17,529200
35635,12,12,431,1025216,12,1025204
35636,14,5,408,806752,14,806738
35637,6,14,740,1078615,6,1078609
35638,20,10,381,962682,20,962662
35639,11,10,710,965337,11,965326
35640,13,15,218,1118458,13,1118445
35641,13,2,765,716286,13,716273
35642,20,-8,781,403446,20,403426
35643,19,-2,209,586659,19,586640
35644,14,-10,454,338420,14,338406
35645,18,11,359,993470,18,993452
35646,6,6,520,824140,6,824134
35647,17,-1,689,621868,17,621851
35648,5,16,689,1139556,5,1139551
35649,13,-19,237,55895,13,55882
35650,20,-9,92,367319,20,367299
35651,17,-6,811,465349,17,465332
35652,6,6,802,830365,6,830359
35653,17,3,537,745750,17,745733
35654,13,17,264,1179873,13,1179860
35655,8,-7,835,423519,8,423511
35656,19,-18,660,90090,19,90071
35657,9,8,30,875735,9,875726
35658,12,17,579,1182118,12,1182106
35659,17,7,617,871532,17,871515
35660,12,5,851,809954,12,809942
35661,15,-6,930,466179,15,466164
35662,17,-10,845,341438,17,341421
35663,9,14,266,1067699,9,1067690
35664,15,-5,873,497423,15,497408
35665,12,-16,105,147693,12,147681
35666,6,-18,861,80989,6,80983
35667,13,2,980,717745,13,717732
35668,13,0,681,653490,13,653477
35669,15,1,354,682699,15,682684
35670,5,1,791,674184,5,674179
35671,14,-4,338,524711,14,524697
35672,11,9,461,932372,11,932361
35673,14,-20,314,25301,14,25287
35674,14,-13,540,245010,14,244996
35675,7,13,269,1036377,7,1036370
35676,14,-7,990,435643,14,435629
35677,17,9,357,931654,17,931637
35678,11,-11,967,311286,11,311275
35679,5,2,53,689738,5,689733
35680,6,-14,145,189626,6,189620
35681,9,19,830,1235886,9,1235877
35682,11,10,987,967361,11,967350
35683,20,18,91,1209653,20,1209633
35684,7,14,854,1080924,7,1080917
35685,16,-16,162,148119,16,148103
35686,16,-15,122,178711,16,178695
35687,13,-1,78,617173,13,617160
35688,7,11,65,969852,7,969845
35689,15,17,595,1182267,15,1182252
35690,10,7,754,860702,10,860692
35691,7,3,839,736872,7,736865
35692,8,-14,955,207249,8,207241
35693,8,-8,204,379829,8,379821
35694,11,8,271,900060,11,900049
35695,17,17,549,1181966,17,1181949
35696,17,-5,537,495020,17,495003
35697,19,-19,369,56863,19,56844
35698,18,-7,231,430024,18,430006
35699,15,-16,327,149368,15,149353
35700,17,-10,206,336577,17,336560
35701,18,18,138,1210077,18,1210059
35702,17,1,964,687354,17,687337
35703,17,14,806,1091776,17,1091759
35704,16,-18,600,89585,16,89569
35705,12,6,793,842117,12,842105
35706,8,14,807,1080063,8,1080055
35707,6,18,553,1198599,6,1198593
35708,9,-6,474,446926,9,446917
35709,7,-10,924,332273,7,332266
35710,18,12,838,1028319,18,1028301
35711,19,7,968,873858,19,873839
35712,20,11,236,992511,20,992491
35713,13,4,134,774223,13,774210
35714,19,3,709,747257,19,747238
35715,8,12,812,1016689,8,1016681
35716,18,19,867,1247819,18,1247801
35717,10,-14,209,191163,10,191153
35718,5,-1,288,600254,5,600249
35719,14,-13,758,246652,14,246638
35720,15,2,450,714009,15,713994
35721,16,5,97,804494,16,804478
35722,14,18,967,1216096,14,1216082
35723,14,14,107,1086335,14,1086321
35724,16,16,354,1149701,16,1149685
35725,15,12,89,1022719,15,1022704
35726,9,10,867,956154,9,956145
35727,17,-10,379,337798,17,337781
35728,19,-4,220,523813,19,523794
35729,8,0,977,646579,8,646571
35730,17,18,9,1208983,17,1208966
35731,18,-1,325,619134,18,619116
35732,11,14,883,1092350,11,1092339
35733,5,-5,590,480810,5,480805
35734,7,0,958,646190,7,646183
35735,16,15,321,1119129,16,1119113
35736,14,-12,643,277232,14,277218
35737,5,12,338,1006585,5,1006580
35738,11,-9,367,369403,11,369392
35739,12,13,284,1055279,12,1055267
35740,14,3,1,741839,14,741825
35741,14,7,80,867611,14,867597
35742,16,-7,94,428940,16,428924
35743,10,-9,81,345425,10,345415
35744,6,17,473,1165420,6,1165414
35745,5,-9,708,359186,5,359181
35746,12,5,776,809402,12,809390
35747,19,7,58,867449,19,867430
35748,6,-14,441,196327,6,196321
35749,18,19,77,1241400,18,1241382
35750,5,-18,197,66755,5,66750
35751,5,0,643,639369,5,639364
35752,10,-17,408,102120,10,102110
35753,15,10,299,962062,15,962047
35754,11,-14,810,215882,11,215871
35755,8,18,648,1200420,8,1200412
35756,18,-13,247,242866,18,242848
35757,5,4,468,760677,5,760672
35758,15,7,423,870155,15,870140
35759,17,6,131,836748,17,836731
35760,7,-17,998,114465,7,114458
35761,10,7,342,852221,10,852211
35762,16,13,668,1058270,16,1058254
35763,20,-3,793,560178,20,560158
35764,10,-16,981,145107,10,145097
35765,14,-11,837,310252,14,310238
35766,19,-19,80,54516,19,54497
35767,18,-3,263,555631,18,555613
35768,16,12,669,1027089,16,1027073
35769,10,9,920,926332,10,926322
35770,20,-3,331,556242,20,556222
35771,11,6,264,837761,11,837750
35772,14,0,615,652912,14,652898
35773,19,13,786,1059115,19,1059096
35774,9,-15,713,170625,9,170616
35775,8,-8,423,384063,8,384055
35776,13,12,791,1027946,13,1027933
35777,7,3,984,740409,7,740402
35778,16,-8,887,404165,16,404149
35779,12,8,905,905032,12,905020
35780,11,-12,48,272824,11,272813
35781,7,6,40,813071,7,813064
35782,9,-3,972,552228,9,552219
35783,15,13,977,1060461,15,1060446
35784,16,-6,683,464321,16,464305
35785,5,7,746,860536,5,860531
35786,17,-13,279,243171,17,243154
35787,11,7,721,872241,11,872230
35788,13,-13,161,242199,13,242186
35789,19,6,853,842571,19,842552
35790,13,-2,674,590193,13,590180
35791,6,-19,316,38314,6,38308
35792,17,17,387,1180822,17,1180805
35793,20,9,757,934563,20,934543
35794,12,6,805,842221,12,842209
35795,11,-19,345,56703,11,56692
35796,17,-9,459,370202,17,370185
35797,7,-10,993,333945,7,333938
35798,12,19,374,1243798,12,1243786
35799,12,12,549,1026087,12,1026075
35800,14,-2,967,592486,14,592472
35801,6,3,294,725279,6,725273
35802,15,-14,363,212248,15,212233
35803,17,-5,113,491771,17,491754
35804,12,-9,174,367779,12,367767
35805,7,18,822,1204115,7,1204108
35806,16,18,63,1209454,16,1209438
35807,16,-11,462,307450,16,307434
35808,12,14,18,1085502,12,1085490
35809,19,12,619,1026640,19,1026621
35810,12,-18,490,88904,12,88892
35811,19,9,142,930115,19,930096
35812,7,-3,915,550970,7,550963
35813,19,-4,132,523069,19,523050
35814,7,19,997,1239506,7,1239499
35815,8,-5,684,482790,8,482782
35816,11,-6,564,463500,11,463489
35817,9,-16,413,132916,9,132907
35818,7,-11,770,297704,7,297697
35819,17,11,663,995556,17,995539
35820,14,8,241,899936,14,899922
35821,9,18,61,1188078,9,1188069
35822,17,5,640,808470,17,808453
35823,16,16,731,1152324,16,1152308
35824,5,12,540,1010737,5,1010732
35825,15,-9,344,369221,15,369206
35826,5,-8,329,382420,5,382415
35827,16,-10,152,336224,16,336208
35828,5,14,62,1063228,5,1063223
35829,8,-18,925,82558,8,82550
35830,5,8,217,879897,5,879892
35831,19,-10,535,339046,19,339027
35832,6,11,552,980267,6,980261
35833,12,-18,693,90255,12,90243
35834,16,12,166,1023266,16,1023250
35835,10,-8,799,392442,10,392432
35836,20,-14,800,215812,20,215792
35837,13,8,174,899311,13,899298
35838,6,1,869,675909,6,675903
35839,12,0,937,655374,12,655362
35840,10,0,604,638426,10,638416
35841,7,-17,350,101023,7,101016
35842,18,5,681,808769,18,808751
35843,17,-6,279,461368,17,461351
35844,11,8,786,904164,11,904153
35845,8,0,51,626379,8,626371
35846,8,-7,619,418986,8,418978
35847,19,-11,969,311300,19,311281
35848,5,17,193,1159356,5,1159351
35849,12,-4,595,526559,12,526547
35850,10,6,742,829070,10,829060
35851,15,11,962,997731,15,997716
35852,15,-2,675,590201,15,590186
35853,17,-19,106,54778,17,54761
35854,14,4,837,779482,14,779468
35855,19,9,26,929239,19,929220
35856,18,-1,197,618021,18,618003
35857,8,-10,366,320491,8,320483
35858,20,-17,668,120556,20,120536
35859,9,13,625,1044248,9,1044239
35860,6,-5,558,480100,6,480094
35861,12,-12,336,275014,12,275002
35862,15,0,403,651120,15,651105
35863,6,-5,351,475841,6,475835
35864,13,2,350,713237,13,713224
35865,19,6,325,838312,19,838293
35866,11,1,65,680260,11,680249
35867,7,-10,529,324010,7,324003
35868,5,0,731,641419,5,641414
35869,11,16,504,1150674,11,1150663
35870,13,18,986,1216207,13,1216194
35871,12,5,681,808771,12,808759
35872,6,-6,937,456785,6,456779
35873,13,-20,253,24706,13,24693
35874,18,-2,652,590051,18,590033
35875,13,-15,124,178727,13,178714
35876,16,6,566,840346,16,840330
35877,14,9,194,930476,14,930462
35878,20,-9,846,373259,20,373239
35879,15,10,693,965245,15,965230
35880,16,5,516,807559,16,807543
35881,12,-19,624,58931,12,58919
35882,11,11,563,994899,11,994888
35883,6,-7,31,406794,6,406788
35884,6,13,966,1051391,6,1051385
35885,11,12,437,1025265,11,1025254
35886,12,19,713,1246545,12,1246533
35887,7,15,530,1105747,7,1105740
35888,10,2,485,698987,10,698977
35889,6,3,955,739585,6,739579
35890,5,18,154,1190162,5,1190157
35891,17,5,198,805325,17,805308
35892,13,-19,511,57936,13,57923
35893,6,19,904,1237642,6,1237636
35894,19,0,192,649724,19,649705
35895,14,-12,385,275338,14,275324
35896,15,-20,670,27951,15,27936
35897,19,6,31,836056,19,836037
35898,16,1,745,685671,16,685655
35899,14,17,543,1181926,14,1181912
35900,15,10,22,960007,15,959992
35901,15,2,408,713743,15,713728
35902,16,16,127,1147945,16,1147929
35903,20,-2,686,590301,20,590281
35904,17,3,654,746795,17,746778
35905,15,9,928,935995,15,935980
35906,7,5,998,802721,7,802714
35907,6,-15,573,167806,6,167800
35908,13,2,122,711516,13,711503
35909,5,-12,217,254190,5,254185
35910,12,-6,634,464004,12,463992
35911,17,18,582,1213160,17,1213143
35912,10,-15,4,155411,10,155401
35913,7,-13,282,224468,7,224461
35914,9,19,608,1231128,9,1231119
35915,8,3,521,729850,8,729842
35916,18,-19,420,57220,18,57202
35917,5,5,568,793349,5,793344
35918,14,11,66,991368,14,991354
35919,6,-15,830,173122,6,173116
35920,12,6,695,841393,12,841381
35921,20,9,120,929933,20,929913
35922,7,-18,457,72262,7,72255
35923,20,11,348,993409,20,993389
35924,20,12,966,1029571,20,1029551
35925,12,-12,515,276347,12,276335
35926,11,4,25,773431,11,773420
35927,18,4,3,773332,18,773314
35928,6,-7,535,417338,6,417332
35929,18,-11,601,308526,18,308508
35930,12,-2,364,587801,12,587789
35931,5,-14,707,202161,5,202156
35932,14,9,669,933980,14,933966
35933,19,-15,480,181330,19,181311
35934,8,9,674,920915,8,920907
35935,9,14,475,1072341,9,1072332
35936,11,-3,539,558086,11,558075
35937,19,16,475,1150521,19,1150502
35938,20,19,17,1240808,20,1240788
35939,6,19,382,1226127,6,1226121
35940,7,5,277,787446,7,787439
35941,15,-13,97,241741,15,241726
35942,19,13,580,1057686,19,1057667
35943,13,10,114,960774,13,960761
35944,5,-6,444,446196,5,446191
35945,11,-17,870,121938,11,121927
35946,11,-7,741,433672,11,433661
35947,10,3,312,725761,10,725751
35948,10,4,959,771529,10,771519
35949,19,12,636,1026751,19,1026732
35950,18,-11,841,310280,18,310262
35951,16,5,227,805527,16,805511
35952,15,6,41,836132,15,836117
35953,7,-20,547,11956,7,11949
35954,15,12,178,1023353,15,1023338
35955,6,-2,301,569279,6,569273
35956,12,17,442,1181240,12,1181228
35957,14,3,176,743158,14,743144
35958,16,15,495,1120285,16,1120269
35959,7,5,267,787245,7,787238
35960,15,-13,557,245132,15,245117
35961,16,11,227,992425,16,992409
35962,10,13,179,1034518,10,1034508
35963,17,9,328,931413,17,931396
35964,19,-1,424,619927,19,619908
35965,12,-3,270,555688,12,555676
35966,7,-1,791,610878,7,610871
35967,9,-17,982,114205,9,114196
35968,15,19,255,1242761,15,1242746
35969,8,-11,336,288516,8,288508
35970,10,9,976,927596,10,927586
35971,11,18,502,1212622,11,1212611
35972,9,-18,944,82899,9,82890
35973,16,-4,164,523324,16,523308
35974,11,15,682,1121766,11,1121755
35975,8,-11,102,283328,8,283320
35976,8,15,51,1095561,8,1095553
35977,11,4,126,774139,11,774128
35978,8,-14,906,206208,8,206200
35979,7,16,979,1145669,7,1145662
35980,14,-4,638,526882,14,526868
35981,6,16,852,1142793,6,1142787
35982,6,-17,317,100335,6,100329
35983,11,12,558,1026129,11,1026118
35984,15,19,191,1242270,15,1242255
35985,8,-1,883,612922,8,612914
35986,11,-10,429,338197,11,338186
35987,13,-16,518,150819,13,150806
35988,12,-8,807,403652,12,403640
35989,6,11,862,986907,6,986901
35990,20,-20,310,25260,20,25240
35991,10,18,418,1195675,10,1195665
35992,17,-18,204,86885,17,86868
35993,14,-1,979,623972,14,623958
35994,9,10,665,951901,9,951892
35995,10,12,140,1002162,10,1002152
35996,5,-9,161,347007,5,347002
35997,17,-15,858,184277,17,184260
35998,16,-3,669,559128,16,559112
35999,5,-5,280,474185,5,474180
36000,14,-14,259,211471,14,211457
36001,14,0,175,649561,14,649547
36002,5,16,280,1131128,5,1131123
36003,7,7,693,859489,7,859482
36004,17,-13,91,241691,17,241674
36005,9,17,985,1176531,9,1176522
36006,6,14,739,1078590,6,1078584
36007,19,-20,401,25861,19,25842
36008,7,1,903,676653,7,676646
36009,11,6,163,836965,11,836954
36010,5,10,191,941621,5,941616
36011,7,-11,367,289288,7,289281
36012,6,5,177,785275,6,785269
36013,11,-9,851,373312,11,373301
36014,19,9,566,933238,19,933219
36015,11,4,154,774366,11,774355
36016,15,-3,424,557007,15,556992
36017,15,7,137,868045,15,868030
36018,17,-1,982,624020,17,624003
36019,5,-12,616,262797,5,262792
36020,12,4,693,778321,12,778309
36021,7,17,426,1164337,7,1164330
36022,19,-5,963,498102,19,498083
36023,15,-18,854,91400,15,91385
36024,16,9,792,934925,16,934909
36025,19,-7,469,431872,19,431853
36026,16,16,682,1151986,16,1151970
36027,20,-16,61,147266,20,147246
36028,16,-19,358,56792,16,56776
36029,5,-3,437,540144,5,540139
36030,18,16,961,1153957,18,1153939
36031,11,3,790,747809,11,747798
36032,19,-2,45,585485,19,585466
36033,11,9,266,930860,11,930849
36034,13,-3,610,558615,13,558602
36035,5,-18,123,65203,5,65198
36036,8,18,648,1200428,8,1200420
36037,6,19,589,1230788,6,1230782
36038,14,-11,550,308158,14,308144
36039,16,-13,65,241520,16,241504
36040,5,0,321,632030,5,632025
36041,20,-9,214,368070,20,368050
36042,10,-19,625,45262,10,45252
36043,20,6,628,840844,20,840824
36044,19,11,384,993693,19,993674
36045,14,15,369,1119473,14,1119459
36046,11,5,436,806935,11,806924
36047,15,18,877,1215345,15,1215330
36048,14,9,156,930217,14,930203
36049,19,-19,79,54508,19,54489
36050,7,-3,86,532234,7,532227
36051,10,2,886,707084,10,707074
36052,7,18,93,1188775,7,1188768
36053,15,11,569,994955,15,994940
36054,11,-16,597,151380,11,151369
36055,12,15,770,1122471,12,1122459
36056,17,-13,562,245172,17,245155
36057,17,-8,724,403018,17,403001
36058,19,8,12,897988,19,897969
36059,8,-9,98,345719,8,345711
36060,14,1,618,684697,14,684683
36061,18,2,384,713504,18,713486
36062,14,-9,422,369873,14,369859
36063,18,2,159,711806,18,711788
36064,12,0,444,651454,12,651442
36065,7,-16,69,125305,7,125298
36066,8,-16,533,135623,8,135615
36067,6,-7,379,414142,6,414136
36068,17,17,928,1184852,17,1184835
36069,9,15,418,1103123,9,1103114
36070,5,-17,877,112054,5,112049
36071,12,3,510,745622,12,745610
36072,16,19,346,1243544,16,1243528
36073,10,17,437,1164595,10,1164585
36074,8,3,540,730161,8,730153
36075,13,-3,466,557360,13,557347
36076,16,-4,233,523936,16,523920
36077,10,2,942,708247,10,708237
36078,15,-16,106,147710,15,147695
36079,10,2,1000,709502,10,709492
36080,19,9,587,933411,19,933392
36081,20,1,15,679858,20,679838
36082,18,-6,80,459638,18,459620
36083,7,-10,889,331640,7,331633
36084,7,-3,940,551544,7,551537
36085,15,7,94,867687,15,867672
36086,6,-4,104,501628,6,501622
36087,14,1,81,680385,14,680371
36088,16,-20,986,30340,16,30324
36089,15,-16,310,149227,15,149212
36090,16,-12,16,272624,16,272608
36091,17,-13,505,244758,17,244741
36092,20,-3,475,557434,20,557414
36093,8,8,611,888523,8,888515
36094,19,-17,72,116035,19,116016
36095,11,-17,545,119592,11,119581
36096,12,-11,37,303923,12,303911
36097,14,-13,646,245746,14,245732
36098,15,-2,447,588485,15,588470
36099,6,-18,776,79233,6,79227
36100,8,4,520,761834,8,761826
36101,17,11,880,997249,17,997232
36102,16,0,167,649496,16,649480
36103,9,6,975,834244,9,834235
36104,14,-9,150,367664,14,367650
36105,20,-3,359,556441,20,556421
36106,12,-5,207,492475,12,492463
36107,17,4,625,777829,17,777812
36108,14,19,1,1240611,14,1240597
36109,13,9,194,930479,13,930466
36110,15,-17,448,118802,15,118787
36111,10,-10,508,323710,10,323700
36112,5,-8,263,381036,5,381031
36113,19,-14,107,210149,19,210130
36114,10,16,19,1125600,10,1125590
36115,18,18,167,1210292,18,1210274
36116,17,-3,158,554874,17,554857
36117,20,8,329,900575,20,900555
36118,6,-16,286,130190,6,130184
36119,8,15,464,1104266,8,1104258
36120,18,8,980,905581,18,905563
36121,15,12,870,1028636,15,1028621
36122,5,11,173,971978,5,971973
36123,10,14,269,1067794,10,1067784
36124,20,8,892,904882,20,904862
36125,12,-13,385,243841,12,243829
36126,19,18,511,1212725,19,1212706
36127,9,-20,149,3304,9,3295
36128,19,1,119,680751,19,680732
36129,13,-17,251,117322,13,117309
36130,10,18,505,1197518,10,1197508
36131,8,7,598,857514,8,857506
36132,5,-6,268,442655,5,442650
36133,17,-20,496,26529,17,26512
36134,13,-8,409,400792,13,400779
36135,5,-4,298,505979,5,505974
36136,19,-15,701,182964,19,182945
36137,16,-20,177,24157,16,24141
36138,7,-9,890,363608,7,363601
36139,17,1,840,686340,17,686323
36140,5,3,160,722216,5,722211
36141,18,-9,412,369772,18,369754
36142,20,-5,410,494036,20,494016
36143,17,-19,569,58499,17,58482
36144,8,18,372,1194736,8,1194728
36145,5,2,936,708113,5,708108
36146,13,15,968,1123904,13,1123891
36147,20,-13,877,247592,20,247572
36148,15,14,769,1091508,15,1091493
36149,20,-17,304,117781,20,117761
36150,18,-18,171,86587,18,86569
36151,6,-9,305,350254,6,350248
36152,14,5,606,808233,14,808219
36153,8,-13,848,236729,8,236721
36154,8,11,649,982287,8,982279
36155,16,-3,856,560612,16,560596
36156,5,8,893,894513,5,894508
36157,7,0,263,631082,7,631075
36158,8,7,142,847861,8,847853
36159,11,-15,589,182103,11,182092
36160,8,7,415,853709,8,853701
36161,10,16,24,1125703,10,1125693
36162,9,15,822,1111858,9,1111849
36163,5,-12,341,257060,5,257055
36164,9,-8,110,377677,9,377668
36165,11,-18,536,89158,11,89147
36166,19,16,724,1152261,19,1152242
36167,19,14,628,1090305,19,1090286
36168,10,15,574,1106636,10,1106626
36169,16,-11,200,305319,16,305303
36170,10,-8,516,386169,10,386159
36171,16,6,484,839664,16,839648
36172,14,8,484,901777,14,901763
36173,7,17,469,1165368,7,1165361
36174,15,-19,167,55350,15,55335
36175,12,17,83,1178469,12,1178457
36176,19,13,734,1058703,19,1058684
36177,5,6,596,825812,5,825807
36178,5,1,343,664740,5,664735
36179,7,5,254,786931,7,786924
36180,13,11,667,995573,13,995560
36181,13,-4,230,523893,13,523880
36182,13,13,644,1058099,13,1058086
36183,6,-6,748,452905,6,452899
36184,17,18,947,1215924,17,1215907
36185,6,18,227,1191759,6,1191753
36186,17,16,140,1148083,17,1148066
36187,11,-20,184,24232,11,24221
36188,7,3,220,723574,7,723567
36189,18,-4,512,526003,18,525985
36190,15,15,444,1119936,15,1119921
36191,12,-1,439,620020,12,620008
36192,15,17,954,1185032,15,1185017
36193,13,9,794,934943,13,934930
36194,11,-15,40,178086,11,178075
36195,9,1,765,673663,9,673654
36196,7,2,291,694944,7,694937
36197,15,18,57,1209380,15,1209365
36198,14,-10,792,341039,14,341025
36199,15,-12,318,274884,15,274869
36200,20,8,110,898797,20,898777
36201,9,16,357,1132759,9,1132750
36202,15,-17,743,121156,15,121141
36203,14,8,640,903068,14,903054
36204,7,-10,341,319979,7,319972
36205,17,-17,424,118589,17,118572
36206,10,-19,466,41523,10,41513
36207,17,-15,449,181090,17,181073
36208,20,-13,140,242025,20,242005
36209,14,-8,171,399132,14,399118
36210,6,6,175,815964,6,815958
36211,15,-2,769,590882,15,590867
36212,12,2,485,714277,12,714265
36213,10,10,883,956489,10,956479
36214,11,-5,834,497078,11,497067
36215,7,-1,89,595741,7,595734
36216,20,18,683,1213911,20,1213891
36217,14,11,372,993590,14,993576
36218,20,-5,164,492245,20,492225
36219,16,-15,487,181354,16,181338
36220,19,-14,722,215146,19,215127
36221,15,-12,1000,280121,15,280106
36222,14,-11,509,307807,14,307793
36223,12,14,522,1089526,12,1089514
36224,11,-12,943,279617,11,279606
36225,10,-1,265,599650,10,599640
36226,15,-20,933,29891,15,29876
36227,12,-1,599,621244,12,621232
36228,9,-14,595,199719,9,199710
36229,14,14,978,1093136,14,1093122
36230,8,-20,320,7148,8,7140
36231,8,12,185,1003234,8,1003226
36232,12,-10,17,335276,12,335264
36233,7,-13,637,231944,7,231937
36234,17,-16,293,149111,17,149094
36235,9,12,576,1011433,9,1011424
36236,20,0,959,655612,20,655592
36237,11,-7,617,432850,11,432839
36238,11,-11,193,305257,11,305246
36239,8,-1,661,608149,8,608141
36240,14,0,195,649737,14,649723
36241,14,10,256,961747,14,961733
36242,7,-3,659,545327,7,545320
36243,7,-4,79,501063,7,501056
36244,5,13,659,1044991,5,1044986
36245,8,4,300,756982,8,756974
36246,7,-6,412,445570,7,445563
36247,5,-19,705,47001,5,46996
36248,12,-8,711,402913,12,402901
36249,8,13,229,1035589,8,1035581
36250,13,17,924,1184839,13,1184826
36251,7,-6,856,455089,7,455082
36252,16,15,953,1123788,16,1123772
36253,19,-8,569,401876,19,401857
36254,15,-7,243,430082,15,430067
36255,14,-20,661,27884,14,27870
36256,15,7,979,873975,15,873960
36257,10,8,246,880626,10,880616
36258,19,11,726,996063,19,996044
36259,11,10,187,961272,11,961261
36260,19,-6,447,462540,19,462521
36261,9,-10,308,319198,9,319189
36262,14,17,133,1178850,14,1178836
36263,15,3,569,746059,15,746044
36264,19,17,482,1181536,19,1181517
36265,7,8,564,887603,7,887596
36266,16,17,91,1178523,16,1178507
36267,20,-8,244,399637,20,399617
36268,13,-8,553,401760,13,401747
36269,9,13,991,1051885,9,1051876
36270,19,-3,365,556461,19,556442
36271,13,19,276,1242964,13,1242951
36272,15,-13,495,244654,15,244639
36273,20,-12,858,278902,20,278882
36274,19,1,325,682488,19,682469
36275,10,6,217,816972,10,816962
36276,12,-20,707,28233,12,28221
36277,20,15,790,1122575,20,1122555
36278,9,19,149,1220760,9,1220751
36279,15,-1,879,623323,15,623308
36280,11,-8,912,404376,11,404365
36281,20,0,39,648543,20,648523
36282,7,12,216,1003851,7,1003844
36283,17,-7,693,433345,17,433328
36284,6,-6,360,444434,6,444428
36285,16,-6,945,466300,16,466284
36286,5,-15,315,162197,5,162192
36287,15,14,533,1089636,15,1089621
36288,19,-16,76,147430,19,147411
36289,18,-11,51,304039,18,304021
36290,19,-1,786,622617,19,622598
36291,17,4,700,778363,17,778346
36292,12,-10,875,341667,12,341655
36293,5,8,878,894219,5,894214
36294,18,-14,383,212537,18,212519
36295,15,10,675,965129,15,965114
36296,15,0,985,655812,15,655797
36297,12,-8,241,399606,12,399594
36298,15,9,812,935042,15,935027
36299,18,-7,481,431948,18,431930
36300,14,11,162,992006,14,991992
36301,6,10,22,937994,6,937988
36302,7,18,12,1186841,7,1186834
36303,15,3,142,742903,15,742888
36304,8,-2,202,567085,8,567077
36305,13,12,221,1023686,13,1023673
36306,6,5,155,784751,6,784745
36307,15,14,425,1088806,15,1088791
36308,5,3,478,729066,5,729061
36309,13,-13,192,242466,13,242453
36310,15,-9,35,366867,15,366852
36311,8,-7,813,423031,8,423023
36312,9,14,223,1066706,9,1066697
36313,9,10,918,957279,9,957270
36314,20,-13,361,243690,20,243670
36315,17,-3,472,557419,17,557402
36316,11,-6,521,463187,11,463176
36317,6,-6,185,440921,6,440915
36318,20,5,713,808995,20,808975
36319,10,4,389,759022,10,759012
36320,11,-18,262,87342,11,87331
36321,9,1,270,663120,9,663111
36322,11,-16,742,152315,11,152304
36323,7,7,545,856404,7,856397
36324,15,6,285,837952,15,837937
36325,5,2,256,694131,5,694126
36326,10,7,698,859589,10,859579
36327,13,4,705,778398,13,778385
36328,9,9,662,920678,9,920669
36329,6,-9,70,345078,6,345072
36330,16,0,372,650883,16,650867
36331,6,-8,417,383962,6,383956
36332,13,6,81,836317,13,836304
36333,16,-5,430,494167,16,494151
36334,17,5,159,804930,17,804913
36335,11,-4,145,523132,11,523121
36336,9,-2,960,583402,9,583393
36337,8,11,94,970466,8,970458
36338,15,-19,629,58965,15,58950
36339,19,-6,533,463259,19,463240
36340,19,15,659,1121633,19,1121614
36341,14,-10,168,336362,14,336348
36342,13,13,60,1053657,13,1053644
36343,7,-18,49,63402,7,63395
36344,14,-4,570,526393,14,526379
36345,6,-2,65,564276,6,564270
36346,16,5,382,806593,16,806577
36347,15,9,342,931512,15,931497
36348,15,4,740,778703,15,778688
36349,18,-17,56,115944,18,115926
36350,7,-20,873,19397,7,19390
36351,19,-11,245,305616,19,305597
36352,11,5,938,810674,11,810663
36353,8,-19,948,51893,8,51885
36354,19,-7,875,434696,19,434677
36355,17,10,575,964329,17,964312
36356,12,-8,261,399737,12,399725
36357,19,-10,664,340111,19,340092
36358,14,-1,650,621601,14,621587
36359,11,-14,617,214363,11,214352
36360,9,7,817,862098,9,862089
36361,10,5,193,785740,10,785730
36362,5,10,932,957609,5,957604
36363,8,6,664,827298,8,827290
36364,12,-14,206,210917,12,210905
36365,12,6,483,839651,12,839639
36366,11,4,642,777919,11,777908
36367,7,14,463,1072148,7,1072141
36368,11,15,489,1120267,11,1120256
36369,11,16,855,1153197,11,1153186
36370,14,-17,572,119835,14,119821
36371,6,-10,523,323899,6,323893
36372,20,-7,408,431431,20,431411
36373,14,13,839,1059522,14,1059508
36374,19,-4,508,525960,19,525941
36375,7,5,872,799962,7,799955
36376,16,14,885,1092389,16,1092373
36377,9,7,784,861360,9,861351
36378,16,9,518,932875,16,932859
36379,16,-11,702,309230,16,309214
36380,13,1,511,683885,13,683872
36381,12,16,866,1153255,12,1153243
36382,9,-5,529,479540,9,479531
36383,18,17,584,1182168,18,1182150
36384,6,-8,497,385701,6,385695
36385,16,-12,622,277044,16,277028
36386,15,-8,136,398846,15,398831
36387,9,-4,154,502720,9,502711
36388,12,9,379,931810,12,931798
36389,8,-4,415,508649,8,508641
36390,11,-4,985,529533,11,529522
36391,20,11,37,991145,20,991125
36392,5,-2,321,569657,5,569652
36393,16,-20,254,24726,16,24710
36394,9,-4,857,517700,9,517691
36395,12,-20,399,25834,12,25822
36396,15,14,231,1087229,15,1087214
36397,18,-9,60,367098,18,367080
36398,6,18,373,1194751,6,1194745
36399,13,-17,426,118603,13,118590
36400,15,15,296,1118975,15,1118960
36401,9,10,967,958185,9,958176
36402,14,8,900,904974,14,904960
36403,10,17,653,1169277,10,1169267
36404,6,-5,190,472208,6,472202
36405,5,-12,160,253009,5,253004
36406,18,15,260,1118701,18,1118683
36407,12,-15,572,182003,12,181991
36408,20,3,117,742710,20,742690
36409,12,0,438,651403,12,651391
36410,11,-8,493,401269,11,401258
36411,15,12,558,1026134,15,1026119
36412,9,8,261,880835,9,880826
36413,20,17,964,1185148,20,1185128
36414,6,-16,581,136626,6,136620
36415,6,2,329,695722,6,695716
36416,16,8,758,903949,16,903933
36417,9,-20,350,7712,9,7703
36418,20,-12,521,276390,20,276370
36419,14,-17,754,121234,14,121220
36420,8,-12,428,258838,8,258830
36421,12,18,288,1211227,12,1211215
36422,10,-13,898,237708,10,237698
36423,16,-11,57,304123,16,304107
36424,7,-7,306,412441,7,412434
36425,5,19,809,1235445,5,1235440
36426,19,-14,469,213132,19,213113
36427,7,10,994,958737,7,958730
36428,20,19,359,1243686,20,1243666
36429,11,6,413,839101,11,839090
36430,11,7,308,869248,11,869237
36431,5,-19,693,46762,5,46757
36432,15,-10,31,335392,15,335377
36433,19,18,76,1209541,19,1209522
36434,9,-18,930,82685,9,82676
36435,14,-16,551,151049,14,151035
36436,12,4,628,777837,12,777825
36437,9,14,413,1071032,9,1071023
36438,14,18,103,1209767,14,1209753
36439,5,18,532,1198202,5,1198197
36440,7,-6,652,450773,7,450766
36441,6,19,11,1217677,6,1217671
36442,9,-3,294,536816,9,536807
36443,8,-19,740,47874,8,47866
36444,10,-13,874,237295,10,237285
36445,14,-17,501,119242,14,119228
36446,6,2,800,705254,6,705248
36447,18,19,732,1246729,18,1246711
36448,18,-6,577,463556,18,463538
36449,7,-3,459,540720,7,540713
36450,7,-18,735,78256,7,78249
36451,6,4,46,751547,6,751541
36452,13,-17,476,119004,13,118991
36453,14,-6,21,459308,14,459294
36454,11,0,524,652146,11,652135
36455,10,-11,118,283729,10,283719
36456,13,-9,757,372492,13,372479
36457,16,7,772,872592,16,872576
36458,15,-14,134,210351,15,210336
36459,20,-15,299,179962,20,179942
36460,19,14,861,1092149,19,1092130
36461,18,-4,289,524318,18,524300
36462,10,-13,881,237439,10,237429
36463,16,15,674,1121720,16,1121704
36464,8,3,974,740220,8,740212
36465,19,16,24,1147264,19,1147245
36466,15,18,959,1216022,15,1216007
36467,7,-8,883,394174,7,394167
36468,14,-14,345,212083,14,212069
36469,14,2,648,715424,14,715410
36470,9,5,979,802309,9,802300
36471,6,9,525,917869,6,917863
36472,20,-1,396,619717,20,619697
36473,13,-13,101,241821,13,241808
36474,11,13,63,1053685,11,1053674
36475,8,4,240,755921,8,755913
36476,14,17,15,1177946,14,1177932
36477,13,-17,235,117190,13,117177
36478,14,5,826,809797,14,809783
36479,10,1,929,677256,10,677246
36480,7,8,832,893261,7,893254
36481,16,-12,226,274189,16,274173
36482,19,-1,672,621736,19,621717
36483,18,3,361,744608,18,744590
36484,18,-19,564,58457,18,58439
36485,14,-18,347,87941,14,87927
36486,7,17,985,1176538,7,1176531
36487,13,10,910,966826,13,966813
36488,19,15,361,1119417,19,1119398
36489,8,5,932,801257,8,801249
36490,13,-5,629,495655,13,495642
36491,19,-7,751,433723,19,433704
36492,12,-11,306,306192,12,306180
36493,12,6,482,839644,12,839632
36494,9,6,92,814190,9,814181
36495,8,5,525,792553,8,792545
36496,19,-10,310,337317,19,337298
36497,19,14,614,1090193,19,1090174
36498,18,-15,807,183795,18,183777
36499,8,-20,726,15975,8,15967
36500,20,13,327,1055635,20,1055615
36501,18,-7,763,433844,18,433826
36502,11,-18,844,91314,11,91303
36503,16,-5,887,497538,16,497522
36504,19,-3,63,554207,19,554188
36505,6,-13,355,225784,6,225778
36506,11,-8,360,400400,11,400389
36507,20,9,735,934459,20,934439
36508,18,-13,889,247683,18,247665
36509,10,-13,974,239452,10,239442
36510,8,-14,623,200405,8,200397
36511,16,-19,318,56432,16,56416
36512,17,5,789,809514,17,809497
36513,10,6,71,813719,10,813709
36514,9,3,817,736419,9,736410
36515,9,-13,494,228766,9,228757
36516,16,19,995,1248740,16,1248724
36517,20,4,447,776451,20,776431
36518,20,4,562,777323,20,777303
36519,20,17,387,1180832,20,1180812
36520,6,-14,567,198925,6,198919
36521,6,-5,895,487544,6,487538
36522,17,19,954,1248466,17,1248449
36523,5,-17,859,111620,5,111615
36524,14,-17,255,117354,14,117340
36525,12,7,734,872386,12,872374
36526,18,8,162,899232,18,899214
36527,16,-15,66,178251,16,178235
36528,18,-16,516,150809,18,150791
36529,8,-4,300,506027,8,506019
36530,15,19,639,1245977,15,1245962
36531,18,16,652,1151798,18,1151780
36532,5,-18,745,78496,5,78491
36533,18,11,652,995473,18,995455
36534,8,-15,769,171867,8,171859
36535,5,-10,351,320217,5,320212
36536,12,-5,553,495108,12,495096
36537,15,-4,24,522227,15,522212
36538,13,-11,598,308493,13,308480
36539,8,8,696,890489,8,890481
36540,6,3,21,719274,6,719268
36541,18,-6,690,464426,18,464408
36542,18,-12,834,278678,18,278660
36543,10,-14,121,189086,10,189076
36544,6,1,703,672299,6,672293
36545,20,-13,465,244383,20,244363
36546,11,-1,170,617822,11,617811
36547,6,12,411,1007880,6,1007874
36548,9,-1,22,594173,9,594164
36549,8,13,3,1030926,8,1030918
36550,13,13,572,1057574,13,1057561
36551,13,-6,289,461426,13,461413
36552,11,-17,615,120112,11,120101
36553,20,-16,960,154012,20,153992
36554,8,-20,866,19258,8,19250
36555,9,-17,862,111676,9,111667
36556,18,12,702,1027360,18,1027342
36557,6,-12,29,250233,6,250227
36558,15,-13,680,245949,15,245934
36559,17,12,272,1024151,17,1024134
36560,20,0,788,654256,20,654236
36561,14,0,427,651353,14,651339
36562,12,3,835,748080,12,748068
36563,19,5,228,805540,19,805521
36564,12,1,440,683292,12,683280
36565,12,12,553,1026097,12,1026085
36566,19,-9,932,373943,19,373924
36567,17,-6,739,464813,17,464796
36568,7,-2,438,572109,7,572102
36569,9,5,227,786417,9,786408
36570,15,0,628,652983,15,652968
36571,9,6,994,834619,9,834610
36572,19,10,264,961816,19,961797
36573,11,6,767,841921,11,841910
36574,18,2,459,714101,18,714083
36575,13,-9,758,372511,13,372498
36576,17,-9,552,371103,17,371086
36577,14,11,182,992097,14,992083
36578,15,3,228,743603,15,743588
36579,18,-15,239,179483,18,179465
36580,5,-13,203,222723,5,222718
36581,16,-1,109,617409,16,617393
36582,12,9,993,936481,12,936469
36583,16,-2,391,587982,16,587966
36584,15,-8,646,402417,15,402402
36585,9,-10,574,325040,9,325031
36586,7,-11,815,298524,7,298517
36587,10,-10,495,323412,10,323402
36588,14,8,587,902567,14,902553
36589,19,-14,875,216317,19,216298
36590,9,-16,273,129950,9,129941
36591,7,-17,426,102503,7,102496
36592,14,-4,696,527331,14,527317
36593,17,18,748,1214378,17,1214361
36594,14,3,246,743720,14,743706
36595,5,-14,766,203425,5,203420
36596,15,19,778,1247084,15,1247069
36597,13,-14,123,210248,13,210235
36598,13,-19,422,57237,13,57224
36599,18,-12,985,279986,18,279968
36600,16,-15,746,183329,16,183313
36601,19,18,77,1209556,19,1209537
36602,20,5,515,807554,20,807534
36603,14,2,574,714885,14,714871
36604,11,-19,618,58871,11,58860
36605,14,-4,421,525374,14,525360
36606,15,-1,970,623910,15,623895
36607,14,-14,937,216782,14,216768
36608,20,15,321,1119139,20,1119119
36609,6,-19,585,44370,6,44364
36610,10,6,441,822407,10,822397
36611,5,14,821,1080348,5,1080343
36612,14,5,832,809849,14,809835
36613,12,-13,225,242702,12,242690
36614,6,-20,498,10699,6,10693
36615,9,-13,885,237499,9,237490
36616,15,10,848,966306,15,966291
36617,6,-7,330,413038,6,413032
36618,7,18,782,1203272,7,1203265
36619,20,8,903,904999,20,904979
36620,9,-10,482,323172,9,323163
36621,13,-20,545,26962,13,26949
36622,17,0,52,648642,17,648625
36623,19,-3,528,557995,19,557976
36624,17,17,385,1180780,17,1180763
36625,20,17,31,1178103,20,1178083
36626,14,9,906,935803,14,935789
36627,8,9,115,909192,8,909184
36628,10,7,621,857954,10,857944
36629,5,-16,946,144310,5,144305
36630,18,11,434,994037,18,994019
36631,9,-14,335,194003,9,193994
36632,5,-15,997,176767,5,176762
36633,20,0,630,653006,20,652986
36634,15,-13,553,245104,15,245089
36635,19,10,410,962963,19,962944
36636,14,14,620,1090244,14,1090230
36637,12,-11,556,308186,12,308174
36638,15,5,412,806763,15,806748
36639,14,11,623,995299,14,995285
36640,18,-4,181,523467,18,523449
36641,5,10,882,956463,5,956458
36642,17,14,395,1088494,17,1088477
36643,18,17,818,1184088,18,1184070
36644,20,-8,948,404616,20,404596
36645,8,19,764,1234407,8,1234399
36646,5,-17,309,100198,5,100193
36647,16,16,957,1153905,16,1153889
36648,17,-2,667,590158,17,590141
36649,14,-13,807,247048,14,247034
36650,16,-17,479,119034,16,119018
36651,18,-11,999,311515,18,311497
36652,10,-15,701,170360,10,170350
36653,5,-10,204,317025,5,317020
36654,16,18,467,1212415,16,1212399
36655,13,7,454,870422,13,870409
36656,10,8,435,884713,10,884703
36657,9,16,52,1126241,9,1126232
36658,18,7,711,872170,18,872152
36659,14,-19,395,57092,14,57078
36660,15,-11,712,309287,15,309272
36661,9,11,402,977162,9,977153
36662,12,1,732,685558,12,685546
36663,11,-11,94,304419,11,304408
36664,20,-10,295,337172,20,337152
36665,9,-13,935,238611,9,238602
36666,9,-8,652,389343,9,389334
36667,5,-14,309,193387,5,193382
36668,15,15,429,1119808,15,1119793
36669,5,10,60,938791,5,938786
36670,20,18,507,1212660,20,1212640
36671,12,2,403,713692,12,713680
36672,12,-14,858,216198,12,216186
36673,15,-1,300,618946,15,618931
36674,8,-16,60,125132,8,125124
36675,16,6,763,841903,16,841887
36676,9,15,406,1102968,9,1102959
36677,15,18,230,1210813,15,1210798
36678,15,-18,193,86780,15,86765
36679,15,15,903,1123369,15,1123354
36680,16,13,365,1055906,16,1055890
36681,15,12,892,1028781,15,1028766
36682,5,16,445,1134769,5,1134764
36683,17,5,923,810537,17,810520
36684,17,5,673,808686,17,808669
36685,15,-4,707,527398,15,527383
36686,15,19,796,1247212,15,1247197
36687,19,-20,742,28485,19,28466
36688,7,-16,858,142453,7,142446
36689,12,7,713,872202,12,872190
36690,17,16,267,1149048,17,1149031
36691,14,10,371,962628,14,962614
36692,11,-11,778,309817,11,309806
36693,20,-11,873,310551,20,310531
36694,16,-2,218,586798,16,586782
36695,20,-19,508,57918,20,57898
36696,7,-7,938,425882,7,425875
36697,14,-16,221,148621,14,148607
36698,10,-6,433,446028,10,446018
36699,13,-1,120,617482,13,617469
36700,19,17,791,1183824,19,1183805
36701,11,5,246,805655,11,805644
36702,7,19,213,1222228,7,1222221
36703,5,18,609,1199559,5,1199554
36704,20,19,110,1241652,20,1241632
36705,17,2,36,710758,17,710741
36706,17,-13,210,242561,17,242544
36707,12,13,756,1058869,12,1058857
36708,8,17,533,1166731,8,1166723
36709,15,-7,426,431510,15,431495
36710,12,-18,341,87863,12,87851
36711,11,14,610,1090148,11,1090137
36712,15,-14,202,210874,15,210859
36713,6,-12,695,264504,6,264498
36714,18,-19,293,56267,18,56249
36715,10,-16,734,139769,10,139759
36716,20,-16,775,152600,20,152580
36717,12,-2,530,589120,12,589108
36718,11,-6,857,465619,11,465608
36719,16,3,32,742039,16,742023
36720,12,-15,622,182329,12,182317
36721,12,8,985,905608,12,905596
36722,19,-12,190,273861,19,273842
36723,9,12,294,1005670,9,1005661
36724,12,11,302,993107,12,993095
36725,18,-18,241,87210,18,87192
36726,5,8,236,880453,5,880448
36727,10,15,255,1100021,10,1100011
36728,9,-2,408,571382,9,571373
36729,13,-1,547,620893,13,620880
36730,6,-8,376,383270,6,383264
36731,9,-19,969,52297,9,52288
36732,8,6,557,824819,8,824811
36733,8,-14,831,204634,8,204626
36734,11,16,198,1148540,11,1148529
36735,17,-12,779,278224,17,278207
36736,13,-11,183,305206,13,305193
36737,20,-11,24,303843,20,303823
36738,10,-6,760,453168,10,453158
36739,6,-10,501,323557,6,323551
36740,17,-10,890,341785,17,341768
36741,8,14,719,1078205,8,1078197
36742,12,-20,497,26532,12,26520
36743,14,17,132,1178830,14,1178816
36744,9,-3,66,531911,9,531902
36745,14,19,745,1246838,14,1246824
36746,10,13,5,1030967,10,1030957
36747,8,2,182,692618,8,692610
36748,20,13,863,1059696,20,1059676
36749,15,19,575,1245515,15,1245500
36750,9,-12,828,267512,9,267503
36751,18,-16,973,154090,18,154072
36752,6,6,442,822420,6,822414
36753,8,-4,468,509551,8,509543
36754,15,-6,691,464449,15,464434
36755,14,-19,819,60271,14,60257
36756,11,-14,908,216575,11,216564
36757,9,-11,353,288947,9,288938
36758,14,16,922,1153725,14,1153711
36759,17,17,564,1182039,17,1182022
36760,19,7,613,871525,19,871506
36761,7,11,592,981191,7,981184
36762,13,-19,283,56220,13,56207
36763,14,18,546,1212969,14,1212955
36764,8,-11,391,289787,8,289779
36765,19,-4,645,526921,19,526902
36766,5,2,811,705494,5,705489
36767,14,6,410,839059,14,839045
36768,11,-7,549,432476,11,432465
36769,9,-17,737,109315,9,109306
36770,16,17,769,1183561,16,1183545
36771,5,-3,599,543875,5,543870
36772,20,-11,247,305635,20,305615
36773,9,-9,73,345143,9,345134
36774,9,-4,48,500325,9,500316
36775,19,13,508,1057022,19,1057003
36776,18,-4,983,529489,18,529471
36777,20,5,993,811092,20,811072
36778,5,-20,643,14091,5,14086
36779,19,14,820,1091889,19,1091870
36780,7,-3,946,551701,7,551694
36781,11,18,197,1210605,11,1210594
36782,6,19,719,1233474,6,1233468
36783,12,6,336,838400,12,838388
36784,20,15,992,1124082,20,1124062
36785,13,1,219,681618,13,681605
36786,11,-3,410,556821,11,556810
36787,8,-7,889,424922,8,424914
36788,20,12,38,1022385,20,1022365
36789,12,2,600,715072,12,715060
36790,9,-18,30,63057,9,63048
36791,12,-16,693,151999,12,151987
36792,20,13,501,1056934,20,1056914
36793,16,-18,509,89015,16,88999
36794,8,15,243,1099687,8,1099679
36795,11,-15,949,185013,11,185002
36796,5,15,724,1109882,5,1109877
36797,15,-2,690,590353,15,590338
36798,9,16,833,1142484,9,1142475
36799,7,12,638,1012995,7,1012988
36800,5,7,2,844798,5,844793
36801,7,10,929,957535,7,957528
36802,14,8,713,903644,14,903630
36803,16,-13,730,246400,16,246384
36804,18,5,422,806830,18,806812
36805,18,8,771,904071,18,904053
36806,7,6,112,814643,7,814636
36807,8,-8,365,382986,8,382978
36808,7,5,835,799100,7,799093
36809,19,11,583,995044,19,995025
36810,8,-13,2,218375,8,218367
36811,8,-9,978,365267,8,365259
36812,20,-18,64,85691,20,85671
36813,11,11,219,992391,11,992380
36814,8,13,924,1050506,8,1050498
36815,16,-1,988,624098,16,624082
36816,12,-9,234,368263,12,368251
36817,17,-18,867,91506,17,91489
36818,16,13,541,1057266,16,1057250
36819,14,5,380,806581,14,806567
36820,6,-16,240,129296,6,129290
36821,15,13,658,1058225,15,1058210
36822,12,-1,665,621686,12,621674
36823,16,-17,887,122103,16,122087
36824,19,-16,575,151247,19,151228
36825,17,-3,724,559543,17,559526
36826,5,-9,821,361880,5,361875
36827,5,-3,165,533918,5,533913
36828,20,4,954,780290,20,780270
36829,8,17,608,1168231,8,1168223
36830,16,19,854,1247669,16,1247653
36831,5,2,625,701834,5,701829
36832,6,14,880,1081531,6,1081525
36833,19,-12,41,272800,19,272781
36834,8,0,823,643235,8,643227
36835,5,-15,795,172325,5,172320
36836,9,-7,645,419524,9,419515
36837,17,-10,117,335968,17,335951
36838,6,-20,630,13789,6,13783
36839,13,-20,851,29376,13,29363
36840,14,13,434,1056476,14,1056462
36841,14,-1,255,618524,14,618510
36842,5,-4,36,500057,5,500052
36843,5,6,116,814719,5,814714
36844,5,2,865,706617,5,706612
36845,15,-4,424,525387,15,525372
36846,16,19,688,1246350,16,1246334
36847,19,16,489,1150599,19,1150580
36848,14,-1,520,620725,14,620711
36849,12,-3,287,555829,12,555817
36850,14,-16,167,148124,14,148110
36851,10,4,817,768423,10,768413
36852,19,-17,575,119871,19,119852
36853,18,-17,241,117252,18,117234
36854,18,-1,721,622156,18,622138
36855,15,-7,823,434277,15,434262
36856,12,-14,255,211445,12,211433
36857,10,-7,575,418222,10,418212
36858,10,-14,577,199198,10,199188
36859,11,16,922,1153726,11,1153715
36860,19,-7,567,432588,19,432569
36861,10,2,559,700438,10,700428
36862,18,17,327,1180434,18,1180416
36863,14,15,153,1117937,14,1117923
36864,13,-14,243,211305,13,211292
36865,20,-9,566,371181,20,371161
36866,16,5,544,807758,16,807742
36867,17,1,766,685840,17,685823
36868,11,-14,164,210548,11,210537
36869,15,14,138,1086550,15,1086535
36870,15,7,717,872220,15,872205
36871,7,-10,271,318387,7,318380
36872,10,-20,626,13659,10,13649
36873,17,8,712,903630,17,903613
36874,17,-12,306,274802,17,274785
36875,16,-5,370,493789,16,493773
36876,16,-6,617,463858,16,463842
36877,18,-20,736,28444,18,28426
36878,13,-20,164,24014,13,24001
36879,20,-4,500,525859,20,525839
36880,16,-9,246,368380,16,368364
36881,14,12,613,1026543,14,1026529
36882,6,19,554,1230036,6,1230030
36883,20,3,401,744885,20,744865
36884,19,7,319,869335,19,869316
36885,7,-18,725,78015,7,78008
36886,15,18,601,1213220,15,1213205
36887,14,2,93,711259,14,711245
36888,20,-7,331,430840,20,430820
36889,12,-19,930,61006,12,60994
36890,17,-1,50,616946,17,616929
36891,8,-5,77,469617,8,469609
36892,10,14,795,1079735,10,1079725
36893,19,10,752,965625,19,965606
36894,14,-7,118,429145,14,429131
36895,13,-11,110,304560,13,304547
36896,17,13,239,1054974,17,1054957
36897,9,-16,336,131156,9,131147
36898,18,-11,723,309376,18,309358
36899,8,-3,510,541927,8,541919
36900,13,-8,955,404673,13,404660
36901,20,13,129,1054162,20,1054142
36902,13,4,791,779053,13,779040
36903,6,2,457,698391,6,698385
36904,12,-5,782,496678,12,496666
36905,6,-6,971,457417,6,457411
36906,16,-16,397,149790,16,149774
36907,10,12,323,1006251,10,1006241
36908,18,-2,260,587086,18,587068
36909,17,-14,662,214673,17,214656
36910,8,15,784,1111094,8,1111086
36911,15,-12,4,272538,15,272523
36912,11,14,260,1087457,11,1087446
36913,18,11,712,995920,18,995902
36914,17,10,959,967213,17,967196
36915,5,-12,297,256052,5,256047
36916,9,19,9,1217634,9,1217625
36917,15,-5,129,491947,15,491932
36918,8,7,288,850969,8,850961
36919,17,5,870,810111,17,810094
36920,12,-4,251,524067,12,524055
36921,7,-17,610,106644,7,106637
36922,20,10,160,961116,20,961096
36923,15,1,198,681443,15,681428
36924,5,12,920,1019384,5,1019379
36925,16,-4,664,527114,16,527098
36926,9,16,432,1134538,9,1134529
36927,17,-7,837,434395,17,434378
36928,7,13,457,1040599,7,1040592
36929,8,11,114,970863,8,970855
36930,19,-17,665,120508,19,120489
36931,20,-16,592,151351,20,151331
36932,18,18,147,1210173,18,1210155
36933,7,5,746,797209,7,797202
36934,19,18,157,1210236,19,1210217
36935,17,-13,388,243887,17,243870
36936,12,19,450,1244534,12,1244522
36937,9,11,189,972279,9,972270
36938,6,-11,513,292617,6,292611
36939,15,-19,153,55285,15,55270
36940,10,-8,909,394819,10,394809
36941,6,16,471,1135269,6,1135263
36942,6,-2,327,569786,6,569780
36943,7,7,33,845493,7,845486
36944,17,-17,785,121455,17,121438
36945,8,-6,363,444538,8,444530
36946,10,-14,337,194053,10,194043
36947,7,-1,578,606520,7,606513
36948,20,7,750,872435,20,872415
36949,7,-19,359,39274,7,39267
36950,8,-20,767,16847,8,16839
36951,11,-16,234,148711,11,148700
36952,6,12,343,1006659,6,1006653
36953,17,-5,316,493426,17,493409
36954,17,-1,648,621565,17,621548
36955,6,8,803,892793,6,892787
36956,6,-15,783,172128,6,172122
36957,19,0,9,648255,19,648236
36958,12,6,905,842976,12,842964
36959,8,19,760,1234332,8,1234324
36960,6,-14,196,190742,6,190736
36961,17,-14,50,209704,17,209687
36962,14,-11,601,308530,14,308516
36963,8,-11,720,296705,8,296697
36964,14,-4,723,527487,14,527473
36965,13,8,400,901141,13,901128
36966,15,4,519,777026,15,777011
36967,5,-6,159,440180,5,440175
36968,16,11,745,996180,16,996164
36969,17,-18,228,87074,17,87057
36970,11,3,911,748703,11,748692
36971,12,-14,161,210546,12,210534
36972,19,6,225,837450,19,837431
36973,10,18,919,1206149,10,1206139
36974,17,-8,997,405012,17,404995
36975,6,17,537,1166774,6,1166768
36976,9,-17,602,106507,9,106498
36977,16,5,37,804042,16,804026
36978,13,-20,402,25863,13,25850
36979,10,11,498,979079,10,979069
36980,6,16,158,1128402,6,1128396
36981,9,-14,602,199878,9,199869
36982,11,17,727,1183332,11,1183321
36983,5,-16,187,128113,5,128108
36984,17,-20,612,27435,17,27418
36985,7,13,392,1039140,7,1039133
36986,17,-2,632,589878,17,589861
36987,14,-9,910,373806,14,373792
36988,14,18,835,1215026,14,1215012
36989,11,12,973,1029594,11,1029583
36990,15,-13,90,241685,15,241670
36991,15,-1,351,619394,15,619379
36992,12,8,75,898479,12,898467
36993,7,-4,713,514727,7,514720
36994,20,-19,412,57190,20,57170
36995,19,9,589,933435,19,933416
36996,8,4,85,752419,8,752411
36997,17,14,671,1090708,17,1090691
36998,14,16,789,1152739,14,1152725
36999,17,-6,121,459980,17,459963
37000,16,5,385,806619,16,806603
37001,19,-3,45,554126,19,554107
37002,12,10,502,963670,12,963658
37003,15,-8,986,404917,15,404902
37004,13,-13,66,241522,13,241509
37005,10,-16,124,126773,10,126763
37006,17,-18,765,90822,17,90805
37007,19,-20,479,26381,19,26362
37008,11,3,123,742770,11,742759
37009,10,4,283,756645,10,756635
37010,10,-10,970,333293,10,333283
37011,7,10,535,948915,7,948908
37012,10,2,924,707809,10,707799
37013,7,-20,325,7272,7,7265
37014,15,-1,491,620484,15,620469
37015,10,4,903,770467,10,770457
37016,14,7,629,871612,14,871598
37017,10,13,360,1038505,10,1038495
37018,15,19,617,1245801,15,1245786
37019,14,-6,972,466467,14,466453
37020,9,-19,125,34354,9,34345
37021,7,1,817,674750,7,674743
37022,14,10,555,964096,14,964082
37023,6,12,86,1001042,6,1001036
37024,16,4,131,774192,16,774176
37025,9,-15,938,175385,9,175376
37026,15,3,879,748435,15,748420
37027,15,-3,198,555169,15,555154
37028,5,18,813,1203923,5,1203918
37029,10,19,808,1235411,10,1235401
37030,20,-18,4,85229,20,85209
37031,13,-14,26,209531,13,209518
37032,14,13,293,1055385,14,1055371
37033,6,12,480,1009390,6,1009384
37034,8,-20,442,9455,8,9447
37035,7,-12,504,260565,7,260558
37036,6,-17,275,99326,6,99320
37037,19,3,503,745591,19,745572
37038,10,-12,149,252782,10,252772
37039,13,8,707,903578,13,903565
37040,6,-3,10,530823,6,530817
37041,13,18,294,1211241,13,1211228
37042,19,8,379,900937,19,900918
37043,9,-9,423,352913,9,352904
37044,7,-11,775,297849,7,297842
37045,11,-6,797,465235,11,465224
37046,15,-1,948,623790,15,623775
37047,17,18,974,1216148,17,1216131
37048,5,-3,772,547737,5,547732
37049,16,-7,882,434784,16,434768
37050,14,7,759,872489,14,872475
37051,14,15,937,1123629,14,1123615
37052,18,3,437,745116,18,745098
37053,18,0,865,654819,18,654801
37054,6,-16,712,139288,6,139282
37055,5,-11,855,299455,5,299450
37056,14,5,257,805719,14,805705
37057,6,14,590,1074884,6,1074878
37058,9,6,309,819175,9,819166
37059,11,-7,140,429310,11,429299
37060,16,-20,552,27014,16,26998
37061,13,6,359,838546,13,838533
37062,20,2,406,713731,20,713711
37063,11,-7,885,434821,11,434810
37064,6,-6,316,443646,6,443640
37065,5,15,681,1108898,5,1108893
37066,17,11,304,993116,17,993099
37067,20,-13,720,246331,20,246311
37068,13,-6,730,464740,13,464727
37069,16,-8,136,398852,16,398836
37070,11,11,874,997205,11,997194
37071,16,19,952,1248440,16,1248424
37072,5,5,257,786992,5,786987
37073,12,15,718,1122109,12,1122097
37074,5,-9,353,351372,5,351367
37075,19,0,293,650275,19,650256
37076,20,11,230,992432,20,992412
37077,5,15,554,1106228,5,1106223
37078,18,19,593,1245601,18,1245583
37079,10,0,849,643792,10,643782
37080,10,-11,903,300562,10,300552
37081,19,-11,853,310399,19,310380
37082,15,1,320,682399,15,682384
37083,6,-17,34,94277,6,94271
37084,19,6,906,842984,19,842965
37085,19,-12,964,279817,19,279798
37086,7,-12,414,258653,7,258646
37087,18,-15,463,181191,18,181173
37088,20,14,143,1086588,20,1086568
37089,12,16,568,1151117,12,1151105
37090,13,-15,793,183645,13,183632
37091,16,14,32,1085626,16,1085610
37092,16,-8,936,404502,16,404486
37093,15,2,970,717718,15,717703
37094,13,4,987,780481,13,780468
37095,6,-7,145,408857,6,408851
37096,9,5,142,784518,9,784509
37097,16,7,106,867791,16,867775
37098,11,18,50,1209288,11,1209277
37099,9,14,937,1082799,9,1082790
37100,8,-4,619,512748,8,512740
37101,16,3,380,744733,16,744717
37102,13,-2,168,586300,13,586287
37103,10,17,518,1166418,10,1166408
37104,6,-20,468,9999,6,9993
37105,6,10,655,951706,6,951700
37106,6,7,227,849615,6,849609
37107,17,14,835,1091984,17,1091967
37108,17,-4,887,528730,17,528713
37109,8,-6,488,447257,8,447249
37110,19,-8,236,399571,19,399552
37111,15,6,165,836985,15,836970
37112,10,-10,972,333381,10,333371
37113,11,17,159,1179051,11,1179040
37114,13,-2,471,588697,13,588684
37115,9,-14,803,204147,9,204138
37116,17,-20,134,23777,17,23760
37117,9,11,457,978185,9,978176
37118,11,19,665,1246156,11,1246145
37119,16,-15,398,180667,16,180651
37120,13,-19,140,55127,13,55114
37121,20,3,29,742003,20,741983
37122,13,16,960,1153925,13,1153912
37123,15,-6,124,460001,15,459986
37124,5,18,346,1194175,5,1194170
37125,11,-19,896,60822,11,60811
37126,7,-4,832,517019,7,517012
37127,19,-20,483,26402,19,26383
37128,13,7,59,867455,13,867442
37129,20,12,901,1028926,20,1028906
37130,7,12,56,1000329,7,1000322
37131,18,17,304,1180246,18,1180228
37132,5,8,571,887744,5,887739
37133,18,10,497,963619,18,963601
37134,5,3,88,720681,5,720676
37135,15,-3,861,560668,15,560653
37136,15,-10,694,340327,15,340312
37137,9,8,227,880109,9,880100
37138,11,-10,202,336541,11,336530
37139,11,-20,21,12771,11,12760
37140,12,6,895,842895,12,842883
37141,19,19,427,1244391,19,1244372
37142,13,17,464,1181415,13,1181402
37143,19,12,996,1029782,19,1029763
37144,10,-7,13,406332,10,406322
37145,7,-6,446,446266,7,446259
37146,8,11,976,989400,8,989392
37147,11,12,33,1022336,11,1022325
37148,19,7,617,871541,19,871522
37149,17,-3,680,559228,17,559211
37150,13,16,366,1149782,13,1149769
37151,6,-8,853,393512,6,393506
37152,5,-16,782,140836,5,140831
37153,16,-20,156,23931,16,23915
37154,5,4,673,765118,5,765113
37155,16,-5,753,496536,16,496520
37156,6,18,851,1204781,6,1204775
37157,8,-4,278,505641,8,505633
37158,12,13,971,1060431,12,1060419
37159,5,-17,941,113284,5,113279
37160,6,10,161,941049,6,941043
37161,7,-9,305,350261,7,350254
37162,6,16,46,1126134,6,1126128
37163,19,7,489,870670,19,870651
37164,7,-20,196,4625,7,4618
37165,14,-7,483,431962,14,431948
37166,19,15,84,1117422,19,1117403
37167,7,-4,702,514511,7,514504
37168,10,-7,46,407043,10,407033
37169,15,15,810,1122693,15,1122678
37170,9,-6,948,457000,9,456991
37171,20,1,210,681551,20,681531
37172,10,-15,480,165890,10,165880
37173,13,0,69,648752,13,648739
37174,6,3,616,731943,6,731937
37175,5,-16,524,135466,5,135461
37176,10,0,307,631843,10,631833
37177,11,8,664,903203,11,903192
37178,11,19,421,1244325,11,1244314
37179,9,-6,704,451943,9,451934
37180,6,-3,955,551931,6,551925
37181,18,1,810,686162,18,686144
37182,5,9,569,918753,5,918748
37183,7,6,756,829328,7,829321
37184,16,-18,144,86313,16,86297
37185,8,14,500,1073037,8,1073029
37186,14,14,864,1092166,14,1092152
37187,7,-16,427,133231,7,133224
37188,16,-17,798,121534,16,121518
37189,17,7,75,867551,17,867534
37190,17,-20,527,26789,17,26772
37191,16,6,683,841243,16,841227
37192,14,-1,260,618566,14,618552
37193,20,17,804,1183951,20,1183931
37194,19,18,204,1210654,19,1210635
37195,10,-18,770,79101,10,79091
37196,17,13,771,1059015,17,1058998
37197,15,-1,788,622623,15,622608
37198,15,13,106,1054002,15,1053987
37199,11,-8,495,401271,11,401260
37200,15,-18,594,89544,15,89529
37201,16,-19,80,54522,16,54506
37202,20,3,409,744942,20,744922
37203,15,11,147,991900,15,991885
37204,19,18,922,1215694,19,1215675
37205,14,18,538,1212924,14,1212910
37206,7,-20,626,13666,7,13659
37207,17,7,596,871422,17,871405
37208,10,14,770,1079226,10,1079216
37209,19,-2,804,591166,19,591147
37210,11,-2,663,590115,11,590104
37211,7,-20,167,3724,7,3717
37212,19,-20,146,23891,19,23872
37213,19,-4,511,525983,19,525964
37214,17,-19,913,60891,17,60874
37215,10,0,328,632261,10,632251
37216,11,1,701,685284,11,685273
37217,19,-15,733,183257,19,183238
37218,7,-20,788,17335,7,17328
37219,7,0,442,634862,7,634855
37220,11,6,382,838741,11,838730
37221,20,-2,563,589361,20,589341
37222,7,3,683,733586,7,733579
37223,6,16,973,1145574,6,1145568
37224,11,-18,780,90953,11,90942
37225,20,13,53,1053634,20,1053614
37226,19,16,479,1150565,19,1150546
37227,10,-18,707,77607,10,77597
37228,14,7,822,872952,14,872938
37229,9,-19,116,34104,9,34095
37230,13,-12,626,277061,13,277048
37231,19,-18,366,88051,19,88032
37232,18,-3,211,555263,18,555245
37233,8,12,708,1014637,8,1014629
37234,12,-6,33,459413,12,459401
37235,16,-8,712,402920,16,402904
37236,9,-8,821,392930,9,392921
37237,8,18,863,1204947,8,1204939
37238,7,-9,992,365425,7,365418
37239,17,9,224,930715,17,930698
37240,16,-5,187,492340,16,492324
37241,20,19,270,1242927,20,1242907
37242,13,-14,425,212867,13,212854
37243,8,-16,161,127507,8,127499
37244,20,6,323,838282,20,838262
37245,10,-1,855,612157,10,612147
37246,19,11,494,994454,19,994435
37247,10,10,795,954776,10,954766
37248,14,1,494,683776,14,683762
37249,12,-2,432,588405,12,588393
37250,10,4,726,766367,10,766357
37251,17,5,334,806239,17,806222
37252,16,-15,64,178235,16,178219
37253,16,-8,962,404715,16,404699
37254,15,-1,598,621234,15,621219
37255,19,8,604,902709,19,902690
37256,6,14,726,1078339,6,1078333
37257,5,-3,368,538453,5,538448
37258,20,-15,824,183952,20,183932
37259,14,-1,700,621939,14,621925
37260,15,-16,218,148594,15,148579
37261,12,-13,22,241223,12,241211
37262,9,-18,879,81401,9,81392
37263,11,-13,31,241325,11,241314
37264,5,0,384,633673,5,633668
37265,11,-6,901,465958,11,465947
37266,18,3,837,748118,18,748100
37267,16,0,790,654277,16,654261
37268,18,5,281,805911,18,805893
37269,16,-18,911,91839,16,91823
37270,18,-13,402,243956,18,243938
37271,10,14,129,1064773,10,1064763
37272,18,19,673,1246230,18,1246212
37273,15,9,142,930120,15,930105
37274,12,5,734,809141,12,809129
37275,19,-12,91,273209,19,273190
37276,5,-15,634,169096,5,169091
37277,14,10,844,966291,14,966277
37278,12,-19,715,59568,12,59556
37279,18,-4,232,523908,18,523890
37280,17,-15,229,179405,17,179388
37281,7,5,458,791128,7,791121
37282,17,-8,736,403089,17,403072
37283,16,-16,887,153482,16,153466
37284,20,0,470,651685,20,651665
37285,10,-1,345,601703,10,601693
37286,16,-6,973,466480,16,466464
37287,5,-15,800,172422,5,172417
37288,11,3,745,747469,11,747458
37289,5,2,0,688578,5,688573
37290,12,-18,670,90143,12,90131
37291,15,-5,533,494987,15,494972
37292,15,-19,665,59168,15,59153
37293,18,-10,448,338382,18,338364
37294,9,12,108,1001438,9,1001429
37295,6,-20,968,21277,6,21271
37296,20,13,613,1057914,20,1057894
37297,8,2,54,689750,8,689742
37298,16,-20,284,25003,16,24987
37299,17,14,815,1091872,17,1091855
37300,8,19,246,1222899,8,1222891
37301,19,14,967,1092983,19,1092964
37302,5,14,687,1077489,5,1077484
37303,5,12,766,1015728,5,1015723
37304,13,-4,374,525018,13,525005
37305,10,-1,781,610661,10,610651
37306,17,9,405,931991,17,931974
37307,14,10,42,960171,14,960157
37308,8,5,418,790155,8,790147
37309,5,7,763,860919,5,860914
37310,18,-11,469,307504,18,307486
37311,19,15,452,1119989,19,1119970
37312,18,11,538,994733,18,994715
37313,8,-8,808,392643,8,392635
37314,9,-18,51,63456,9,63447
37315,12,5,477,807312,12,807300
37316,19,14,567,1089844,19,1089825
37317,12,18,764,1214489,12,1214477
37318,10,-15,365,163327,10,163317
37319,20,-11,746,309537,20,309517
37320,18,7,669,871960,18,871942
37321,5,12,16,999429,5,999424
37322,6,-2,271,568600,6,568594
37323,6,17,835,1173266,6,1173260
37324,8,-7,742,421556,8,421548
37325,16,-18,127,86194,16,86178
37326,15,-9,726,372101,15,372086
37327,13,7,483,870641,13,870628
37328,17,9,830,935208,17,935191
37329,16,13,178,1054512,16,1054496
37330,6,4,121,753179,6,753173
37331,5,-9,319,350587,5,350582
37332,18,17,620,1182453,18,1182435
37333,8,1,353,664931,8,664923
37334,7,13,79,1032421,7,1032414
37335,18,5,768,809374,18,809356
37336,7,-20,151,3360,7,3353
37337,14,8,503,901939,14,901925
37338,14,-3,81,554351,14,554337
37339,7,-13,702,233241,7,233234
37340,9,-20,23,593,9,584
37341,14,-15,937,184898,14,184884
37342,7,9,214,911327,7,911320
37343,10,2,731,704068,10,704058
37344,9,-6,983,457748,9,457739
37345,8,-17,352,101049,8,101041
37346,14,-8,71,398504,14,398490
37347,8,-4,531,510976,8,510968
37348,17,-9,453,370172,17,370155
37349,8,-1,467,604274,8,604266
37350,19,-4,724,527495,19,527476
37351,6,11,260,973773,6,973767
37352,16,-2,166,586286,16,586270
37353,5,2,383,696889,5,696884
37354,20,-12,822,278550,20,278530
37355,20,1,83,680420,20,680400
37356,6,-6,718,452225,6,452219
37357,16,-20,291,25068,16,25052
37358,20,6,807,842263,20,842243
37359,11,18,951,1215969,11,1215958
37360,15,-19,119,54953,15,54938
37361,6,1,437,666663,6,666657
37362,14,13,105,1053997,14,1053983
37363,8,7,237,849799,8,849791
37364,5,-1,978,614942,5,614937
37365,19,-1,816,622839,19,622820
37366,11,17,953,1185025,11,1185014
37367,19,11,620,995289,19,995270
37368,19,1,570,684398,19,684379
37369,13,-6,692,464451,13,464438
37370,13,3,674,746960,13,746947
37371,6,-17,467,103447,6,103441
37372,16,12,762,1027692,16,1027676
37373,16,16,263,1149009,16,1148993
37374,14,-2,107,585945,14,585931
37375,8,8,727,891289,8,891281
37376,15,11,514,994573,15,994558
37377,17,16,980,1154138,17,1154121
37378,14,2,223,712247,14,712233
37379,5,11,884,987550,5,987545
37380,8,17,608,1168239,8,1168231
37381,6,15,42,1095399,6,1095393
37382,16,-20,839,29308,16,29292
37383,15,-6,640,464072,15,464057
37384,19,-15,392,180629,19,180610
37385,6,0,578,637851,6,637845
37386,12,5,339,806266,12,806254
37387,19,3,980,749371,19,749352
37388,18,-7,248,430132,18,430114
37389,13,-13,408,243976,13,243963
37390,7,-19,175,35498,7,35491
37391,10,10,209,941980,10,941970
37392,18,-5,449,494310,18,494292
37393,6,6,439,822340,6,822334
37394,16,8,233,899885,16,899869
37395,11,4,816,779273,11,779262
37396,7,-13,770,235104,7,235097
37397,16,-2,873,591788,16,591772
37398,15,-13,989,248494,15,248479
37399,20,-17,799,121543,20,121523
37400,16,-10,541,339107,16,339091
37401,15,-13,310,243361,15,243346
37402,12,-3,882,560827,12,560815
37403,11,10,917,966919,11,966908
37404,10,8,12,875385,10,875375
37405,18,1,630,684809,18,684791
37406,9,-11,414,290312,9,290303
37407,20,-2,171,586308,20,586288
37408,12,2,27,710658,12,710646
37409,19,-11,410,306993,19,306974
37410,19,-11,419,307087,19,307068
37411,5,10,201,941796,5,941791
37412,9,15,360,1102104,9,1102095
37413,10,-5,357,475920,10,475910
37414,19,6,439,839288,19,839269
37415,18,6,820,842368,18,842350
37416,6,2,821,705695,6,705689
37417,14,-7,648,433027,14,433013
37418,11,-3,664,559074,11,559063
37419,17,-16,403,149850,17,149833
37420,6,-1,182,597620,6,597614
37421,10,-20,840,18694,10,18684
37422,15,-19,336,56620,15,56605
37423,11,0,92,648916,11,648905
37424,19,-17,174,116743,19,116724
37425,9,9,118,909246,9,909237
37426,9,15,475,1104480,9,1104471
37427,19,-12,516,276364,19,276345
37428,5,-19,587,44406,5,44401
37429,13,-9,441,370078,13,370065
37430,12,-3,933,561248,12,561236
37431,9,-20,791,17462,9,17453
37432,11,2,893,717134,11,717123
37433,12,-7,608,432784,12,432772
37434,8,-6,586,449408,8,449400
37435,9,3,90,720753,9,720744
37436,7,-2,553,574539,7,574532
37437,5,-12,368,257630,5,257625
37438,19,-10,392,337881,19,337862
37439,13,-19,883,60763,13,60750
37440,17,11,155,991920,17,991903
37441,8,5,522,792479,8,792471
37442,11,2,487,714285,11,714274
37443,14,14,802,1091733,14,1091719
37444,7,-5,265,473871,7,473864
37445,15,13,637,1058056,15,1058041
37446,13,4,152,774366,13,774353
37447,6,-1,613,607171,6,607165
37448,18,10,246,961662,18,961644
37449,18,14,404,1088610,18,1088592
37450,9,0,629,639029,9,639020
37451,19,4,166,774476,19,774457
37452,11,4,706,778403,11,778392
37453,9,-6,336,444036,9,444027
37454,20,-3,195,555135,20,555115
37455,15,11,562,994889,15,994874
37456,11,-16,147,148022,11,148011
37457,7,-2,215,567326,7,567319
37458,8,11,233,973098,8,973090
37459,13,-13,603,245487,13,245474
37460,7,8,264,880931,7,880924
37461,19,-7,752,433745,19,433726
37462,13,-16,308,149218,13,149205
37463,9,17,759,1171457,9,1171448
37464,9,19,713,1233302,9,1233293
37465,7,-2,51,563982,7,563975
37466,20,-9,195,367939,20,367919
37467,8,-11,140,284207,8,284199
37468,13,9,671,934003,13,933990
37469,6,-19,562,43776,6,43770
37470,13,9,641,933808,13,933795
37471,8,-1,226,598791,8,598783
37472,7,-9,134,346402,7,346395
37473,18,17,738,1183387,18,1183369
37474,16,-2,817,591297,16,591281
37475,19,5,589,808091,19,808072
37476,9,-9,577,356655,9,356646
37477,18,8,102,898719,18,898701
37478,6,11,1000,989824,6,989818
37479,12,12,20,1022233,12,1022221
37480,16,2,185,711973,16,711957
37481,9,7,914,864183,9,864174
37482,13,-18,988,92402,13,92389
37483,7,16,879,1143358,7,1143351
37484,6,8,132,877914,6,877908
37485,16,-20,402,25869,16,25853
37486,13,3,590,746246,13,746233
37487,12,16,284,1149192,12,1149180
37488,20,4,130,774177,20,774157
37489,5,13,163,1034111,5,1034106
37490,18,-16,399,149796,18,149778
37491,18,3,572,746088,18,746070
37492,19,-6,490,462948,19,462929
37493,12,2,234,712328,12,712316
37494,19,-13,284,243215,19,243196
37495,8,-3,408,539418,8,539410
37496,14,-17,297,117738,14,117724
37497,13,12,233,1023758,13,1023745
37498,17,6,446,839325,17,839308
37499,16,14,334,1088067,16,1088051
37500,15,17,59,1178331,15,1178316
37501,8,-1,493,604856,8,604848
37502,17,7,2,867029,17,867012
37503,17,-13,970,248365,17,248348
37504,14,-20,364,25609,14,25595
37505,14,-14,125,210259,14,210245
37506,14,2,497,714372,14,714358
37507,7,19,973,1239053,7,1239046
37508,10,-20,79,1789,10,1779
37509,12,1,555,684277,12,684265
37510,13,-7,597,432771,13,432758
37511,14,15,946,1123719,14,1123705
37512,5,-5,978,489311,5,489306
37513,15,-7,694,433361,15,433346
37514,13,2,294,712820,13,712807
37515,19,5,36,804021,19,804002
37516,14,11,350,993421,14,993407
37517,7,1,587,670105,7,670098
37518,5,19,142,1220586,5,1220581
37519,11,16,613,1151425,11,1151414
37520,10,-19,449,41170,10,41160
37521,11,-4,911,528931,11,528920
37522,11,15,56,1117218,11,1117207
37523,9,7,363,852652,9,852643
37524,20,0,516,652072,20,652052
37525,14,-3,108,554558,14,554544
37526,11,-10,205,336557,11,336546
37527,20,-7,431,431559,20,431539
37528,17,-4,778,527865,17,527848
37529,18,-11,60,304146,18,304128
37530,17,-18,297,87543,17,87526
37531,7,-10,425,321874,7,321867
37532,6,-15,209,159745,6,159739
37533,10,8,716,891052,10,891042
37534,8,13,910,1050210,8,1050202
37535,18,17,16,1177956,18,1177938
37536,15,6,669,841143,15,841128
37537,14,9,576,933300,14,933286
37538,15,6,865,842672,15,842657
37539,19,4,979,780421,19,780402
37540,5,7,2,844813,5,844808
37541,20,11,254,992675,20,992655
37542,19,18,477,1212496,19,1212477
37543,20,-14,378,212484,20,212464
37544,15,6,953,843327,15,843312
37545,7,-9,168,347154,7,347147
37546,11,-10,609,339627,11,339616
37547,13,8,67,898392,13,898379
37548,6,18,67,1188244,6,1188238
37549,19,11,711,995899,19,995880
37550,13,15,512,1120488,13,1120475
37551,14,0,42,648569,14,648555
37552,6,-3,390,538972,6,538966
37553,10,1,797,674359,10,674349
37554,16,13,100,1053976,16,1053960
37555,13,-10,933,342091,13,342078
37556,8,2,853,706347,8,706339
37557,8,8,712,890916,8,890908
37558,6,-20,823,18282,6,18276
37559,13,-3,711,559451,13,559438
37560,10,-6,982,457720,10,457710
37561,14,10,638,964850,14,964836
37562,10,12,156,1002553,10,1002543
37563,19,17,173,1179192,19,1179173
37564,17,-3,920,561161,17,561144
37565,11,17,254,1179799,11,1179788
37566,8,-19,303,38089,8,38081
37567,14,-18,516,89056,14,89042
37568,16,11,284,992923,16,992907
37569,8,-6,331,443940,8,443932
37570,10,-4,383,507917,10,507907
37571,9,7,663,858851,9,858842
37572,14,19,243,1242634,14,1242620
37573,8,8,728,891325,8,891317
37574,14,4,819,779281,14,779267
37575,19,5,564,807881,19,807862
37576,18,12,513,1025800,18,1025782
37577,20,6,411,839068,20,839048
37578,10,-17,733,109235,10,109225
37579,9,9,434,915784,9,915775
37580,11,-5,134,491967,11,491956
37581,14,3,515,745637,14,745623
37582,18,-4,163,523301,18,523283
37583,14,17,363,1180687,14,1180673
37584,15,14,152,1086646,15,1086631
37585,20,14,144,1086597,20,1086577
37586,11,15,225,1118503,11,1118492
37587,11,17,864,1184500,11,1184489
37588,17,-2,423,588293,17,588276
37589,5,-9,887,363506,5,363501
37590,10,15,665,1108548,10,1108538
37591,18,-3,247,555521,18,555503
37592,15,6,266,837791,15,837776
37593,14,-9,311,368884,14,368870
37594,9,12,601,1012055,9,1012046
37595,11,-9,727,372108,11,372097
37596,16,-11,171,305079,16,305063
37597,19,14,929,1092673,19,1092654
37598,19,13,1000,1060652,19,1060633
37599,19,-13,909,247823,19,247804
37600,13,-16,903,153571,13,153558
37601,6,-14,579,199237,6,199231
37602,5,6,588,825542,5,825537
37603,19,-10,118,335981,19,335962
37604,5,-12,452,259318,5,259313
37605,18,14,126,1086475,18,1086457
37606,15,17,842,1184316,15,1184301
37607,19,7,561,871148,19,871129
37608,18,15,969,1123931,18,1123913
37609,9,17,609,1168267,9,1168258
37610,6,10,951,957967,6,957961
37611,16,-11,491,307662,16,307646
37612,9,-6,489,447318,9,447309
37613,15,-17,30,115762,15,115747
37614,18,-20,502,26604,18,26586
37615,20,15,503,1120376,20,1120356
37616,16,-9,826,373081,16,373065
37617,7,-7,412,414773,7,414766
37618,13,-1,575,621076,13,621063
37619,15,4,621,777801,15,777786
37620,6,18,527,1198100,6,1198094
37621,16,-17,137,116491,16,116475
37622,13,-4,193,523551,13,523538
37623,13,16,309,1149365,13,1149352
37624,17,14,881,1092331,17,1092314
37625,10,2,948,708381,10,708371
37626,7,12,600,1011996,7,1011989
37627,20,4,262,775097,20,775077
37628,20,-4,574,526445,20,526425
37629,13,-19,958,61218,13,61205
37630,5,-11,674,295975,5,295970
37631,12,-10,12,335202,12,335190
37632,7,-11,261,286756,7,286749
37633,15,19,861,1247756,15,1247741
37634,13,-16,651,151771,13,151758
37635,8,-2,611,575780,8,575772
37636,19,-15,996,185343,19,185324
37637,16,-1,701,621957,16,621941
37638,10,-9,120,346153,10,346143
37639,19,18,945,1215909,19,1215890
37640,5,5,810,798534,5,798529
37641,20,-12,739,277915,20,277895
37642,10,-6,162,440270,10,440260
37643,19,4,283,775225,19,775206
37644,18,-19,333,56575,18,56557
37645,12,13,108,1054024,12,1054012
37646,20,4,159,774408,20,774388
37647,14,12,217,1023671,14,1023657
37648,11,6,450,839349,11,839338
37649,14,-20,587,27262,14,27248
37650,15,13,287,1055320,15,1055305
37651,6,-1,191,597795,6,597789
37652,10,-14,818,204408,10,204398
37653,8,-19,132,34494,8,34486
37654,13,4,5,773346,13,773333
37655,20,-7,881,434778,20,434758
37656,19,13,386,1056085,19,1056066
37657,5,-20,658,14464,5,14459
37658,20,-14,729,215177,20,215157
37659,16,9,106,929829,16,929813
37660,13,-2,914,592100,13,592087
37661,18,18,769,1214522,18,1214504
37662,16,-15,36,178057,16,178041
37663,16,12,642,1026859,16,1026843
37664,8,-17,97,95539,8,95531
37665,15,2,839,716775,15,716760
37666,6,5,725,796742,6,796736
37667,13,-15,608,182222,13,182209
37668,10,16,739,1140476,10,1140466
37669,6,-12,866,268453,6,268447
37670,18,12,707,1027392,18,1027374
37671,12,15,602,1121193,12,1121181
37672,20,-15,752,183376,20,183356
37673,9,18,264,1192624,9,1192615
37674,19,-7,80,428855,19,428836
37675,16,-9,591,371327,16,371311
37676,7,-18,502,73269,7,73262
37677,14,7,928,873608,14,873594
37678,20,-17,655,120418,20,120398
37679,13,-17,498,119229,13,119216
37680,16,-20,858,29402,16,29386
37681,19,-6,850,465569,19,465550
37682,14,0,841,654659,14,654645
37683,10,5,234,786552,10,786542
37684,8,6,637,826697,8,826689
37685,20,-3,95,554447,20,554427
37686,12,-18,995,92446,12,92434
37687,9,-4,838,517178,9,517169
37688,18,2,879,717055,18,717037
37689,19,-3,900,561017,19,560998
37690,19,-5,481,494601,19,494582
37691,8,-4,314,506338,8,506330
37692,8,-13,757,234619,8,234611
37693,5,-4,40,500158,5,500153
37694,18,-5,894,497591,18,497573
37695,10,-10,80,314409,10,314399
37696,8,7,779,861270,8,861262
37697,13,-2,266,587126,13,587113
37698,20,9,672,934021,20,934001
37699,16,10,48,960217,16,960201
37700,7,14,597,1075096,7,1075089
37701,7,18,298,1193282,7,1193275
37702,14,-12,696,277626,14,277612
37703,16,11,912,997487,16,997471
37704,9,6,661,827212,9,827203
37705,20,15,266,1118761,20,1118741
37706,16,1,516,683932,16,683916
37707,6,15,292,1100814,6,1100808
37708,9,-2,801,579844,9,579835
37709,19,-18,605,89625,19,89606
37710,5,-17,104,95675,5,95670
37711,16,-15,844,184118,16,184102
37712,16,-19,52,54256,16,54240
37713,12,-10,138,336146,12,336134
37714,9,-12,193,253578,9,253569
37715,6,8,724,891214,6,891208
37716,10,-1,147,596953,10,596943
37717,9,-2,179,566518,9,566509
37718,5,18,946,1206743,5,1206738
37719,14,19,127,1241811,14,1241797
37720,13,-12,747,277996,13,277983
37721,10,17,319,1162194,10,1162184
37722,18,6,404,839023,18,839005
37723,8,13,301,1037151,8,1037143
37724,7,-6,660,450929,7,450922
37725,5,-9,991,365409,5,365404
37726,15,15,481,1120200,15,1120185
37727,20,-10,738,340639,20,340619
37728,10,-1,101,596020,10,596010
37729,16,9,38,929321,16,929305
37730,7,-1,443,603676,7,603669
37731,17,15,10,1116843,17,1116826
37732,20,-8,481,401195,20,401175
37733,5,0,214,630107,5,630102
37734,9,-5,266,473889,9,473880
37735,16,-9,639,371600,16,371584
37736,13,8,10,897971,13,897958
37737,6,17,105,1157449,6,1157443
37738,13,-3,808,560280,13,560267
37739,12,-10,543,339127,12,339115
37740,20,12,881,1028691,20,1028671
37741,12,-20,388,25770,12,25758
37742,20,9,484,932605,20,932585
37743,19,-15,335,180207,19,180188
37744,9,3,183,722788,9,722779
37745,10,-9,769,360760,10,360750
37746,19,-11,269,305853,19,305834
37747,19,5,995,811099,19,811080
37748,7,3,753,735113,7,735106
37749,16,14,903,1092511,16,1092495
37750,7,-4,977,520421,7,520414
37751,10,-18,73,64062,10,64052
37752,13,14,271,1087516,13,1087503
37753,19,3,397,744867,19,744848
37754,17,-4,347,524825,17,524808
37755,12,10,93,960594,12,960582
37756,20,17,539,1181875,20,1181855
37757,13,6,965,843437,13,843424
37758,11,-4,648,526951,11,526940
37759,17,-8,645,402413,17,402396
37760,17,13,970,1060417,17,1060400
37761,16,-10,161,336289,16,336273
37762,11,-6,705,464533,11,464522
37763,6,1,938,677393,6,677387
37764,6,-15,542,167105,6,167099
37765,13,-5,887,497541,13,497528
37766,13,-15,85,178442,13,178429
37767,5,-19,722,47361,5,47356
37768,16,-19,448,57415,16,57399
37769,18,4,658,778062,18,778044
37770,8,11,18,968830,8,968822
37771,17,-12,523,276423,17,276406
37772,16,-14,615,214345,16,214329
37773,11,-1,435,620007,11,619996
37774,8,-19,481,41866,8,41858
37775,10,-6,301,443384,10,443374
37776,12,-20,792,28954,12,28942
37777,15,-8,929,404433,15,404418
37778,12,12,821,1028156,12,1028144
37779,15,0,572,652584,15,652569
37780,19,-13,698,246117,19,246098
37781,15,0,456,651589,15,651574
37782,5,-18,160,65974,5,65969
37783,16,4,335,775627,16,775611
37784,14,-5,236,492741,14,492727
37785,7,-6,373,444822,7,444815
37786,16,6,241,837560,16,837544
37787,8,-9,86,345483,8,345475
37788,5,8,53,876193,5,876188
37789,7,10,575,949891,7,949884
37790,17,-1,953,623815,17,623798
37791,19,-1,856,623107,19,623088
37792,19,11,701,995811,19,995792
37793,7,-18,584,74994,7,74987
37794,5,-6,699,451834,5,451829
37795,12,13,990,1060526,12,1060514
37796,7,11,654,982399,7,982392
37797,7,-8,929,395175,7,395168
37798,18,17,342,1180553,18,1180535
37799,17,14,780,1091599,17,1091582
37800,11,4,285,775251,11,775240
37801,15,-13,447,244282,15,244267
37802,13,-5,961,498071,13,498058
37803,15,-16,629,151655,15,151640
37804,11,10,340,962376,11,962365
37805,17,-4,430,525418,17,525401
37806,10,-20,737,16202,10,16192
37807,20,18,317,1211400,20,1211380
37808,15,-12,523,276428,15,276413
37809,14,17,283,1180043,14,1180029
37810,5,6,1,812153,5,812148
37811,8,8,443,884924,8,884916
37812,18,12,532,1025938,18,1025920
37813,10,-19,261,37254,10,37244
37814,16,-1,281,618747,16,618731
37815,19,-20,612,27444,19,27425
37816,12,9,221,930699,12,930687
37817,5,16,131,1127844,5,1127839
37818,18,-15,802,183736,18,183718
37819,18,19,517,1245049,18,1245031
37820,6,8,372,883266,6,883260
37821,13,-11,460,307433,13,307420
37822,15,-19,211,55752,15,55737
37823,6,2,602,701299,6,701293
37824,12,-5,491,494660,12,494648
37825,19,-8,742,403121,19,403102
37826,17,1,78,680359,17,680342
37827,7,10,605,950567,7,950560
37828,13,0,18,648342,13,648329
37829,7,-14,726,202537,7,202530
37830,15,-9,476,370415,15,370400
37831,11,3,259,743829,11,743818
37832,20,-7,412,431439,20,431419
37833,14,-17,228,117121,14,117107
37834,19,-11,442,307314,19,307295
37835,17,16,480,1150571,17,1150554
37836,18,-10,609,339635,18,339617
37837,14,16,245,1148844,14,1148830
37838,13,5,109,804595,13,804582
37839,17,10,276,961912,17,961895
37840,20,-6,189,460633,20,460613
37841,5,-16,949,144395,5,144390
37842,16,9,337,931489,16,931473
37843,11,7,974,873919,11,873908
37844,8,0,715,641035,8,641027
37845,10,-12,619,262901,10,262891
37846,20,-8,348,400354,20,400334
37847,20,8,128,898933,20,898913
37848,20,-10,371,337734,20,337714
37849,20,5,567,807895,20,807875
37850,10,-1,142,596845,10,596835
37851,13,-2,899,591985,13,591972
37852,9,-17,322,100480,9,100471
37853,11,4,469,776634,11,776623
37854,20,-13,911,247885,20,247865
37855,18,0,303,650359,18,650341
37856,17,19,29,1240933,17,1240916
37857,11,-6,50,459488,11,459477
37858,13,14,389,1088456,13,1088443
37859,18,-13,256,242933,18,242915
37860,6,16,592,1137634,6,1137628
37861,5,-3,318,537338,5,537333
37862,12,19,201,1242344,12,1242332
37863,5,15,125,1097245,5,1097240
37864,18,-1,216,618242,18,618224
37865,12,-15,304,179986,12,179974
37866,7,-2,802,579875,7,579868
37867,19,3,108,742668,19,742649
37868,11,16,15,1147197,11,1147186
37869,10,17,265,1160913,10,1160903
37870,19,17,774,1183617,19,1183598
37871,9,-11,557,293515,9,293506
37872,19,17,707,1183152,19,1183133
37873,17,-6,757,464927,17,464910
37874,17,-10,230,336767,17,336750
37875,7,-10,785,329361,7,329354
37876,9,-10,400,321269,9,321260
37877,7,-4,365,507556,7,507549
37878,12,0,832,654578,12,654566
37879,18,-12,319,274899,18,274881
37880,9,-17,374,101509,9,101500
37881,13,0,400,651102,13,651089
37882,12,18,736,1214221,12,1214209
37883,12,-12,719,277792,12,277780
37884,6,15,143,1097610,6,1097604
37885,7,-9,623,357418,7,357411
37886,6,-13,583,230816,6,230810
37887,12,11,462,994218,12,994206
37888,5,-15,678,169944,5,169939
37889,13,9,203,930549,13,930536
37890,10,-20,115,2554,10,2544
37891,13,-9,486,370507,13,370494
37892,6,-2,172,566344,6,566338
37893,8,-3,708,546401,8,546393
37894,10,-11,588,294218,10,294208
37895,20,-18,50,85576,20,85556
37896,15,-3,62,554199,15,554184
37897,20,-6,143,460222,20,460202
37898,20,19,70,1241313,20,1241293
37899,6,-3,122,533053,6,533047
37900,11,-20,166,24016,11,24005
37901,6,8,614,888569,6,888563
37902,14,9,152,930149,14,930135
37903,20,6,651,841016,20,840996
37904,7,15,407,1102988,7,1102981
37905,5,-17,282,99554,5,99549
37906,15,-8,540,401667,15,401652
37907,7,-3,136,533377,7,533370
37908,7,6,333,819817,7,819810
37909,12,6,167,836998,12,836986
37910,19,8,119,898885,19,898866
37911,15,5,950,810787,15,810772
37912,5,0,83,627085,5,627080
37913,13,-7,464,431829,13,431816
37914,5,10,900,956806,5,956801
37915,17,-11,497,307728,17,307711
37916,5,-7,468,415831,5,415826
37917,14,-10,696,340343,14,340329
37918,15,6,275,837860,15,837845
37919,14,-6,164,460399,14,460385
37920,8,14,728,1078391,8,1078383
37921,9,4,386,758944,9,758935
37922,6,7,257,850331,6,850325
37923,7,-14,948,207101,7,207094
37924,11,-1,731,622207,11,622196
37925,16,6,779,841998,16,841982
37926,16,14,903,1092517,16,1092501
37927,6,19,663,1232207,6,1232201
37928,11,15,291,1118955,11,1118944
37929,10,3,727,734657,10,734647
37930,6,13,272,1036435,6,1036429
37931,17,7,972,873889,17,873872
37932,8,-3,13,530863,8,530855
37933,8,19,460,1228049,8,1228041
37934,8,1,385,665632,8,665624
37935,12,-9,240,368317,12,368305
37936,5,9,545,918265,5,918260
37937,5,-4,541,511199,5,511194
37938,6,-13,572,230528,6,230522
37939,10,-14,583,199340,10,199330
37940,10,-9,274,349591,10,349581
37941,6,-20,466,9961,6,9955
37942,5,10,456,947233,5,947228
37943,19,-7,64,428761,19,428742
37944,8,4,468,760685,8,760677
37945,19,-15,913,184726,19,184707
37946,8,-5,206,472468,8,472460
37947,10,12,148,1002335,10,1002325
37948,16,-10,574,339343,16,339327
37949,13,18,729,1214171,13,1214158
37950,10,-15,305,162010,10,162000
37951,17,6,111,836622,17,836605
37952,11,-10,451,338419,11,338408
37953,15,-19,746,59880,15,59865
37954,6,-8,453,384709,6,384703
37955,9,9,247,911900,9,911891
37956,13,10,849,966330,13,966317
37957,14,-3,213,555275,14,555261
37958,6,-7,173,409512,6,409506
37959,9,-10,393,321090,9,321081
37960,16,0,98,649012,16,648996
37961,9,17,881,1174255,9,1174246
37962,11,-5,510,494776,11,494765
37963,8,15,103,1096734,8,1096726
37964,20,-2,191,586499,20,586479
37965,5,12,402,1007750,5,1007745
37966,19,3,317,744321,19,744302
37967,8,-1,944,614319,8,614311
37968,5,-2,542,574217,5,574212
37969,20,14,760,1091441,20,1091421
37970,12,6,899,842921,12,842909
37971,11,-3,377,556589,11,556578
37972,18,5,86,804435,18,804417
37973,20,-16,493,150644,20,150624
37974,17,11,269,992796,17,992779
37975,9,16,85,1126952,9,1126943
37976,12,9,50,929465,12,929453
37977,15,-3,292,555881,15,555866
37978,15,-12,981,279971,15,279956
37979,13,4,325,775560,13,775547
37980,16,9,60,929505,16,929489
37981,14,13,898,1059918,14,1059904
37982,13,13,129,1054165,13,1054152
37983,12,7,321,869349,12,869337
37984,11,5,896,810286,11,810275
37985,12,8,298,900302,12,900290
37986,16,-10,16,335266,16,335250
37987,15,-13,514,244833,15,244818
37988,14,13,0,1053231,14,1053217
37989,6,-5,740,484013,6,484007
37990,15,-10,432,338211,15,338196
37991,11,-18,265,87358,11,87347
37992,10,18,718,1201647,10,1201637
37993,6,0,239,630606,6,630600
37994,18,-17,665,120516,18,120498
37995,6,1,813,674689,6,674683
37996,18,-11,810,310046,18,310028
37997,16,1,524,684011,16,683995
37998,18,-7,932,435204,18,435186
37999,19,-4,951,529191,19,529172
38000,15,-13,741,246497,15,246482
38001,10,18,303,1193343,10,1193333
38002,7,3,360,726638,7,726631
38003,7,7,515,855809,7,855802
38004,20,-5,77,491454,20,491434
38005,15,-15,983,185247,15,185232
38006,12,9,828,935202,12,935190
38007,10,18,329,1193844,10,1193834
38008,8,2,341,695990,8,695982
38009,19,5,881,810190,19,810171
38010,12,15,8,1116802,12,1116790
38011,11,1,759,685771,11,685760
38012,9,13,79,1032430,9,1032421
38013,12,-1,730,622205,12,622193
38014,11,3,60,742292,11,742281
38015,18,19,286,1243027,18,1243009
38016,9,17,973,1176260,9,1176251
38017,6,-15,544,167156,6,167150
38018,12,-20,755,28622,12,28610
38019,19,-15,698,182930,19,182911
38020,18,-1,565,621020,18,621002
38021,8,-3,35,531320,8,531312
38022,10,9,415,915374,10,915364
38023,18,-13,86,241661,18,241643
38024,20,19,641,1245991,20,1245971
38025,10,2,110,690963,10,690953
38026,16,14,18,1085508,16,1085492
38027,5,-2,697,577736,5,577731
38028,9,0,717,641122,9,641113
38029,9,-5,72,469459,9,469450
38030,5,10,854,955873,5,955868
38031,14,13,702,1058503,14,1058489
38032,11,-15,972,185157,11,185146
38033,6,-5,43,468821,6,468815
38034,8,-10,631,326190,8,326182
38035,5,-11,298,287603,5,287598
38036,15,17,457,1181363,15,1181348
38037,11,13,806,1059305,11,1059294
38038,5,19,187,1221665,5,1221660
38039,9,19,779,1234750,9,1234741
38040,5,-12,987,271131,5,271126
38041,10,14,0,1061672,10,1061662
38042,13,10,571,964279,13,964266
38043,17,-4,438,525441,17,525424
38044,14,-8,105,398648,14,398634
38045,19,10,158,961070,19,961051
38046,11,-19,461,57501,11,57490
38047,15,-14,71,209858,15,209843
38048,19,-13,869,247504,19,247485
38049,13,-6,808,465333,13,465320
38050,14,-9,755,372430,14,372416
38051,18,-3,866,560720,18,560702
38052,20,-12,263,274461,20,274441
38053,13,19,643,1246006,13,1245993
38054,7,-3,59,531753,7,531746
38055,9,13,170,1034264,9,1034255
38056,9,-8,588,387733,9,387724
38057,9,14,573,1074539,9,1074530
38058,9,-3,288,536654,9,536645
38059,7,-7,530,417220,7,417213
38060,18,10,558,964161,18,964143
38061,7,-13,294,224712,7,224705
38062,10,-9,781,361023,10,361013
38063,6,8,973,896331,6,896325
38064,16,16,960,1153931,16,1153915
38065,17,-4,388,525113,17,525096
38066,5,-5,531,479563,5,479558
38067,15,-20,123,23678,15,23663
38068,18,15,628,1121400,18,1121382
38069,13,-4,504,525928,13,525915
38070,17,14,807,1091790,17,1091773
38071,12,-12,21,272653,12,272641
38072,13,-18,888,91675,13,91662
38073,18,-16,241,148743,18,148725
38074,8,13,908,1050163,8,1050155
38075,12,-16,226,148654,12,148642
38076,18,-13,722,246345,18,246327
38077,6,10,933,957614,6,957608
38078,18,2,944,717503,18,717485
38079,15,1,324,682470,15,682455
38080,12,-15,846,184133,12,184121
38081,10,16,28,1125775,10,1125765
38082,20,-15,271,179718,20,179698
38083,8,0,786,642541,8,642533
38084,20,0,154,649369,20,649349
38085,18,-9,767,372609,18,372591
38086,8,-10,291,318819,8,318811
38087,18,6,82,836335,18,836317
38088,7,4,767,767313,7,767306
38089,6,-20,2,77,6,71
38090,7,2,954,708577,7,708570
38091,5,9,277,912470,5,912465
38092,11,19,707,1246509,11,1246498
38093,10,6,405,821542,10,821532
38094,13,-16,737,152300,13,152287
38095,16,13,766,1058984,16,1058968
38096,9,-8,63,376797,9,376788
38097,13,4,413,776206,13,776193
38098,7,-20,177,4049,7,4042
38099,14,-14,337,212035,14,212021
38100,16,-18,105,86037,16,86021
38101,20,-10,771,340868,20,340848
38102,17,-4,478,525672,17,525655
38103,19,-3,4,553877,19,553858
38104,15,-17,163,116681,15,116666
38105,20,5,183,805168,20,805148
38106,14,11,691,995737,14,995723
38107,9,-13,162,221793,9,221784
38108,18,-17,412,118494,18,118476
38109,10,9,616,919870,10,919860
38110,7,7,300,851260,7,851253
38111,6,-4,353,507257,6,507251
38112,11,-20,400,25839,11,25828
38113,17,10,341,962397,17,962380
38114,16,-20,402,25875,16,25859
38115,20,8,71,898433,20,898413
38116,6,7,904,863931,6,863925
38117,16,16,431,1150243,16,1150227
38118,6,-7,662,419761,6,419755
38119,13,-16,668,151816,13,151803
38120,7,15,238,1099560,7,1099553
38121,15,18,14,1209022,15,1209007
38122,18,3,674,746968,18,746950
38123,13,-1,808,622764,13,622751
38124,12,16,85,1147668,12,1147656
38125,11,10,55,960262,11,960251
38126,17,14,827,1091939,17,1091922
38127,12,1,723,685488,12,685476
38128,6,-17,577,105982,6,105976
38129,17,1,871,686595,17,686578
38130,13,-17,41,115859,13,115846
38131,16,-15,82,178393,16,178377
38132,7,11,504,979207,7,979200
38133,15,5,798,809574,15,809559
38134,19,19,9,1240725,19,1240706
38135,17,-17,863,121920,17,121903
38136,5,13,33,1031468,5,1031463
38137,12,-3,235,555419,12,555407
38138,14,9,681,934064,14,934050
38139,19,-13,550,245086,19,245067
38140,18,-19,696,59425,18,59407
38141,19,-18,661,90098,19,90079
38142,12,-18,686,90225,12,90213
38143,11,12,866,1028584,11,1028573
38144,11,-5,334,493628,11,493617
38145,5,1,652,671434,5,671429
38146,17,-18,350,87969,17,87952
38147,14,-3,741,559663,14,559649
38148,6,-15,971,176124,6,176118
38149,19,5,344,806313,19,806294
38150,14,16,690,1152017,14,1152003
38151,20,5,958,810841,20,810821
38152,19,-18,250,87270,19,87251
38153,11,-11,61,304152,11,304141
38154,13,-20,527,26792,13,26779
38155,7,16,750,1140644,7,1140637
38156,17,1,731,685552,17,685535
38157,16,0,95,648988,16,648972
38158,10,-13,750,234436,10,234426
38159,11,-1,859,623126,11,623115
38160,6,11,667,982639,6,982633
38161,12,3,212,743476,12,743464
38162,11,14,364,1088270,11,1088259
38163,16,-11,918,310875,16,310859
38164,18,1,537,684159,18,684141
38165,18,0,641,653101,18,653083
38166,7,1,775,673863,7,673856
38167,12,-7,122,429184,12,429172
38168,11,5,197,805310,11,805299
38169,19,-10,798,341118,19,341099
38170,14,-9,514,370714,14,370700
38171,10,8,320,882247,10,882237
38172,17,4,34,773529,17,773512
38173,8,2,747,704417,8,704409
38174,6,-14,301,193231,6,193225
38175,10,-16,998,145620,10,145610
38176,5,18,49,1187717,5,1187712
38177,10,-6,944,456919,10,456909
38178,18,10,354,962472,18,962454
38179,18,2,580,714921,18,714903
38180,7,-18,486,72861,7,72854
38181,20,-13,192,242476,20,242456
38182,6,-19,942,51756,6,51750
38183,9,3,494,729414,9,729405
38184,7,19,750,1234106,7,1234099
38185,5,-12,192,253544,5,253539
38186,19,10,359,962540,19,962521
38187,13,5,751,809250,13,809237
38188,20,-2,13,585207,20,585187
38189,13,-5,629,495658,13,495645
38190,20,11,285,992942,20,992922
38191,9,7,29,845372,9,845363
38192,10,-11,999,302664,10,302654
38193,7,-6,819,454409,7,454402
38194,12,-9,701,371981,12,371969
38195,17,8,297,900294,17,900277
38196,13,4,900,779912,13,779899
38197,12,12,112,1022888,12,1022876
38198,16,-1,184,617909,16,617893
38199,6,-18,690,77125,6,77119
38200,9,8,554,887361,9,887352
38201,5,14,437,1071589,5,1071584
38202,16,0,890,655045,16,655029
38203,7,0,920,645309,7,645302
38204,16,6,482,839650,16,839634
38205,18,-5,317,493445,18,493427
38206,16,-6,719,464646,16,464630
38207,6,-6,420,445771,6,445765
38208,19,-4,288,524309,19,524290
38209,7,-3,606,544019,7,544012
38210,16,10,220,961498,16,961482
38211,7,-2,761,578968,7,578961
38212,9,16,862,1143002,9,1142993
38213,20,-11,430,307216,20,307196
38214,11,-4,244,524026,11,524015
38215,5,0,140,628494,5,628489
38216,18,-10,883,341762,18,341744
38217,20,16,87,1147705,20,1147685
38218,12,16,427,1150208,12,1150196
38219,17,-20,983,30303,17,30286
38220,11,15,420,1119742,11,1119731
38221,14,-7,720,433547,14,433533
38222,8,-9,732,359740,8,359732
38223,6,19,622,1231427,6,1231421
38224,16,9,316,931322,16,931306
38225,8,-19,18,31863,8,31855
38226,18,8,156,899190,18,899172
38227,8,-2,931,582736,8,582728
38228,5,7,144,847874,5,847869
38229,16,-13,698,246123,16,246107
38230,14,-9,690,371887,14,371873
38231,8,4,818,768468,8,768460
38232,18,-4,70,522580,18,522562
38233,8,-2,233,567707,8,567699
38234,13,4,434,776391,13,776378
38235,5,12,395,1007605,5,1007600
38236,11,-7,333,430855,11,430844
38237,18,10,675,965137,18,965119
38238,13,7,35,867279,13,867266
38239,8,4,100,752827,8,752819
38240,10,-4,167,503035,10,503025
38241,15,19,265,1242882,15,1242867
38242,18,2,630,715305,18,715287
38243,17,14,843,1092023,17,1092006
38244,19,9,115,929904,19,929885
38245,7,1,486,667861,7,667854
38246,9,8,761,891901,9,891892
38247,19,5,85,804418,19,804399
38248,11,4,790,779051,11,779040
38249,14,2,164,711831,14,711817
38250,5,-3,416,539587,5,539582
38251,17,11,622,995296,17,995279
38252,14,-16,110,147732,14,147718
38253,13,18,462,1212392,13,1212379
38254,7,-15,922,175052,7,175045
38255,19,-7,243,430091,19,430072
38256,9,-3,508,541866,9,541857
38257,10,-19,304,38113,10,38103
38258,12,0,55,648651,12,648639
38259,16,-11,569,308265,16,308249
38260,16,2,794,716416,16,716400
38261,10,6,273,818381,10,818371
38262,9,-4,292,505866,9,505857
38263,12,-1,459,620209,12,620197
38264,12,11,668,995577,12,995565
38265,20,-15,530,181681,20,181661
38266,13,-13,608,245550,13,245537
38267,14,19,503,1244921,14,1244907
38268,7,19,453,1227944,7,1227937
38269,15,10,106,960699,15,960684
38270,14,-17,481,119057,14,119043
38271,18,-18,124,86165,18,86147
38272,14,-10,705,340396,14,340382
38273,12,-12,568,276709,12,276697
38274,9,-20,639,13992,9,13983
38275,6,0,961,646254,6,646248
38276,14,-8,647,402420,14,402406
38277,14,-9,913,373829,14,373815
38278,12,4,649,777996,12,777984
38279,8,9,722,921958,8,921950
38280,14,4,836,779470,14,779456
38281,9,15,901,1113627,9,1113618
38282,5,11,819,985965,5,985960
38283,19,-4,102,522804,19,522785
38284,11,-10,284,337099,11,337088
38285,9,-8,140,378415,9,378406
38286,15,3,680,747010,15,746995
38287,18,-13,647,245766,18,245748
38288,13,7,290,869107,13,869094
38289,17,-19,762,59967,17,59950
38290,14,6,653,841021,14,841007
38291,19,13,153,1054329,19,1054310
38292,15,-4,332,524664,15,524649
38293,19,8,331,900594,19,900575
38294,18,-10,515,338907,18,338889
38295,15,-18,102,86005,15,85990
38296,19,10,774,965808,19,965789
38297,15,1,452,683399,15,683384
38298,20,6,11,835843,20,835823
38299,9,-4,999,521014,9,521005
38300,20,-20,721,28318,20,28298
38301,7,-4,824,516886,7,516879
38302,7,17,353,1162897,7,1162890
38303,20,-3,773,559999,20,559979
38304,18,-9,75,367201,18,367183
38305,11,-18,548,89277,11,89266
38306,11,13,546,1057349,11,1057338
38307,14,-12,349,275147,14,275133
38308,17,-7,857,434568,17,434551
38309,6,15,225,1099358,6,1099352
38310,6,-2,248,568070,6,568064
38311,13,-2,259,587071,13,587058
38312,18,-9,447,370128,18,370110
38313,8,-17,885,112214,8,112206
38314,11,10,771,965782,11,965771
38315,16,-10,284,337105,16,337089
38316,17,1,283,682119,17,682102
38317,19,7,698,872131,19,872112
38318,16,-13,793,246924,16,246908
38319,14,16,80,1147639,14,1147625
38320,9,13,510,1041713,9,1041704
38321,8,2,375,696789,8,696781
38322,16,7,718,872231,16,872215
38323,20,-2,237,586936,20,586916
38324,17,3,201,743430,17,743413
38325,8,10,690,952410,8,952402
38326,6,-3,129,533218,6,533212
38327,14,19,676,1246245,14,1246231
38328,11,4,949,780258,11,780247
38329,7,-16,994,145505,7,145498
38330,14,3,413,744972,14,744958
38331,9,8,997,896864,9,896855
38332,14,9,679,934055,14,934041
38333,8,-9,927,364435,8,364427
38334,7,-5,773,484615,7,484608
38335,18,-12,400,275444,18,275426
38336,5,1,347,664794,5,664789
38337,9,7,41,845694,9,845685
38338,20,19,115,1241730,20,1241710
38339,6,-18,185,66517,6,66511
38340,12,-13,264,243023,12,243011
38341,11,9,786,934846,11,934835
38342,9,-20,529,11426,9,11417
38343,10,8,385,883564,10,883554
38344,14,-19,427,57275,14,57261
38345,5,13,271,1036410,5,1036405
38346,19,10,608,964609,19,964590
38347,12,-6,604,463762,12,463750
38348,13,-18,67,85727,13,85714
38349,19,-8,603,402073,19,402054
38350,19,3,443,745174,19,745155
38351,8,-1,820,611452,8,611444
38352,19,9,826,935160,19,935141
38353,15,-5,908,497698,15,497683
38354,10,-2,642,576404,10,576394
38355,18,19,396,1244032,18,1244014
38356,17,-9,26,366788,17,366771
38357,11,-2,282,587220,11,587209
38358,11,4,332,775603,11,775592
38359,7,-3,690,546018,7,546011
38360,12,2,114,711449,12,711437
38361,5,18,811,1203867,5,1203862
38362,10,0,71,626828,10,626818
38363,5,6,90,814133,5,814128
38364,12,-12,428,275603,12,275591
38365,8,4,83,752373,8,752365
38366,7,-5,151,471365,7,471358
38367,20,1,92,680498,20,680478
38368,13,-1,589,621168,13,621155
38369,12,18,572,1213082,12,1213070
38370,18,-7,694,433369,18,433351
38371,17,-1,261,618576,17,618559
38372,20,-12,700,277666,20,277646
38373,8,-3,68,531982,8,531974
38374,8,14,120,1064526,8,1064518
38375,19,12,196,1023435,19,1023416
38376,9,2,877,706851,9,706842
38377,8,-16,321,130971,8,130963
38378,5,-9,954,364953,5,364948
38379,20,5,51,804192,20,804172
38380,5,5,864,799740,5,799735
38381,17,4,690,778303,17,778286
38382,19,-15,542,181752,19,181733
38383,20,-14,837,216028,20,216008
38384,13,9,485,932615,13,932602
38385,17,-19,575,58572,17,58555
38386,19,10,912,966864,19,966845
38387,12,2,996,717826,12,717814
38388,11,16,884,1153359,11,1153348
38389,13,-15,495,181422,13,181409
38390,15,10,549,964045,15,964030
38391,14,-16,789,152719,14,152705
38392,16,9,183,930425,16,930409
38393,7,10,104,939866,7,939859
38394,10,-11,145,284353,10,284343
38395,10,-9,367,351699,10,351689
38396,14,-13,333,243506,14,243492
38397,19,3,31,742028,19,742009
38398,18,1,139,680966,18,680948
38399,17,-4,519,526027,17,526010
38400,6,-2,284,568849,6,568843
38401,8,1,669,671767,8,671759
38402,17,7,227,868611,17,868594
38403,7,-4,568,511694,7,511687
38404,13,-3,536,558062,13,558049
38405,18,-3,612,558621,18,558603
38406,14,-6,947,466307,14,466293
38407,8,8,747,891626,8,891618
38408,9,3,125,721560,9,721551
38409,8,-6,593,449565,8,449557
38410,18,6,801,842187,18,842169
38411,13,-10,916,341940,13,341927
38412,18,3,825,748028,18,748010
38413,20,0,825,654524,20,654504
38414,14,-15,584,182080,14,182066
38415,9,-14,529,197995,9,197986
38416,11,2,859,716892,11,716881
38417,12,14,710,1091038,12,1091026
38418,14,7,612,871517,14,871503
38419,19,6,259,837755,19,837736
38420,13,-7,279,430400,13,430387
38421,6,9,294,912810,6,912804
38422,17,14,46,1085777,17,1085760
38423,11,-7,516,432233,11,432222
38424,9,-1,268,599721,9,599712
38425,19,13,901,1059930,19,1059911
38426,14,17,505,1181684,14,1181670
38427,17,14,381,1088400,17,1088383
38428,10,-8,993,396617,10,396607
38429,9,-8,732,391051,9,391042
38430,15,-11,221,305436,15,305421
38431,7,8,180,878985,7,878978
38432,5,-19,619,45098,5,45093
38433,18,16,258,1148982,18,1148964
38434,18,17,974,1185262,18,1185244
38435,10,-10,834,330492,10,330482
38436,12,-6,946,466304,12,466292
38437,19,10,682,965205,19,965186
38438,8,6,604,825951,8,825943
38439,9,11,898,987853,9,987844
38440,7,-17,690,108251,7,108244
38441,20,15,14,1116866,20,1116846
38442,18,-17,365,118187,18,118169
38443,11,-2,280,587221,11,587210
38444,17,-13,231,242753,17,242736
38445,12,-16,679,151895,12,151883
38446,5,12,129,1001915,5,1001910
38447,8,-5,237,473239,8,473231
38448,6,-8,611,388363,6,388357
38449,5,-9,208,347984,5,347979
38450,7,-5,98,470249,7,470242
38451,16,5,21,803898,16,803882
38452,16,15,753,1122414,16,1122398
38453,11,-2,182,586381,11,586370
38454,11,12,576,1026272,11,1026261
38455,8,-8,498,385734,8,385726
38456,11,13,329,1055644,11,1055633
38457,14,-2,776,590935,14,590921
38458,19,17,304,1180255,19,1180236
38459,16,17,852,1184406,16,1184390
38460,19,-3,399,556730,19,556711
38461,12,-15,607,182220,12,182208
38462,6,-2,324,569712,6,569706
38463,13,6,753,841806,13,841793
38464,15,0,639,653081,15,653066
38465,16,-18,164,86508,16,86492
38466,18,9,354,931627,18,931609
38467,12,11,900,997422,12,997410
38468,18,-5,579,495326,18,495308
38469,5,-19,158,35210,5,35205
38470,20,8,272,900088,20,900068
38471,16,-6,17,459249,16,459233
38472,5,8,366,883171,5,883166
38473,9,14,507,1073143,9,1073134
38474,9,8,388,883701,9,883692
38475,18,-12,324,274953,18,274935
38476,16,9,26,929245,16,929229
38477,7,-11,55,282272,7,282265
38478,13,8,81,898528,13,898515
38479,9,-15,914,174900,9,174891
38480,15,14,485,1089216,15,1089201
38481,17,4,748,778769,17,778752
38482,5,5,681,795763,5,795758
38483,17,-15,821,183932,17,183915
38484,19,0,975,655742,19,655723
38485,19,-13,773,246808,19,246789
38486,9,-2,227,567613,9,567604
38487,11,-8,600,402037,11,402026
38488,17,1,787,685979,17,685962
38489,18,4,845,779572,18,779554
38490,6,17,580,1167602,6,1167596
38491,5,-18,881,81446,5,81441
38492,6,14,377,1070138,6,1070132
38493,6,0,3,625222,6,625216
38494,11,-14,104,210137,11,210126
38495,13,-20,566,27111,13,27098
38496,17,4,783,779026,17,779009
38497,12,-10,134,336135,12,336123
38498,5,3,649,732801,5,732796
38499,10,19,714,1233338,10,1233328
38500,9,-1,820,611461,9,611452
38501,19,6,661,841083,19,841064
38502,14,-5,176,492307,14,492293
38503,6,0,447,635065,6,635059
38504,19,-12,185,273840,19,273821
38505,14,6,218,837350,14,837336
38506,9,-13,514,229268,9,229259
38507,17,7,827,873001,17,872984
38508,13,18,62,1209449,13,1209436
38509,11,10,632,964781,11,964770
38510,15,-20,270,24844,15,24829
38511,8,4,98,752761,8,752753
38512,9,0,629,639038,9,639029
38513,15,5,71,804322,15,804307
38514,16,4,675,778193,16,778177
38515,11,8,436,901444,11,901433
38516,16,-16,498,150673,16,150657
38517,18,7,652,871791,18,871773
38518,20,10,93,960604,20,960584
38519,9,6,41,813137,9,813128
38520,7,6,771,829614,7,829607
38521,8,-17,134,96242,8,96234
38522,16,7,331,869440,16,869424
38523,14,0,327,650489,14,650475
38524,19,-16,580,151275,19,151256
38525,15,-3,985,561646,15,561631
38526,16,7,632,871645,16,871629
38527,6,14,901,1081991,6,1081985
38528,20,-14,988,217187,20,217167
38529,6,11,174,972018,6,972012
38530,15,18,746,1214344,15,1214329
38531,15,-9,898,373700,15,373685
38532,10,10,933,957624,10,957614
38533,6,8,918,895112,6,895106
38534,17,-19,239,55915,17,55898
38535,14,13,657,1058201,14,1058187
38536,13,-8,974,404831,13,404818
38537,9,-10,568,324976,9,324967
38538,15,-20,896,29700,15,29685
38539,11,7,574,871253,11,871242
38540,14,-14,795,215732,14,215718
38541,19,-12,451,275760,19,275741
38542,11,-19,865,60653,11,60642
38543,14,14,950,1092901,14,1092887
38544,20,11,293,993036,20,993016
38545,18,5,139,804812,18,804794
38546,6,-15,929,175183,6,175177
38547,18,-12,880,279080,18,279062
38548,7,15,808,1111508,7,1111501
38549,11,12,863,1028571,11,1028560
38550,13,-11,952,311168,13,311155
38551,13,-19,410,57173,13,57160
38552,5,-15,143,158538,5,158533
38553,15,-3,524,557931,15,557916
38554,13,15,147,1117912,13,1117899
38555,8,-10,219,317439,8,317431
38556,14,-17,555,119666,14,119652
38557,15,12,321,1024467,15,1024452
38558,7,-5,616,481372,7,481365
38559,11,3,956,749135,11,749124
38560,18,-4,323,524622,18,524604
38561,7,4,589,763337,7,763330
38562,18,-19,197,55627,18,55609
38563,6,3,737,734827,6,734821
38564,18,-20,182,24210,18,24192
38565,16,7,651,871775,16,871759
38566,18,-17,176,116755,18,116737
38567,10,12,602,1012078,10,1012068
38568,15,10,799,966094,15,966079
38569,13,9,708,934295,13,934282
38570,17,-18,388,88207,17,88190
38571,15,-2,723,590587,15,590572
38572,17,8,900,904981,17,904964
38573,9,-5,949,488670,9,488661
38574,20,3,370,744648,20,744628
38575,14,-1,417,619880,14,619866
38576,7,7,88,846740,7,846733
38577,18,7,295,869134,18,869116
38578,7,-20,910,20154,7,20147
38579,11,17,493,1181582,11,1181571
38580,19,3,317,744330,19,744311
38581,7,-1,662,608161,7,608154
38582,11,6,222,837393,11,837382
38583,11,-17,127,116441,11,116430
38584,6,13,850,1049043,6,1049037
38585,9,8,189,879164,9,879155
38586,18,-10,895,341813,18,341795
38587,13,6,231,837498,13,837485
38588,6,10,440,946994,6,946988
38589,6,-11,126,283843,6,283837
38590,17,4,87,773889,17,773872
38591,11,-6,975,466523,11,466512
38592,17,13,297,1055408,17,1055391
38593,10,-10,685,327452,10,327442
38594,9,-7,754,421784,9,421775
38595,6,3,204,723282,6,723276
38596,15,3,301,744181,15,744166
38597,20,0,238,650018,20,649998
38598,7,-12,635,263246,7,263239
38599,20,-16,268,148958,20,148938
38600,10,4,226,755569,10,755559
38601,14,-5,884,497518,14,497504
38602,9,-13,108,220726,9,220717
38603,8,14,837,1080623,8,1080615
38604,17,5,174,805068,17,805051
38605,10,19,923,1237965,10,1237955
38606,10,-1,459,604043,10,604033
38607,15,-18,78,85826,15,85811
38608,14,16,60,1147519,14,1147505
38609,16,4,496,776810,16,776794
38610,6,11,579,980860,6,980854
38611,15,-1,393,619696,15,619681
38612,6,8,679,890139,6,890133
38613,17,-4,35,522294,17,522277
38614,19,9,634,933787,19,933768
38615,7,15,776,1110909,7,1110902
38616,7,-16,826,141769,7,141762
38617,20,16,630,1151585,20,1151565
38618,17,4,41,773565,17,773548
38619,10,-11,68,282630,10,282620
38620,11,-14,479,213197,11,213186
38621,14,5,605,808215,14,808201
38622,15,-17,942,122418,15,122403
38623,8,17,623,1168591,8,1168583
38624,7,-6,926,456527,7,456520
38625,20,-19,538,58171,20,58151
38626,16,6,848,842553,16,842537
38627,11,-10,281,337089,11,337078
38628,15,-3,637,558888,15,558873
38629,17,-15,191,179123,17,179106
38630,13,8,699,903539,13,903526
38631,20,12,243,1023853,20,1023833
38632,18,-15,258,179626,18,179608
38633,16,-17,274,117505,16,117489
38634,16,12,641,1026836,16,1026820
38635,7,-3,941,551560,7,551553
38636,5,-20,150,3328,5,3323
38637,19,-9,73,367175,19,367156
38638,10,-2,569,574887,10,574877
38639,5,-18,152,65775,5,65770
38640,6,-16,438,133636,6,133630
38641,6,-10,217,317376,6,317370
38642,8,19,170,1221251,8,1221243
38643,7,-9,563,356294,7,356287
38644,13,15,561,1120829,13,1120816
38645,19,5,904,810385,19,810366
38646,14,15,193,1118245,14,1118231
38647,7,5,758,797445,7,797438
38648,18,9,623,933712,18,933694
38649,16,4,978,780413,16,780397
38650,16,11,235,992497,16,992481
38651,20,-11,375,306759,20,306739
38652,15,16,465,1150448,15,1150433
38653,6,-2,624,576047,6,576041
38654,16,-17,648,120329,16,120313
38655,20,-1,576,621100,20,621080
38656,15,9,92,929711,15,929696
38657,20,14,690,1090905,20,1090885
38658,17,-17,983,122702,17,122685
38659,9,10,666,951934,9,951925
38660,18,8,513,902036,18,902018
38661,9,-18,127,65304,9,65295
38662,19,2,158,711794,19,711775
38663,11,4,553,777254,11,777243
38664,16,-9,555,371113,16,371097
38665,11,-1,548,620904,11,620893
38666,9,-11,115,283652,9,283643
38667,20,-12,868,279016,20,278996
38668,17,-19,489,57725,17,57708
38669,6,-13,253,223731,6,223725
38670,7,1,236,662385,7,662378
38671,14,19,73,1241354,14,1241340
38672,17,10,35,960124,17,960107
38673,9,2,457,698400,9,698391
38674,18,-9,309,368846,18,368828
38675,6,-4,724,514931,6,514925
38676,17,18,805,1214818,17,1214801
38677,8,4,981,771921,8,771913
38678,7,2,91,690544,7,690537
38679,19,1,978,687445,19,687426
38680,15,-1,642,621510,15,621495
38681,20,-19,171,55414,20,55394
38682,10,-5,76,469582,10,469572
38683,6,1,488,667917,6,667911
38684,20,17,297,1180204,20,1180184
38685,11,-9,536,370973,11,370962
38686,12,-18,943,92065,12,92053
38687,13,-7,269,430301,13,430288
38688,13,9,942,936113,13,936100
38689,6,-7,45,407016,6,407010
38690,18,13,726,1058634,18,1058616
38691,11,7,602,871485,11,871474
38692,6,19,84,1219377,6,1219371
38693,10,13,751,1046856,10,1046846
38694,14,9,959,936228,14,936214
38695,6,16,503,1135897,6,1135891
38696,17,4,184,774573,17,774556
38697,12,12,712,1027399,12,1027387
38698,14,13,974,1060447,14,1060433
38699,8,-13,134,221221,8,221213
38700,20,-14,365,212292,20,212272
38701,11,9,797,934958,11,934947
38702,11,-17,950,122480,11,122469
38703,10,14,446,1071726,10,1071716
38704,15,1,524,684016,15,684001
38705,20,-3,285,555803,20,555783
38706,12,13,744,1058768,12,1058756
38707,7,12,298,1005769,7,1005762
38708,12,2,694,715854,12,715842
38709,15,-4,89,522728,15,522713
38710,8,-17,731,109175,8,109167
38711,16,-9,510,370713,16,370697
38712,17,-9,299,368773,17,368756
38713,7,19,599,1230955,7,1230948
38714,9,-14,167,190094,9,190085
38715,11,-7,559,432522,11,432511
38716,12,-11,484,307590,12,307578
38717,16,-19,371,56887,16,56871
38718,14,-5,550,495075,14,495061
38719,19,5,742,809210,19,809191
38720,20,-6,80,459648,20,459628
38721,18,17,211,1179456,18,1179438
38722,8,-4,320,506502,8,506494
38723,5,17,888,1174371,5,1174366
38724,12,-3,377,556591,12,556579
38725,20,4,366,775871,20,775851
38726,18,5,908,810409,18,810391
38727,14,1,716,685403,14,685389
38728,7,9,311,913294,7,913287
38729,15,-4,439,525462,15,525447
38730,16,-15,728,183211,16,183195
38731,17,-4,472,525628,17,525611
38732,5,-8,374,383224,5,383219
38733,14,-20,745,28498,14,28484
38734,17,-9,724,372094,17,372077
38735,8,-11,944,301397,8,301389
38736,15,5,280,805878,15,805863
38737,20,-20,753,28605,20,28585
38738,7,18,461,1196638,7,1196631
38739,15,18,8,1208971,15,1208956
38740,10,-9,338,351038,10,351028
38741,16,2,649,715448,16,715432
38742,15,-8,385,400600,15,400585
38743,20,-12,34,272754,20,272734
38744,16,-10,731,340577,16,340561
38745,13,-11,751,309554,13,309541
38746,9,17,339,1162675,9,1162666
38747,12,-3,846,560540,12,560528
38748,15,4,673,778174,15,778159
38749,20,-2,396,588050,20,588030
38750,18,18,245,1210933,18,1210915
38751,14,-9,582,371282,14,371268
38752,15,18,368,1211803,15,1211788
38753,11,5,546,807773,11,807762
38754,20,7,601,871467,20,871447
38755,16,18,734,1214201,16,1214185
38756,6,-13,967,239295,6,239289
38757,6,-15,900,174535,6,174529
38758,6,8,707,890794,6,890788
38759,6,-1,331,601243,6,601237
38760,16,-7,436,431596,16,431580
38761,10,2,303,695124,10,695114
38762,7,-13,309,224958,7,224951
38763,7,-20,471,10075,7,10068
38764,14,-16,785,152686,14,152672
38765,5,-12,877,268605,5,268600
38766,16,4,421,776279,16,776263
38767,16,0,721,653838,16,653822
38768,5,9,501,917287,5,917282
38769,20,-6,254,461155,20,461135
38770,15,14,777,1091561,15,1091546
38771,6,14,316,1068732,6,1068726
38772,5,-3,155,533719,5,533714
38773,14,0,770,654174,14,654160
38774,13,3,379,744719,13,744706
38775,10,-4,677,514049,10,514039
38776,10,-14,586,199458,10,199448
38777,17,11,265,992753,17,992736
38778,14,-12,157,273683,14,273669
38779,14,-3,536,558066,14,558052
38780,9,13,903,1050079,9,1050070
38781,13,19,181,1242181,13,1242168
38782,9,16,313,1131834,9,1131825
38783,9,19,781,1234757,9,1234748
38784,14,4,83,773845,14,773831
38785,10,-12,300,256159,10,256149
38786,18,5,801,809605,18,809587
38787,10,3,616,731953,10,731943
38788,7,-4,828,516961,7,516954
38789,10,-13,785,235450,10,235440
38790,8,3,40,719675,8,719667
38791,10,3,684,733640,10,733630
38792,13,12,147,1023096,13,1023083
38793,11,11,163,992006,11,991995
38794,13,-5,45,491179,13,491166
38795,18,11,5,990892,18,990874
38796,18,11,489,994424,18,994406
38797,9,6,47,813205,9,813196
38798,20,12,819,1028125,20,1028105
38799,15,14,288,1087645,15,1087630
38800,18,17,701,1183136,18,1183118
38801,9,-3,855,549522,9,549513
38802,18,12,662,1027003,18,1026985
38803,15,7,516,870852,15,870837
38804,7,-3,387,538912,7,538905
38805,13,-19,816,60263,13,60250
38806,12,10,379,962641,12,962629
38807,6,-8,993,396623,6,396617
38808,20,-2,663,590125,20,590105
38809,8,13,79,1032438,8,1032430
38810,16,5,936,810658,16,810642
38811,11,-18,520,89086,11,89075
38812,5,3,309,725697,5,725692
38813,18,-6,838,465498,18,465480
38814,7,-5,322,475252,7,475245
38815,20,4,242,775031,20,775011
38816,13,19,483,1244743,13,1244730
38817,17,-3,468,557370,17,557353
38818,8,8,809,892882,8,892874
38819,7,-18,713,77738,7,77731
38820,17,-11,330,306397,17,306380
38821,17,7,577,871290,17,871273
38822,15,12,198,1023479,15,1023464
38823,14,-3,821,560360,14,560346
38824,13,6,376,838702,13,838689
38825,6,19,270,1223482,6,1223476
38826,11,-3,604,558537,11,558526
38827,7,6,899,832466,7,832459
38828,10,-14,206,191039,10,191029
38829,8,0,239,630614,8,630606
38830,13,13,953,1060315,13,1060302
38831,5,-13,242,223494,5,223489
38832,15,-3,312,556055,15,556040
38833,14,15,648,1121541,14,1121527
38834,9,5,738,797053,9,797044
38835,13,-2,325,587549,13,587536
38836,10,1,398,665893,10,665883
38837,19,3,657,746820,19,746801
38838,7,-5,298,474681,7,474674
38839,16,-6,319,461643,16,461627
38840,14,15,812,1122738,14,1122724
38841,18,2,496,714369,18,714351
38842,6,19,856,1236621,6,1236615
38843,16,5,898,810319,16,810303
38844,18,-17,721,120967,18,120949
38845,17,-5,614,495556,17,495539
38846,14,16,418,1150155,14,1150141
38847,16,-9,509,370700,16,370684
38848,12,12,597,1026418,12,1026406
38849,5,5,585,793738,5,793733
38850,19,-11,493,307681,19,307662
38851,11,19,3,1240665,11,1240654
38852,8,12,346,1006694,8,1006686
38853,18,17,825,1184130,18,1184112
38854,13,-6,485,462894,13,462881
38855,13,15,570,1120924,13,1120911
38856,20,-19,184,55521,20,55501
38857,20,1,991,687501,20,687481
38858,8,6,134,815108,8,815100
38859,17,-6,344,461844,17,461827
38860,8,-1,770,610377,8,610369
38861,18,12,28,1022293,18,1022275
38862,6,11,173,971984,6,971978
38863,5,-4,237,504818,5,504813
38864,19,11,93,991543,19,991524
38865,13,-8,608,402129,13,402116
38866,6,-19,724,47399,6,47393
38867,16,17,596,1182276,16,1182260
38868,19,-12,86,273156,19,273137
38869,6,17,653,1169283,6,1169277
38870,8,-7,293,412200,8,412192
38871,15,14,123,1086425,15,1086410
38872,20,-15,981,185213,20,185193
38873,9,-7,621,419013,9,419004
38874,20,-16,427,150092,20,150072
38875,14,9,577,933319,14,933305
38876,9,-6,704,451952,9,451943
38877,13,-12,924,279484,13,279471
38878,9,-6,727,452459,9,452450
38879,7,-20,32,749,7,742
38880,12,-9,309,368848,12,368836
38881,5,13,216,1035352,5,1035347
38882,12,-3,950,561402,12,561390
38883,19,17,995,1185435,19,1185416
38884,7,-3,68,531989,7,531982
38885,18,-12,50,272851,18,272833
38886,16,4,229,774954,16,774938
38887,9,-1,139,596810,9,596801
38888,14,7,571,871238,14,871224
38889,14,-18,362,88023,14,88009
38890,15,-13,964,248329,15,248314
38891,11,19,758,1246917,11,1246906
38892,13,19,321,1243339,13,1243326
38893,7,5,312,788043,7,788036
38894,5,-6,896,455945,5,455940
38895,11,-17,904,122189,11,122178
38896,14,18,983,1216188,14,1216174
38897,19,-16,185,148278,19,148259
38898,12,5,424,806845,12,806833
38899,16,-7,149,429380,16,429364
38900,13,17,527,1181800,13,1181787
38901,18,-10,132,336103,18,336085
38902,8,-15,206,159657,8,159649
38903,19,2,375,713447,19,713428
38904,5,-18,772,79180,5,79175
38905,16,19,756,1246910,16,1246894
38906,6,-16,643,137956,6,137950
38907,9,1,738,673083,9,673074
38908,7,19,806,1235329,7,1235322
38909,7,-14,274,192757,7,192750
38910,19,17,729,1183349,19,1183330
38911,8,11,88,970314,8,970306
38912,9,14,882,1081617,9,1081608
38913,7,3,402,727439,7,727432
38914,10,-3,547,542812,10,542802
38915,16,-10,187,336457,16,336441
38916,14,-7,360,431101,14,431087
38917,5,15,990,1115513,5,1115508
38918,6,-3,896,550477,6,550471
38919,8,3,104,721131,8,721123
38920,11,-6,170,460436,11,460425
38921,7,15,249,1099867,7,1099860
38922,7,-8,155,378807,7,378800
38923,11,-12,294,274677,11,274666
38924,10,6,602,825896,10,825886
38925,20,13,361,1055900,20,1055880
38926,16,-14,630,214456,16,214440
38927,7,-15,343,162870,7,162863
38928,5,-6,168,440427,5,440422
38929,9,-15,442,164975,9,164966
38930,17,11,361,993493,17,993476
38931,9,14,718,1078182,9,1078173
38932,5,17,727,1170826,5,1170821
38933,18,-4,146,523147,18,523129
38934,10,-20,182,4196,10,4186
38935,6,-18,379,70559,6,70553
38936,17,2,401,713680,17,713663
38937,11,-7,206,429840,11,429829
38938,6,-16,36,124556,6,124550
38939,18,-8,366,400438,18,400420
38940,12,-9,493,370580,12,370568
38941,10,8,231,880298,10,880288
38942,18,-4,740,527605,18,527587
38943,11,-19,215,55774,11,55763
38944,20,-20,18,10335,20,10315
38945,17,0,829,654561,17,654544
38946,20,-8,157,399033,20,399013
38947,18,-12,754,278047,18,278029
38948,9,2,912,707592,9,707583
38949,6,-4,687,514251,6,514245
38950,13,10,69,960346,13,960333
38951,8,-12,344,257119,8,257111
38952,8,16,134,1127945,8,1127937
38953,12,15,281,1118864,12,1118852
38954,9,-20,191,4527,9,4518
38955,12,14,106,1086326,12,1086314
38956,19,-15,717,183126,19,183107
38957,19,13,287,1055329,19,1055310
38958,13,8,100,898706,13,898693
38959,18,0,732,653927,18,653909
38960,8,-19,632,45422,8,45414
38961,5,8,847,893569,5,893564
38962,17,-15,414,180813,17,180796
38963,6,-2,343,570033,6,570027
38964,11,12,207,1023541,11,1023530
38965,11,2,951,717572,11,717561
38966,13,7,781,872653,13,872640
38967,14,-8,430,400879,14,400865
38968,12,-15,294,179919,12,179907
38969,5,13,266,1036315,5,1036310
38970,13,-13,754,246607,13,246594
38971,18,-17,295,117687,18,117669
38972,11,-16,19,146904,11,146893
38973,18,14,111,1086357,18,1086339
38974,10,15,458,1104163,10,1104153
38975,20,-7,162,429515,20,429495
38976,15,-2,375,587878,15,587863
38977,14,0,763,654155,14,654141
38978,12,-12,752,278028,12,278016
38979,19,-17,436,118707,19,118688
38980,14,16,507,1150699,14,1150685
38981,9,-10,662,327030,9,327021
38982,17,-8,561,401779,17,401762
38983,20,11,396,993806,20,993786
38984,15,13,750,1058809,15,1058794
38985,6,-12,129,252389,6,252383
38986,16,-12,777,278216,16,278200
38987,6,-19,874,50569,6,50563
38988,15,-19,296,56303,15,56288
38989,8,8,700,890632,8,890624
38990,18,-6,124,460009,18,459991
38991,15,-13,387,243874,15,243859
38992,20,14,555,1089779,20,1089759
38993,8,-1,92,595844,8,595836
38994,6,-5,860,486636,6,486630
38995,9,-1,908,613545,9,613536
38996,8,18,0,1186525,8,1186517
38997,14,13,290,1055342,14,1055328
38998,15,-13,99,241771,15,241756
38999,16,-3,535,558051,16,558035
39000,11,17,270,1179942,11,1179931
39001,9,-8,527,386477,9,386468
39002,18,19,88,1241507,18,1241489
39003,18,-1,202,618085,18,618067
39004,18,3,958,749184,18,749166
39005,11,18,308,1211303,11,1211292
39006,13,9,293,931056,13,931043
39007,5,-20,867,19281,5,19276
39008,14,10,792,965996,14,965982
39009,20,-15,229,179415,20,179395
39010,18,-2,463,588616,18,588598
39011,18,6,275,837868,18,837850
39012,14,-1,636,621458,14,621444
39013,6,-19,752,48091,6,48085
39014,5,-7,289,412093,5,412088
39015,18,-3,920,561169,18,561151
39016,6,-16,366,131803,6,131797
39017,7,1,194,661410,7,661403
39018,19,14,104,1086309,19,1086290
39019,12,-14,99,210091,12,210079
39020,7,9,662,920685,7,920678
39021,14,-8,154,399002,14,398988
39022,20,7,100,867736,20,867716
39023,11,12,836,1028290,11,1028279
39024,12,13,801,1059267,12,1059255
39025,8,14,610,1075451,8,1075443
39026,18,-2,47,585509,18,585491
39027,5,15,593,1106975,5,1106970
39028,9,0,426,634589,9,634580
39029,6,13,796,1047861,6,1047855
39030,13,9,381,931818,13,931805
39031,14,-7,472,431885,14,431871
39032,10,1,528,668878,10,668868
39033,14,14,37,1085701,14,1085687
39034,15,-9,713,372050,15,372035
39035,7,-7,373,413994,7,413987
39036,20,-17,338,118017,20,117997
39037,13,15,635,1121440,13,1121427
39038,19,0,120,649175,19,649156
39039,19,19,610,1245732,19,1245713
39040,13,0,737,653953,13,653940
39041,13,-17,827,121685,13,121672
39042,5,-2,965,583475,5,583470
39043,15,5,659,808592,15,808577
39044,7,-2,741,578507,7,578500
39045,13,6,710,841530,13,841517
39046,11,19,980,1248629,11,1248618
39047,6,-11,455,291293,6,291287
39048,7,10,79,939206,7,939199
39049,8,-2,748,578649,8,578641
39050,9,-3,232,535389,9,535380
39051,7,11,687,983061,7,983054
39052,20,17,508,1181724,20,1181704
39053,13,5,748,809248,13,809235
39054,15,12,14,1022185,15,1022170
39055,12,-20,271,24845,12,24833
39056,20,11,21,991025,20,991005
39057,20,-4,924,528985,20,528965
39058,12,19,293,1243107,12,1243095
39059,5,-1,874,612666,5,612661
39060,5,13,475,1040899,5,1040894
39061,9,-10,18,312978,9,312969
39062,20,-4,122,522953,20,522933
39063,17,19,862,1247771,17,1247754
39064,8,4,804,768101,8,768093
39065,18,10,252,961708,18,961690
39066,6,-10,45,313585,6,313579
39067,6,18,1,1186548,6,1186542
39068,12,16,973,1154103,12,1154091
39069,14,15,76,1117338,14,1117324
39070,10,9,211,911256,10,911246
39071,20,1,137,680954,20,680934
39072,20,-7,178,429642,20,429622
39073,7,18,620,1199819,7,1199812
39074,10,-5,452,477704,10,477694
39075,19,8,117,898838,19,898819
39076,5,-12,446,259179,5,259174
39077,20,-11,826,310170,20,310150
39078,8,-12,805,266906,8,266898
39079,8,5,541,792873,8,792865
39080,15,13,235,1054957,15,1054942
39081,17,-6,596,463674,17,463657
39082,15,-20,239,24616,15,24601
39083,13,18,135,1210025,13,1210012
39084,8,-8,942,395501,8,395493
39085,7,4,563,762711,7,762704
39086,6,15,440,1103746,6,1103740
39087,20,16,812,1152946,20,1152926
39088,10,16,449,1134901,10,1134891
39089,13,18,171,1210324,13,1210311
39090,5,-8,485,385388,5,385383
39091,8,3,99,720908,8,720900
39092,5,-14,260,192472,5,192467
39093,6,-1,946,614342,6,614336
39094,17,-14,482,213210,17,213193
39095,7,3,630,732340,7,732333
39096,12,-6,853,465581,12,465569
39097,17,-12,188,273848,17,273831
39098,19,-20,677,28011,19,27992
39099,10,10,544,949100,10,949090
39100,18,-6,957,466377,18,466359
39101,14,-19,5,53923,14,53909
39102,12,3,814,747980,12,747968
39103,19,-2,91,585818,19,585799
39104,13,11,655,995487,13,995474
39105,19,-9,743,372329,19,372310
39106,9,13,583,1043350,9,1043341
39107,9,-3,273,536297,9,536288
39108,19,1,544,684189,19,684170
39109,10,6,48,813223,10,813213
39110,8,9,358,914297,8,914289
39111,7,-19,736,47774,7,47767
39112,5,19,97,1219628,5,1219623
39113,13,-14,330,211994,13,211981
39114,19,2,848,716830,19,716811
39115,16,-18,622,89732,16,89716
39116,20,7,50,867427,20,867407
39117,6,-13,767,234940,6,234934
39118,7,11,433,977725,7,977718
39119,13,-12,886,279132,13,279119
39120,11,9,829,935202,11,935191
39121,6,1,224,662101,6,662095
39122,6,-12,571,261880,6,261874
39123,7,-7,386,414249,7,414242
39124,15,1,728,685523,15,685508
39125,16,8,284,900236,16,900220
39126,16,-11,818,310074,16,310058
39127,16,3,506,745601,16,745585
39128,15,7,34,867270,15,867255
39129,13,16,967,1154039,13,1154026
39130,5,15,852,1112601,5,1112596
39131,14,8,466,901650,14,901636
39132,10,1,818,674769,10,674759
39133,5,-11,884,300129,5,300124
39134,10,3,154,722110,10,722100
39135,11,-15,257,179619,11,179608
39136,17,-3,417,556906,17,556889
39137,19,6,336,838409,19,838390
39138,7,17,327,1162386,7,1162379
39139,6,-8,972,396171,6,396165
39140,11,-1,66,617033,11,617022
39141,20,5,792,809549,20,809529
39142,17,5,57,804253,17,804236
39143,16,-3,366,556501,16,556485
39144,19,-2,932,592237,19,592218
39145,7,-16,252,129519,7,129512
39146,15,17,271,1179949,15,1179934
39147,13,7,404,870034,13,870021
39148,10,-20,216,4921,10,4911
39149,10,9,844,924764,10,924754
39150,16,16,780,1152640,16,1152624
39151,7,12,176,1002957,7,1002950
39152,9,13,932,1050686,9,1050677
39153,15,0,487,651861,15,651846
39154,18,-13,337,243519,18,243501
39155,6,-16,831,141854,6,141848
39156,15,5,453,807100,15,807085
39157,18,14,838,1092001,18,1091983
39158,19,18,746,1214353,19,1214334
39159,12,7,809,872857,12,872845
39160,16,3,616,746446,16,746430
39161,18,-9,789,372810,18,372792
39162,15,18,740,1214273,15,1214258
39163,14,-7,517,432245,14,432231
39164,6,-12,190,253541,6,253535
39165,8,19,216,1222322,8,1222314
39166,8,-16,853,142329,8,142321
39167,10,-9,568,356419,10,356409
39168,14,-16,115,147771,14,147757
39169,6,7,87,846701,6,846695
39170,18,3,138,742882,18,742864
39171,9,17,634,1168864,9,1168855
39172,8,2,100,690800,8,690792
39173,20,-4,262,524136,20,524116
39174,14,-4,237,523979,14,523965
39175,15,-13,548,245062,15,245047
39176,11,-3,0,553853,11,553842
39177,18,-16,730,152266,18,152248
39178,15,-10,993,342652,15,342637
39179,16,12,195,1023409,16,1023393
39180,11,3,213,743476,11,743465
39181,20,-6,327,461704,20,461684
39182,6,16,527,1136392,6,1136386
39183,11,13,339,1055710,11,1055699
39184,7,-11,541,293229,7,293222
39185,13,8,667,903235,13,903222
39186,10,12,87,1001066,10,1001056
39187,18,-8,166,399083,18,399065
39188,20,-18,383,88172,20,88152
39189,20,2,476,714221,20,714201
39190,18,-16,611,151516,18,151498
39191,18,-20,265,24803,18,24785
39192,19,3,566,746031,19,746012
39193,19,18,476,1212488,19,1212469
39194,14,-19,745,59876,14,59862
39195,19,19,513,1245016,19,1244997
39196,12,-8,828,403792,12,403780
39197,14,6,930,843165,14,843151
39198,11,-16,390,149747,11,149736
39199,12,-12,66,273019,12,273007
39200,13,-5,905,497678,13,497665
39201,16,-11,171,305085,16,305069
39202,20,-5,684,496011,20,495991
39203,8,-14,118,189067,8,189059
39204,11,-10,422,338158,11,338147
39205,11,-20,69,23306,11,23295
39206,14,12,992,1029751,14,1029737
39207,10,14,745,1078699,10,1078689
39208,5,-7,286,411987,5,411982
39209,9,12,600,1012005,9,1011996
39210,19,6,344,838457,19,838438
39211,5,4,949,771383,5,771378
39212,17,-10,295,337179,17,337162
39213,13,15,622,1121343,13,1121330
39214,19,3,625,746530,19,746511
39215,20,-17,384,118330,20,118310
39216,13,-19,862,60638,13,60625
39217,16,12,412,1025044,16,1025028
39218,20,-19,472,57619,20,57599
39219,20,8,890,904844,20,904824
39220,19,2,797,716434,19,716415
39221,10,10,28,938136,10,938126
39222,5,14,713,1078071,5,1078066
39223,10,-18,688,77093,10,77083
39224,14,14,310,1087854,14,1087840
39225,10,15,836,1112225,10,1112215
39226,6,0,516,636489,6,636483
39227,10,-20,257,5735,10,5725
39228,17,-11,402,306930,17,306913
39229,16,-13,697,246101,16,246085
39230,5,6,415,821757,5,821752
39231,14,-2,407,588150,14,588136
39232,13,13,554,1057418,13,1057405
39233,6,17,61,1156658,6,1156652
39234,14,18,886,1215447,14,1215433
39235,19,-19,563,58436,19,58417
39236,20,-5,568,495218,20,495198
39237,10,6,525,824300,10,824290
39238,17,10,519,963849,17,963832
39239,15,5,367,806498,15,806483
39240,16,17,530,1181816,16,1181800
39241,15,18,773,1214573,15,1214558
39242,10,9,836,924532,10,924522
39243,6,-1,689,608709,6,608703
39244,8,-14,394,195448,8,195440
39245,11,-19,733,59772,11,59761
39246,12,10,89,960529,12,960517
39247,11,-19,958,61219,11,61208
39248,19,10,652,964968,19,964949
39249,14,-6,211,460789,14,460775
39250,10,-20,894,19809,10,19799
39251,7,-7,18,406463,7,406456
39252,11,18,994,1216262,11,1216251
39253,17,-10,652,339954,17,339937
39254,15,5,86,804440,15,804425
39255,19,14,340,1088103,19,1088084
39256,14,-16,899,153540,14,153526
39257,10,-2,214,567290,10,567280
39258,8,19,171,1221298,8,1221290
39259,8,5,799,798310,8,798302
39260,18,0,506,652012,18,651994
39261,19,13,992,1060557,19,1060538
39262,18,-12,612,276942,18,276924
39263,19,-13,839,247281,19,247262
39264,8,-19,308,38193,8,38185
39265,12,14,55,1085844,12,1085832
39266,13,3,841,748134,13,748121
39267,14,13,778,1059054,14,1059040
39268,19,13,549,1057379,19,1057360
39269,11,8,905,905033,11,905022
39270,16,11,31,991107,16,991091
39271,6,9,866,925154,6,925148
39272,15,9,833,935240,15,935225
39273,15,17,42,1178210,15,1178195
39274,10,6,87,814048,10,814038
39275,11,17,457,1181364,11,1181353
39276,5,-6,554,448850,5,448845
39277,5,-16,510,135127,5,135122
39278,7,-7,228,410690,7,410683
39279,14,10,333,962354,14,962340
39280,6,14,766,1079115,6,1079109
39281,16,-8,662,402583,16,402567
39282,11,-20,943,29954,11,29943
39283,11,-19,120,54958,11,54947
39284,14,-1,171,617832,14,617818
39285,7,11,326,975388,7,975381
39286,8,-9,80,345347,8,345339
39287,9,-7,587,418461,9,418452
39288,5,-2,441,572176,5,572171
39289,20,-11,301,306128,20,306108
39290,17,9,621,933689,17,933672
39291,8,10,794,954757,8,954749
39292,17,-13,5,241079,17,241062
39293,10,-8,507,385958,10,385948
39294,11,5,422,806831,11,806820
39295,10,1,541,669177,10,669167
39296,14,15,556,1120811,14,1120797
39297,11,-10,875,341668,11,341657
39298,20,-15,69,178265,20,178245
39299,6,15,127,1097276,6,1097270
39300,12,10,983,967327,12,967315
39301,7,2,259,694190,7,694183
39302,19,8,968,905484,19,905465
39303,12,-11,728,309402,12,309390
39304,6,-2,315,569542,6,569536
39305,15,0,880,654925,15,654910
39306,5,9,765,922766,5,922761
39307,13,19,170,1242108,13,1242095
39308,18,9,586,933386,18,933368
39309,14,12,814,1028093,14,1028079
39310,5,11,630,981877,5,981872
39311,5,18,343,1194141,5,1194136
39312,8,7,472,854967,8,854959
39313,17,11,144,991872,17,991855
39314,14,14,126,1086479,14,1086465
39315,18,-14,231,211231,18,211213
39316,9,-20,728,16012,9,16003
39317,8,6,882,832104,8,832096
39318,20,-8,994,404972,20,404952
39319,16,1,900,686828,16,686812
39320,12,-1,289,618863,12,618851
39321,9,19,219,1222374,9,1222365
39322,7,13,81,1032469,7,1032462
39323,15,18,604,1213247,15,1213232
39324,7,-18,676,76864,7,76857
39325,10,-19,221,36436,10,36426
39326,14,-14,178,210659,14,210645
39327,19,5,932,810630,19,810611
39328,11,-8,931,404434,11,404423
39329,13,-19,138,55114,13,55101
39330,18,1,551,684255,18,684237
39331,6,15,664,1108523,6,1108517
39332,15,10,483,963512,15,963497
39333,18,-6,752,464911,18,464893
39334,10,-17,238,98509,10,98499
39335,18,16,411,1150112,18,1150094
39336,9,3,421,727822,9,727813
39337,5,-15,801,172483,5,172478
39338,5,4,48,751599,5,751594
39339,5,6,220,817055,5,817050
39340,14,-20,471,26318,14,26304
39341,12,-2,547,589237,12,589225
39342,14,-9,442,370081,14,370067
39343,18,2,112,711414,18,711396
39344,16,8,890,904850,16,904834
39345,13,17,0,1177866,13,1177853
39346,14,-18,371,88079,14,88065
39347,17,16,278,1149136,17,1149119
39348,9,7,225,849556,9,849547
39349,14,18,22,1209051,14,1209037
39350,12,1,450,683373,12,683361
39351,8,1,383,665557,8,665549
39352,13,1,391,682972,13,682959
39353,6,12,38,999941,6,999935
39354,12,12,405,1025010,12,1024998
39355,12,14,78,1086050,12,1086038
39356,6,12,912,1019187,6,1019181
39357,9,3,199,723174,9,723165
39358,10,1,646,671297,10,671287
39359,16,11,689,995725,16,995709
39360,13,-5,790,496723,13,496710
39361,20,1,532,684101,20,684081
39362,11,-1,426,619948,11,619937
39363,20,-19,369,56873,20,56853
39364,16,-12,236,274244,16,274228
39365,19,13,970,1060426,19,1060407
39366,9,-19,673,46237,9,46228
39367,14,-10,399,337937,14,337923
39368,13,19,541,1245228,13,1245215
39369,12,6,620,840748,12,840736
39370,9,3,594,731482,9,731473
39371,8,12,211,1003764,8,1003756
39372,14,1,926,687110,14,687096
39373,11,13,103,1053984,11,1053973
39374,20,0,826,654533,20,654513
39375,10,-19,783,48668,10,48658
39376,11,10,763,965712,11,965701
39377,9,-3,390,538981,9,538972
39378,14,17,65,1178359,14,1178345
39379,18,16,882,1153353,18,1153335
39380,8,-19,844,50040,8,50032
39381,7,9,78,908365,7,908358
39382,20,16,175,1148360,20,1148340
39383,5,-18,708,77631,5,77626
39384,8,-16,461,134185,8,134177
39385,10,14,175,1065669,10,1065659
39386,14,-7,879,434752,14,434738
39387,16,15,613,1121275,16,1121259
39388,9,5,509,792120,9,792111
39389,19,17,396,1180888,19,1180869
39390,11,-5,29,491033,11,491022
39391,7,-11,418,290433,7,290426
39392,19,-15,594,182153,19,182134
39393,13,6,805,842224,13,842211
39394,7,-15,352,163048,7,163041
39395,8,6,55,813391,8,813383
39396,14,-3,459,557310,14,557296
39397,18,6,750,841803,18,841785
39398,20,15,34,1117018,20,1116998
39399,19,-7,427,431530,19,431511
39400,15,-5,711,496219,15,496204
39401,12,-1,180,617887,12,617875
39402,15,-17,168,116714,15,116699
39403,14,-19,1,53892,14,53878
39404,16,9,487,932627,16,932611
39405,5,-5,89,470028,5,470023
39406,6,14,260,1067610,6,1067604
39407,12,-16,108,147727,12,147715
39408,20,16,528,1150849,20,1150829
39409,12,9,514,932826,12,932814
39410,19,14,292,1087685,19,1087666
39411,8,6,774,829660,8,829652
39412,17,-13,575,245304,17,245287
39413,20,-11,957,311209,20,311189
39414,9,11,601,981328,9,981319
39415,11,8,959,905401,11,905390
39416,13,-16,125,147870,13,147857
39417,8,14,491,1072768,8,1072760
39418,10,9,530,917960,10,917950
39419,8,-14,245,192090,8,192082
39420,20,19,440,1244479,20,1244459
39421,12,1,12,679815,12,679803
39422,18,1,33,680057,18,680039
39423,13,-13,72,241570,13,241557
39424,14,-19,752,59903,14,59889
39425,11,-3,222,555322,11,555311
39426,16,15,584,1121011,16,1120995
39427,8,-18,981,83779,8,83771
39428,11,8,385,901000,11,900989
39429,15,-5,3,490786,15,490771
39430,14,8,503,901943,14,901929
39431,9,19,156,1220946,9,1220937
39432,13,17,531,1181826,13,1181813
39433,14,16,39,1147350,14,1147336
39434,7,-3,888,550285,7,550278
39435,20,-20,451,26241,20,26221
39436,8,-18,409,71166,8,71158
39437,6,-15,181,159275,6,159269
39438,12,-2,774,590909,12,590897
39439,17,0,777,654214,17,654197
39440,16,-14,220,211061,16,211045
39441,7,-13,872,237227,7,237220
39442,6,-5,814,485538,6,485532
39443,8,3,476,729007,8,728999
39444,6,12,514,1010073,6,1010067
39445,10,-10,443,322212,10,322202
39446,15,-18,603,89606,15,89591
39447,5,9,908,926060,5,926055
39448,6,-13,260,223900,6,223894
39449,12,-19,831,60385,12,60373
39450,9,17,106,1157497,9,1157488
39451,17,-20,864,29449,17,29432
39452,6,-16,677,138576,6,138570
39453,16,16,914,1153664,16,1153648
39454,12,-16,463,150476,12,150464
39455,6,-13,746,234323,6,234317
39456,7,-2,860,581192,7,581185
39457,7,-15,716,170763,7,170756
39458,14,18,870,1215302,14,1215288
39459,7,12,895,1018767,7,1018760
39460,5,17,106,1157502,5,1157497
39461,8,-16,907,143508,8,143500
39462,16,17,827,1184156,16,1184140
39463,7,9,912,926114,7,926107
39464,7,-13,114,220868,7,220861
39465,8,-1,737,609713,8,609705
39466,13,-19,497,57809,13,57796
39467,15,-14,235,211250,15,211235
39468,5,13,239,1035784,5,1035779
39469,11,-18,703,90338,11,90327
39470,14,1,244,681804,14,681790
39471,9,8,301,881810,9,881801
39472,10,0,22,625744,10,625734
39473,18,12,699,1027334,18,1027316
39474,19,-7,735,433641,19,433622
39475,9,-16,476,134467,9,134458
39476,11,-19,943,61110,11,61099
39477,5,-11,262,286800,5,286795
39478,19,18,883,1215369,19,1215350
39479,20,-2,902,592007,20,591987
39480,15,-9,362,369346,15,369331
39481,10,9,126,909443,10,909433
39482,12,-8,82,398589,12,398577
39483,5,19,196,1221837,5,1221832
39484,8,-5,193,472253,8,472245
39485,16,16,474,1150496,16,1150480
39486,15,-11,910,310851,15,310836
39487,8,14,680,1077274,8,1077266
39488,8,-17,770,109961,8,109953
39489,13,10,870,966504,13,966491
39490,11,0,191,649691,11,649680
39491,18,2,858,716878,18,716860
39492,12,-4,265,524146,12,524134
39493,16,-15,291,179897,16,179881
39494,9,12,392,1007558,9,1007549
39495,17,6,728,841697,17,841680
39496,6,9,955,927020,6,927014
39497,9,-10,399,321246,9,321237
39498,13,-13,569,245257,13,245244
39499,6,-1,374,602232,6,602226
39500,10,-7,19,406492,10,406482
39501,16,-2,829,591443,16,591427
39502,15,-16,703,152087,15,152072
39503,19,14,746,1091282,19,1091263
39504,11,-6,587,463625,11,463614
39505,5,2,208,693094,5,693089
39506,17,-13,297,243315,17,243298
39507,9,-14,137,189499,9,189490
39508,20,-10,367,337697,20,337677
39509,6,6,363,820400,6,820394
39510,8,-16,923,143818,8,143810
39511,14,-13,419,244052,14,244038
39512,12,-20,182,24212,12,24200
39513,16,-19,18,54023,16,54007
39514,18,-5,191,492384,18,492366
39515,15,19,766,1246997,15,1246982
39516,20,-16,404,149878,20,149858
39517,5,9,463,916384,5,916379
39518,19,-10,441,338312,19,338293
39519,17,3,299,744157,17,744140
39520,14,-8,574,401889,14,401875
39521,10,-6,542,448512,10,448502
39522,13,-1,708,622027,13,622014
39523,13,-20,372,25666,13,25653
39524,18,-19,580,58617,18,58599
39525,5,12,237,1004299,5,1004294
39526,7,-19,457,41322,7,41315
39527,5,6,692,827927,5,827922
39528,18,-10,489,338711,18,338693
39529,19,-14,765,215479,19,215460
39530,17,-6,276,461341,17,461324
39531,19,-2,417,588246,19,588227
39532,17,0,438,651410,17,651393
39533,12,-16,579,151257,12,151245
39534,16,10,89,960535,16,960519
39535,6,-19,139,34672,6,34666
39536,15,11,678,995665,15,995650
39537,19,0,758,654090,19,654071
39538,6,12,333,1006440,6,1006434
39539,18,-12,856,278874,18,278856
39540,14,-18,228,87078,14,87064
39541,19,14,189,1086907,19,1086888
39542,7,3,314,725816,7,725809
39543,9,17,756,1171391,9,1171382
39544,7,9,443,915952,7,915945
39545,9,11,668,982674,9,982665
39546,15,-10,75,335788,15,335773
39547,19,-6,821,465423,19,465404
39548,10,9,323,913553,10,913543
39549,16,-3,339,556290,16,556274
39550,16,11,810,996747,16,996731
39551,19,-4,526,526104,19,526085
39552,19,2,831,716703,19,716684
39553,12,-12,891,279179,12,279167
39554,6,18,410,1195477,6,1195471
39555,12,19,458,1244589,12,1244577
39556,20,1,762,685811,20,685791
39557,10,4,920,770822,10,770812
39558,5,-16,705,139143,5,139138
39559,18,-8,7,397911,18,397893
39560,5,-9,674,358356,5,358351
39561,8,12,306,1005926,8,1005918
39562,8,-8,312,382011,8,382003
39563,19,-5,275,493060,19,493041
39564,11,1,980,687460,11,687449
39565,18,-2,686,590309,18,590291
39566,12,13,150,1054304,12,1054292
39567,12,0,804,654435,12,654423
39568,13,-9,809,372951,13,372938
39569,7,-2,141,565855,7,565848
39570,6,-18,347,70000,6,69994
39571,13,-5,957,498054,13,498041
39572,19,-14,663,214681,19,214662
39573,12,-9,855,373337,12,373325
39574,7,-8,175,379288,7,379281
39575,13,19,865,1247793,13,1247780
39576,20,-7,29,428566,20,428546
39577,5,-12,892,268992,5,268987
39578,6,1,239,662448,6,662442
39579,20,-16,400,149814,20,149794
39580,13,-4,176,523394,13,523381
39581,12,-5,481,494603,12,494591
39582,17,13,17,1053355,17,1053338
39583,15,19,310,1243290,15,1243275
39584,14,-11,373,306741,14,306727
39585,15,-16,994,154267,15,154252
39586,19,19,883,1247934,19,1247915
39587,13,11,864,997114,13,997101
39588,14,-1,309,619041,14,619027
39589,20,-8,251,399685,20,399665
39590,18,14,589,1089952,18,1089934
39591,10,2,723,703894,10,703884
39592,5,18,246,1192147,5,1192142
39593,12,-11,18,303803,12,303791
39594,5,18,729,1201921,5,1201916
39595,13,4,875,779786,13,779773
39596,19,15,558,1120821,19,1120802
39597,10,-20,578,12587,10,12577
39598,13,10,103,960686,13,960673
39599,11,6,913,843078,11,843067
39600,10,-11,175,284952,10,284942
39601,11,3,654,746796,11,746785
39602,19,-11,577,308335,19,308316
39603,8,-15,489,166085,8,166077
39604,11,-19,393,57060,11,57049
39605,13,-16,542,150993,13,150980
39606,19,18,576,1213138,19,1213119
39607,7,18,803,1203752,7,1203745
39608,18,3,484,745445,18,745427
39609,6,11,360,976131,6,976125
39610,7,-14,708,202197,7,202190
39611,17,-4,846,528269,17,528252
39612,11,-6,10,459217,11,459206
39613,20,-17,381,118313,20,118293
39614,16,-5,528,494959,16,494943
39615,10,-9,273,349552,10,349542
39616,19,13,876,1059802,19,1059783
39617,14,15,183,1118176,14,1118162
39618,16,7,88,867659,16,867643
39619,5,4,771,767382,5,767377
39620,16,2,741,716139,16,716123
39621,17,-7,413,431445,17,431428
39622,10,15,599,1107158,10,1107148
39623,19,12,127,1022983,19,1022964
39624,15,7,564,871175,15,871160
39625,8,15,558,1106332,8,1106324
39626,16,-2,420,588261,16,588245
39627,19,11,740,996143,19,996124
39628,20,10,281,961945,20,961925
39629,8,8,144,878187,8,878179
39630,8,-15,236,160386,8,160378
39631,13,11,222,992405,13,992392
39632,8,3,211,723424,8,723416
39633,11,-18,481,88863,11,88852
39634,14,-1,895,623405,14,623391
39635,11,-7,881,434779,11,434768
39636,20,4,95,773969,20,773949
39637,20,-15,981,185223,20,185203
39638,12,-6,419,462360,12,462348
39639,5,12,967,1020438,5,1020433
39640,14,7,787,872714,14,872700
39641,5,4,990,772116,5,772111
39642,14,-20,433,26070,14,26056
39643,15,16,477,1150538,15,1150523
39644,12,10,230,961576,12,961564
39645,17,-14,461,213065,17,213048
39646,8,-11,316,288123,8,288115
39647,6,14,581,1074730,6,1074724
39648,9,6,410,821655,9,821646
39649,19,5,797,809563,19,809544
39650,17,19,357,1243664,17,1243647
39651,10,16,318,1131898,10,1131888
39652,11,-11,939,311031,11,311020
39653,18,-12,854,278860,18,278842
39654,6,3,257,724374,6,724368
39655,9,-19,47,32530,9,32521
39656,9,4,894,770265,9,770256
39657,12,-1,352,619403,12,619391
39658,17,-7,71,428811,17,428794
39659,15,15,927,1123536,15,1123521
39660,14,-9,760,372541,14,372527
39661,6,-19,685,46567,6,46561
39662,20,-13,238,242789,20,242769
39663,15,-6,635,464023,15,464008
39664,19,-3,884,560879,19,560860
39665,15,-4,289,524323,15,524308
39666,15,13,996,1060594,15,1060579
39667,5,16,127,1127708,5,1127703
39668,8,19,295,1224041,8,1224033
39669,16,4,125,774130,16,774114
39670,7,-8,812,392754,7,392747
39671,9,-10,311,319312,9,319303
39672,17,-7,914,435061,17,435044
39673,12,-2,254,587041,12,587029
39674,5,-16,719,139492,5,139487
39675,7,-1,225,598744,7,598737
39676,20,7,430,870242,20,870222
39677,15,10,786,965924,15,965909
39678,19,-12,571,276732,19,276713
39679,20,-1,367,619548,20,619528
39680,5,3,861,737479,5,737474
39681,20,16,826,1153047,20,1153027
39682,6,15,297,1100921,6,1100915
39683,18,7,98,867718,18,867700
39684,17,-9,47,366995,17,366978
39685,7,9,557,918522,7,918515
39686,18,16,351,1149683,18,1149665
39687,14,-18,879,91585,14,91571
39688,10,9,402,915163,10,915153
39689,8,-18,606,75405,8,75397
39690,16,13,614,1057937,16,1057921
39691,6,17,617,1168441,6,1168435
39692,12,-20,38,21601,12,21589
39693,14,8,777,904126,14,904112
39694,8,6,606,826002,8,825994
39695,16,-10,784,340960,16,340944
39696,20,-2,107,585955,20,585935
39697,10,14,777,1079344,10,1079334
39698,8,-11,92,283030,8,283022
39699,20,-13,618,245656,20,245636
39700,20,4,69,773760,20,773740
39701,9,11,864,986972,9,986963
39702,18,-5,154,492151,18,492133
39703,20,-16,579,151267,20,151247
39704,20,13,662,1058238,20,1058218
39705,8,-18,304,69157,8,69149
39706,6,-11,694,296297,6,296291
39707,6,1,667,671716,6,671710
39708,11,-14,136,210380,11,210369
39709,18,-12,462,275879,18,275861
39710,8,0,68,626745,8,626737
39711,5,-7,999,427206,5,427201
39712,12,-2,557,589337,12,589325
39713,11,14,717,1091131,11,1091120
39714,20,5,806,809646,20,809626
39715,19,12,883,1028717,19,1028698
39716,19,-1,448,620112,19,620093
39717,13,-15,594,182156,13,182143
39718,7,-2,112,565259,7,565252
39719,10,19,369,1225856,10,1225846
39720,17,2,285,712706,17,712689
39721,15,-15,590,182109,15,182094
39722,7,-10,266,318330,7,318323
39723,6,11,438,977828,6,977822
39724,9,-16,908,143534,9,143525
39725,17,-2,42,585452,17,585435
39726,15,-16,418,150004,15,149989
39727,14,-20,57,23207,14,23193
39728,12,16,55,1147478,12,1147466
39729,10,-17,614,106724,10,106714
39730,20,-11,601,308540,20,308520
39731,10,2,454,698309,10,698299
39732,8,0,584,637996,8,637988
39733,6,-11,196,285431,6,285425
39734,7,-18,227,67409,7,67402
39735,9,-5,282,474234,9,474225
39736,7,-12,193,253585,7,253578
39737,8,17,590,1167835,8,1167827
39738,12,18,253,1211032,12,1211020
39739,12,19,359,1243688,12,1243676
39740,5,-18,106,64849,5,64844
39741,5,4,953,771454,5,771449
39742,9,10,670,952004,9,951995
39743,18,4,524,777058,18,777040
39744,6,-14,946,207059,6,207053
39745,10,12,966,1020434,10,1020424
39746,15,6,387,838819,15,838804
39747,6,12,34,999825,6,999819
39748,20,-19,571,58523,20,58503
39749,7,-18,23,62900,7,62893
39750,8,11,519,979549,8,979541
39751,6,-5,896,487569,6,487563
39752,19,-7,710,433488,19,433469
39753,5,-5,141,471145,5,471140
39754,9,-8,524,386386,9,386377
39755,11,-15,24,177985,11,177974
39756,5,-19,511,42543,5,42538
39757,7,-19,539,43221,7,43214
39758,11,15,691,1121825,11,1121814
39759,19,-9,532,370938,19,370919
39760,11,-5,599,495455,11,495444
39761,19,7,804,872813,19,872794
39762,14,14,299,1087745,14,1087731
39763,13,-20,186,24267,13,24254
39764,7,14,719,1078212,7,1078205
39765,19,-10,931,342076,19,342057
39766,13,-18,813,91166,13,91153
39767,16,11,263,992730,16,992714
39768,12,-20,557,27049,12,27037
39769,20,8,235,899903,20,899883
39770,7,-3,290,536698,7,536691
39771,15,-7,214,429908,15,429893
39772,7,-18,457,72269,7,72262
39773,14,17,122,1178758,14,1178744
39774,6,-11,913,300739,6,300733
39775,9,3,690,733801,9,733792
39776,8,10,840,955604,8,955596
39777,17,-5,885,497527,17,497510
39778,15,-1,778,622582,15,622567
39779,9,10,173,941270,9,941261
39780,20,2,290,712814,20,712794
39781,9,6,947,833529,9,833520
39782,16,3,483,745435,16,745419
39783,12,18,444,1212294,12,1212282
39784,20,17,145,1178930,20,1178910
39785,17,-15,810,183819,17,183802
39786,16,11,190,992161,16,992145
39787,7,-12,499,260399,7,260392
39788,9,-7,287,412045,9,412036
39789,10,-7,198,410026,10,410016
39790,6,13,214,1035290,6,1035284
39791,11,11,560,994872,11,994861
39792,12,-3,69,554280,12,554268
39793,7,11,390,976894,7,976887
39794,18,17,939,1184930,18,1184912
39795,8,-8,295,381624,8,381616
39796,19,-7,892,434907,19,434888
39797,10,-6,798,453993,10,453983
39798,14,17,901,1184714,14,1184700
39799,9,-11,240,286252,9,286243
39800,6,-18,25,62977,6,62971
39801,15,4,672,778150,15,778135
39802,16,-17,880,122029,16,122013
39803,18,-5,324,493535,18,493517
39804,6,-18,822,80237,6,80231
39805,5,-9,394,352282,5,352277
39806,11,9,444,932260,11,932249
39807,14,-20,526,26776,14,26762
39808,16,19,570,1245430,16,1245414
39809,12,-17,610,120079,12,120067
39810,20,-1,991,624114,20,624094
39811,18,-16,107,147726,18,147708
39812,16,-18,245,87225,16,87209
39813,20,-16,478,150552,20,150532
39814,14,4,935,780140,14,780126
39815,16,-16,721,152205,16,152189
39816,6,-20,287,6421,6,6415
39817,16,-11,556,308192,16,308176
39818,7,4,523,761922,7,761915
39819,14,0,944,655418,14,655404
39820,12,18,738,1214248,12,1214236
39821,16,9,503,932738,16,932722
39822,16,-8,51,398309,16,398293
39823,13,-9,505,370644,13,370631
39824,16,-12,296,274709,16,274693
39825,20,-2,973,592555,20,592535
39826,14,13,258,1055086,14,1055072
39827,17,-16,659,151793,17,151776
39828,16,12,234,1023771,16,1023755
39829,10,-16,595,136955,10,136945
39830,13,0,398,651091,13,651078
39831,12,12,304,1024371,12,1024359
39832,20,-3,686,559261,20,559241
39833,10,14,527,1073582,10,1073572
39834,20,-4,197,523605,20,523585
39835,18,-15,284,179826,18,179808
39836,18,-5,889,497566,18,497548
39837,6,12,784,1016079,6,1016073
39838,12,-2,516,589033,12,589021
39839,20,12,596,1026410,20,1026390
39840,15,-4,959,529302,15,529287
39841,7,-12,800,266788,7,266781
39842,13,8,160,899216,13,899203
39843,11,9,412,932024,11,932013
39844,9,-19,531,43028,9,43019
39845,5,7,230,849675,5,849670
39846,11,15,998,1124110,11,1124099
39847,18,12,196,1023443,18,1023425
39848,17,16,294,1149242,17,1149225
39849,7,13,458,1040605,7,1040598
39850,9,0,526,636697,9,636688
39851,12,14,779,1091588,12,1091576
39852,17,10,181,961242,17,961225
39853,18,18,906,1215566,18,1215548
39854,5,-1,439,603574,5,603569
39855,15,-8,996,405006,15,404991
39856,10,-5,783,484780,10,484770
39857,19,-15,641,182569,19,182550
39858,12,1,465,683512,12,683500
39859,19,13,442,1056562,19,1056543
39860,12,-19,231,55855,12,55843
39861,16,-18,545,89261,16,89245
39862,10,-10,194,316844,10,316834
39863,8,-20,902,20006,8,19998
39864,18,-12,665,277433,18,277415
39865,12,-5,986,498262,12,498250
39866,11,1,123,680794,11,680783
39867,5,9,148,909871,5,909866
39868,16,17,497,1181617,16,1181601
39869,9,19,653,1232035,9,1232026
39870,10,-11,490,292125,10,292115
39871,17,15,934,1123622,17,1123605
39872,18,14,190,1086928,18,1086910
39873,18,-14,493,213326,18,213308
39874,20,10,665,965063,20,965043
39875,15,3,172,743131,15,743116
39876,18,-2,184,586424,18,586406
39877,17,-16,412,149966,17,149949
39878,18,9,91,929705,18,929687
39879,14,5,33,803981,14,803967
39880,11,-15,926,184797,11,184786
39881,7,-20,792,17504,7,17497
39882,13,-17,567,119786,13,119773
39883,14,17,884,1184578,14,1184564
39884,10,19,227,1222580,10,1222570
39885,17,16,750,1152405,17,1152388
39886,9,14,110,1064315,9,1064306
39887,11,-18,454,88674,11,88663
39888,16,-8,269,399755,16,399739
39889,10,4,556,762559,10,762549
39890,7,14,58,1063064,7,1063057
39891,15,17,473,1181460,15,1181445
39892,16,13,76,1053791,16,1053775
39893,18,5,283,805941,18,805923
39894,11,-19,835,60401,11,60390
39895,9,-18,744,78486,9,78477
39896,8,18,439,1196115,8,1196107
39897,16,-11,463,307462,16,307446
39898,18,5,366,806486,18,806468
39899,5,-13,59,219705,5,219700
39900,7,14,952,1083137,7,1083130
39901,8,-16,101,126200,8,126192
39902,7,18,759,1202714,7,1202707
39903,10,2,376,696818,10,696808
39904,6,-10,511,323761,6,323755
39905,14,-7,267,430290,14,430276
39906,8,-7,368,413878,8,413870
39907,20,3,1000,749556,20,749536
39908,12,10,36,960125,12,960113
39909,12,12,90,1022720,12,1022708
39910,10,-9,291,349944,10,349934
39911,15,-13,174,242298,15,242283
39912,14,-13,580,245327,14,245313
39913,5,-1,192,597816,5,597811
39914,10,-16,638,137812,10,137802
39915,17,-1,105,617363,17,617346
39916,18,2,876,717029,18,717011
39917,10,13,231,1035671,10,1035661
39918,17,3,537,745757,17,745740
39919,6,-17,577,105988,6,105982
39920,14,6,60,836220,14,836206
39921,10,-19,450,41199,10,41189
39922,5,3,882,737841,5,737836
39923,7,15,860,1112750,7,1112743
39924,13,-7,195,429745,13,429732
39925,12,13,193,1054632,12,1054620
39926,12,13,737,1058720,12,1058708
39927,12,7,676,871988,12,871976
39928,13,-8,199,399314,13,399301
39929,17,17,929,1184866,17,1184849
39930,17,8,853,904598,17,904581
39931,12,12,237,1023780,12,1023768
39932,11,-11,853,310400,11,310389
39933,19,-9,338,369162,19,369143
39934,11,-9,286,368668,11,368657
39935,6,-9,380,351917,6,351911
39936,14,8,821,904361,14,904347
39937,12,13,132,1054186,12,1054174
39938,18,9,762,934585,18,934567
39939,20,15,183,1118186,20,1118166
39940,8,-8,837,393215,8,393207
39941,20,-10,685,340252,20,340232
39942,5,2,684,703028,5,703023
39943,18,-1,771,622489,18,622471
39944,11,4,737,778689,11,778678
39945,15,15,930,1123573,15,1123558
39946,19,-16,742,152324,19,152305
39947,19,-18,415,88402,19,88383
39948,6,3,583,731238,6,731232
39949,15,-3,138,554752,15,554737
39950,5,-9,454,353671,5,353666
39951,18,6,783,842038,18,842020
39952,17,9,510,932816,17,932799
39953,7,-10,435,322059,7,322052
39954,7,4,828,768749,7,768742
39955,17,17,685,1182928,17,1182911
39956,16,-8,725,403026,16,403010
39957,19,-10,462,338474,19,338455
39958,5,-10,136,315669,5,315664
39959,14,-11,934,310984,14,310970
39960,10,5,836,799114,10,799104
39961,15,16,161,1148198,15,1148183
39962,16,19,410,1244160,16,1244144
39963,14,-8,356,400398,14,400384
39964,18,16,803,1152900,18,1152882
39965,16,-18,727,90557,16,90541
39966,12,-20,5,3003,12,2991
39967,13,19,20,1240846,13,1240833
39968,13,-6,714,464580,13,464567
39969,17,-3,985,561653,17,561636
39970,18,10,387,962740,18,962722
39971,12,14,295,1087710,12,1087698
39972,13,1,480,683647,13,683634
39973,19,-14,501,213358,19,213339
39974,12,-7,166,429535,12,429523
39975,7,9,106,909004,7,908997
39976,13,-8,904,404311,13,404298
39977,9,14,626,1075882,9,1075873
39978,17,-5,202,492426,17,492409
39979,15,-2,607,589692,15,589677
39980,6,-5,852,486434,6,486428
39981,12,-8,530,401565,12,401553
39982,19,17,737,1183380,19,1183361
39983,20,-13,736,246460,20,246440
39984,8,-10,43,313551,8,313543
39985,11,-16,45,147095,11,147084
39986,6,9,519,917751,6,917745
39987,18,-17,177,116763,18,116745
39988,19,-16,410,149934,19,149915
39989,16,-7,834,434366,16,434350
39990,20,-13,730,246410,20,246390
39991,11,-16,933,153808,11,153797
39992,7,17,260,1160778,7,1160771
39993,18,14,466,1089082,18,1089064
39994,11,-15,524,181589,11,181578
39995,11,-19,621,58899,11,58888
39996,6,6,973,834207,6,834201
39997,9,0,169,629130,9,629121
39998,8,-18,743,78453,8,78445
39999,10,-20,136,2982,10,2972
40000,17,18,977,1216171,17,1216154
40001,12,1,771,685876,12,685864
40002,10,-3,31,531223,10,531213
40003,16,2,857,716871,16,716855
40004,10,-12,26,250156,10,250146
40005,7,2,808,705435,7,705428
40006,17,2,19,710589,17,710572
40007,8,14,481,1072532,8,1072524
40008,10,17,376,1163355,10,1163345
40009,11,1,282,682104,11,682093
40010,8,9,590,919284,8,919276
40011,16,11,759,996319,16,996303
40012,16,-10,964,342325,16,342309
40013,13,-11,580,308361,13,308348
40014,10,-4,140,502449,10,502439
40015,17,-17,82,116171,17,116154
40016,11,5,318,806072,11,806061
40017,9,-6,779,453590,9,453581
40018,20,2,487,714295,20,714275
40019,11,8,522,902132,11,902121
40020,16,16,315,1149421,16,1149405
40021,9,-19,409,40380,9,40371
40022,6,16,646,1138782,6,1138776
40023,13,-5,300,493312,13,493299
40024,8,1,644,671250,8,671242
40025,12,5,128,804698,12,804686
40026,16,11,311,993143,16,993127
40027,6,-2,886,581846,6,581840
40028,7,11,642,982123,7,982116
40029,18,-5,661,495820,18,495802
40030,18,-18,851,91380,18,91362
40031,10,-19,245,36960,10,36950
40032,10,-13,479,228431,10,228421
40033,16,0,523,652132,16,652116
40034,18,-9,933,373970,18,373952
40035,20,-12,911,279442,20,279422
40036,12,12,540,1026026,12,1026014
40037,6,13,463,1040698,6,1040692
40038,20,19,813,1247370,20,1247350
40039,18,-9,637,371594,18,371576
40040,11,16,1000,1154286,11,1154275
40041,18,-2,47,585517,18,585499
40042,17,3,97,742531,17,742514
40043,9,10,439,946963,9,946954
40044,19,-7,161,429493,19,429474
40045,5,-11,441,290969,5,290964
40046,6,12,893,1018712,6,1018706
40047,20,-17,883,122061,20,122041
40048,5,-17,23,94050,5,94045
40049,13,-19,462,57510,13,57497
40050,11,-10,129,336075,11,336064
40051,9,7,199,848987,9,848978
40052,6,-17,516,104630,6,104624
40053,17,6,781,842019,17,842002
40054,16,-8,693,402798,16,402782
40055,13,-11,14,303789,13,303776
40056,8,-4,772,515927,8,515919
40057,8,2,803,705325,8,705317
40058,16,-3,407,556803,16,556787
40059,12,-12,171,273761,12,273749
40060,15,-10,922,342013,15,341998
40061,6,-20,601,13149,6,13143
40062,15,-14,863,216261,15,216246
40063,8,-15,45,156261,8,156253
40064,9,19,959,1238736,9,1238727
40065,14,12,811,1028078,14,1028064
40066,8,10,55,938702,8,938694
40067,16,-8,390,400648,16,400632
40068,19,6,622,840766,19,840747
40069,15,15,212,1118396,15,1118381
40070,19,3,263,743883,19,743864
40071,16,6,19,835961,16,835945
40072,7,17,168,1158807,7,1158800
40073,12,11,506,994520,12,994508
40074,12,19,165,1242074,12,1242062
40075,12,16,235,1148777,12,1148765
40076,19,15,203,1118316,19,1118297
40077,9,-13,655,232264,9,232255
40078,6,-1,556,606083,6,606077
40079,11,8,243,899952,11,899941
40080,17,-7,859,434591,17,434574
40081,5,15,355,1102050,5,1102045
40082,9,-17,392,101837,9,101828
40083,14,17,20,1178001,14,1177987
40084,10,11,581,980914,10,980904
40085,12,-7,160,429475,12,429463
40086,17,8,223,899740,17,899723
40087,12,1,474,683578,12,683566
40088,10,13,317,1037510,10,1037500
40089,14,-18,724,90537,14,90523
40090,16,5,831,809831,16,809815
40091,18,-8,68,398470,18,398452
40092,13,-1,572,621056,13,621043
40093,19,11,657,995504,19,995485
40094,10,10,876,956336,10,956326
40095,7,3,389,727221,7,727214
40096,17,-4,954,529254,17,529237
40097,13,13,531,1057133,13,1057120
40098,5,13,343,1038200,5,1038195
40099,6,15,369,1102276,6,1102270
40100,19,4,961,780311,19,780292
40101,18,-11,242,305587,18,305569
40102,18,9,586,933394,18,933376
40103,13,19,363,1243712,13,1243699
40104,6,-4,431,508940,6,508934
40105,17,-9,136,367571,17,367554
40106,8,-20,700,15434,8,15426
40107,10,-17,571,105825,10,105815
40108,12,-7,263,430254,12,430242
40109,7,7,943,864671,7,864664
40110,17,4,6,773353,17,773336
40111,6,0,915,645212,6,645206
40112,10,-7,198,410036,10,410026
40113,10,12,378,1007285,10,1007275
40114,9,7,73,846378,9,846369
40115,14,6,860,842618,14,842604
40116,20,-16,545,151008,20,150988
40117,8,1,626,670917,8,670909
40118,17,-5,520,494887,17,494870
40119,6,-17,933,113154,6,113148
40120,14,-18,592,89524,14,89510
40121,19,-19,488,57708,19,57689
40122,20,5,859,810007,20,809987
40123,20,-11,849,310361,20,310341
40124,17,-3,624,558754,17,558737
40125,18,-6,75,459618,18,459600
40126,10,11,161,971768,10,971758
40127,15,-10,23,335290,15,335275
40128,6,14,591,1074919,6,1074913
40129,16,8,117,898844,16,898828
40130,10,-10,727,328265,10,328255
40131,9,-5,834,486023,9,486014
40132,5,-3,624,544408,5,544403
40133,16,-18,396,88279,16,88263
40134,15,-3,953,561433,15,561418
40135,18,-10,45,335491,18,335473
40136,13,5,202,805358,13,805345
40137,11,-10,278,337078,11,337067
40138,5,-6,40,437703,5,437698
40139,8,17,579,1167558,8,1167550
40140,20,12,577,1026283,20,1026263
40141,8,-16,19,124341,8,124333
40142,12,-13,857,247444,12,247432
40143,16,-7,441,431630,16,431614
40144,14,-6,45,459462,14,459448
40145,20,-8,816,403746,20,403726
40146,6,-12,883,268797,6,268791
40147,9,19,138,1220460,9,1220451
40148,19,19,768,1247025,19,1247006
40149,19,-4,463,525569,19,525550
40150,20,5,27,803931,20,803911
40151,11,7,736,872398,11,872387
40152,7,-14,144,189614,7,189607
40153,11,-14,319,211866,11,211855
40154,17,-4,933,529047,17,529030
40155,8,8,75,876664,8,876656
40156,20,2,937,717452,20,717432
40157,14,9,12,929118,14,929104
40158,20,12,296,1024325,20,1024305
40159,10,4,452,760376,10,760366
40160,5,4,195,754818,5,754813
40161,6,12,747,1015370,6,1015364
40162,15,-11,453,307405,15,307390
40163,16,11,331,993274,16,993258
40164,17,5,69,804319,17,804302
40165,17,-15,688,182855,17,182838
40166,6,10,120,940324,6,940318
40167,19,-20,719,28293,19,28274
40168,7,-12,509,260681,7,260674
40169,20,-7,576,432656,20,432636
40170,11,-8,933,404453,11,404442
40171,5,9,509,917529,5,917524
40172,17,19,629,1245904,17,1245887
40173,17,16,189,1148480,17,1148463
40174,9,7,203,849113,9,849104
40175,5,3,499,729519,5,729514
40176,15,1,308,682274,15,682259
40177,18,11,486,994412,18,994394
40178,18,-9,548,371061,18,371043
40179,17,9,73,929599,17,929582
40180,20,-18,56,85628,20,85608
40181,15,2,609,715120,15,715105
40182,5,-18,377,70526,5,70521
40183,6,-19,907,51039,6,51033
40184,12,-19,853,60543,12,60531
40185,15,1,601,684560,15,684545
40186,16,3,210,743476,16,743460
40187,16,3,313,744300,16,744284
40188,18,-15,996,185351,18,185333
40189,12,11,965,997785,12,997773
40190,13,18,487,1212541,13,1212528
40191,8,-3,629,544564,8,544556
40192,11,5,779,809426,11,809415
40193,14,5,260,805745,14,805731
40194,10,-19,878,50653,10,50643
40195,18,-3,541,558098,18,558080
40196,13,16,800,1152858,13,1152845
40197,15,-9,762,372554,15,372539
40198,17,7,17,867143,17,867126
40199,12,-15,81,178366,12,178354
40200,15,1,386,682947,15,682932
40201,18,-15,14,177926,18,177908
40202,20,1,572,684416,20,684396
40203,6,-14,128,189231,6,189225
40204,20,-11,808,310030,20,310010
40205,19,15,1000,1124124,19,1124105
40206,11,-5,448,494301,11,494290
40207,12,2,478,714255,12,714243
40208,13,-11,101,304485,13,304472
40209,16,-3,812,560316,16,560300
40210,6,-14,716,202373,6,202367
40211,19,-2,602,589665,19,589646
40212,19,-16,73,147360,19,147341
40213,9,-19,871,50511,9,50502
40214,10,-2,300,569264,10,569254
40215,19,-12,559,276652,19,276633
40216,17,10,849,966337,17,966320
40217,18,-14,80,209946,18,209928
40218,15,-10,644,339886,15,339871
40219,12,-9,857,373356,12,373344
40220,7,-12,122,252196,7,252189
40221,7,-2,185,566689,7,566682
40222,19,19,695,1246431,19,1246412
40223,5,-1,216,598451,5,598446
40224,10,16,412,1134076,10,1134066
40225,9,14,661,1076784,9,1076775
40226,8,7,330,851896,8,851888
40227,9,11,653,982387,9,982378
40228,15,1,908,686921,15,686906
40229,11,-12,753,278030,11,278019
40230,9,-13,10,218503,9,218494
40231,6,-5,357,475926,6,475920
40232,8,-18,713,77746,8,77738
40233,17,-1,96,617308,17,617291
40234,12,18,274,1211154,12,1211142
40235,15,3,163,743057,15,743042
40236,5,-14,101,188730,5,188725
40237,19,18,215,1210721,19,1210702
40238,17,-8,796,403579,17,403562
40239,16,-14,755,215387,16,215371
40240,8,-9,302,350189,8,350181
40241,20,-2,741,590679,20,590659
40242,10,1,451,666994,10,666984
40243,11,2,799,716446,11,716435
40244,15,-11,106,304527,15,304512
40245,8,6,589,825559,8,825551
40246,18,5,985,811030,18,811012
40247,14,-8,25,398086,14,398072
40248,5,-19,585,44375,5,44370
40249,6,-4,501,510271,6,510265
40250,5,-17,177,97146,5,97141
40251,18,12,902,1028941,18,1028923
40252,8,2,1,688585,8,688577
40253,20,12,604,1026494,20,1026474
40254,17,16,434,1150264,17,1150247
40255,12,-17,587,119962,12,119950
40256,18,-6,806,465313,18,465295
40257,9,1,758,673453,9,673444
40258,8,6,792,830126,8,830118
40259,17,-5,673,495911,17,495894
40260,16,11,367,993548,16,993532
40261,12,-4,938,529087,12,529075
40262,11,-13,604,245516,11,245505
40263,20,7,3,867048,20,867028
40264,9,4,391,759069,9,759060
40265,20,17,507,1181715,20,1181695
40266,16,-2,511,589005,16,588989
40267,19,-6,415,462325,19,462306
40268,10,16,209,1129601,10,1129591
40269,7,9,307,913197,7,913190
40270,10,-10,467,322820,10,322810
40271,8,8,479,885619,8,885611
40272,8,17,846,1173562,8,1173554
40273,13,17,933,1184883,13,1184870
40274,14,-13,108,241841,14,241827
40275,5,-15,218,159918,5,159913
40276,19,17,23,1178025,19,1178006
40277,10,-11,484,291966,10,291956
40278,9,15,945,1114576,9,1114567
40279,9,-18,555,74373,9,74364
40280,5,-5,550,479877,5,479872
40281,9,0,965,646342,9,646333
40282,8,-3,759,547436,8,547428
40283,7,-5,629,481654,7,481647
40284,18,-16,538,150955,18,150937
40285,11,-15,152,178926,11,178915
40286,18,0,688,653539,18,653521
40287,8,6,331,819744,8,819736
40288,5,8,391,883744,5,883739
40289,20,15,911,1123438,20,1123418
40290,20,-19,300,56333,20,56313
40291,18,11,276,992862,18,992844
40292,18,-20,184,24240,18,24222
40293,17,3,238,743675,17,743658
40294,19,-6,141,460182,19,460163
40295,5,15,255,1100026,5,1100021
40296,8,14,938,1082845,8,1082837
40297,15,3,120,742726,15,742711
40298,14,-11,474,307528,14,307514
40299,16,18,83,1209586,16,1209570
40300,7,-2,351,570199,7,570192
40301,5,17,866,1174037,5,1174032
40302,12,9,272,930910,12,930898
40303,13,-16,391,149755,13,149742
40304,6,0,976,646562,6,646556
40305,19,-20,274,24878,19,24859
40306,16,7,36,867296,16,867280
40307,18,-4,521,526055,18,526037
40308,20,16,54,1147470,20,1147450
40309,13,-11,857,310441,13,310428
40310,18,19,905,1248138,18,1248120
40311,15,-14,366,212296,15,212281
40312,9,14,334,1069194,9,1069185
40313,20,19,829,1247462,20,1247442
40314,19,-15,583,182076,19,182057
40315,11,14,871,1092234,11,1092223
40316,10,-15,702,170409,10,170399
40317,12,6,220,837365,12,837353
40318,6,7,530,856086,6,856080
40319,17,13,950,1060290,17,1060273
40320,14,17,802,1183933,14,1183919
40321,8,-15,310,162103,8,162095
40322,9,-1,633,607540,9,607531
40323,9,1,123,659837,9,659828
40324,14,16,383,1149887,14,1149873
40325,17,-1,810,622802,17,622785
40326,13,9,560,933189,13,933176
40327,9,-9,867,362990,9,362981
40328,14,7,329,869419,14,869405
40329,5,-8,638,389019,5,389014
40330,20,0,676,653428,20,653408
40331,8,14,116,1064441,8,1064433
40332,5,-15,354,163075,5,163070
40333,13,10,235,961587,13,961574
40334,15,15,277,1118832,15,1118817
40335,6,4,363,758398,6,758392
40336,14,-16,147,148026,14,148012
40337,11,18,178,1210386,11,1210375
40338,12,11,762,996358,12,996346
40339,15,8,676,903335,15,903320
40340,14,-17,432,118665,14,118651
40341,18,-19,282,56212,18,56194
40342,9,-12,729,265206,9,265197
40343,6,-10,178,316523,6,316517
40344,17,7,402,870030,17,870013
40345,16,-7,259,430223,16,430207
40346,10,-15,86,157238,10,157228
40347,19,3,303,744207,19,744188
40348,16,17,73,1178427,16,1178411
40349,13,2,424,713834,13,713821
40350,16,-14,820,215927,16,215911
40351,19,-5,382,493839,19,493820
40352,14,10,582,964383,14,964369
40353,13,14,745,1091274,13,1091261
40354,8,13,584,1043367,8,1043359
40355,10,11,929,988563,10,988553
40356,20,-17,663,120492,20,120472
40357,19,12,72,1022574,19,1022555
40358,16,14,625,1090269,16,1090253
40359,6,-6,296,443268,6,443262
40360,7,14,406,1070830,7,1070823
40361,20,-13,498,244681,20,244661
40362,17,-20,96,23478,17,23461
40363,10,12,949,1020027,10,1020017
40364,13,8,656,903134,13,903121
40365,13,6,852,842563,13,842550
40366,6,-10,736,328465,6,328459
40367,5,-10,366,320496,5,320491
40368,8,9,587,919226,8,919218
40369,20,-16,20,146922,20,146902
40370,7,19,221,1222442,7,1222435
40371,7,11,997,989753,7,989746
40372,17,-13,692,246032,17,246015
40373,8,2,911,707554,8,707546
40374,11,-16,769,152548,11,152537
40375,14,10,540,963974,14,963960
40376,15,19,338,1243496,15,1243481
40377,18,17,899,1184712,18,1184694
40378,5,13,712,1045965,5,1045960
40379,17,-11,971,311321,17,311304
40380,6,19,442,1227790,6,1227784
40381,15,2,913,717273,15,717258
40382,13,14,757,1091374,13,1091361
40383,10,16,276,1130991,10,1130981
40384,20,-4,656,527053,20,527033
40385,11,-2,30,585360,11,585349
40386,12,-1,832,622936,12,622924
40387,14,-4,727,527534,14,527520
40388,10,9,421,915485,10,915475
40389,12,-1,331,619199,12,619187
40390,17,12,690,1027261,17,1027244
40391,19,8,435,901434,19,901415
40392,13,6,960,843374,13,843361
40393,8,4,209,755142,8,755134
40394,13,-5,759,496554,13,496541
40395,6,15,335,1101660,6,1101654
40396,20,0,958,655588,20,655568
40397,20,-16,427,150102,20,150082
40398,13,0,175,649564,13,649551
40399,14,-5,162,492204,14,492190
40400,16,19,553,1245319,16,1245303
40401,17,-9,549,371074,17,371057
40402,10,14,758,1078970,10,1078960
40403,15,-9,121,367492,15,367477
40404,10,-12,448,259252,10,259242
40405,19,8,44,898196,19,898177
40406,16,-8,621,402234,16,402218
40407,11,-10,557,339217,11,339206
40408,9,-9,74,345191,9,345182
40409,20,-14,368,212321,20,212301
40410,19,0,6,648233,19,648214
40411,15,-9,5,366654,15,366639
40412,20,11,632,995352,20,995332
40413,7,-16,723,139557,7,139550
40414,19,-12,102,273267,19,273248
40415,20,6,443,839295,20,839275
40416,19,-15,848,184174,19,184155
40417,10,16,286,1131236,10,1131226
40418,20,10,972,967255,20,967235
40419,18,-6,897,465928,18,465910
40420,8,-15,214,159844,8,159836
40421,12,-12,232,274217,12,274205
40422,17,-5,961,498078,17,498061
40423,19,-11,115,304639,19,304620
40424,13,7,812,872874,13,872861
40425,17,-10,637,339862,17,339845
40426,17,16,826,1153054,17,1153037
40427,17,8,353,900744,17,900727
40428,8,-8,622,388637,8,388629
40429,18,3,269,743916,18,743898
40430,14,-17,279,117541,14,117527
40431,13,-4,255,524098,13,524085
40432,17,-7,359,431072,17,431055
40433,18,2,833,716709,18,716691
40434,12,5,30,803952,12,803940
40435,5,19,319,1224671,5,1224666
40436,6,-5,784,484805,6,484799
40437,17,-17,835,121758,17,121741
40438,13,16,391,1149957,13,1149944
40439,5,11,269,974004,5,973999
40440,6,-3,465,540869,6,540863
40441,7,-1,285,600187,7,600180
40442,10,6,163,815713,10,815703
40443,5,-14,849,204978,5,204973
40444,12,-17,346,118069,12,118057
40445,15,-10,198,336528,15,336513
40446,19,17,441,1181229,19,1181210
40447,8,4,123,753232,8,753224
40448,6,5,730,796844,6,796838
40449,7,12,598,1011924,7,1011917
40450,5,6,48,813228,5,813223
40451,6,14,570,1074485,6,1074479
40452,17,12,82,1022664,17,1022647
40453,10,3,830,736702,10,736692
40454,14,19,53,1241160,14,1241146
40455,17,15,551,1120737,17,1120720
40456,15,9,213,930627,15,930612
40457,7,-7,163,409225,7,409218
40458,10,6,284,818666,10,818656
40459,18,10,778,965858,18,965840
40460,13,1,944,687226,13,687213
40461,20,-14,357,212173,20,212153
40462,11,2,219,712231,11,712220
40463,10,18,358,1194428,10,1194418
40464,20,-4,472,525638,20,525618
40465,16,-9,27,366793,16,366777
40466,5,18,111,1189225,5,1189220
40467,10,-4,702,514521,10,514511
40468,10,13,714,1046024,10,1046014
40469,19,6,778,841988,19,841969
40470,14,-1,224,618329,14,618315
40471,17,8,460,901603,17,901586
40472,10,10,210,941989,10,941979
40473,11,11,703,995828,11,995817
40474,12,-5,341,493663,12,493651
40475,15,-17,908,122229,15,122214
40476,15,13,167,1054431,15,1054416
40477,14,-13,422,244079,14,244065
40478,6,-3,827,548823,6,548817
40479,5,-18,76,64183,5,64178
40480,14,11,581,995023,14,995009
40481,13,5,432,806904,13,806891
40482,17,-7,756,433773,17,433756
40483,9,-3,909,550806,9,550797
40484,18,-6,784,465154,18,465136
40485,19,16,328,1149490,19,1149471
40486,14,-15,547,181803,14,181789
40487,7,6,648,826888,7,826881
40488,20,-12,298,274732,20,274712
40489,17,-14,536,213624,17,213607
40490,7,3,963,739852,7,739845
40491,19,16,591,1151283,19,1151264
40492,17,15,632,1121429,17,1121412
40493,14,10,699,965289,14,965275
40494,5,17,749,1171229,5,1171224
40495,10,16,615,1138077,10,1138067
40496,9,-18,291,68818,9,68809
40497,5,-7,990,426975,5,426970
40498,14,-19,156,55314,14,55300
40499,12,14,935,1092742,12,1092730
40500,8,3,10,719038,8,719030
40501,14,-12,71,273063,14,273049
40502,11,10,203,961366,11,961355
40503,13,-8,594,402011,13,401998
40504,17,-18,984,92361,17,92344
40505,14,15,597,1121136,14,1121122
40506,11,12,365,1024771,11,1024760
40507,6,2,886,707090,6,707084
40508,5,-10,929,332361,5,332356
40509,15,10,537,963956,15,963941
40510,19,-7,727,433591,19,433572
40511,16,18,189,1210552,16,1210536
40512,11,-15,243,179511,11,179500
40513,11,4,418,776236,11,776225
40514,9,15,380,1102550,9,1102541
40515,20,15,453,1120007,20,1119987
40516,20,-14,514,213512,20,213492
40517,12,-15,271,179720,12,179708
40518,20,-17,163,116691,20,116671
40519,6,-10,261,318254,6,318248
40520,10,-17,833,111143,10,111133
40521,16,-19,240,55920,16,55904
40522,8,13,274,1036503,8,1036495
40523,14,-19,642,59068,14,59054
40524,9,-9,659,358095,9,358086
40525,20,15,551,1120747,20,1120727
40526,6,-16,658,138230,6,138224
40527,14,5,316,806066,14,806052
40528,10,6,148,815347,10,815337
40529,11,-17,897,122149,11,122138
40530,8,10,418,946464,8,946456
40531,7,4,98,752768,7,752761
40532,11,11,618,995279,11,995268
40533,10,6,894,832366,10,832356
40534,9,5,105,783779,9,783770
40535,5,-5,217,472793,5,472788
40536,15,9,830,935213,15,935198
40537,7,-15,248,160751,7,160744
40538,14,-11,345,306496,14,306482
40539,14,-10,734,340613,14,340599
40540,20,7,676,871998,20,871978
40541,20,0,936,655369,20,655349
40542,8,8,233,880354,8,880346
40543,6,-7,962,426379,6,426373
40544,17,5,531,807654,17,807637
40545,14,10,735,965523,14,965509
40546,19,-8,954,404671,19,404652
40547,18,6,255,837692,18,837674
40548,19,-14,763,215435,19,215416
40549,13,4,89,773911,13,773898
40550,15,2,722,716052,15,716037
40551,8,-8,459,384765,8,384757
40552,5,3,489,729318,5,729313
40553,7,-3,282,536481,7,536474
40554,10,-10,361,320369,10,320359
40555,19,0,696,653618,19,653599
40556,13,-17,708,120823,13,120810
40557,14,-17,39,115843,14,115829
40558,11,17,501,1181641,11,1181630
40559,6,-11,357,289071,6,289065
40560,17,9,492,932643,17,932626
40561,13,19,800,1247248,13,1247235
40562,7,-2,357,570322,7,570315
40563,9,-4,612,512612,9,512603
40564,18,-13,563,245195,18,245177
40565,10,-2,373,570606,10,570596
40566,7,-19,26,32100,7,32093
40567,14,9,744,934488,14,934474
40568,10,16,772,1141109,10,1141099
40569,10,12,382,1007354,10,1007344
40570,8,12,128,1001901,8,1001893
40571,9,15,556,1106306,9,1106297
40572,10,-8,960,395881,10,395871
40573,7,-3,824,548772,7,548765
40574,19,-18,974,92305,19,92286
40575,10,8,707,890804,10,890794
40576,6,-12,286,255731,6,255725
40577,7,-2,708,577944,7,577937
40578,20,4,768,778904,20,778884
40579,15,17,896,1184679,15,1184664
40580,5,-11,731,296939,5,296934
40581,6,17,245,1160484,6,1160478
40582,11,-16,667,151810,11,151799
40583,14,12,176,1023319,14,1023305
40584,8,-8,941,395464,8,395456
40585,12,-3,849,560566,12,560554
40586,17,0,977,655769,17,655752
40587,18,-12,79,273115,18,273097
40588,16,6,630,840855,16,840839
40589,14,-5,197,492400,14,492386
40590,12,18,834,1215007,12,1214995
40591,18,-2,666,590152,18,590134
40592,7,-7,856,424009,7,424002
40593,12,-5,932,497891,12,497879
40594,15,-9,55,367062,15,367047
40595,6,1,34,657812,6,657806
40596,16,-17,416,118509,16,118493
40597,8,17,141,1158283,8,1158275
40598,17,-13,0,241043,17,241026
40599,14,-1,768,622449,14,622435
40600,19,-7,888,434861,19,434842
40601,13,-12,359,275224,13,275211
40602,11,11,291,992983,11,992972
40603,8,-1,415,603027,8,603019
40604,18,-17,352,118104,18,118086
40605,5,15,308,1101093,5,1101088
40606,6,-19,692,46709,6,46703
40607,19,-2,484,588817,19,588798
40608,19,1,583,684505,19,684486
40609,15,-10,298,337215,15,337200
40610,19,0,374,650915,19,650896
40611,9,-11,838,299080,9,299071
40612,14,14,108,1086338,14,1086324
40613,20,10,923,966956,20,966936
40614,17,4,95,773976,17,773959
40615,8,4,675,765172,8,765164
40616,5,-2,829,580564,5,580559
40617,20,10,236,961604,20,961584
40618,11,-14,739,215249,11,215238
40619,10,18,443,1196194,10,1196184
40620,17,12,640,1026811,17,1026794
40621,8,-14,205,190992,8,190984
40622,5,8,56,876271,5,876266
40623,20,-7,791,434009,20,433989
40624,9,-16,141,127091,9,127082
40625,12,-18,103,86015,12,86003
40626,17,16,622,1151490,17,1151473
40627,9,-5,522,479352,9,479343
40628,8,-9,882,363371,8,363363
40629,20,12,900,1028905,20,1028885
40630,19,-6,45,459471,19,459452
40631,10,18,895,1205721,10,1205711
40632,18,0,799,654395,18,654377
40633,12,12,697,1027309,12,1027297
40634,13,15,943,1123686,13,1123673
40635,15,18,417,1212138,15,1212123
40636,20,15,618,1121302,20,1121282
40637,11,-2,263,587108,11,587097
40638,11,-12,698,277637,11,277626
40639,7,17,766,1171535,7,1171528
40640,13,8,77,898517,13,898504
40641,15,-10,946,342199,15,342184
40642,5,-12,834,267674,5,267669
40643,19,-19,196,55593,19,55574
40644,16,-8,594,402017,16,402001
40645,5,-8,120,377869,5,377864
40646,7,0,382,633628,7,633621
40647,18,-8,562,401800,18,401782
40648,11,-3,639,558907,11,558896
40649,13,3,613,746405,13,746392
40650,11,1,922,687063,11,687052
40651,20,3,939,748984,20,748964
40652,10,3,882,737851,10,737841
40653,14,-2,39,585417,14,585403
40654,17,16,1000,1154293,17,1154276
40655,19,11,888,997318,19,997299
40656,16,-20,614,27457,16,27441
40657,9,-14,316,193547,9,193538
40658,11,17,677,1182888,11,1182877
40659,5,19,297,1224106,5,1224101
40660,13,18,35,1209151,13,1209138
40661,5,-12,171,253186,5,253181
40662,12,-18,21,85368,12,85356
40663,16,4,74,773790,16,773774
40664,10,-5,237,473249,10,473239
40665,14,16,421,1150163,14,1150149
40666,20,-6,59,459531,20,459511
40667,13,-5,116,491817,13,491804
40668,11,19,987,1248702,11,1248691
40669,19,15,198,1118288,19,1118269
40670,13,-17,500,119235,13,119222
40671,17,10,482,963503,17,963486
40672,17,19,941,1248360,17,1248343
40673,19,14,696,1090955,19,1090936
40674,14,7,417,870138,14,870124
40675,17,-11,258,305740,17,305723
40676,15,-10,880,341728,15,341713
40677,8,15,64,1095837,8,1095829
40678,20,-19,937,61050,20,61030
40679,16,10,563,964195,16,964179
40680,5,13,837,1048756,5,1048751
40681,11,2,13,710557,11,710546
40682,9,2,885,707051,9,707042
40683,10,-13,621,231675,10,231665
40684,14,14,108,1086342,14,1086328
40685,20,-20,745,28508,20,28488
40686,13,2,533,714630,13,714617
40687,11,-6,394,462134,11,462123
40688,20,15,248,1118639,20,1118619
40689,8,-10,100,314735,8,314727
40690,13,19,753,1246884,13,1246871
40691,17,12,485,1025657,17,1025640
40692,12,-7,285,430458,12,430446
40693,14,18,22,1209055,14,1209041
40694,15,12,680,1027179,15,1027164
40695,12,-7,767,433894,12,433882
40696,20,-14,345,212093,20,212073
40697,7,18,567,1198826,7,1198819
40698,9,-5,706,483270,9,483261
40699,11,10,307,962105,11,962094
40700,17,-13,781,246869,17,246852
40701,6,10,23,938019,6,938013
40702,8,11,317,975149,8,975141
40703,7,-11,612,294742,7,294735
40704,7,-18,881,81453,7,81446
40705,6,-4,667,513812,6,513806
40706,6,0,241,630627,6,630621
40707,19,-18,119,86116,19,86097
40708,10,12,68,1000572,10,1000562
40709,17,3,57,742269,17,742252
40710,14,-5,271,493040,14,493026
40711,5,-19,157,35199,5,35194
40712,18,-16,139,147961,18,147943
40713,10,8,975,896370,10,896360
40714,5,-19,574,44122,5,44117
40715,18,6,31,836064,18,836046
40716,17,-6,460,462684,17,462667
40717,16,-6,621,463920,16,463904
40718,17,-2,697,590409,17,590392
40719,19,-13,769,246762,19,246743
40720,13,-20,271,24848,13,24835
40721,12,-4,397,525216,12,525204
40722,7,11,766,984890,7,984883
40723,15,8,89,898615,15,898600
40724,5,-3,485,541395,5,541390
40725,5,8,769,892101,5,892096
40726,8,2,931,707974,8,707966
40727,7,12,44,1000107,7,1000100
40728,7,-18,814,80022,7,80015
40729,7,9,956,927063,7,927056
40730,17,7,98,867725,17,867708
40731,15,8,765,904003,15,903988
40732,12,9,151,930146,12,930134
40733,15,-12,279,274591,15,274576
40734,19,-18,912,91853,19,91834
40735,18,-20,982,30283,18,30265
40736,16,9,898,935707,16,935691
40737,17,1,833,686289,17,686272
40738,7,-19,457,41329,7,41322
40739,8,4,106,752923,8,752915
40740,12,-17,464,118951,12,118939
40741,7,-6,17,437181,7,437174
40742,14,14,547,1089749,14,1089735
40743,17,-15,433,180998,17,180981
40744,5,14,881,1081583,5,1081578
40745,17,0,649,653205,17,653188
40746,14,16,365,1149780,14,1149766
40747,8,-12,265,255246,8,255238
40748,6,9,281,912528,6,912522
40749,16,12,767,1027744,16,1027728
40750,10,-3,298,536912,10,536902
40751,14,-8,860,403986,14,403972
40752,8,6,127,814925,8,814917
40753,6,4,195,754824,6,754818
40754,11,11,105,991608,11,991597
40755,5,-12,542,261353,5,261348
40756,13,-14,885,216396,13,216383
40757,13,-20,982,30286,13,30273
40758,8,7,803,861777,8,861769
40759,14,5,376,806554,14,806540
40760,19,19,721,1246625,19,1246606
40761,12,0,382,650988,12,650976
40762,6,19,711,1233236,6,1233230
40763,12,-20,776,28783,12,28771
40764,5,-6,908,456189,5,456184
40765,17,16,916,1153677,17,1153660
40766,5,5,245,786772,5,786767
40767,16,11,791,996580,16,996564
40768,17,-3,685,559242,17,559225
40769,18,9,500,932697,18,932679
40770,16,9,240,930768,16,930752
40771,15,-9,819,373021,15,373006
40772,6,14,126,1064695,6,1064689
40773,14,-7,724,433578,14,433564
40774,6,-8,497,385707,6,385701
40775,15,-4,612,526699,15,526684
40776,11,3,233,743632,11,743621
40777,8,13,18,1031195,8,1031187
40778,5,-2,96,564868,5,564863
40779,9,-4,62,500685,9,500676
40780,5,5,861,799634,5,799629
40781,11,-13,647,245767,11,245756
40782,7,-6,553,448826,7,448819
40783,20,-17,601,120050,20,120030
40784,13,14,263,1087470,13,1087457
40785,15,-14,504,213375,15,213360
40786,5,-1,229,598885,5,598880
40787,16,5,175,805083,16,805067
40788,11,0,386,651010,11,650999
40789,13,-14,572,214025,13,214012
40790,11,-10,398,337918,11,337907
40791,15,13,141,1054222,15,1054207
40792,15,1,408,683095,15,683080
40793,16,1,526,684023,16,684007
40794,10,-16,986,145230,10,145220
40795,6,-1,743,609796,6,609790
40796,20,0,296,650311,20,650291
40797,13,7,464,870475,13,870462
40798,11,0,826,654534,11,654523
40799,11,-18,324,87756,11,87745
40800,18,-4,297,524380,18,524362
40801,17,12,820,1028135,17,1028118
40802,6,0,397,633960,6,633954
40803,9,-18,506,73338,9,73329
40804,5,3,754,735143,5,735138
40805,10,-6,264,442579,10,442569
40806,13,11,526,994665,13,994652
40807,15,-15,315,180037,15,180022
40808,6,-9,790,361277,6,361271
40809,9,19,134,1220344,9,1220335
40810,7,-13,338,225493,7,225486
40811,13,-6,193,460667,13,460654
40812,15,12,460,1025419,15,1025404
40813,16,-8,31,398142,16,398126
40814,12,3,313,744302,12,744290
40815,20,-12,14,272610,20,272590
40816,15,-10,434,338241,15,338226
40817,19,-3,309,556032,19,556013
40818,12,9,100,929815,12,929803
40819,13,13,210,1054784,13,1054771
40820,14,15,414,1119707,14,1119693
40821,10,13,37,1031572,10,1031562
40822,16,1,612,684671,16,684655
40823,14,-10,392,337885,14,337871
40824,20,-16,615,151578,20,151558
40825,11,-16,216,148551,11,148540
40826,10,-11,839,299115,10,299105
40827,17,16,779,1152635,17,1152618
40828,8,7,622,857971,8,857963
40829,18,-9,438,370063,18,370045
40830,5,-15,604,168366,5,168361
40831,9,7,398,853404,9,853395
40832,10,7,81,846604,10,846594
40833,16,8,252,899973,16,899957
40834,7,1,641,671184,7,671177
40835,15,14,396,1088519,15,1088504
40836,20,8,789,904188,20,904168
40837,12,15,256,1118676,12,1118664
40838,12,15,400,1119653,12,1119641
40839,9,7,655,858665,9,858656
40840,16,5,699,808900,16,808884
40841,15,-13,50,241421,15,241406
40842,11,14,893,1092454,11,1092443
40843,6,3,222,723622,6,723616
40844,17,-15,730,183229,17,183212
40845,9,1,11,657237,9,657228
40846,19,-6,140,460164,19,460145
40847,10,-7,628,419172,10,419162
40848,19,-8,116,398711,19,398692
40849,14,19,774,1247055,14,1247041
40850,7,13,571,1043026,7,1043019
40851,14,-13,830,247188,14,247174
40852,14,-20,167,24019,14,24005
40853,7,1,101,659315,7,659308
40854,17,17,715,1183228,17,1183211
40855,10,10,734,953281,10,953271
40856,11,19,49,1241102,11,1241091
40857,5,0,469,635558,5,635553
40858,7,2,879,706906,7,706899
40859,12,-13,751,246581,12,246569
40860,17,10,862,966437,17,966420
40861,15,-6,209,460772,15,460757
40862,5,-12,293,255851,5,255846
40863,10,-10,95,314621,10,314611
40864,12,-7,100,428983,12,428971
40865,20,17,914,1184789,20,1184769
40866,20,9,652,933876,20,933856
40867,18,-9,898,373708,18,373690
40868,11,-10,972,342419,11,342408
40869,13,19,728,1246710,13,1246697
40870,6,-2,117,565400,6,565394
40871,9,9,890,925555,9,925546
40872,9,-13,725,233871,9,233862
40873,10,14,557,1074251,10,1074241
40874,13,18,24,1209072,13,1209059
40875,5,-4,157,502762,5,502757
40876,5,15,236,1099545,5,1099540
40877,5,-1,547,605885,5,605880
40878,16,6,467,839529,16,839513
40879,18,8,891,904857,18,904839
40880,17,3,739,747429,17,747412
40881,12,-4,288,524311,12,524299
40882,18,-2,544,589212,18,589194
40883,7,15,384,1102620,7,1102613
40884,13,-10,690,340314,13,340301
40885,18,-15,638,182495,18,182477
40886,12,-13,993,248524,12,248512
40887,5,1,214,661909,5,661904
40888,15,-5,473,494541,15,494526
40889,17,-2,537,589152,17,589135
40890,6,11,846,986593,6,986587
40891,6,-2,538,574135,6,574129
40892,7,-16,743,139953,7,139946
40893,12,-8,744,403157,12,403145
40894,12,7,315,869305,12,869293
40895,16,-10,421,338158,16,338142
40896,7,12,511,1010003,7,1009996
40897,19,18,854,1215208,19,1215189
40898,10,-12,280,255624,10,255614
40899,13,1,441,683299,13,683286
40900,12,-16,111,147758,12,147746
40901,7,10,182,941426,7,941419
40902,20,8,823,904377,20,904357
40903,6,2,604,701330,6,701324
40904,11,1,627,684773,11,684762
40905,18,18,666,1213798,18,1213780
40906,5,14,220,1066562,5,1066557
40907,13,-18,171,86590,13,86577
40908,14,5,544,807762,14,807748
40909,8,7,331,851971,8,851963
40910,20,-8,651,402449,20,402429
40911,16,-7,31,428577,16,428561
40912,5,-17,798,110505,5,110500
40913,5,10,820,955266,5,955261
40914,11,-19,251,55989,11,55978
40915,5,5,523,792500,5,792495
40916,13,2,402,713685,13,713672
40917,11,11,897,997388,11,997377
40918,9,10,703,952693,9,952684
40919,6,-1,112,596191,6,596185
40920,12,15,114,1117629,12,1117617
40921,12,-15,360,180390,12,180378
40922,13,-2,688,590336,13,590323
40923,11,6,888,842860,11,842849
40924,10,2,94,690636,10,690626
40925,8,-17,7,93639,8,93631
40926,17,5,573,807958,17,807941
40927,16,4,885,779831,16,779815
40928,9,7,298,851175,9,851166
40929,20,9,836,935269,20,935249
40930,10,11,651,982337,10,982327
40931,11,-18,671,90162,11,90151
40932,10,-1,190,597762,10,597752
40933,13,11,751,996242,13,996229
40934,14,-2,420,588265,14,588251
40935,19,5,35,804008,19,803989
40936,19,-19,65,54364,19,54345
40937,8,-8,895,394504,8,394496
40938,19,-17,534,119472,19,119453
40939,18,18,225,1210783,18,1210765
40940,6,11,925,988503,6,988497
40941,17,-16,242,148749,17,148732
40942,20,11,608,995207,20,995187
40943,6,-7,971,426578,6,426572
40944,12,-14,768,215538,12,215526
40945,7,-6,257,442453,7,442446
40946,15,-1,223,618312,15,618297
40947,12,-5,184,492321,12,492309
40948,12,7,524,870921,12,870909
40949,10,-16,80,125606,10,125596
40950,12,-11,930,310961,12,310949
40951,5,-4,306,506144,5,506139
40952,7,-17,480,103697,7,103690
40953,13,4,784,779028,13,779015
40954,7,18,37,1187400,7,1187393
40955,7,5,235,786572,7,786565
40956,6,18,502,1197465,6,1197459
40957,15,19,634,1245919,15,1245904
40958,5,10,423,946561,5,946556
40959,11,11,929,997638,11,997627
40960,17,11,868,997170,17,997153
40961,9,-18,875,81320,9,81311
40962,11,18,242,1210910,11,1210899
40963,8,-8,762,391679,8,391671
40964,16,-15,541,181744,16,181728
40965,6,2,281,694636,6,694630
40966,13,15,239,1118550,13,1118537
40967,15,-1,917,623579,15,623564
40968,18,-8,893,404229,18,404211
40969,14,16,269,1149071,14,1149057
40970,19,16,410,1150088,19,1150069
40971,5,8,560,887465,5,887460
40972,20,-4,872,528579,20,528559
40973,10,9,971,927542,10,927532
40974,9,17,310,1162007,9,1161998
40975,16,2,674,715689,16,715673
40976,6,-9,254,349142,6,349136
40977,13,-14,827,215944,13,215931
40978,19,-20,432,26057,19,26038
40979,19,-15,995,185308,19,185289
40980,20,-10,971,342397,20,342377
40981,7,-3,657,545267,7,545260
40982,12,-8,702,402847,12,402835
40983,18,13,756,1058877,18,1058859
40984,5,-15,799,172411,5,172406
40985,19,19,348,1243581,19,1243562
40986,8,-6,55,438022,8,438014
40987,8,-11,712,296569,8,296561
40988,20,-18,309,87659,20,87639
40989,10,16,496,1135703,10,1135693
40990,11,1,477,683623,11,683612
40991,15,15,537,1120676,15,1120661
40992,8,-19,104,33747,8,33739
40993,9,5,303,787884,9,787875
40994,19,8,334,900607,19,900588
40995,8,18,375,1194795,8,1194787
40996,11,-5,672,495888,11,495877
40997,10,12,584,1011639,10,1011629
40998,5,-9,722,359484,5,359479
40999,11,19,65,1241259,11,1241248
41000,12,-12,404,275463,12,275451
41001,13,-10,442,338314,13,338301
41002,12,-2,645,589960,12,589948
41003,17,-4,72,522589,17,522572
41004,6,11,153,971622,6,971616
41005,9,16,12,1125459,9,1125450
41006,16,9,633,933779,16,933763
41007,19,-11,635,308759,19,308740
41008,6,-13,751,234461,6,234455
41009,7,19,262,1223230,7,1223223
41010,7,-13,323,225231,7,225224
41011,19,4,548,777230,19,777211
41012,19,-15,136,178838,19,178819
41013,17,-11,937,310997,17,310980
41014,15,-8,183,399214,15,399199
41015,9,16,210,1129634,9,1129625
41016,8,19,535,1229622,8,1229614
41017,19,0,63,648707,19,648688
41018,8,-18,553,74317,8,74309
41019,6,-3,579,543499,6,543493
41020,6,0,922,645383,6,645377
41021,12,-20,322,25333,12,25321
41022,14,-12,898,279253,14,279239
41023,14,-18,635,89855,14,89841
41024,14,-15,423,180932,14,180918
41025,10,-12,382,257890,10,257880
41026,6,-14,849,204984,6,204978
41027,5,8,783,892446,5,892441
41028,16,-8,564,401826,16,401810
41029,17,8,281,900201,17,900184
41030,17,-16,58,147231,17,147214
41031,5,-18,327,69592,5,69587
41032,11,-10,43,335472,11,335461
41033,6,12,245,1004473,6,1004467
41034,18,4,192,774623,18,774605
41035,19,13,844,1059560,19,1059541
41036,7,-11,1,281145,7,281138
41037,14,-20,280,24955,14,24941
41038,18,12,921,1029156,18,1029138
41039,12,-20,274,24880,12,24868
41040,11,15,68,1117273,11,1117262
41041,10,13,54,1031959,10,1031949
41042,14,9,621,933693,14,933679
41043,10,5,31,782224,10,782214
41044,12,3,820,748007,12,747995
41045,12,19,410,1244162,12,1244150
41046,8,-20,993,21987,8,21979
41047,13,-10,158,336248,13,336235
41048,18,17,807,1183993,18,1183975
41049,8,5,423,790281,8,790273
41050,20,3,624,746506,20,746486
41051,16,13,30,1053430,16,1053414
41052,14,-4,171,523376,14,523362
41053,14,17,306,1180287,14,1180273
41054,19,-13,140,242034,19,242015
41055,18,-9,753,372398,18,372380
41056,18,14,526,1089557,18,1089539
41057,16,10,702,965318,16,965302
41058,6,-3,467,540889,6,540883
41059,9,-2,346,570102,9,570093
41060,20,-20,593,27301,20,27281
41061,14,16,177,1148381,14,1148367
41062,12,5,117,804641,12,804629
41063,14,-20,224,24501,14,24487
41064,11,15,136,1117811,11,1117800
41065,15,7,320,869347,15,869332
41066,6,-4,440,509099,6,509093
41067,15,-10,970,342379,15,342364
41068,16,-17,1,115545,16,115529
41069,12,-18,676,90176,12,90164
41070,8,10,945,957845,8,957837
41071,11,13,898,1059919,11,1059908
41072,15,-15,58,178212,15,178197
41073,11,-20,530,26798,11,26787
41074,6,-1,888,612991,6,612985
41075,12,6,922,843109,12,843097
41076,14,0,305,650363,14,650349
41077,7,10,295,943744,7,943737
41078,18,-20,822,29187,18,29169
41079,12,2,160,711807,12,711795
41080,18,-16,998,154297,18,154279
41081,10,6,744,829088,10,829078
41082,15,2,558,714802,15,714787
41083,12,16,302,1149321,12,1149309
41084,8,17,144,1158317,8,1158309
41085,11,4,813,779238,11,779227
41086,5,12,981,1020740,5,1020735
41087,13,-18,759,90806,13,90793
41088,16,-8,137,398857,16,398841
41089,19,-20,451,26250,19,26231
41090,5,-15,158,158812,5,158807
41091,10,16,229,1130113,10,1130103
41092,8,-5,887,487341,8,487333
41093,5,-3,624,544413,5,544408
41094,19,6,682,841232,19,841213
41095,18,-17,793,121489,18,121471
41096,17,-10,375,337776,17,337759
41097,13,9,216,930637,13,930624
41098,12,2,249,712457,12,712445
41099,13,-8,974,404834,13,404821
41100,20,8,228,899806,20,899786
41101,18,1,79,680374,18,680356
41102,13,-8,446,400951,13,400938
41103,10,-6,147,439894,10,439884
41104,5,19,963,1238795,5,1238790
41105,5,-16,362,131722,5,131717
41106,18,-9,771,372656,18,372638
41107,17,7,281,869030,17,869013
41108,15,7,284,869059,15,869044
41109,10,4,261,756226,10,756216
41110,13,-7,712,433493,13,433480
41111,13,-5,1000,498341,13,498328
41112,12,8,965,905455,12,905443
41113,15,-10,697,340361,15,340346
41114,20,-2,258,587067,20,587047
41115,11,8,978,905567,11,905556
41116,10,-9,794,361354,10,361344
41117,7,18,390,1195067,7,1195060
41118,5,12,693,1014310,5,1014305
41119,12,-1,298,618924,12,618912
41120,18,-8,877,404093,18,404075
41121,7,-17,968,113863,7,113856
41122,12,9,235,930743,12,930731
41123,16,-14,966,216999,16,216983
41124,16,15,648,1121547,16,1121531
41125,13,-8,75,398563,13,398550
41126,11,12,980,1029670,11,1029659
41127,8,-2,623,576026,8,576018
41128,17,11,699,995780,17,995763
41129,14,12,521,1025845,14,1025831
41130,15,-6,259,461190,15,461175
41131,17,18,147,1210180,17,1210163
41132,20,8,897,904964,20,904944
41133,11,-16,791,152723,11,152712
41134,20,7,475,870581,20,870561
41135,5,-5,834,486028,5,486023
41136,16,-5,91,491632,16,491616
41137,6,12,796,1016373,6,1016367
41138,15,-3,621,558750,15,558735
41139,10,9,302,913033,10,913023
41140,5,-20,822,18268,5,18263
41141,20,-6,268,461274,20,461254
41142,17,-12,783,278245,17,278228
41143,9,14,102,1064127,9,1064118
41144,5,-15,511,166475,5,166470
41145,19,18,235,1210859,19,1210840
41146,18,10,680,965174,18,965156
41147,16,-2,46,585502,16,585486
41148,12,-19,705,59480,12,59468
41149,19,4,87,773898,19,773879
41150,7,-19,185,35691,7,35684
41151,18,9,35,929315,18,929297
41152,20,-7,368,431144,20,431124
41153,13,-18,590,89521,13,89508
41154,12,7,259,868912,12,868900
41155,17,18,643,1213619,17,1213602
41156,13,12,581,1026313,13,1026300
41157,6,14,153,1065255,6,1065249
41158,7,19,217,1222338,7,1222331
41159,8,14,510,1073212,8,1073204
41160,7,-5,384,476426,7,476419
41161,15,7,223,868557,15,868542
41162,12,-11,168,305066,12,305054
41163,8,10,951,957975,8,957967
41164,14,11,516,994603,14,994589
41165,11,8,346,900729,11,900718
41166,5,11,544,980109,5,980104
41167,9,17,695,1170151,9,1170142
41168,20,-7,422,431505,20,431485
41169,13,8,436,901447,13,901434
41170,6,-6,148,439929,6,439923
41171,5,18,160,1190295,5,1190290
41172,19,2,269,712572,19,712553
41173,7,12,720,1014855,7,1014848
41174,7,-1,314,600888,7,600881
41175,5,16,399,1133727,5,1133722
41176,7,-3,261,536092,7,536085
41177,19,0,797,654357,19,654338
41178,17,7,424,870161,17,870144
41179,19,8,833,904434,19,904415
41180,18,6,675,841193,18,841175
41181,10,4,288,756757,10,756747
41182,8,8,479,885627,8,885619
41183,15,-2,906,592034,15,592019
41184,17,16,563,1151095,17,1151078
41185,9,-12,514,260787,9,260778
41186,11,6,823,842377,11,842366
41187,18,-11,928,310939,18,310921
41188,10,15,97,1096526,10,1096516
41189,8,10,574,949862,8,949854
41190,8,-6,871,455349,8,455341
41191,6,-10,315,319390,6,319384
41192,12,6,821,842369,12,842357
41193,10,1,415,666255,10,666245
41194,9,0,359,632978,9,632969
41195,7,15,445,1103890,7,1103883
41196,9,-16,151,127324,9,127315
41197,8,8,270,881032,8,881024
41198,16,-2,222,586810,16,586794
41199,10,4,68,752103,10,752093
41200,7,12,712,1014698,7,1014691
41201,13,6,798,842140,13,842127
41202,6,4,286,756713,6,756707
41203,7,12,873,1018244,7,1018237
41204,14,10,323,962277,14,962263
41205,17,2,992,717816,17,717799
41206,9,12,565,1011189,9,1011180
41207,5,18,562,1198732,5,1198727
41208,18,15,248,1118647,18,1118629
41209,9,-15,487,166017,9,166008
41210,11,-5,73,491408,11,491397
41211,14,-5,578,495300,14,495286
41212,13,14,138,1086553,13,1086540
41213,20,-19,1000,61458,20,61438
41214,14,6,674,841186,14,841172
41215,9,-14,756,203191,9,203182
41216,10,-20,879,19560,10,19550
41217,18,11,55,991274,18,991256
41218,15,13,272,1055180,15,1055165
41219,6,-17,446,102935,6,102929
41220,9,-1,609,607090,9,607081
41221,7,4,871,769779,7,769772
41222,12,-12,317,274876,12,274864
41223,5,-17,42,94448,5,94443
41224,18,-19,939,61063,18,61045
41225,16,12,527,1025887,16,1025871
41226,12,2,957,717634,12,717622
41227,9,-15,602,168324,9,168315
41228,17,4,652,778016,17,777999
41229,12,-8,738,403094,12,403082
41230,10,13,833,1048666,10,1048656
41231,20,-15,812,183842,20,183822
41232,7,18,375,1194802,7,1194795
41233,18,-8,378,400562,18,400544
41234,9,14,649,1076500,9,1076491
41235,14,7,896,873433,14,873419
41236,18,15,913,1123459,18,1123441
41237,17,-16,38,147017,17,147000
41238,17,1,407,683086,17,683069
41239,15,1,253,681906,15,681891
41240,15,-4,933,529052,15,529037
41241,17,10,586,964414,17,964397
41242,14,-13,888,247669,14,247655
41243,10,18,397,1195197,10,1195187
41244,8,19,328,1224935,8,1224927
41245,18,10,724,965430,18,965412
41246,19,10,864,966463,19,966444
41247,19,-13,565,245214,19,245195
41248,5,13,858,1049199,5,1049194
41249,9,-19,803,49015,9,49006
41250,17,-6,213,460811,17,460794
41251,17,13,650,1058149,17,1058132
41252,10,17,64,1156703,10,1156693
41253,11,-10,872,341624,11,341613
41254,12,-19,687,59355,12,59343
41255,9,10,267,943169,9,943160
41256,5,12,690,1014268,5,1014263
41257,7,16,656,1138944,7,1138937
41258,5,-11,285,287250,5,287245
41259,8,-12,37,250324,8,250316
41260,18,-10,745,340716,18,340698
41261,7,12,677,1013993,7,1013986
41262,7,-17,417,102271,7,102264
41263,11,-7,444,431661,11,431650
41264,6,-16,617,137463,6,137457
41265,9,14,547,1074042,9,1074033
41266,14,5,611,808289,14,808275
41267,17,-14,249,211364,17,211347
41268,6,-18,849,80654,6,80648
41269,16,19,830,1247482,16,1247466
41270,7,-17,313,100270,7,100263
41271,9,-13,231,223294,9,223285
41272,18,10,992,967391,18,967373
41273,15,7,842,873105,15,873090
41274,7,9,453,916184,7,916177
41275,18,9,681,934072,18,934054
41276,15,-18,232,87137,15,87122
41277,13,7,98,867728,13,867715
41278,18,-5,990,498272,18,498254
41279,12,8,908,905058,12,905046
41280,18,-13,766,246721,18,246703
41281,11,4,348,775725,11,775714
41282,9,-3,529,542420,9,542411
41283,16,-7,190,429716,16,429700
41284,6,9,307,913203,6,913197
41285,10,17,644,1169089,10,1169079
41286,17,-2,752,590745,17,590728
41287,12,13,332,1055667,12,1055655
41288,12,5,740,809195,12,809183
41289,15,-18,520,89091,15,89076
41290,10,3,361,726690,10,726680
41291,19,-10,258,337000,19,336981
41292,10,11,323,975304,10,975294
41293,10,8,398,883937,10,883927
41294,9,11,895,987769,9,987760
41295,18,-18,603,89614,18,89596
41296,8,-12,990,271204,8,271196
41297,19,-6,54,459519,19,459500
41298,20,-12,114,273387,20,273367
41299,19,-10,988,342565,19,342546
41300,14,6,227,837461,14,837447
41301,20,-4,36,522304,20,522284
41302,13,18,447,1212309,13,1212296
41303,16,-12,717,277785,16,277769
41304,5,3,565,730771,5,730766
41305,16,-7,343,430949,16,430933
41306,7,-5,250,473539,7,473532
41307,15,-4,358,524941,15,524926
41308,19,1,356,682706,19,682687
41309,18,19,518,1245057,18,1245039
41310,15,-4,351,524835,15,524820
41311,19,-16,857,153190,19,153171
41312,8,-3,534,542553,8,542545
41313,12,-12,254,274384,12,274372
41314,15,-6,891,465852,15,465837
41315,19,-19,449,57438,19,57419
41316,10,-13,800,235737,10,235727
41317,13,8,607,902730,13,902717
41318,19,-17,336,117992,19,117973
41319,16,-6,19,459296,16,459280
41320,8,13,676,1045301,8,1045293
41321,5,0,589,638147,5,638142
41322,6,19,367,1225793,6,1225787
41323,19,-9,805,372933,19,372914
41324,11,4,691,778315,11,778304
41325,11,-9,510,370714,11,370703
41326,9,-20,826,18335,9,18326
41327,11,-11,225,305457,11,305446
41328,6,-14,892,205870,6,205864
41329,12,17,555,1182011,12,1181999
41330,5,9,579,918953,5,918948
41331,16,10,566,964232,16,964216
41332,9,-16,83,125657,9,125648
41333,14,0,302,650336,14,650322
41334,14,-13,129,241943,14,241929
41335,9,9,405,915216,9,915207
41336,8,14,803,1079948,8,1079940
41337,19,17,819,1184096,19,1184077
41338,20,9,661,933939,20,933919
41339,7,16,999,1146048,7,1146041
41340,13,10,158,961073,13,961060
41341,8,7,48,845881,8,845873
41342,16,13,778,1059060,16,1059044
41343,13,10,938,967041,13,967028
41344,7,5,439,790647,7,790640
41345,8,4,950,771410,8,771402
41346,13,8,146,899084,13,899071
41347,7,-6,989,457930,7,457923
41348,7,10,564,949595,7,949588
41349,12,15,947,1123752,12,1123740
41350,6,5,171,785064,6,785058
41351,16,-15,942,184962,16,184946
41352,16,-14,262,211474,16,211458
41353,14,12,561,1026155,14,1026141
41354,20,0,526,652185,20,652165
41355,17,12,229,1023733,17,1023716
41356,9,4,571,762874,9,762865
41357,18,-4,843,528233,18,528215
41358,8,0,246,630688,8,630680
41359,19,-19,731,59730,19,59711
41360,6,-15,296,161773,6,161767
41361,8,-9,768,360737,8,360729
41362,13,-11,720,309315,13,309302
41363,14,14,208,1087017,14,1087003
41364,13,7,792,872748,13,872735
41365,20,19,830,1247492,20,1247472
41366,17,-14,815,215914,17,215897
41367,8,-14,937,206882,8,206874
41368,7,6,22,812720,7,812713
41369,19,-8,934,404467,19,404448
41370,10,14,78,1063567,10,1063557
41371,13,-6,132,460088,13,460075
41372,5,1,398,665898,5,665893
41373,10,-6,685,451568,10,451558
41374,18,15,350,1119378,18,1119360
41375,14,-11,493,307685,14,307671
41376,16,-14,589,214160,16,214144
41377,12,-4,874,528618,12,528606
41378,10,-6,245,442214,10,442204
41379,8,13,191,1034767,8,1034759
41380,16,-14,695,214969,16,214953
41381,13,1,49,680174,13,680161
41382,16,13,663,1058253,16,1058237
41383,14,9,333,931439,14,931425
41384,5,-17,884,112170,5,112165
41385,13,-17,493,119187,13,119174
41386,16,16,322,1149450,16,1149434
41387,18,0,245,650042,18,650024
41388,7,6,112,814650,7,814643
41389,5,-12,848,268021,5,268016
41390,12,13,591,1057741,12,1057729
41391,20,4,99,774015,20,773995
41392,20,-14,217,211044,20,211024
41393,12,15,140,1117859,12,1117847
41394,5,19,86,1219449,5,1219444
41395,13,-14,422,212831,13,212818
41396,14,16,798,1152833,14,1152819
41397,11,4,703,778378,11,778367
41398,19,-8,610,402152,19,402133
41399,8,9,271,912303,8,912295
41400,19,-10,394,337901,19,337882
41401,14,-15,701,182968,14,182954
41402,20,13,388,1056109,20,1056089
41403,12,3,447,745182,12,745170
41404,16,9,127,930023,16,930007
41405,10,-18,488,72923,10,72913
41406,8,-13,734,234040,8,234032
41407,6,19,770,1234580,6,1234574
41408,13,-12,346,275102,13,275089
41409,12,9,243,930779,12,930767
41410,17,10,182,961252,17,961235
41411,19,-8,138,398865,19,398846
41412,20,6,221,837384,20,837364
41413,17,4,234,774980,17,774963
41414,5,-2,651,576653,5,576648
41415,11,-13,183,242399,11,242388
41416,7,12,82,1000936,7,1000929
41417,17,16,906,1153572,17,1153555
41418,16,19,675,1246237,16,1246221
41419,12,2,772,716314,12,716302
41420,10,-18,201,66853,10,66843
41421,19,-17,36,115826,19,115807
41422,15,18,27,1209089,15,1209074
41423,8,14,394,1070458,8,1070450
41424,12,14,958,1092931,12,1092919
41425,20,-6,569,463525,20,463505
41426,6,19,648,1231966,6,1231960
41427,15,0,869,654843,15,654828
41428,20,-2,415,588211,20,588191
41429,10,2,151,691815,10,691805
41430,5,-17,371,101431,5,101426
41431,20,-20,59,23245,20,23225
41432,5,1,337,664615,5,664610
41433,11,9,7,929099,11,929088
41434,7,-18,513,73486,7,73479
41435,16,-16,9,146786,16,146770
41436,15,16,121,1147902,15,1147887
41437,20,5,812,809715,20,809695
41438,18,-4,292,524347,18,524329
41439,13,-13,620,245668,13,245655
41440,16,13,543,1057292,16,1057276
41441,13,-3,490,557583,13,557570
41442,7,-7,628,419179,7,419172
41443,10,-14,207,191089,10,191079
41444,11,-17,404,118432,11,118421
41445,11,9,15,929143,11,929132
41446,10,13,462,1040683,10,1040673
41447,15,-20,427,25996,15,25981
41448,18,3,11,741889,18,741871
41449,7,0,275,631273,7,631266
41450,5,-19,964,52161,5,52156
41451,19,-2,868,591750,19,591731
41452,15,6,568,840383,15,840368
41453,6,-8,998,396791,6,396785
41454,12,-10,39,335457,12,335445
41455,7,18,617,1199760,7,1199753
41456,5,16,939,1144731,5,1144726
41457,9,11,156,971661,9,971652
41458,7,15,951,1114751,7,1114744
41459,7,2,996,709418,7,709411
41460,7,3,63,720148,7,720141
41461,6,-11,573,293809,6,293803
41462,7,-5,748,484177,7,484170
41463,8,16,399,1133735,8,1133727
41464,15,-17,905,122213,15,122198
41465,11,-17,357,118118,11,118107
41466,9,1,730,672887,9,672878
41467,17,-16,510,150761,17,150744
41468,13,-5,820,496931,13,496918
41469,9,17,896,1174653,9,1174644
41470,7,-2,635,576220,7,576213
41471,11,11,492,994437,11,994426
41472,10,-4,264,505344,10,505334
41473,20,-3,963,561501,20,561481
41474,17,-12,30,272723,17,272706
41475,18,-9,709,372020,18,372002
41476,8,-19,940,51705,8,51697
41477,9,-14,71,188096,9,188087
41478,15,-6,450,462568,15,462553
41479,12,-12,367,275256,12,275244
41480,9,-19,754,48128,9,48119
41481,20,-1,222,618294,20,618274
41482,12,16,307,1149338,12,1149326
41483,19,14,792,1091665,19,1091646
41484,15,-3,747,559741,15,559726
41485,10,-20,555,12154,10,12144
41486,19,15,194,1118266,19,1118247
41487,11,-8,477,401138,11,401127
41488,7,-8,348,382773,7,382766
41489,20,5,78,804369,20,804349
41490,8,11,319,975198,8,975190
41491,19,19,244,1242655,19,1242636
41492,15,2,338,713150,15,713135
41493,6,-11,656,295592,6,295586
41494,12,12,669,1027091,12,1027079
41495,5,-2,535,574063,5,574058
41496,8,-17,674,107956,8,107948
41497,20,-19,332,56560,20,56540
41498,10,-16,3,123848,10,123838
41499,5,19,616,1231276,5,1231271
41500,7,9,184,910656,7,910649
41501,7,-8,806,392574,7,392567
41502,13,10,316,962206,13,962193
41503,10,8,713,890955,10,890945
41504,12,1,634,684857,12,684845
41505,12,-13,278,243143,12,243131
41506,18,-3,490,557591,18,557573
41507,6,7,6,844880,6,844874
41508,10,14,488,1072687,10,1072677
41509,5,4,76,752229,5,752224
41510,5,-2,61,564172,5,564167
41511,5,-14,79,188309,5,188304
41512,11,9,472,932447,11,932436
41513,11,-9,822,373054,11,373043
41514,8,-13,556,230156,8,230148
41515,10,-17,855,111534,10,111524
41516,6,-12,468,259727,6,259721
41517,13,-1,939,623736,13,623723
41518,5,17,109,1157576,5,1157571
41519,9,-7,50,407103,9,407094
41520,10,-18,454,72180,10,72170
41521,19,-13,216,242611,19,242592
41522,17,11,215,992315,17,992298
41523,11,-5,6,490814,11,490803
41524,12,13,971,1060433,12,1060421
41525,14,-13,519,244869,14,244855
41526,8,-11,420,290488,8,290480
41527,12,10,180,961228,12,961216
41528,11,-17,808,121596,11,121585
41529,13,16,48,1147435,13,1147422
41530,19,8,673,903300,19,903281
41531,20,11,194,992229,20,992209
41532,7,16,289,1131280,7,1131273
41533,12,-7,730,433603,12,433591
41534,20,15,20,1116931,20,1116911
41535,16,-10,652,339960,16,339944
41536,9,-3,441,540266,9,540257
41537,19,6,792,842110,19,842091
41538,19,8,103,898727,19,898708
41539,9,16,285,1131217,9,1131208
41540,15,-19,655,59131,15,59116
41541,12,-8,39,398204,12,398192
41542,13,3,279,744002,13,743989
41543,20,8,939,905259,20,905239
41544,16,-10,98,335859,16,335843
41545,16,18,381,1211862,16,1211846
41546,12,1,903,686874,12,686862
41547,9,0,61,626607,9,626598
41548,19,15,164,1117995,19,1117976
41549,11,-10,974,342443,11,342432
41550,8,1,56,658276,8,658268
41551,12,16,452,1150399,12,1150387
41552,17,-5,964,498136,17,498119
41553,7,-16,370,131939,7,131932
41554,5,12,921,1019408,5,1019403
41555,8,5,474,791426,8,791418
41556,15,2,950,717560,15,717545
41557,8,13,214,1035298,8,1035290
41558,11,-14,640,214562,11,214551
41559,6,19,27,1218029,6,1218023
41560,17,-4,201,523647,17,523630
41561,17,11,59,991313,17,991296
41562,9,4,115,753088,9,753079
41563,12,19,475,1244698,12,1244686
41564,17,9,127,930030,17,930013
41565,11,8,672,903292,11,903281
41566,16,-10,464,338494,16,338478
41567,15,2,462,714117,15,714102
41568,20,-18,785,90968,20,90948
41569,16,8,322,900497,16,900481
41570,8,15,209,1098925,8,1098917
41571,14,18,607,1213282,14,1213268
41572,8,-11,555,293478,8,293470
41573,20,-19,369,56883,20,56863
41574,8,1,623,670813,8,670805
41575,6,-9,74,345197,6,345191
41576,14,19,142,1241913,14,1241899
41577,20,9,873,935531,20,935511
41578,20,-12,483,276066,20,276046
41579,6,-11,514,292632,6,292626
41580,11,7,132,867977,11,867966
41581,10,9,244,911864,10,911854
41582,18,-17,559,119689,18,119671
41583,20,18,177,1210380,20,1210360
41584,10,-5,473,478244,10,478234
41585,19,1,451,683392,19,683373
41586,18,-7,28,428544,18,428526
41587,17,7,199,868410,17,868393
41588,12,16,895,1153456,12,1153444
41589,7,6,92,814197,7,814190
41590,10,19,860,1236710,10,1236700
41591,7,13,8,1031031,7,1031024
41592,12,6,924,843115,12,843103
41593,5,-9,951,364926,5,364921
41594,13,1,917,687011,13,686998
41595,5,19,146,1220696,5,1220691
41596,8,11,162,971825,8,971817
41597,10,-18,207,66958,10,66948
41598,10,-10,807,329912,10,329902
41599,12,6,989,843666,12,843654
41600,11,3,206,743454,11,743443
41601,12,7,687,872036,12,872024
41602,5,7,984,865613,5,865608
41603,6,13,435,1040141,6,1040135
41604,20,-10,841,341409,20,341389
41605,6,9,953,926961,6,926955
41606,11,-2,640,589923,11,589912
41607,20,17,631,1182545,20,1182525
41608,12,-5,869,497358,12,497346
41609,10,10,642,951380,10,951370
41610,17,18,659,1213735,17,1213718
41611,11,19,224,1242523,11,1242512
41612,12,7,21,867165,12,867153
41613,7,4,518,761744,7,761737
41614,15,5,115,804637,15,804622
41615,11,-2,245,586980,11,586969
41616,13,-10,397,337918,13,337905
41617,15,14,95,1086219,15,1086204
41618,19,2,121,711502,19,711483
41619,8,2,48,689631,8,689623
41620,10,-14,195,190722,10,190712
41621,12,-6,277,461342,12,461330
41622,19,-1,354,619433,19,619414
41623,18,11,421,993938,18,993920
41624,11,7,550,871077,11,871066
41625,18,14,292,1087693,18,1087675
41626,15,-2,809,591199,15,591184
41627,12,-19,614,58808,12,58796
41628,18,-20,376,25706,18,25688
41629,18,18,105,1209803,18,1209785
41630,20,17,376,1180752,20,1180732
41631,15,1,291,682146,15,682131
41632,13,11,765,996371,13,996358
41633,14,-2,616,589783,14,589769
41634,15,-7,308,430659,15,430644
41635,17,7,823,872968,17,872951
41636,18,10,173,961202,18,961184
41637,14,15,921,1123515,14,1123501
41638,15,-1,250,618499,15,618484
41639,9,3,407,727543,9,727534
41640,10,-3,783,547994,10,547984
41641,16,2,162,711827,16,711811
41642,6,-14,903,206117,6,206111
41643,7,11,831,986176,7,986169
41644,20,-6,472,462758,20,462738
41645,18,-16,11,146812,18,146794
41646,8,12,73,1000654,8,1000646
41647,20,2,276,712617,20,712597
41648,14,9,959,936232,14,936218
41649,6,3,270,724708,6,724702
41650,16,17,449,1181306,16,1181290
41651,10,-15,460,165362,10,165352
41652,13,15,61,1117241,13,1117228
41653,12,8,3,897934,12,897922
41654,7,11,974,989348,7,989341
41655,13,0,578,652632,13,652619
41656,7,-13,153,221627,7,221620
41657,11,-2,795,591102,11,591091
41658,15,18,424,1212181,15,1212166
41659,8,4,609,763827,8,763819
41660,10,17,194,1159381,10,1159371
41661,12,-20,128,23729,12,23717
41662,7,-2,294,569176,7,569169
41663,20,-1,903,623493,20,623473
41664,13,2,187,711995,13,711982
41665,17,1,56,680222,17,680205
41666,16,2,452,714020,16,714004
41667,12,-14,954,216886,12,216874
41668,16,-15,402,180705,16,180689
41669,7,-18,690,77132,7,77125
41670,19,5,914,810459,19,810440
41671,15,0,101,649033,15,649018
41672,10,5,827,798921,10,798911
41673,9,6,101,814359,9,814350
41674,12,0,364,650795,12,650783
41675,20,-5,151,492113,20,492093
41676,17,-9,5,366661,17,366644
41677,12,-12,216,274078,12,274066
41678,14,-19,425,57262,14,57248
41679,7,4,717,766102,7,766095
41680,19,14,428,1088820,19,1088801
41681,9,-11,215,285743,9,285734
41682,20,5,945,810748,20,810728
41683,11,11,75,991429,11,991418
41684,9,0,334,632419,9,632410
41685,15,8,398,901125,15,901110
41686,13,13,780,1059072,13,1059059
41687,17,5,446,807042,17,807025
41688,19,3,750,747515,19,747496
41689,17,-1,758,622374,17,622357
41690,18,11,429,993994,18,993976
41691,11,-12,843,278748,11,278737
41692,19,-17,934,122385,19,122366
41693,17,-9,704,371990,17,371973
41694,9,13,494,1041339,9,1041330
41695,5,-14,52,187656,5,187651
41696,13,-16,131,147922,13,147909
41697,13,2,629,715285,13,715272
41698,20,-13,828,247157,20,247137
41699,16,-10,88,335825,16,335809
41700,12,14,673,1090722,12,1090710
41701,16,-11,582,308393,16,308377
41702,11,14,507,1089419,11,1089408
41703,15,-2,646,589964,15,589949
41704,20,6,383,838765,20,838745
41705,13,15,429,1119811,13,1119798
41706,14,-10,1000,342721,14,342707
41707,8,7,737,860444,8,860436
41708,6,-12,944,270111,6,270105
41709,14,15,869,1123131,14,1123117
41710,9,-20,621,13553,9,13544
41711,19,-20,777,28814,19,28795
41712,5,12,712,1014703,5,1014698
41713,7,-9,7,343905,7,343898
41714,5,1,994,678589,5,678584
41715,19,-5,521,494896,19,494877
41716,18,3,133,742836,18,742818
41717,20,-16,518,150829,20,150809
41718,11,-10,914,341928,11,341917
41719,15,15,787,1122546,15,1122531
41720,14,-15,429,180980,14,180966
41721,20,19,783,1247131,20,1247111
41722,8,-20,474,10145,8,10137
41723,12,18,80,1209565,12,1209553
41724,16,17,53,1178290,16,1178274
41725,19,-10,927,342045,19,342026
41726,5,13,423,1039893,5,1039888
41727,20,13,883,1059837,20,1059817
41728,9,8,698,890556,9,890547
41729,8,-12,565,261748,8,261740
41730,17,6,490,839713,17,839696
41731,19,6,727,841681,19,841662
41732,11,19,781,1247098,11,1247087
41733,7,-5,396,476682,7,476675
41734,5,-7,429,415070,5,415065
41735,6,-16,469,134360,6,134354
41736,6,1,172,660954,6,660948
41737,8,5,781,797950,8,797942
41738,18,-1,71,617123,18,617105
41739,11,-16,136,147939,11,147928
41740,6,-1,646,607796,6,607790
41741,20,-12,998,280094,20,280074
41742,6,-16,747,140035,6,140029
41743,10,-7,505,416644,10,416634
41744,9,-11,383,289637,9,289628
41745,10,-12,715,264964,10,264954
41746,6,14,201,1066172,6,1066166
41747,15,6,554,840218,15,840203
41748,8,19,235,1222697,8,1222689
41749,20,19,286,1243037,20,1243017
41750,7,5,22,782072,7,782065
41751,9,-17,825,110969,9,110960
41752,13,17,242,1179698,13,1179685
41753,15,-20,669,27947,15,27932
41754,18,5,359,806405,18,806387
41755,13,2,256,712511,13,712498
41756,20,-16,257,148848,20,148828
41757,15,-1,88,617233,15,617218
41758,20,4,590,777561,20,777541
41759,10,8,359,883016,10,883006
41760,12,11,33,991127,12,991115
41761,17,-3,514,557759,17,557742
41762,7,11,122,971017,7,971010
41763,6,15,516,1105494,6,1105488
41764,17,4,774,778956,17,778939
41765,5,-20,453,9698,5,9693
41766,6,12,350,1006780,6,1006774
41767,10,-10,857,330966,10,330956
41768,5,6,961,833801,5,833796
41769,16,-12,348,275134,16,275118
41770,17,17,747,1183436,17,1183419
41771,12,-5,410,494038,12,494026
41772,20,-7,91,428922,20,428902
41773,5,1,790,674165,5,674160
41774,12,5,521,807604,12,807592
41775,14,-16,179,148222,14,148208
41776,17,19,217,1242475,17,1242458
41777,18,-7,752,433753,18,433735
41778,16,-13,927,248003,16,247987
41779,8,3,437,728210,8,728202
41780,14,-18,73,85766,14,85752
41781,9,-9,714,359327,9,359318
41782,7,-10,283,318628,7,318621
41783,20,1,369,682823,20,682803
41784,6,6,420,821850,6,821844
41785,20,-2,850,591609,20,591589
41786,17,-11,385,306811,17,306794
41787,9,2,331,695769,9,695760
41788,15,16,465,1150453,15,1150438
41789,17,15,139,1117843,17,1117826
41790,8,-7,811,422985,8,422977
41791,16,0,756,654078,16,654062
41792,15,13,463,1056664,15,1056649
41793,8,4,125,753254,8,753246
41794,14,-3,730,559579,14,559565
41795,12,12,574,1026238,12,1026226
41796,18,17,828,1184168,18,1184150
41797,15,14,336,1088074,15,1088059
41798,15,-17,392,118374,15,118359
41799,11,-20,864,29450,11,29439
41800,12,-14,686,214911,12,214899
41801,15,-18,681,90201,15,90186
41802,8,-16,489,134746,8,134738
41803,17,-16,205,148439,17,148422
41804,5,18,486,1197132,5,1197127
41805,7,3,754,735150,7,735143
41806,15,-2,56,585570,15,585555
41807,19,-6,976,466540,19,466521
41808,6,-16,184,128002,6,127996
41809,13,-16,560,151123,13,151110
41810,14,-12,743,277941,14,277927
41811,5,-7,376,414066,5,414061
41812,13,-19,337,56650,13,56637
41813,8,-16,470,134394,8,134386
41814,16,1,796,686059,16,686043
41815,7,2,987,709294,7,709287
41816,20,-4,176,523404,20,523384
41817,19,-19,12,53968,19,53949
41818,20,12,602,1026463,20,1026443
41819,20,0,536,652280,20,652260
41820,15,-18,226,87054,15,87039
41821,15,-15,454,181115,15,181100
41822,11,17,336,1180480,11,1180469
41823,9,-19,732,47644,9,47635
41824,17,-20,419,25949,17,25932
41825,20,-9,443,370105,20,370085
41826,9,11,29,969092,9,969083
41827,15,-15,112,178632,15,178617
41828,16,-9,691,371910,16,371894
41829,10,6,354,820253,10,820243
41830,8,16,258,1130721,8,1130713
41831,7,18,740,1202242,7,1202235
41832,7,-15,877,174102,7,174095
41833,5,-1,100,595979,5,595974
41834,17,14,319,1087917,17,1087900
41835,19,0,349,650682,19,650663
41836,16,-17,195,116891,16,116875
41837,17,1,370,682838,17,682821
41838,6,1,594,670180,6,670174
41839,18,-16,750,152388,18,152370
41840,16,-9,828,373085,16,373069
41841,11,-16,540,150979,11,150968
41842,11,-1,516,620669,11,620658
41843,20,-7,548,432468,20,432448
41844,12,3,569,746061,12,746049
41845,7,-8,420,384005,7,383998
41846,18,-9,214,368078,18,368060
41847,14,-10,15,335235,14,335221
41848,7,2,725,703940,7,703933
41849,8,-9,16,344019,8,344011
41850,19,12,690,1027270,19,1027251
41851,15,17,424,1181060,15,1181045
41852,15,-10,552,339188,15,339173
41853,11,-4,484,525714,11,525703
41854,9,9,549,918337,9,918328
41855,12,0,431,651363,12,651351
41856,19,3,999,749546,19,749527
41857,13,17,820,1184106,13,1184093
41858,19,0,306,650371,19,650352
41859,18,12,362,1024737,18,1024719
41860,7,6,909,832738,7,832731
41861,20,15,910,1123419,20,1123399
41862,10,-12,413,258620,10,258610
41863,8,3,906,738359,8,738351
41864,19,3,524,745681,19,745662
41865,7,-3,20,531008,7,531001
41866,18,14,708,1091015,18,1090997
41867,12,-9,527,370872,12,370860
41868,8,17,151,1158403,8,1158395
41869,16,-19,294,56273,16,56257
41870,14,-15,654,182678,14,182664
41871,8,12,983,1020746,8,1020738
41872,17,6,14,835894,17,835877
41873,13,-11,50,304019,13,304006
41874,7,14,383,1070277,7,1070270
41875,16,-5,170,492267,16,492251
41876,15,14,265,1087475,15,1087460
41877,12,7,486,870649,12,870637
41878,7,0,47,626303,7,626296
41879,5,5,978,802261,5,802256
41880,11,-7,965,435462,11,435451
41881,15,19,786,1247167,15,1247152
41882,7,-7,794,422553,7,422546
41883,7,0,108,627811,7,627804
41884,19,-17,745,121176,19,121157
41885,17,10,485,963530,17,963513
41886,10,-6,234,442000,10,441990
41887,6,12,394,1007581,6,1007575
41888,9,18,225,1191698,9,1191689
41889,5,-14,118,189072,5,189067
41890,9,-12,508,260657,9,260648
41891,5,4,997,772251,5,772246
41892,9,0,807,643033,9,643024
41893,19,13,532,1057155,19,1057136
41894,6,8,104,877281,6,877275
41895,15,13,750,1058814,15,1058799
41896,14,1,968,687395,14,687381
41897,7,1,130,660039,7,660032
41898,9,-16,893,143125,9,143116
41899,8,-5,807,485353,8,485345
41900,8,9,119,909263,8,909255
41901,7,4,306,757132,7,757125
41902,17,14,545,1089735,17,1089718
41903,12,-2,680,590247,12,590235
41904,19,-1,983,624042,19,624023
41905,5,-13,629,231804,5,231799
41906,13,1,791,685994,13,685981
41907,13,11,657,995507,13,995494
41908,15,-4,693,527311,15,527296
41909,10,8,145,878196,10,878186
41910,13,13,624,1057980,13,1057967
41911,12,12,866,1028586,12,1028574
41912,14,-10,427,338183,14,338169
41913,10,8,302,881833,10,881823
41914,13,19,59,1241203,13,1241190
41915,11,7,735,872395,11,872384
41916,17,-4,52,522411,17,522394
41917,14,11,898,997401,14,997387
41918,6,-19,540,43246,6,43240
41919,11,14,170,1086779,11,1086768
41920,14,-5,738,496443,14,496429
41921,7,-11,116,283696,7,283689
41922,18,-15,899,184565,18,184547
41923,12,17,491,1181570,12,1181558
41924,18,-8,30,398127,18,398109
41925,20,4,93,773948,20,773928
41926,10,9,108,909051,10,909041
41927,17,10,14,959933,17,959916
41928,9,18,900,1205802,9,1205793
41929,12,-19,301,56348,12,56336
41930,14,17,859,1184465,14,1184451
41931,17,9,350,931591,17,931574
41932,20,19,926,1248217,20,1248197
41933,19,7,395,869955,19,869936
41934,11,-13,108,241842,11,241831
41935,17,14,217,1087095,17,1087078
41936,10,3,27,719420,10,719410
41937,9,-2,766,579050,9,579041
41938,11,6,491,839730,11,839719
41939,11,15,723,1122134,11,1122123
41940,20,18,642,1213603,20,1213583
41941,12,-11,809,310039,12,310027
41942,20,-11,773,309787,20,309767
41943,8,10,41,938387,8,938379
41944,6,-17,517,104650,6,104644
41945,19,-3,139,554764,19,554745
41946,5,19,51,1218509,5,1218504
41947,8,-5,310,474888,8,474880
41948,19,-3,115,554624,19,554605
41949,18,16,506,1150694,18,1150676
41950,10,5,661,795265,10,795255
41951,13,9,301,931154,13,931141
41952,15,-13,294,243282,15,243267
41953,15,-10,70,335710,15,335695
41954,15,0,503,651987,15,651972
41955,7,-9,864,362894,7,362887
41956,9,-14,415,195916,9,195907
41957,12,-5,280,493096,12,493084
41958,13,-15,805,183774,13,183761
41959,12,-13,391,243896,12,243884
41960,15,-18,770,90862,15,90847
41961,14,-9,465,370262,14,370248
41962,20,8,4,897943,20,897923
41963,17,-2,317,587512,17,587495
41964,10,10,88,939451,10,939441
41965,5,-13,240,223466,5,223461
41966,11,8,125,898917,11,898906
41967,17,-11,241,305563,17,305546
41968,15,12,421,1025120,15,1025105
41969,15,3,871,748386,15,748371
41970,19,2,31,710737,19,710718
41971,12,13,336,1055709,12,1055697
41972,8,-10,553,324611,8,324603
41973,16,-8,415,400805,16,400789
41974,19,-15,678,182812,19,182793
41975,18,8,905,905041,18,905023
41976,13,-11,129,304701,13,304688
41977,20,-14,331,212008,20,211988
41978,10,-18,952,83128,10,83118
41979,13,11,416,993890,13,993877
41980,18,12,801,1028003,18,1027985
41981,11,-14,626,214440,11,214429
41982,7,17,343,1162777,7,1162770
41983,6,-17,771,109983,6,109977
41984,11,-9,612,371445,11,371434
41985,13,-6,25,459353,13,459340
41986,7,9,240,911788,7,911781
41987,14,-18,290,87486,14,87472
41988,5,16,870,1143145,5,1143140
41989,19,13,353,1055826,19,1055807
41990,20,5,474,807297,20,807277
41991,17,7,316,869325,17,869308
41992,11,-11,606,308576,11,308565
41993,5,-14,742,202813,5,202808
41994,17,-8,785,403476,17,403459
41995,13,-8,250,399673,13,399660
41996,9,3,423,727878,9,727869
41997,13,7,917,873560,13,873547
41998,16,7,319,869341,16,869325
41999,9,12,206,1003568,9,1003559
42000,5,5,709,796410,5,796405
42001,7,13,113,1033155,7,1033148
42002,17,5,594,808116,17,808099
42003,13,-3,358,556419,13,556406
42004,17,15,460,1120040,17,1120023
42005,15,-9,246,368385,15,368370
42006,5,14,412,1070986,5,1070981
42007,10,-9,175,347283,10,347273
42008,17,-8,185,399229,17,399212
42009,12,-10,121,336002,12,335990
42010,5,-13,26,218922,5,218917
42011,20,2,335,713109,20,713089
42012,11,-3,125,554695,11,554684
42013,13,-15,112,178635,13,178622
42014,5,1,990,678479,5,678474
42015,10,7,819,862177,10,862167
42016,13,5,197,805313,13,805300
42017,17,5,816,809740,17,809723
42018,16,-17,254,117345,16,117329
42019,16,-6,687,464397,16,464381
42020,8,-20,610,13339,8,13331
42021,9,-4,994,520842,9,520833
42022,14,-3,304,556003,14,555989
42023,8,17,328,1162419,8,1162411
42024,5,-9,48,344678,5,344673
42025,18,-8,68,398478,18,398460
42026,13,-8,970,404797,13,404784
42027,6,19,841,1236210,6,1236204
42028,18,4,827,779383,18,779365
42029,10,-17,957,113634,10,113624
42030,11,-2,358,587792,11,587781
42031,19,1,824,686234,19,686215
42032,12,5,119,804643,12,804631
42033,11,-20,781,28839,11,28828
42034,19,8,403,901185,19,901166
42035,6,8,399,883962,6,883956
42036,11,19,189,1242240,11,1242229
42037,19,-7,952,435378,19,435359
42038,14,-10,460,338444,14,338430
42039,8,11,895,987777,8,987769
42040,7,-16,181,127920,7,127913
42041,15,18,32,1209133,15,1209118
42042,17,17,677,1182895,17,1182878
42043,13,-4,714,527437,13,527424
42044,19,15,498,1120313,19,1120294
42045,17,-18,99,85978,17,85961
42046,20,-6,112,459929,20,459909
42047,15,12,897,1028859,15,1028844
42048,17,-9,519,370791,17,370774
42049,19,9,803,935006,19,934987
42050,5,-6,55,438027,5,438022
42051,12,-15,374,180527,12,180515
42052,5,-3,463,540826,5,540821
42053,14,16,592,1151293,14,1151279
42054,20,-16,620,151609,20,151589
42055,9,9,12,906980,9,906971
42056,12,6,370,838641,12,838629
42057,20,3,630,746599,20,746579
42058,12,-14,52,209713,12,209701
42059,20,-6,119,459967,20,459947
42060,16,-7,209,429880,16,429864
42061,6,1,780,673962,6,673956
42062,17,-12,160,273717,17,273700
42063,8,16,959,1145114,8,1145106
42064,16,-11,463,307468,16,307452
42065,20,10,701,965307,20,965287
42066,10,8,501,886238,10,886228
42067,9,19,389,1226326,9,1226317
42068,14,0,589,652731,14,652717
42069,13,3,191,743328,13,743315
42070,14,16,588,1151250,14,1151236
42071,12,-2,550,589272,12,589260
42072,17,4,657,778055,17,778038
42073,8,-8,878,394117,8,394109
42074,5,18,632,1200151,5,1200146
42075,18,15,939,1123635,18,1123617
42076,6,5,785,798019,6,798013
42077,5,-13,74,219977,5,219972
42078,5,-15,151,158666,5,158661
42079,15,2,997,717840,15,717825
42080,15,-13,828,247162,15,247147
42081,13,-15,112,178638,13,178625
42082,13,-1,534,620812,13,620799
42083,12,11,99,991576,12,991564
42084,8,-20,842,18738,8,18730
42085,8,-5,869,486897,8,486889
42086,12,-3,546,558114,12,558102
42087,20,0,686,653526,20,653506
42088,5,-18,451,72101,5,72096
42089,9,17,288,1161521,9,1161512
42090,10,-14,679,201566,10,201556
42091,6,3,184,722847,6,722841
42092,20,-3,184,555084,20,555064
42093,13,-18,823,91243,13,91230
42094,19,-19,10,53947,19,53928
42095,9,-10,413,321596,9,321587
42096,17,-7,833,434357,17,434340
42097,6,11,19,968865,6,968859
42098,5,3,9,719009,5,719004
42099,19,-1,776,622542,19,622523
42100,5,-19,423,40619,5,40614
42101,6,-11,60,282402,6,282396
42102,17,13,491,1056847,17,1056830
42103,11,0,832,654579,11,654568
42104,16,3,349,744529,16,744513
42105,13,3,588,746212,13,746199
42106,6,7,317,851614,6,851608
42107,9,2,478,698872,9,698863
42108,12,6,758,841863,12,841851
42109,19,-19,150,55236,19,55217
42110,5,8,85,876847,5,876842
42111,13,-12,818,278511,13,278498
42112,14,8,39,898159,14,898145
42113,7,-10,72,314216,7,314209
42114,17,15,698,1121920,17,1121903
42115,11,13,313,1055486,11,1055475
42116,14,15,88,1117449,14,1117435
42117,18,3,306,744221,18,744203
42118,14,5,337,806266,14,806252
42119,14,-13,521,244885,14,244871
42120,14,14,576,1089905,14,1089891
42121,18,4,300,775356,18,775338
42122,15,-17,737,121099,15,121084
42123,15,13,65,1053702,15,1053687
42124,20,-4,944,529162,20,529142
42125,5,0,93,627407,5,627402
42126,12,1,528,684033,12,684021
42127,9,11,725,983991,9,983982
42128,18,-20,686,28101,18,28083
42129,16,14,309,1087844,16,1087828
42130,10,2,717,703787,10,703777
42131,19,11,190,992170,19,992151
42132,6,-11,992,302545,6,302539
42133,6,-8,752,391463,6,391457
42134,6,-8,14,375640,6,375634
42135,5,3,630,732355,5,732350
42136,20,16,786,1152698,20,1152678
42137,13,15,553,1120795,13,1120782
42138,19,16,912,1153641,19,1153622
42139,15,10,847,966302,15,966287
42140,20,6,985,843615,20,843595
42141,18,-9,973,374163,18,374145
42142,10,-7,740,421490,10,421480
42143,19,5,615,808340,19,808321
42144,9,-13,12,218528,9,218519
42145,17,15,177,1118126,17,1118109
42146,20,8,451,901559,20,901539
42147,8,3,429,728033,8,728025
42148,18,-5,966,498171,18,498153
42149,13,-1,93,617290,13,617277
42150,15,-20,465,26292,15,26277
42151,9,-5,598,481016,9,481007
42152,7,2,323,695609,7,695602
42153,15,-1,987,624086,15,624071
42154,13,13,106,1054005,13,1053992
42155,19,2,876,717038,19,717019
42156,9,4,367,758472,9,758463
42157,10,16,435,1134589,10,1134579
42158,16,-15,277,179782,16,179766
42159,7,-17,922,112987,7,112980
42160,20,14,20,1085520,20,1085500
42161,13,14,98,1086249,13,1086236
42162,10,1,144,660337,10,660327
42163,18,19,775,1247062,18,1247044
42164,7,6,710,828420,7,828413
42165,9,-4,199,503761,9,503752
42166,9,4,608,763798,9,763789
42167,7,0,421,634507,7,634500
42168,11,0,392,651056,11,651045
42169,19,5,160,804947,19,804928
42170,6,7,550,856509,6,856503
42171,10,13,477,1040960,10,1040950
42172,19,2,967,717701,19,717682
42173,18,2,827,716661,18,716643
42174,11,3,917,748751,11,748740
42175,6,13,502,1041494,6,1041488
42176,15,-10,961,342294,15,342279
42177,10,10,677,952165,10,952155
42178,9,-19,358,39268,9,39259
42179,20,-5,627,495631,20,495611
42180,8,6,482,823309,8,823301
42181,11,16,385,1149886,11,1149875
42182,10,17,202,1159552,10,1159542
42183,19,18,384,1211890,19,1211871
42184,7,-20,804,17827,7,17820
42185,7,17,817,1172864,7,1172857
42186,13,-8,402,400771,13,400758
42187,5,17,661,1169497,5,1169492
42188,16,17,649,1182690,16,1182674
42189,5,-9,219,348237,5,348232
42190,5,14,201,1066177,5,1066172
42191,15,-9,257,368467,15,368452
42192,10,-7,684,420289,10,420279
42193,7,-20,221,4999,7,4992
42194,9,-6,844,454797,9,454788
42195,19,-14,794,215722,19,215703
42196,16,14,446,1088927,16,1088911
42197,5,-10,238,317747,5,317742
42198,19,0,605,652840,19,652821
42199,19,-16,687,151946,19,151927
42200,13,-5,439,494247,13,494234
42201,18,-18,110,86060,18,86042
42202,14,14,750,1091331,14,1091317
42203,5,11,325,975365,5,975360
42204,20,8,769,904056,20,904036
42205,11,8,114,898827,11,898816
42206,10,9,193,910800,10,910790
42207,11,-4,387,525093,11,525082
42208,15,16,296,1149269,15,1149254
42209,17,17,861,1184486,17,1184469
42210,6,-14,904,206142,6,206136
42211,5,10,989,958636,5,958631
42212,8,-8,254,380878,8,380870
42213,16,-10,102,335880,16,335864
42214,11,-11,572,308265,11,308254
42215,11,-6,35,459418,11,459407
42216,13,12,98,1022747,13,1022734
42217,17,-3,617,558697,17,558680
42218,9,-18,7,62627,9,62618
42219,7,14,628,1075926,7,1075919
42220,17,15,900,1123346,17,1123329
42221,9,-15,477,165821,9,165812
42222,10,11,583,980987,10,980977
42223,20,9,45,929401,20,929381
42224,14,5,953,810800,14,810786
42225,8,-7,542,417502,8,417494
42226,6,12,559,1011082,6,1011076
42227,18,-7,480,431937,18,431919
42228,15,-7,563,432546,15,432531
42229,11,10,831,966243,11,966232
42230,15,-12,183,273829,15,273814
42231,10,10,917,957271,10,957261
42232,16,11,816,996777,16,996761
42233,10,3,319,725910,10,725900
42234,18,8,201,899549,18,899531
42235,19,12,265,1024075,19,1024056
42236,9,-4,59,500609,9,500600
42237,6,10,208,941927,6,941921
42238,18,-1,702,621971,18,621953
42239,16,-16,79,147453,16,147437
42240,13,-20,691,28144,13,28131
42241,19,7,69,867528,19,867509
42242,11,-7,27,428523,11,428512
42243,13,-8,621,402237,13,402224
42244,17,-7,679,433224,17,433207
42245,11,-6,694,464482,11,464471
42246,16,-15,262,179654,16,179638
42247,13,0,89,648876,13,648863
42248,11,14,481,1089204,11,1089193
42249,17,-17,766,121339,17,121322
42250,19,11,203,992273,19,992254
42251,12,7,931,873632,12,873620
42252,13,-9,147,367637,13,367624
42253,8,-18,988,83947,8,83939
42254,17,18,878,1215354,17,1215337
42255,12,-19,16,54004,12,53992
42256,20,-12,129,273508,20,273488
42257,19,15,413,1119703,19,1119684
42258,15,-18,881,91590,15,91575
42259,7,-10,800,329779,7,329772
42260,7,2,295,694989,7,694982
42261,5,-15,342,162859,5,162854
42262,7,8,762,891935,7,891928
42263,17,12,105,1022803,17,1022786
42264,8,-9,223,348344,8,348336
42265,9,9,336,913812,9,913803
42266,11,-14,398,212672,11,212661
42267,12,-10,494,338727,12,338715
42268,16,-11,652,308929,16,308913
42269,6,-16,290,130270,6,130264
42270,19,7,989,874041,19,874022
42271,6,-18,514,73519,6,73513
42272,17,-12,636,277150,17,277133
42273,9,-19,926,51410,9,51401
42274,14,-4,216,523786,14,523772
42275,7,17,520,1166487,7,1166480
42276,16,-1,373,619581,16,619565
42277,18,-7,59,428738,18,428720
42278,10,-9,739,359954,10,359944
42279,19,-16,946,153872,19,153853
42280,16,-4,875,528635,16,528619
42281,5,0,36,626090,5,626085
42282,8,18,446,1196278,8,1196270
42283,6,-9,31,344280,6,344274
42284,7,5,879,800141,7,800134
42285,14,6,621,840751,14,840737
42286,8,6,214,816874,8,816866
42287,18,3,628,746574,18,746556
42288,16,3,436,745106,16,745090
42289,17,18,519,1212793,17,1212776
42290,17,-4,606,526646,17,526629
42291,15,16,399,1150010,15,1149995
42292,11,4,819,779282,11,779271
42293,11,-3,381,556634,11,556623
42294,5,13,523,1041906,5,1041901
42295,10,-3,226,535242,10,535232
42296,5,7,808,861940,5,861935
42297,7,-12,980,270988,7,270981
42298,10,-5,786,484879,10,484869
42299,13,-7,9,428315,13,428302
42300,20,15,325,1119192,20,1119172
42301,7,-18,473,72581,7,72574
42302,14,14,620,1090248,14,1090234
42303,18,-13,179,242368,18,242350
42304,15,-1,35,616837,15,616822
42305,6,11,85,970282,6,970276
42306,14,18,720,1214095,14,1214081
42307,10,1,117,659662,10,659652
42308,14,-13,315,243395,14,243381
42309,5,-4,221,504396,5,504391
42310,5,10,3,937560,5,937555
42311,8,-18,895,81804,8,81796
42312,18,4,29,773472,18,773454
42313,17,-7,862,434616,17,434599
42314,7,18,387,1195017,7,1195010
42315,5,-16,143,127094,5,127089
42316,17,-12,122,273458,17,273441
42317,9,-11,948,301502,9,301493
42318,20,19,1,1240621,20,1240601
42319,12,-9,292,368721,12,368709
42320,19,-20,58,23217,19,23198
42321,10,10,956,958035,10,958025
42322,5,-18,989,83981,5,83976
42323,7,-12,840,267750,7,267743
42324,14,12,152,1023118,14,1023104
42325,11,8,100,898707,11,898696
42326,7,7,553,856553,7,856546
42327,11,15,511,1120477,11,1120466
42328,12,9,269,930894,12,930882
42329,16,-20,806,29082,16,29066
42330,13,-20,841,29341,13,29328
42331,11,8,276,900134,11,900123
42332,10,13,644,1044617,10,1044607
42333,18,11,794,996621,18,996603
42334,19,-17,916,122297,19,122278
42335,10,-19,508,42484,10,42474
42336,12,11,367,993550,12,993538
42337,9,-20,652,14318,9,14309
42338,11,11,876,997221,11,997210
42339,17,-1,946,623767,17,623750
42340,11,-17,239,117228,11,117217
42341,17,9,954,936181,17,936164
42342,17,7,566,871180,17,871163
42343,12,-2,515,589020,12,589008
42344,17,-18,320,87727,17,87710
42345,18,-1,203,618111,18,618093
42346,10,5,712,796453,10,796443
42347,7,4,233,755742,7,755735
42348,13,1,494,683779,13,683766
42349,15,14,740,1091247,15,1091232
42350,19,-4,169,523363,19,523344
42351,15,-5,48,491217,15,491202
42352,5,11,557,980360,5,980355
42353,13,-4,802,528019,13,528006
42354,10,17,103,1157395,10,1157385
42355,19,9,712,934325,19,934306
42356,15,-19,11,53953,15,53938
42357,10,-1,441,603651,10,603641
42358,6,13,340,1038109,6,1038103
42359,11,6,50,836154,11,836143
42360,12,18,159,1210251,12,1210239
42361,17,-8,218,399443,17,399426
42362,20,-15,419,180863,20,180843
42363,15,-12,789,278294,15,278279
42364,12,3,596,746277,12,746265
42365,12,6,700,841466,12,841454
42366,7,4,946,771269,7,771262
42367,12,5,157,804925,12,804913
42368,18,10,313,962179,18,962161
42369,17,-18,787,90981,17,90964
42370,16,-5,459,494432,16,494416
42371,12,13,367,1055933,12,1055921
42372,11,-9,886,373606,11,373595
42373,8,-7,730,421313,8,421305
42374,18,3,770,747647,18,747629
42375,11,11,293,993037,11,993026
42376,13,3,307,744245,13,744232
42377,16,-19,727,59667,16,59651
42378,18,-19,489,57733,18,57715
42379,14,4,440,776422,14,776408
42380,12,4,782,779017,12,779005
42381,16,-7,161,429499,16,429483
42382,9,-15,64,156688,9,156679
42383,12,-19,400,57132,12,57120
42384,15,14,883,1092355,15,1092340
42385,12,8,376,900903,12,900891
42386,17,-12,617,277002,17,276985
42387,16,-14,848,216130,16,216114
42388,10,7,33,845503,10,845493
42389,9,-9,98,345728,9,345719
42390,20,5,105,804565,20,804545
42391,7,-18,390,70800,7,70793
42392,20,15,247,1118629,20,1118609
42393,20,19,201,1242354,20,1242334
42394,10,-18,36,63173,10,63163
42395,11,1,656,685034,11,685023
42396,7,-13,405,226748,7,226741
42397,12,-18,959,92200,12,92188
42398,7,1,360,665077,7,665070
42399,17,-20,15,8358,17,8341
42400,17,-4,703,527374,17,527357
42401,19,0,411,651210,19,651191
42402,9,-14,210,191171,9,191162
42403,15,17,645,1182649,15,1182634
42404,14,-4,812,528068,14,528054
42405,17,1,576,684449,17,684432
42406,12,7,271,868958,12,868946
42407,15,5,753,809258,15,809243
42408,10,6,815,830716,10,830706
42409,20,-8,657,402535,20,402515
42410,15,5,720,809054,15,809039
42411,13,14,869,1092221,13,1092208
42412,17,-3,987,561667,17,561650
42413,18,-5,807,496858,18,496840
42414,14,1,831,686266,14,686252
42415,19,-10,873,341632,19,341613
42416,5,-8,887,394286,5,394281
42417,19,16,785,1152689,19,1152670
42418,11,-17,438,118718,11,118707
42419,17,-13,412,244004,17,243987
42420,17,5,786,809489,17,809472
42421,10,-8,41,376250,10,376240
42422,18,-20,553,27025,18,27007
42423,14,7,907,873494,14,873480
42424,11,-4,835,528179,11,528168
42425,13,8,905,905044,13,905031
42426,15,17,11,1177919,15,1177904
42427,5,9,948,926881,5,926876
42428,10,18,421,1195741,10,1195731
42429,7,10,987,958585,7,958578
42430,6,6,183,816163,6,816157
42431,12,7,729,872300,12,872288
42432,7,-2,409,571428,7,571421
42433,7,-20,59,1257,7,1250
42434,17,-2,510,588990,17,588973
42435,19,15,26,1116990,19,1116971
42436,16,-17,7,115607,16,115591
42437,7,-19,3,31517,7,31510
42438,14,6,612,840679,14,840665
42439,19,-12,140,273581,19,273562
42440,20,-9,521,370807,20,370787
42441,19,-5,622,495584,19,495565
42442,14,-11,318,306311,14,306297
42443,18,-13,978,248415,18,248397
42444,7,-6,503,447701,7,447694
42445,13,-2,34,585381,13,585368
42446,9,-9,797,361417,9,361408
42447,5,-20,790,17378,5,17373
42448,12,17,828,1184170,12,1184158
42449,11,13,271,1055169,11,1055158
42450,14,-19,275,56133,14,56119
42451,16,7,218,868530,16,868514
42452,6,16,758,1140849,6,1140843
42453,8,-13,589,230966,8,230958
42454,14,19,111,1241667,14,1241653
42455,15,-17,775,121395,15,121380
42456,5,18,767,1202904,5,1202899
42457,14,-6,684,464354,14,464340
42458,9,13,253,1035984,9,1035975
42459,11,18,699,1213994,11,1213983
42460,14,14,127,1086488,14,1086474
42461,7,-19,144,34785,7,34778
42462,6,-3,438,540169,6,540163
42463,12,0,627,652975,12,652963
42464,16,15,724,1122150,16,1122134
42465,15,13,180,1054538,15,1054523
42466,5,-7,226,410629,5,410624
42467,7,11,560,980452,7,980445
42468,5,19,284,1223794,5,1223789
42469,7,-13,15,218620,7,218613
42470,19,-1,718,622131,19,622112
42471,17,8,86,898577,17,898560
42472,11,5,6,803832,11,803821
42473,13,-13,16,241169,13,241156
42474,7,-9,852,362616,7,362609
42475,15,-1,973,623944,15,623929
42476,19,-14,380,212508,19,212489
42477,16,13,131,1054185,16,1054169
42478,11,18,173,1210332,11,1210321
42479,9,-18,659,76547,9,76538
42480,5,7,589,857319,5,857314
42481,6,16,35,1125924,6,1125918
42482,20,-12,324,274963,20,274943
42483,20,-14,875,216327,20,216307
42484,9,-5,58,469133,9,469124
42485,12,-10,486,338681,12,338669
42486,5,15,422,1103308,5,1103303
42487,12,-19,808,60221,12,60209
42488,16,13,852,1059601,16,1059585
42489,11,-20,885,29606,11,29595
42490,19,13,142,1054237,19,1054218
42491,7,-12,257,255056,7,255049
42492,11,13,490,1056821,11,1056810
42493,16,-3,108,554564,16,554548
42494,8,13,946,1050974,8,1050966
42495,7,3,537,730069,7,730062
42496,20,6,215,837326,20,837306
42497,18,8,97,898700,18,898682
42498,18,-11,421,307098,18,307080
42499,7,0,498,636199,7,636192
42500,13,13,592,1057749,13,1057736
42501,10,-3,918,551017,10,551007
42502,8,18,6,1186636,8,1186628
42503,16,9,688,934119,16,934103
42504,5,-10,793,329517,5,329512
42505,13,-20,623,27507,13,27494
42506,17,-3,288,555852,17,555835
42507,14,-10,59,335619,14,335605
42508,15,3,10,741874,15,741859
42509,9,11,13,968738,9,968729
42510,17,-9,690,371894,17,371877
42511,7,12,56,1000336,7,1000329
42512,10,-19,388,39905,10,39895
42513,15,-6,506,463067,15,463052
42514,18,1,959,687337,18,687319
42515,16,-1,794,622673,16,622657
42516,8,4,61,751904,8,751896
42517,10,13,806,1048170,10,1048160
42518,18,-3,248,555545,18,555527
42519,18,-17,287,117618,18,117600
42520,16,13,487,1056806,16,1056790
42521,17,6,688,841290,17,841273
42522,18,-7,995,435712,18,435694
42523,7,-18,590,75136,7,75129
42524,10,-7,774,422287,10,422277
42525,17,2,197,712092,17,712075
42526,19,-3,497,557628,19,557609
42527,14,8,125,898921,14,898907
42528,15,-20,758,28653,15,28638
42529,9,-10,361,320378,9,320369
42530,5,19,987,1239331,5,1239326
42531,5,0,266,631138,5,631133
42532,13,1,612,684674,13,684661
42533,19,4,145,774304,19,774285
42534,5,-18,447,72013,5,72008
42535,7,19,371,1225896,7,1225889
42536,9,18,174,1190632,9,1190623
42537,7,2,627,701893,7,701886
42538,8,16,112,1127389,8,1127381
42539,15,13,462,1056660,15,1056645
42540,20,-15,489,181382,20,181362
42541,6,10,159,940960,6,940954
42542,7,-19,90,33432,7,33425
42543,20,13,845,1059569,20,1059549
42544,9,4,50,751631,9,751622
42545,9,-6,241,442150,9,442141
42546,16,3,231,743633,16,743617
42547,20,7,847,873130,20,873110
42548,11,16,528,1150850,11,1150839
42549,5,19,347,1225273,5,1225268
42550,16,-19,470,57588,16,57572
42551,10,-20,100,2230,10,2220
42552,12,7,811,872868,12,872856
42553,8,-8,478,385206,8,385198
42554,6,6,205,816681,6,816675
42555,11,16,389,1149917,11,1149906
42556,15,-10,744,340691,15,340676
42557,16,-9,259,368488,16,368472
42558,14,3,410,744945,14,744931
42559,6,12,416,1007969,6,1007963
42560,8,-20,15,358,8,350
42561,13,-15,470,181252,13,181239
42562,19,4,212,774787,19,774768
42563,10,-2,555,574597,10,574587
42564,19,-13,339,243548,19,243529
42565,17,8,666,903229,17,903212
42566,14,-11,97,304456,14,304442
42567,12,-16,853,153165,12,153153
42568,6,4,460,760513,6,760507
42569,10,-12,728,265183,10,265173
42570,7,0,21,625709,7,625702
42571,12,-16,228,148671,12,148659
42572,6,7,40,845676,6,845670
42573,12,-11,875,310590,12,310578
42574,10,-20,177,4059,10,4049
42575,16,-8,372,400518,16,400502
42576,7,14,159,1065470,7,1065463
42577,6,-13,552,230096,6,230090
42578,19,4,440,776431,19,776412
42579,15,14,27,1085582,15,1085567
42580,15,-17,693,120693,15,120678
42581,18,19,426,1244358,18,1244340
42582,16,1,457,683456,16,683440
42583,19,-2,527,589115,19,589096
42584,13,18,406,1212044,13,1212031
42585,20,16,796,1152801,20,1152781
42586,16,-7,385,431265,16,431249
42587,9,19,6,1217565,9,1217556
42588,18,-18,395,88274,18,88256
42589,13,16,940,1153815,13,1153802
42590,17,-6,339,461801,17,461784
42591,12,16,986,1154152,12,1154140
42592,7,12,736,1015146,7,1015139
42593,16,15,138,1117833,16,1117817
42594,8,-6,535,448341,8,448333
42595,5,-13,782,235403,5,235398
42596,8,-3,96,532466,8,532458
42597,5,-19,897,50898,5,50893
42598,20,-5,79,491468,20,491448
42599,11,15,872,1123142,11,1123131
42600,6,19,164,1221123,6,1221117
42601,15,-20,76,23364,15,23349
42602,6,7,775,861149,6,861143
42603,15,11,766,996384,15,996369
42604,10,9,756,922569,10,922559
42605,17,6,152,836921,17,836904
42606,7,19,881,1237166,7,1237159
42607,7,-17,637,107247,7,107240
42608,8,-13,21,218761,8,218753
42609,15,-12,287,274628,15,274613
42610,9,8,897,894676,9,894667
42611,5,-12,881,268763,5,268758
42612,18,-16,462,150473,18,150455
42613,11,13,738,1058726,11,1058715
42614,10,1,963,677944,10,677934
42615,9,13,432,1040055,9,1040046
42616,15,-3,515,557763,15,557748
42617,11,11,939,997654,11,997643
42618,6,16,437,1134603,6,1134597
42619,20,-2,292,587359,20,587339
42620,17,14,87,1086124,17,1086107
42621,14,-7,471,431882,14,431868
42622,15,-3,953,561438,15,561423
42623,9,7,674,859139,9,859130
42624,16,-19,0,53889,16,53873
42625,14,-8,925,404408,14,404394
42626,17,-16,167,148131,17,148114
42627,13,16,872,1153299,13,1153286
42628,16,16,851,1153186,16,1153170
42629,14,8,131,898956,14,898942
42630,17,-12,502,276281,17,276264
42631,12,15,61,1117243,12,1117231
42632,9,-17,345,100899,9,100890
42633,12,-15,222,179335,12,179323
42634,5,-15,81,157065,5,157060
42635,8,-14,654,201010,8,201002
42636,18,-4,510,525972,18,525954
42637,11,-18,549,89282,11,89271
42638,6,16,533,1136509,6,1136503
42639,17,-11,253,305701,17,305684
42640,18,8,488,901838,18,901820
42641,6,7,222,849474,6,849468
42642,20,-12,208,273989,20,273969
42643,17,-14,437,212913,17,212896
42644,7,-7,390,414353,7,414346
42645,11,-14,904,216537,11,216526
42646,5,-12,899,269195,5,269190
42647,6,-12,344,257125,6,257119
42648,17,6,648,840993,17,840976
42649,13,-5,324,493538,13,493525
42650,10,8,299,881738,10,881728
42651,15,12,887,1028749,15,1028734
42652,6,6,762,829422,6,829416
42653,8,10,595,950336,8,950328
42654,8,-7,398,414579,8,414571
42655,16,1,577,684462,16,684446
42656,18,-10,346,337574,18,337556
42657,13,-11,967,311289,13,311276
42658,11,-18,676,90177,11,90166
42659,14,-5,682,495974,14,495960
42660,11,-16,132,147927,11,147916
42661,5,11,129,971222,5,971217
42662,15,-16,613,151538,15,151523
42663,5,-2,203,567099,5,567094
42664,18,-18,574,89424,18,89406
42665,14,-20,364,25613,14,25599
42666,17,1,100,680616,17,680599
42667,15,0,46,648604,15,648589
42668,20,-1,344,619355,20,619335
42669,9,3,247,724210,9,724201
42670,6,-15,166,158976,6,158970
42671,17,7,448,870397,17,870380
42672,12,5,796,809554,12,809542
42673,16,8,628,902946,16,902930
42674,16,-4,844,528249,16,528233
42675,20,15,703,1121951,20,1121931
42676,8,0,74,626867,8,626859
42677,8,3,392,727275,8,727267
42678,6,-2,900,582079,6,582073
42679,8,16,879,1143366,8,1143358
42680,9,4,372,758632,9,758623
42681,19,-18,463,88781,19,88762
42682,7,-14,146,189652,7,189645
42683,7,-4,882,518365,7,518358
42684,13,-2,530,589123,13,589110
42685,16,-13,819,247127,16,247111
42686,19,-12,905,279320,19,279301
42687,10,-16,816,141535,10,141525
42688,9,18,844,1204608,9,1204599
42689,12,-12,436,275654,12,275642
42690,8,-13,603,231239,8,231231
42691,20,0,712,653738,20,653718
42692,8,-14,155,189860,8,189852
42693,20,-3,966,561527,20,561507
42694,13,18,495,1212578,13,1212565
42695,16,-9,234,368269,16,368253
42696,15,-3,88,554386,15,554371
42697,13,-1,70,617101,13,617088
42698,6,-14,892,205876,6,205870
42699,8,2,494,699129,8,699121
42700,20,-14,484,213236,20,213216
42701,5,1,793,674242,5,674237
42702,17,-1,733,622248,17,622231
42703,15,2,320,712988,15,712973
42704,8,-2,695,577693,8,577685
42705,7,-18,273,68457,7,68450
42706,8,7,483,855215,8,855207
42707,8,10,891,956644,8,956636
42708,12,9,411,932014,12,932002
42709,9,-6,700,451852,9,451843
42710,19,-7,346,430962,19,430943
42711,14,-1,31,616770,14,616756
42712,18,-3,508,557723,18,557705
42713,12,-4,636,526870,12,526858
42714,14,5,822,809778,14,809764
42715,10,-19,981,52536,10,52526
42716,6,7,843,862702,6,862696
42717,10,6,823,830836,10,830826
42718,9,-12,184,253401,9,253392
42719,7,-13,768,234991,7,234984
42720,8,15,130,1097321,8,1097313
42721,5,9,781,923211,5,923206
42722,14,-19,135,55093,14,55079
42723,14,-16,566,151165,14,151151
42724,8,-9,31,344288,8,344280
42725,14,15,613,1121279,14,1121265
42726,5,-6,86,438545,5,438540
42727,5,7,404,853524,5,853519
42728,13,-15,161,178966,13,178953
42729,18,5,927,810596,18,810578
42730,11,-16,389,149737,11,149726
42731,6,13,701,1045804,6,1045798
42732,13,12,437,1025268,13,1025255
42733,9,13,85,1032572,9,1032563
42734,7,-16,778,140777,7,140770
42735,11,-3,599,558511,11,558500
42736,9,-5,237,473258,9,473249
42737,11,-19,625,58940,11,58929
42738,9,-14,202,190917,9,190908
42739,6,-16,581,136632,6,136626
42740,5,10,590,950185,5,950180
42741,18,10,623,964740,18,964722
42742,8,-7,193,409913,8,409905
42743,18,8,607,902738,18,902720
42744,14,13,917,1059966,14,1059952
42745,14,-10,405,337991,14,337977
42746,12,9,95,929764,12,929752
42747,14,11,12,990956,14,990942
42748,8,16,634,1138555,8,1138547
42749,10,3,132,721659,10,721649
42750,13,14,101,1086264,13,1086251
42751,14,6,795,842132,14,842118
42752,20,-20,892,29678,20,29658
42753,10,-6,25,437419,10,437409
42754,5,-4,85,501207,5,501202
42755,8,3,558,730584,8,730576
42756,16,8,881,904770,16,904754
42757,14,16,184,1148444,14,1148430
42758,20,0,579,652650,20,652630
42759,17,-6,453,462601,17,462584
42760,13,5,600,808193,13,808180
42761,17,-16,869,153384,17,153367
42762,13,-9,962,374128,13,374115
42763,10,-5,269,473963,10,473953
42764,11,-3,943,561339,11,561328
42765,15,-5,15,490866,15,490851
42766,5,11,894,987741,5,987736
42767,18,6,742,841758,18,841740
42768,20,16,278,1149146,20,1149126
42769,20,7,813,872883,20,872863
42770,17,3,185,743270,17,743253
42771,13,4,194,774634,13,774621
42772,19,12,212,1023636,19,1023617
42773,20,-6,844,465528,20,465508
42774,7,-3,989,552565,7,552558
42775,10,-11,108,283450,10,283440
42776,14,13,814,1059359,14,1059345
42777,6,-5,117,470668,6,470662
42778,13,15,662,1121655,13,1121642
42779,12,17,225,1179525,12,1179513
42780,17,-11,471,307513,17,307496
42781,15,0,147,649321,15,649306
42782,7,-4,219,504323,7,504316
42783,8,-14,979,207854,8,207846
42784,10,10,756,953722,10,953712
42785,20,16,855,1153207,20,1153187
42786,18,-12,889,279169,18,279151
42787,14,-11,421,307102,14,307088
42788,6,5,388,789649,6,789643
42789,8,8,388,883709,8,883701
42790,7,18,601,1199340,7,1199333
42791,5,-17,407,102091,5,102086
42792,18,-10,795,341069,18,341051
42793,8,-10,35,313431,8,313423
42794,5,-5,605,481196,5,481191
42795,10,5,392,789704,10,789694
42796,17,-13,545,245043,17,245026
42797,13,2,360,713324,13,713311
42798,19,6,871,842724,19,842705
42799,14,0,559,652453,14,652439
42800,11,-1,713,622108,11,622097
42801,17,-6,919,466102,17,466085
42802,15,-6,634,464009,15,463994
42803,15,-16,589,151321,15,151306
42804,16,-3,406,556798,16,556782
42805,17,8,791,904210,17,904193
42806,12,19,524,1245140,12,1245128
42807,20,-17,139,116504,20,116484
42808,19,19,869,1247833,19,1247814
42809,16,18,975,1216158,16,1216142
42810,16,-5,154,492157,16,492141
42811,19,-3,32,554045,19,554026
42812,9,8,991,896745,9,896736
42813,14,17,686,1182950,14,1182936
42814,5,-19,177,35521,5,35516
42815,5,5,460,791161,5,791156
42816,5,-18,568,74608,5,74603
42817,9,-4,297,505955,9,505946
42818,12,-15,825,183968,12,183956
42819,13,-4,493,525784,13,525771
42820,12,-2,669,590160,12,590148
42821,16,15,762,1122435,16,1122419
42822,6,16,491,1135633,6,1135627
42823,14,6,825,842389,14,842375
42824,8,18,845,1204635,8,1204627
42825,9,12,516,1010099,9,1010090
42826,14,-17,357,118122,14,118108
42827,14,-18,847,91316,14,91302
42828,7,-14,577,199205,7,199198
42829,11,-20,692,28152,11,28141
42830,8,-11,967,301987,8,301979
42831,7,14,190,1065977,7,1065970
42832,6,18,898,1205776,6,1205770
42833,13,-8,234,399564,13,399551
42834,17,-18,908,91809,17,91792
42835,19,5,900,810343,19,810324
42836,9,-16,240,129305,9,129296
42837,17,11,763,996364,17,996347
42838,6,3,171,722446,6,722440
42839,10,17,54,1156517,10,1156507
42840,14,-20,381,25756,14,25742
42841,11,11,971,997829,11,997818
42842,19,-15,997,185381,19,185362
42843,13,-10,530,338982,13,338969
42844,19,-13,598,245433,19,245414
42845,10,-19,42,32372,10,32362
42846,10,15,58,1095744,10,1095734
42847,16,-20,344,25518,16,25502
42848,8,-18,213,67030,8,67022
42849,10,-19,229,36605,10,36595
42850,11,13,725,1058617,11,1058606
42851,15,18,135,1210030,15,1210015
42852,14,-3,964,561509,14,561495
42853,9,-16,839,141974,9,141965
42854,7,-4,163,502908,7,502901
42855,19,-14,556,213789,19,213770
42856,9,8,563,887567,9,887558
42857,11,-10,819,341236,11,341225
42858,7,7,10,844975,7,844968
42859,18,-8,65,398443,18,398425
42860,5,-4,823,516872,5,516867
42861,19,7,271,868967,19,868948
42862,5,12,816,1016795,5,1016790
42863,13,-14,919,216680,13,216667
42864,16,-11,151,304916,16,304900
42865,20,-20,537,26887,20,26867
42866,14,-2,145,586186,14,586172
42867,12,2,580,714923,12,714911
42868,15,2,523,714585,15,714570
42869,18,-9,568,371199,18,371181
42870,18,-2,758,590807,18,590789
42871,19,11,824,996800,19,996781
42872,11,-4,177,523420,11,523409
42873,16,-18,122,86147,16,86131
42874,14,1,107,680652,14,680638
42875,13,6,241,837563,13,837550
42876,10,-4,411,508542,10,508532
42877,12,-6,441,462486,12,462474
42878,8,-16,598,137036,8,137028
42879,17,-11,172,305091,17,305074
42880,11,-9,886,373607,11,373596
42881,9,7,565,856819,9,856810
42882,19,18,926,1215731,19,1215712
42883,5,-9,733,359754,5,359749
42884,8,2,424,697772,8,697764
42885,5,6,539,824524,5,824519
42886,17,-11,973,311326,17,311309
42887,10,-18,245,67840,10,67830
42888,17,-10,732,340588,17,340571
42889,18,-20,662,27895,18,27877
42890,13,6,425,839170,13,839157
42891,20,-14,772,215577,20,215557
42892,14,6,396,838949,14,838935
42893,5,6,221,817106,5,817101
42894,19,13,929,1060126,19,1060107
42895,12,-12,734,277859,12,277847
42896,20,3,457,745252,20,745232
42897,17,16,372,1149827,17,1149810
42898,13,-7,322,430799,13,430786
42899,6,2,55,689782,6,689776
42900,15,-3,460,557331,15,557316
42901,16,2,943,717496,16,717480
42902,9,11,269,974013,9,974004
42903,16,18,867,1215280,16,1215264
42904,7,-7,352,413512,7,413505
42905,17,-14,955,216897,17,216880
42906,20,1,201,681477,20,681457
42907,20,14,300,1087754,20,1087734
42908,17,18,337,1211571,17,1211554
42909,6,8,811,892934,6,892928
42910,17,-18,713,90438,17,90421
42911,10,-16,111,126497,10,126487
42912,11,-2,693,590366,11,590355
42913,13,19,679,1246276,13,1246263
42914,15,13,475,1056742,15,1056727
42915,7,14,873,1081407,7,1081400
42916,13,13,680,1058348,13,1058335
42917,14,-8,212,399404,14,399390
42918,17,-15,177,179055,17,179038
42919,7,-17,173,97042,7,97035
42920,15,7,446,870363,15,870348
42921,16,-10,467,338548,16,338532
42922,9,10,939,957727,9,957718
42923,18,-3,797,560205,18,560187
42924,7,-1,513,605183,7,605176
42925,7,-13,365,226020,7,226013
42926,15,18,473,1212459,15,1212444
42927,19,-2,682,590269,19,590250
42928,10,6,599,825842,10,825832
42929,5,-10,588,325349,5,325344
42930,16,-19,282,56218,16,56202
42931,5,-3,268,536215,5,536210
42932,6,-13,261,223938,6,223932
42933,11,12,940,1029325,11,1029314
42934,7,13,205,1035110,7,1035103
42935,16,6,102,836501,16,836485
42936,15,16,323,1149454,15,1149439
42937,18,-13,78,241614,18,241596
42938,6,17,773,1171698,6,1171692
42939,18,-10,977,342448,18,342430
42940,20,11,924,997622,20,997602
42941,6,7,672,859070,6,859064
42942,7,-12,238,254666,7,254659
42943,8,0,695,640616,8,640608
42944,9,1,166,660782,9,660773
42945,12,-7,839,434411,12,434399
42946,10,-17,150,96571,10,96561
42947,19,15,718,1122118,19,1122099
42948,7,8,498,886113,7,886106
42949,6,12,58,1000393,6,1000387
42950,8,8,16,875502,8,875494
42951,10,-19,949,51921,10,51911
42952,20,13,841,1059538,20,1059518
42953,8,-13,723,233834,8,233826
42954,19,-12,935,279551,19,279532
42955,13,13,535,1057200,13,1057187
42956,11,-1,391,619674,11,619663
42957,17,-9,438,370070,17,370053
42958,17,1,881,686632,17,686615
42959,13,16,297,1149271,13,1149258
42960,18,3,173,743143,18,743125
42961,12,17,732,1183356,12,1183344
42962,12,4,25,773433,12,773421
42963,9,8,870,894056,9,894047
42964,8,-16,537,135705,8,135697
42965,16,-3,375,556576,16,556560
42966,20,13,0,1053241,20,1053221
42967,5,12,218,1003889,5,1003884
42968,15,-2,425,588314,15,588299
42969,14,8,627,902923,14,902909
42970,11,-7,981,435571,11,435560
42971,13,-17,784,121445,13,121432
42972,5,-16,254,129542,5,129537
42973,12,-15,714,183086,12,183074
42974,19,0,174,649549,19,649530
42975,17,-9,542,370995,17,370978
42976,13,2,524,714587,13,714574
42977,19,15,718,1122127,19,1122108
42978,17,10,64,960310,17,960293
42979,20,1,294,682188,20,682168
42980,15,-3,293,555903,15,555888
42981,11,-1,357,619482,11,619471
42982,6,8,4,875242,6,875236
42983,19,-19,734,59781,19,59762
42984,5,1,203,661640,5,661635
42985,19,-13,23,241251,19,241232
42986,11,-11,389,306855,11,306844
42987,11,-19,266,56097,11,56086
42988,18,-1,552,620929,18,620911
42989,16,-7,194,429739,16,429723
42990,19,16,308,1149354,19,1149335
42991,9,7,135,847729,9,847720
42992,9,-12,386,257990,9,257981
42993,10,0,90,627269,10,627259
42994,13,-4,39,522333,13,522320
42995,14,6,563,840320,14,840306
42996,5,-9,851,362594,5,362589
42997,15,-13,469,244440,15,244425
42998,16,1,898,686797,16,686781
42999,19,-18,45,85545,19,85526
43000,18,5,113,804620,18,804602
43001,19,6,292,837995,19,837976
43002,6,-5,0,467741,6,467735
43003,20,-8,675,402707,20,402687
43004,15,12,918,1029103,15,1029088
43005,12,-11,86,304332,12,304320
43006,12,-18,840,91302,12,91290
43007,15,15,421,1119751,15,1119736
43008,10,-5,379,476325,10,476315
43009,8,-4,27,499893,8,499885
43010,11,0,708,653685,11,653674
43011,15,17,255,1179813,15,1179798
43012,7,1,772,673786,7,673779
43013,8,-4,338,506884,8,506876
43014,5,-18,638,76102,5,76097
43015,11,-8,697,402827,11,402816
43016,16,2,48,710870,16,710854
43017,18,-19,278,56175,18,56157
43018,12,-4,661,527097,12,527085
43019,9,-4,667,513821,9,513812
43020,11,7,72,867538,11,867527
43021,9,2,18,688913,9,688904
43022,16,14,703,1090971,16,1090955
43023,7,-16,732,139733,7,139726
43024,19,-2,893,591963,19,591944
43025,19,7,209,868476,19,868457
43026,6,3,706,734175,6,734169
43027,7,7,719,859974,7,859967
43028,10,6,269,818277,10,818267
43029,9,14,233,1066973,9,1066964
43030,14,12,491,1025674,14,1025660
43031,10,-18,336,69745,10,69735
43032,7,19,144,1220672,7,1220665
43033,5,-4,566,511614,5,511609
43034,17,3,938,748970,17,748953
43035,10,8,784,892465,10,892455
43036,14,11,699,995784,14,995770
43037,11,17,403,1180905,11,1180894
43038,8,14,576,1074635,8,1074627
43039,5,-1,250,599310,5,599305
43040,8,-10,383,320841,8,320833
43041,9,13,406,1039560,9,1039551
43042,7,0,802,642891,7,642884
43043,12,-4,504,525930,12,525918
43044,17,-6,658,464156,17,464139
43045,16,8,32,898116,16,898100
43046,19,-18,6,85263,19,85244
43047,15,1,314,682345,15,682330
43048,15,-17,162,116668,15,116653
43049,12,13,277,1055230,12,1055218
43050,7,-3,381,538826,7,538819
43051,7,7,539,856249,7,856242
43052,18,10,875,966538,18,966520
43053,10,-8,579,387579,10,387569
43054,5,-20,277,6190,5,6185
43055,8,17,221,1159861,8,1159853
43056,17,1,522,683985,17,683968
43057,7,13,160,1034070,7,1034063
43058,10,-3,8,530789,10,530779
43059,20,2,868,716984,20,716964
43060,15,17,813,1184049,15,1184034
43061,13,-2,737,590653,13,590640
43062,6,-16,756,140365,6,140359
43063,20,-12,340,275065,20,275045
43064,12,19,288,1243054,12,1243042
43065,18,-20,944,29966,18,29948
43066,10,19,319,1224681,10,1224671
43067,20,8,953,905359,20,905339
43068,6,12,588,1011712,6,1011706
43069,6,-13,667,232417,6,232411
43070,8,11,596,981262,8,981254
43071,7,-7,511,416783,7,416776
43072,20,13,790,1059182,20,1059162
43073,6,-6,190,441034,6,441028
43074,12,8,119,898887,12,898875
43075,18,14,530,1089593,18,1089575
43076,13,0,470,651688,13,651675
43077,12,6,123,836709,12,836697
43078,10,-11,366,289247,10,289237
43079,11,-3,232,555390,11,555379
43080,13,-17,504,119256,13,119243
43081,8,-6,689,451634,8,451626
43082,6,6,848,831416,6,831410
43083,7,-4,568,511701,7,511694
43084,16,-20,824,29207,16,29191
43085,6,17,90,1157195,6,1157189
43086,15,19,38,1240997,15,1240982
43087,19,-15,371,180506,19,180487
43088,18,-9,735,372223,18,372205
43089,7,0,945,645871,7,645864
43090,5,-14,377,195011,5,195006
43091,16,0,555,652414,16,652398
43092,9,15,754,1110592,9,1110583
43093,18,7,441,870334,18,870316
43094,12,-18,271,87378,12,87366
43095,13,-9,771,372659,13,372646
43096,19,11,289,992978,19,992959
43097,17,-1,31,616777,17,616760
43098,6,-10,609,325812,6,325806
43099,18,-15,705,183013,18,182995
43100,5,9,721,921943,5,921938
43101,8,18,560,1198692,8,1198684
43102,16,-4,234,523956,16,523940
43103,10,11,118,970975,10,970965
43104,17,4,418,776243,17,776226
43105,10,-9,814,361739,10,361729
43106,5,-6,653,450782,5,450777
43107,6,11,571,980723,6,980717
43108,20,-17,154,116622,20,116602
43109,12,-19,208,55737,12,55725
43110,18,7,401,870023,18,870005
43111,18,-5,534,495007,18,494989
43112,10,-16,965,144791,10,144781
43113,6,5,40,782459,6,782453
43114,5,-19,947,51861,5,51856
43115,20,8,113,898824,20,898804
43116,7,13,273,1036456,7,1036449
43117,9,2,789,705103,9,705094
43118,18,6,222,837401,18,837383
43119,10,16,397,1133668,10,1133658
43120,5,18,279,1192928,5,1192923
43121,16,-2,73,585671,16,585655
43122,6,-3,852,549461,6,549455
43123,13,0,544,652333,13,652320
43124,11,12,232,1023744,11,1023733
43125,10,-5,425,477185,10,477175
43126,13,-20,115,23635,13,23622
43127,11,9,427,932131,11,932120
43128,19,1,797,686074,19,686055
43129,14,9,628,933739,14,933725
43130,17,-2,978,592595,17,592578
43131,20,-9,825,373073,20,373053
43132,14,16,690,1152021,14,1152007
43133,19,-5,949,498024,19,498005
43134,19,-12,817,278498,19,278479
43135,15,-16,85,147496,15,147481
43136,9,12,254,1004713,9,1004704
43137,10,0,381,633606,10,633596
43138,9,-13,424,227162,9,227153
43139,13,19,827,1247445,13,1247432
43140,11,17,206,1179438,11,1179427
43141,14,8,397,901110,14,901096
43142,16,-19,936,61041,16,61025
43143,11,14,653,1090567,11,1090556
43144,7,-4,694,514391,7,514384
43145,12,-17,916,122299,12,122287
43146,7,-4,907,518879,7,518872
43147,9,-15,737,171280,9,171271
43148,5,15,595,1107022,5,1107017
43149,15,-12,48,272829,15,272814
43150,11,11,193,992197,11,992186
43151,18,-12,19,272638,18,272620
43152,13,13,275,1055203,13,1055190
43153,11,19,374,1243799,11,1243788
43154,19,-14,169,210587,19,210568
43155,6,-15,498,166266,6,166260
43156,18,-5,84,491522,18,491504
43157,19,12,476,1025543,19,1025524
43158,11,-16,784,152678,11,152667
43159,7,-10,763,328964,7,328957
43160,7,9,807,923874,7,923867
43161,16,9,335,931477,16,931461
43162,9,8,521,886717,9,886708
43163,18,-15,670,182769,18,182751
43164,8,5,129,784219,8,784211
43165,14,-7,969,435481,14,435467
43166,15,-17,973,122613,15,122598
43167,11,-20,346,25524,11,25513
43168,12,11,914,997515,12,997503
43169,20,-3,941,561339,20,561319
43170,14,18,510,1212700,14,1212686
43171,13,-13,657,245811,13,245798
43172,8,8,613,888554,8,888546
43173,6,16,50,1126214,6,1126208
43174,7,13,473,1040853,7,1040846
43175,15,7,715,872208,15,872193
43176,20,17,426,1181085,20,1181065
43177,10,-19,795,48871,10,48861
43178,16,15,377,1119546,16,1119530
43179,13,-1,452,620145,13,620132
43180,13,4,322,775509,13,775496
43181,9,-17,562,105617,9,105608
43182,19,-3,417,556915,19,556896
43183,12,0,720,653812,12,653800
43184,6,16,179,1128952,6,1128946
43185,9,14,955,1083203,9,1083194
43186,7,19,710,1233231,7,1233224
43187,20,14,858,1092117,20,1092097
43188,7,0,408,634168,7,634161
43189,5,14,914,1082183,5,1082178
43190,18,-3,562,558224,18,558206
43191,16,1,772,685881,16,685865
43192,12,11,286,992952,12,992940
43193,18,2,123,711523,18,711505
43194,10,7,561,856713,10,856703
43195,18,10,592,964465,18,964447
43196,7,-2,463,572605,7,572598
43197,8,-15,296,161781,8,161773
43198,15,15,767,1122459,15,1122444
43199,6,-6,189,441016,6,441010
43200,9,-1,695,608873,9,608864
43201,12,-12,574,276761,12,276749
43202,9,-3,520,542100,9,542091
43203,11,15,724,1122151,11,1122140
43204,9,-14,193,190638,9,190629
43205,15,4,213,774804,15,774789
43206,16,-12,430,275622,16,275606
43207,8,-15,480,165898,8,165890
43208,6,0,659,639776,6,639770
43209,5,-15,725,170971,5,170966
43210,7,-9,88,345525,7,345518
43211,19,1,32,680037,19,680018
43212,15,0,49,648617,15,648602
43213,6,1,622,670781,6,670775
43214,13,17,166,1179130,13,1179117
43215,16,13,437,1056512,16,1056496
43216,13,-20,906,29772,13,29759
43217,11,-8,762,403274,11,403263
43218,10,0,37,626109,10,626099
43219,6,18,194,1191197,6,1191191
43220,18,11,104,991608,18,991590
43221,16,-7,151,429398,16,429382
43222,5,18,254,1192412,5,1192407
43223,6,-16,293,130372,6,130366
43224,16,11,524,994650,16,994634
43225,20,-11,412,307030,20,307010
43226,10,16,828,1142391,10,1142381
43227,14,3,725,747340,14,747326
43228,6,-4,172,503145,6,503139
43229,9,-10,177,316500,9,316491
43230,5,5,489,791756,5,791751
43231,12,-7,470,431873,12,431861
43232,8,-1,56,594976,8,594968
43233,14,-10,59,335623,14,335609
43234,20,-10,287,337123,20,337103
43235,6,13,868,1049404,6,1049398
43236,17,12,474,1025532,17,1025515
43237,13,-9,721,372078,13,372065
43238,18,-15,101,178568,18,178550
43239,6,0,79,626957,6,626951
43240,12,5,839,809896,12,809884
43241,8,14,215,1066459,8,1066451
43242,16,-13,745,246543,16,246527
43243,20,-2,175,586333,20,586313
43244,9,-7,345,413369,9,413360
43245,13,-13,581,245334,13,245321
43246,6,6,752,829216,6,829210
43247,15,6,227,837466,15,837451
43248,9,10,85,939351,9,939342
43249,9,-20,530,11449,9,11440
43250,11,3,976,749330,11,749319
43251,9,-12,842,267791,9,267782
43252,8,-12,113,252009,8,252001
43253,17,-14,213,210985,17,210968
43254,17,17,470,1181454,17,1181437
43255,17,17,692,1183045,17,1183028
43256,9,11,151,971589,9,971580
43257,16,4,776,778965,16,778949
43258,9,11,546,980166,9,980157
43259,20,16,772,1152565,20,1152545
43260,16,9,500,932703,16,932687
43261,11,15,596,1121103,11,1121092
43262,10,2,31,689292,10,689282
43263,12,-17,609,120076,12,120064
43264,5,1,898,676521,5,676516
43265,5,-6,586,449413,5,449408
43266,13,-8,176,399166,13,399153
43267,9,7,422,853851,9,853842
43268,5,-15,839,173243,5,173238
43269,11,-4,310,524500,11,524489
43270,6,-20,119,2670,6,2664
43271,17,-10,11,335198,17,335181
43272,16,5,850,809950,16,809934
43273,7,-4,453,509293,7,509286
43274,20,-2,127,586077,20,586057
43275,20,-9,76,367227,20,367207
43276,11,2,727,716062,11,716051
43277,5,-12,410,258556,5,258551
43278,13,-2,443,588456,13,588443
43279,6,-2,68,564342,6,564336
43280,6,15,367,1102222,6,1102216
43281,11,-16,949,153888,11,153877
43282,7,-15,445,165034,7,165027
43283,8,12,130,1001952,8,1001944
43284,12,-8,91,398598,12,398586
43285,12,11,898,997403,12,997391
43286,5,-12,593,262323,5,262318
43287,19,-10,240,336822,19,336803
43288,15,3,180,743222,15,743207
43289,13,-15,374,180530,13,180517
43290,10,-3,392,539017,10,539007
43291,18,-5,132,491968,18,491950
43292,7,-13,634,231914,7,231907
43293,10,-7,871,424360,10,424350
43294,7,0,979,646653,7,646646
43295,20,-19,843,60506,20,60486
43296,5,-10,183,316609,5,316604
43297,20,17,453,1181337,20,1181317
43298,6,-2,35,563565,6,563559
43299,19,-9,59,367091,19,367072
43300,6,3,968,740013,6,740007
43301,12,-2,33,585368,12,585356
43302,16,-12,210,274017,16,274001
43303,16,-5,697,496117,16,496101
43304,12,-17,14,115685,12,115673
43305,8,10,636,951273,8,951265
43306,15,-20,637,27627,15,27612
43307,18,-9,887,373621,18,373603
43308,16,-18,679,90180,16,90164
43309,9,15,465,1104294,9,1104285
43310,5,0,840,643580,5,643575
43311,19,-10,318,337371,19,337352
43312,12,-1,411,619831,12,619819
43313,9,-3,807,548415,9,548406
43314,15,-3,727,559563,15,559548
43315,5,-14,57,187787,5,187782
43316,19,4,270,775141,19,775122
43317,9,0,264,631108,9,631099
43318,5,10,867,956159,5,956154
43319,6,14,288,1068201,6,1068195
43320,7,5,196,785822,7,785815
43321,15,7,984,874015,15,874000
43322,14,-12,700,277670,14,277656
43323,11,5,555,807813,11,807802
43324,8,12,310,1006025,8,1006017
43325,17,-20,660,27868,17,27851
43326,8,-15,818,172914,8,172906
43327,5,13,314,1037451,5,1037446
43328,5,11,488,978853,5,978848
43329,6,4,522,761906,6,761900
43330,20,8,683,903390,20,903370
43331,17,10,474,963457,17,963440
43332,15,-6,165,460408,15,460393
43333,10,-8,479,385262,10,385252
43334,20,-14,891,216449,20,216429
43335,8,-13,453,227828,8,227820
43336,16,13,532,1057161,16,1057145
43337,13,-14,592,214193,13,214180
43338,17,11,629,995331,17,995314
43339,19,16,644,1151757,19,1151738
43340,16,-15,437,181020,16,181004
43341,8,-2,711,578026,8,578018
43342,5,-1,594,606861,5,606856
43343,9,-18,441,71842,9,71833
43344,15,10,651,964950,15,964935
43345,8,-4,997,520934,8,520926
43346,17,-18,45,85552,17,85535
43347,9,1,923,677117,9,677108
43348,20,2,648,715434,20,715414
43349,9,11,788,985313,9,985304
43350,20,12,939,1029296,20,1029276
43351,8,-3,608,544085,8,544077
43352,16,15,80,1117396,16,1117380
43353,14,5,765,809348,14,809334
43354,17,6,928,843147,17,843130
43355,17,-3,45,554133,17,554116
43356,14,6,195,837202,14,837188
43357,11,18,830,1214963,11,1214952
43358,7,16,852,1142800,7,1142793
43359,10,8,496,886044,10,886034
43360,6,5,320,788199,6,788193
43361,13,-6,173,460456,13,460443
43362,20,-1,291,618873,20,618853
43363,19,15,779,1122520,19,1122501
43364,7,9,5,906792,7,906785
43365,17,-14,159,210529,17,210512
43366,18,5,266,805795,18,805777
43367,5,-20,113,2466,5,2461
43368,17,-6,455,462619,17,462602
43369,20,-2,839,591541,20,591521
43370,14,14,810,1091827,14,1091813
43371,10,-16,560,136211,10,136201
43372,18,16,652,1151806,18,1151788
43373,6,-12,107,251847,6,251841
43374,16,16,205,1148597,16,1148581
43375,11,-11,850,310361,11,310350
43376,6,-10,519,323852,6,323846
43377,20,-3,560,558199,20,558179
43378,13,14,844,1092029,13,1092016
43379,14,-20,459,26263,14,26249
43380,8,-2,575,574964,8,574956
43381,12,-8,98,398631,12,398619
43382,13,-1,737,622270,13,622257
43383,6,-2,60,564147,6,564141
43384,6,-17,777,110109,6,110103
43385,11,1,466,683512,11,683501
43386,17,-5,591,495405,17,495388
43387,6,-19,715,47241,6,47235
43388,14,-20,280,24959,14,24945
43389,12,1,236,681762,12,681750
43390,8,-10,560,324808,8,324800
43391,12,-16,701,152064,12,152052
43392,9,-12,651,263646,9,263637
43393,9,-15,435,164871,9,164862
43394,6,-7,274,411643,6,411637
43395,19,-17,918,122313,19,122294
43396,13,-5,259,492954,13,492941
43397,17,-18,308,87629,17,87612
43398,11,-3,177,555013,11,555002
43399,9,-7,394,414471,9,414462
43400,20,-20,719,28303,20,28283
43401,17,4,619,777769,17,777752
43402,13,-1,33,616812,13,616799
43403,11,13,926,1060106,11,1060095
43404,7,14,799,1079789,7,1079782
43405,18,12,861,1028536,18,1028518
43406,7,-18,970,83553,7,83546
43407,16,13,997,1060609,16,1060593
43408,10,-17,131,96155,10,96145
43409,15,-12,621,277037,15,277022
43410,20,4,406,776129,20,776109
43411,10,4,670,765027,10,765017
43412,14,15,559,1120828,14,1120814
43413,20,-19,708,59512,20,59492
43414,7,5,1000,802773,7,802766
43415,5,-11,169,284791,5,284786
43416,16,18,527,1212852,16,1212836
43417,11,-15,691,182879,11,182868
43418,13,13,478,1056761,13,1056748
43419,16,-16,896,153523,16,153507
43420,19,-14,565,213934,19,213915
43421,19,17,796,1183877,19,1183858
43422,15,7,750,872440,15,872425
43423,5,4,588,763281,5,763276
43424,12,-6,839,465508,12,465496
43425,20,-18,74,85784,20,85764
43426,14,-1,383,619626,14,619612
43427,19,17,849,1184381,19,1184362
43428,12,14,236,1087262,12,1087250
43429,13,-11,312,306281,13,306268
43430,11,-14,295,211698,11,211687
43431,8,-7,669,419923,8,419915
43432,7,2,408,697527,7,697520
43433,20,0,294,650284,20,650264
43434,14,-11,507,307805,14,307791
43435,11,10,630,964773,11,964762
43436,8,-16,466,134275,8,134267
43437,8,-8,503,385825,8,385817
43438,6,17,15,1155564,6,1155558
43439,9,8,285,881474,9,881465
43440,12,8,73,898459,12,898447
43441,18,6,903,842964,18,842946
43442,20,-13,111,241849,20,241829
43443,18,-17,570,119808,18,119790
43444,14,16,762,1152491,14,1152477
43445,6,-14,261,192503,6,192497
43446,8,-5,663,482372,8,482364
43447,20,12,810,1028075,20,1028055
43448,7,17,390,1163683,7,1163676
43449,11,10,682,965206,11,965195
43450,17,4,732,778661,17,778644
43451,16,18,781,1214656,16,1214640
43452,7,13,958,1051247,7,1051240
43453,12,-15,132,178807,12,178795
43454,10,-7,260,411309,10,411299
43455,17,5,655,808544,17,808527
43456,8,11,99,970617,8,970609
43457,17,-1,829,622923,17,622906
43458,18,-1,100,617329,18,617311
43459,12,-9,299,368775,12,368763
43460,10,1,323,664300,10,664290
43461,20,-10,854,341517,20,341497
43462,14,-11,973,311330,14,311316
43463,12,8,816,904355,12,904343
43464,15,-18,663,90123,15,90108
43465,14,-4,863,528451,14,528437
43466,17,2,735,716115,17,716098
43467,5,10,36,938312,5,938307
43468,19,-16,750,152397,19,152378
43469,17,14,223,1087162,17,1087145
43470,12,-7,455,431755,12,431743
43471,8,-2,200,567011,8,567003
43472,6,-2,605,575630,6,575624
43473,14,14,607,1090140,14,1090126
43474,17,-1,521,620731,17,620714
43475,20,-10,780,340924,20,340904
43476,16,-18,806,91144,16,91128
43477,5,-2,630,576128,5,576123
43478,14,9,961,936253,14,936239
43479,7,17,325,1162306,7,1162299
43480,13,-11,467,307491,13,307478
43481,18,-2,431,588378,18,588360
43482,20,-18,736,90636,20,90616
43483,15,0,600,652789,15,652774
43484,9,11,307,974913,9,974904
43485,18,-7,103,429043,18,429025
43486,12,6,593,840572,12,840560
43487,12,-13,813,247077,12,247065
43488,18,-10,478,338662,18,338644
43489,10,9,532,918013,10,918003
43490,18,1,633,684856,18,684838
43491,18,-11,822,310119,18,310101
43492,20,19,16,1240777,20,1240757
43493,8,-13,458,227897,8,227889
43494,12,-5,752,496529,12,496517
43495,9,18,8,1186732,9,1186723
43496,7,3,430,728049,7,728042
43497,17,15,654,1121596,17,1121579
43498,17,-20,52,23185,17,23168
43499,8,6,572,825199,8,825191
43500,15,-17,882,122049,15,122034
43501,11,15,228,1118516,11,1118505
43502,8,-16,897,143193,8,143185
43503,16,-3,507,557708,16,557692
43504,11,-4,192,523534,11,523523
43505,18,10,132,960920,18,960902
43506,10,-9,141,346601,10,346591
43507,7,14,482,1072573,7,1072566
43508,13,2,835,716736,13,716723
43509,13,12,166,1023269,13,1023256
43510,7,14,235,1067023,7,1067016
43511,11,0,493,651913,11,651902
43512,6,-9,654,358026,6,358020
43513,16,7,305,869228,16,869212
43514,10,2,617,701681,10,701671
43515,15,10,473,963451,15,963436
43516,6,2,93,690588,6,690582
43517,8,10,248,942678,8,942670
43518,5,6,852,831481,5,831476
43519,18,-6,748,464887,18,464869
43520,17,-16,148,148032,17,148015
43521,5,-18,743,78458,5,78453
43522,15,-1,690,621877,15,621862
43523,15,9,398,931902,15,931887
43524,10,11,478,978635,10,978625
43525,7,10,495,947990,7,947983
43526,11,-2,13,585208,11,585197
43527,14,-19,124,55003,14,54989
43528,14,-13,19,241187,14,241173
43529,7,16,420,1134208,7,1134201
43530,10,9,861,925053,10,925043
43531,12,2,644,715373,12,715361
43532,17,-16,572,151216,17,151199
43533,18,16,632,1151623,18,1151605
43534,18,2,104,711372,18,711354
43535,15,-6,917,466090,15,466075
43536,11,-9,464,370238,11,370227
43537,17,13,709,1058537,17,1058520
43538,8,1,599,670264,8,670256
43539,15,-7,854,434544,15,434529
43540,7,-16,323,130986,7,130979
43541,19,-6,633,464003,19,463984
43542,14,16,426,1150207,14,1150193
43543,16,18,632,1213513,16,1213497
43544,6,-3,283,536503,6,536497
43545,7,-19,648,45794,7,45787
43546,20,-16,205,148449,20,148429
43547,20,7,799,872783,20,872763
43548,13,-3,179,555047,13,555034
43549,13,5,579,808009,13,807996
43550,8,4,838,768991,8,768983
43551,18,7,70,867539,18,867521
43552,17,17,204,1179410,17,1179393
43553,19,-5,940,497935,19,497916
43554,13,-5,111,491766,13,491753
43555,7,6,858,831572,7,831565
43556,8,-9,804,361544,8,361536
43557,13,-14,113,210188,13,210175
43558,9,-1,678,608482,9,608473
43559,5,10,633,951167,5,951162
43560,13,-14,345,212096,13,212083
43561,15,1,167,681189,15,681174
43562,20,4,756,778841,20,778821
43563,7,14,182,1065794,7,1065787
43564,17,14,196,1086958,17,1086941
43565,18,17,118,1178719,18,1178701
43566,13,-20,890,29649,13,29636
43567,14,7,221,868546,14,868532
43568,16,7,136,868033,16,868017
43569,6,-9,166,347118,6,347112
43570,20,-11,601,308550,20,308530
43571,20,16,341,1149595,20,1149575
43572,10,18,552,1198594,10,1198584
43573,19,5,174,805077,19,805058
43574,10,3,961,739780,10,739770
43575,18,-14,723,215155,18,215137
43576,18,5,377,806561,18,806543
43577,13,6,160,836957,13,836944
43578,13,10,357,962508,13,962495
43579,5,-2,661,576846,5,576841
43580,13,19,802,1247281,13,1247268
43581,19,8,224,899755,19,899736
43582,15,-7,87,428904,15,428889
43583,20,-1,288,618862,20,618842
43584,13,4,820,779289,13,779276
43585,16,8,677,903349,16,903333
43586,10,-12,143,252649,10,252639
43587,16,-10,664,340117,16,340101
43588,13,10,885,966573,13,966560
43589,5,-18,892,81757,5,81752
43590,6,-12,435,258989,6,258983
43591,8,-11,949,301539,8,301531
43592,17,-20,549,26999,17,26982
43593,8,8,475,885578,8,885570
43594,16,1,264,682004,16,681988
43595,9,9,671,920836,9,920827
43596,12,-18,54,85605,12,85593
43597,9,9,786,923314,9,923305
43598,7,-18,604,75378,7,75371
43599,5,-20,883,19612,5,19607
43600,12,-1,148,617665,12,617653
43601,19,-12,941,279597,19,279578
43602,15,-19,764,59973,15,59958
43603,8,-14,275,192784,8,192776
43604,14,13,0,1053245,14,1053231
43605,12,17,478,1181502,12,1181490
43606,12,-1,788,622625,12,622613
43607,8,6,123,814834,8,814826
43608,6,-1,455,603971,6,603965
43609,18,-12,746,277984,18,277966
43610,12,15,994,1124110,12,1124098
43611,13,-8,483,401197,13,401184
43612,19,13,920,1060016,19,1059997
43613,19,1,431,683214,19,683195
43614,12,15,919,1123498,12,1123486
43615,10,13,436,1040150,10,1040140
43616,6,1,242,662510,6,662504
43617,17,0,621,652936,17,652919
43618,5,-1,475,604445,5,604440
43619,18,-11,683,309155,18,309137
43620,15,-1,1000,624155,15,624140
43621,14,6,699,841465,14,841451
43622,12,13,946,1060245,12,1060233
43623,15,-14,277,211605,15,211590
43624,18,16,16,1147204,18,1147186
43625,6,-19,491,42040,6,42034
43626,15,-20,938,29923,15,29908
43627,9,11,233,973107,9,973098
43628,15,-10,530,338987,15,338972
43629,7,-17,904,112598,7,112591
43630,14,12,357,1024705,14,1024691
43631,5,13,19,1031207,5,1031202
43632,11,14,321,1087939,11,1087928
43633,14,-10,512,338892,14,338878
43634,5,-14,15,186796,5,186791
43635,10,8,775,892298,10,892288
43636,6,-13,255,223774,6,223768
43637,18,6,827,842403,18,842385
43638,17,11,292,993008,17,992991
43639,14,17,182,1179247,14,1179233
43640,7,-11,560,293587,7,293580
43641,14,0,357,650729,14,650715
43642,20,-2,235,586906,20,586886
43643,6,-15,127,158248,6,158242
43644,12,17,745,1183425,12,1183413
43645,8,0,823,643243,8,643235
43646,20,-10,416,338111,20,338091
43647,13,2,401,713683,13,713670
43648,5,-11,922,300892,5,300887
43649,10,-5,832,485953,10,485943
43650,11,-17,67,115994,11,115983
43651,17,3,434,745096,17,745079
43652,8,9,307,913211,8,913203
43653,18,-10,433,338225,18,338207
43654,13,12,195,1023412,13,1023399
43655,13,5,419,806810,13,806797
43656,15,7,322,869380,15,869365
43657,12,8,318,900458,12,900446
43658,7,-14,927,206654,7,206647
43659,15,-12,612,276947,15,276932
43660,10,1,212,661857,10,661847
43661,17,-16,740,152307,17,152290
43662,7,18,767,1202911,7,1202904
43663,14,-20,720,28309,14,28295
43664,8,-13,688,232866,8,232858
43665,9,-16,194,128293,9,128284
43666,14,-14,985,217162,14,217148
43667,13,9,185,930426,13,930413
43668,9,-11,593,294267,9,294258
43669,16,8,947,905324,16,905308
43670,14,-10,509,338874,14,338860
43671,12,-9,287,368692,12,368680
43672,17,-10,283,337094,17,337077
43673,16,-18,552,89299,16,89283
43674,17,-18,583,89487,17,89470
43675,19,17,417,1181031,19,1181012
43676,9,11,205,972604,9,972595
43677,10,-10,342,320038,10,320028
43678,9,18,279,1192937,9,1192928
43679,16,-18,251,87275,16,87259
43680,11,-11,668,309044,11,309033
43681,15,12,821,1028161,15,1028146
43682,19,-17,664,120500,19,120481
43683,11,14,18,1085509,11,1085498
43684,18,11,72,991415,18,991397
43685,5,17,337,1162638,5,1162633
43686,18,15,173,1118099,18,1118081
43687,12,2,944,717505,12,717493
43688,14,-14,62,209771,14,209757
43689,11,10,135,960936,11,960925
43690,8,-15,433,164826,8,164818
43691,12,-14,469,213134,12,213122
43692,17,7,176,868277,17,868260
43693,10,5,516,792335,10,792325
43694,14,-12,123,273474,14,273460
43695,16,-3,745,559706,16,559690
43696,13,3,654,746799,13,746786
43697,10,-7,320,412843,10,412833
43698,8,-14,633,200669,8,200661
43699,13,-19,639,59043,13,59030
43700,15,-13,182,242398,15,242383
43701,6,-7,500,416536,6,416530
43702,8,-3,689,546002,8,545994
43703,16,-5,772,496629,16,496613
43704,6,3,238,723999,6,723993
43705,15,-18,416,88406,15,88391
43706,20,-3,110,554578,20,554558
43707,12,-15,407,180771,12,180759
43708,7,11,452,978080,7,978073
43709,17,0,94,648975,17,648958
43710,5,-2,217,567406,5,567401
43711,18,9,486,932622,18,932604
43712,13,-12,81,273134,13,273121
43713,5,2,548,700222,5,700217
43714,18,-3,966,561535,18,561517
43715,16,7,645,871746,16,871730
43716,13,0,567,652504,13,652491
43717,14,-10,722,340511,14,340497
43718,6,12,67,1000537,6,1000531
43719,5,1,738,673088,5,673083
43720,10,6,827,830913,10,830903
43721,16,2,301,712852,16,712836
43722,13,19,623,1245871,13,1245858
43723,17,11,892,997364,17,997347
43724,7,-13,167,221896,7,221889
43725,15,-11,744,309495,15,309480
43726,7,-20,233,5212,7,5205
43727,16,-1,461,620240,16,620224
43728,7,10,173,941287,7,941280
43729,5,-18,74,64106,5,64101
43730,10,16,848,1142716,10,1142706
43731,10,-5,141,471155,10,471145
43732,15,7,65,867493,15,867478
43733,15,-6,940,466266,15,466251
43734,15,14,361,1088232,15,1088217
43735,17,4,643,777932,17,777915
43736,16,16,104,1147807,16,1147791
43737,14,-10,479,338665,14,338651
43738,19,-5,163,492236,19,492217
43739,9,5,825,798863,9,798854
43740,12,-11,601,308552,12,308540
43741,8,6,54,813364,8,813356
43742,16,13,17,1053361,16,1053345
43743,13,-7,614,432832,13,432819
43744,9,3,812,736284,9,736275
43745,7,8,506,886348,7,886341
43746,16,-17,408,118452,16,118436
43747,19,-18,698,90279,19,90260
43748,10,-3,338,537868,10,537858
43749,14,-11,676,309110,14,309096
43750,10,-8,871,393939,10,393929
43751,7,-8,108,377637,7,377630
43752,7,-17,829,111067,7,111060
43753,14,-18,983,92355,14,92341
43754,12,13,284,1055281,12,1055269
43755,5,-18,317,69471,5,69466
43756,13,-10,783,340948,13,340935
43757,10,-3,657,545277,10,545267
43758,10,-1,319,600995,10,600985
43759,18,15,505,1120414,18,1120396
43760,16,-8,740,403099,16,403083
43761,14,4,855,779675,14,779661
43762,20,-12,813,278470,20,278450
43763,12,6,901,842939,12,842927
43764,8,-17,78,95078,8,95070
43765,10,-5,549,479843,10,479833
43766,16,9,455,932343,16,932327
43767,15,-17,217,117064,15,117049
43768,15,-18,578,89448,15,89433
43769,8,19,409,1226813,8,1226805
43770,11,18,593,1213175,11,1213164
43771,5,8,314,882129,5,882124
43772,8,16,763,1140944,8,1140936
43773,7,7,499,855470,7,855463
43774,18,18,787,1214708,18,1214690
43775,5,0,427,634623,5,634618
43776,10,-6,292,443181,10,443171
43777,19,-12,497,276219,19,276200
43778,13,18,726,1214136,13,1214123
43779,14,3,954,749126,14,749112
43780,16,-16,862,153283,16,153267
43781,18,-3,90,554413,18,554395
43782,18,0,438,651418,18,651400
43783,9,9,54,907923,9,907914
43784,12,15,340,1119277,12,1119265
43785,11,4,60,773671,11,773660
43786,14,14,701,1090964,14,1090950
43787,9,-5,428,477244,9,477235
43788,18,-3,124,554692,18,554674
43789,15,-1,433,619993,15,619978
43790,6,-14,825,204518,6,204512
43791,9,12,147,1002299,9,1002290
43792,14,14,364,1088274,14,1088260
43793,19,11,276,992871,19,992852
43794,5,10,482,947746,5,947741
43795,19,-4,760,527692,19,527673
43796,17,18,568,1213074,17,1213057
43797,6,19,757,1234281,6,1234275
43798,17,12,559,1026144,17,1026127
43799,16,8,66,898378,16,898362
43800,14,18,204,1210658,14,1210644
43801,16,-8,155,399013,16,398997
43802,11,-2,750,590722,11,590711
43803,5,-14,35,187266,5,187261
43804,20,-18,236,87185,20,87165
43805,8,10,388,945801,8,945793
43806,15,7,558,871117,15,871102
43807,18,-11,815,310054,18,310036
43808,12,-4,316,524553,12,524541
43809,8,5,999,802756,8,802748
43810,14,-10,746,340719,14,340705
43811,20,-17,714,120844,20,120824
43812,19,14,881,1092340,19,1092321
43813,12,6,315,838178,12,838166
43814,14,-7,635,432959,14,432945
43815,18,0,92,648924,18,648906
43816,13,7,314,869304,13,869291
43817,8,9,681,921076,8,921068
43818,19,2,416,713796,19,713777
43819,12,13,839,1059524,12,1059512
43820,18,14,629,1090336,18,1090318
43821,8,-12,127,252355,8,252347
43822,12,-10,9,335183,12,335171
43823,9,-20,528,11403,9,11394
43824,13,-2,185,586438,13,586425
43825,7,19,637,1231699,7,1231692
43826,14,-16,956,153940,14,153926
43827,9,-15,90,157357,9,157348
43828,15,1,301,682226,15,682211
43829,9,1,941,677437,9,677428
43830,17,-8,50,398275,17,398258
43831,13,-12,847,278780,13,278767
43832,10,8,447,884990,10,884980
43833,17,-10,38,335448,17,335431
43834,5,2,282,694681,5,694676
43835,20,12,327,1024514,20,1024494
43836,11,-10,381,337797,11,337786
43837,8,14,994,1084107,8,1084099
43838,5,-11,987,302454,5,302449
43839,13,-17,705,120792,13,120779
43840,8,-1,856,612194,8,612186
43841,17,7,408,870062,17,870045
43842,6,5,596,793996,6,793990
43843,6,-15,726,171002,6,170996
43844,19,19,620,1245862,19,1245843
43845,12,17,658,1182753,12,1182741
43846,15,-3,341,556307,15,556292
43847,16,7,280,868998,16,868982
43848,10,5,510,792143,10,792133
43849,7,18,909,1205986,7,1205979
43850,20,-5,209,492506,20,492486
43851,19,-8,54,398336,19,398317
43852,18,16,684,1152001,18,1151983
43853,14,13,302,1055420,14,1055406
43854,18,-4,819,528113,18,528095
43855,15,-5,902,497627,15,497612
43856,13,-10,780,340927,13,340914
43857,18,-13,520,244882,18,244864
43858,9,4,377,758774,9,758765
43859,18,3,987,749418,18,749400
43860,12,-1,835,622961,12,622949
43861,12,15,111,1117611,12,1117599
43862,8,-6,513,447922,8,447914
43863,17,-18,860,91448,17,91431
43864,5,-12,586,262202,5,262197
43865,8,7,726,860113,8,860105
43866,8,-3,732,546837,8,546829
43867,7,11,635,981989,7,981982
43868,7,17,168,1158814,7,1158807
43869,16,0,481,651781,16,651765
43870,13,10,159,961075,13,961062
43871,14,-4,232,523912,14,523898
43872,5,16,312,1131806,5,1131801
43873,5,-18,175,66355,5,66350
43874,15,0,363,650794,15,650779
43875,15,-3,117,554644,15,554629
43876,13,15,981,1123999,13,1123986
43877,8,-12,816,267242,8,267234
43878,6,7,109,847196,6,847190
43879,16,-12,519,276377,16,276361
43880,12,10,735,965525,12,965513
43881,15,-12,122,273463,15,273448
43882,5,-18,546,74168,5,74163
43883,14,-14,963,216957,14,216943
43884,11,-20,498,26551,11,26540
43885,5,2,159,692031,5,692026
43886,15,-2,863,591694,15,591679
43887,15,12,850,1028480,15,1028465
43888,6,8,526,886805,6,886799
43889,18,-1,763,622412,18,622394
43890,14,2,281,712640,14,712626
43891,20,16,191,1148495,20,1148475
43892,12,-19,298,56318,12,56306
43893,16,-3,903,561032,16,561016
43894,20,-18,35,85476,20,85456
43895,15,18,896,1215527,15,1215512
43896,5,-15,938,175390,5,175385
43897,16,-4,460,525561,16,525545
43898,6,-12,360,257476,6,257470
43899,16,1,50,680181,16,680165
43900,12,-10,448,338384,12,338372
43901,11,12,857,1028512,11,1028501
43902,5,13,357,1038464,5,1038459
43903,9,11,793,985402,9,985393
43904,16,2,858,716884,16,716868
43905,19,-16,243,148757,19,148738
43906,20,5,447,807065,20,807045
43907,17,-20,298,25121,17,25104
43908,9,2,835,706025,9,706016
43909,9,12,956,1020186,9,1020177
43910,13,-5,703,496171,13,496158
43911,15,7,36,867301,15,867286
43912,8,13,122,1033362,8,1033354
43913,8,-18,164,66068,8,66060
43914,7,-16,421,133107,7,133100
43915,9,-14,165,190030,9,190021
43916,7,-5,761,484391,7,484384
43917,18,8,300,900335,18,900317
43918,8,-13,598,231087,8,231079
43919,11,-1,32,616792,11,616781
43920,14,13,319,1055528,14,1055514
43921,10,5,836,799124,10,799114
43922,11,-11,294,306019,11,306008
43923,20,13,171,1054463,20,1054443
43924,5,-18,905,82075,5,82070
43925,12,9,117,929904,12,929892
43926,5,11,769,984959,5,984954
43927,16,15,74,1117323,16,1117307
43928,20,6,436,839269,20,839249
43929,17,7,999,874117,17,874100
43930,9,7,237,849808,9,849799
43931,18,16,694,1152035,18,1152017
43932,5,10,792,954653,5,954648
43933,7,-2,198,566985,7,566978
43934,20,-14,846,216106,20,216086
43935,5,18,966,1207194,5,1207189
43936,20,1,19,679919,20,679899
43937,13,13,562,1057470,13,1057457
43938,6,-16,578,136537,6,136531
43939,6,11,646,982203,6,982197
43940,7,5,821,798797,7,798790
43941,20,-5,51,491238,20,491218
43942,5,6,412,821715,5,821710
43943,5,-4,245,505004,5,504999
43944,12,-19,886,60774,12,60762
43945,16,-20,567,27134,16,27118
43946,5,-10,573,325012,5,325007
43947,9,-8,249,380779,9,380770
43948,6,-18,250,67955,6,67949
43949,6,-11,850,299348,6,299342
43950,5,2,465,698569,5,698564
43951,7,-12,379,257843,7,257836
43952,18,5,756,809270,18,809252
43953,7,3,39,719668,7,719661
43954,6,19,922,1237934,6,1237928
43955,20,9,541,933010,20,932990
43956,9,9,261,912096,9,912087
43957,19,-12,224,274164,19,274145
43958,8,-3,124,533119,8,533111
43959,16,13,215,1054841,16,1054825
43960,14,14,921,1092609,14,1092595
43961,14,-19,819,60275,14,60261
43962,13,-19,141,55136,13,55123
43963,13,6,454,839398,13,839385
43964,18,10,370,962621,18,962603
43965,20,18,792,1214768,20,1214748
43966,16,-11,525,307931,16,307915
43967,13,-15,4,177858,13,177845
43968,7,-4,488,509929,7,509922
43969,14,-17,38,115839,14,115825
43970,8,5,260,787112,8,787104
43971,16,-17,978,122654,16,122638
43972,12,-3,367,556505,12,556493
43973,13,-14,449,213001,13,212988
43974,11,-10,774,340897,11,340886
43975,14,-19,563,58440,14,58426
43976,19,8,612,902775,19,902756
43977,11,-11,84,304308,11,304297
43978,10,-6,731,452544,10,452534
43979,20,-3,206,555239,20,555219
43980,18,-16,289,149075,18,149057
43981,8,-9,768,360745,8,360737
43982,11,-19,841,60487,11,60476
43983,18,-17,741,121130,18,121112
43984,14,5,361,806423,14,806409
43985,7,13,618,1044114,7,1044107
43986,9,8,750,891677,9,891668
43987,6,10,790,954561,6,954555
43988,19,-6,17,459258,19,459239
43989,12,-16,507,150746,12,150734
43990,16,-2,398,588070,16,588054
43991,7,3,681,733536,7,733529
43992,20,1,253,681916,20,681896
43993,6,-18,964,83421,6,83415
43994,19,-20,127,23721,19,23702
43995,13,-8,115,398685,13,398672
43996,17,-3,110,554585,17,554568
43997,13,-8,862,403987,13,403974
43998,10,-5,873,487059,10,487049
43999,15,-1,797,622691,15,622676
44000,7,11,298,974742,7,974735
44001,20,-10,831,341329,20,341309
44002,16,13,262,1055120,16,1055104
44003,20,2,916,717292,20,717272
44004,5,-20,110,2399,5,2394
44005,16,-11,208,305350,16,305334
44006,12,-7,86,428890,12,428878
44007,17,-1,373,619588,17,619571
44008,11,-16,292,149105,11,149094
44009,16,-20,136,23788,16,23772
44010,10,15,831,1112096,10,1112086
44011,19,5,324,806163,19,806144
44012,10,-1,834,611785,10,611775
44013,16,-10,674,340173,16,340157
44014,13,6,741,841744,13,841731
44015,18,1,879,686616,18,686598
44016,19,-19,656,59139,19,59120
44017,15,-4,366,524952,15,524937
44018,9,-10,196,316886,9,316877
44019,9,13,395,1039240,9,1039231
44020,9,-2,418,571641,9,571632
44021,18,-19,42,54178,18,54160
44022,14,1,899,686808,14,686794
44023,20,10,745,965616,20,965596
44024,18,-19,983,61349,18,61331
44025,15,-13,543,245028,15,245013
44026,13,-10,574,339346,13,339333
44027,12,-1,719,622142,12,622130
44028,17,-7,827,434294,17,434277
44029,12,5,385,806621,12,806609
44030,7,-2,73,564409,7,564402
44031,9,-2,788,579560,9,579551
44032,12,-10,877,341685,12,341673
44033,6,-18,872,81238,6,81232
44034,12,6,32,836074,12,836062
44035,19,-7,272,430353,19,430334
44036,7,19,753,1234186,7,1234179
44037,9,11,100,970635,9,970626
44038,5,-7,122,408389,5,408384
44039,5,-18,909,82196,5,82191
44040,7,14,443,1071699,7,1071692
44041,16,8,331,900600,16,900584
44042,15,-17,213,117037,15,117022
44043,17,-16,783,152672,17,152655
44044,7,-15,522,166675,7,166668
44045,17,0,229,649945,17,649928
44046,17,9,192,930462,17,930445
44047,20,8,178,899337,20,899317
44048,14,13,951,1060299,14,1060285
44049,19,2,223,712256,19,712237
44050,9,7,266,850446,9,850437
44051,6,14,208,1066286,6,1066280
44052,6,-16,240,129311,6,129305
44053,6,8,235,880416,6,880410
44054,12,-12,218,274103,12,274091
44055,18,-15,474,181276,18,181258
44056,8,-13,409,226810,8,226802
44057,5,-3,153,533686,5,533681
44058,18,-9,912,373817,18,373799
44059,9,19,772,1234614,9,1234605
44060,14,12,705,1027379,14,1027365
44061,9,-2,750,578681,9,578672
44062,9,17,448,1164898,9,1164889
44063,19,-6,719,464655,19,464636
44064,14,-20,285,25019,14,25005
44065,7,-6,551,448766,7,448759
44066,17,12,813,1028090,17,1028073
44067,5,-2,259,568331,5,568326
44068,7,9,653,920515,7,920508
44069,7,-7,179,409658,7,409651
44070,12,-3,153,554839,12,554827
44071,13,17,191,1179331,13,1179318
44072,20,1,775,685916,20,685896
44073,20,9,346,931546,20,931526
44074,5,-6,994,458018,5,458013
44075,16,4,436,776403,16,776387
44076,19,17,263,1179869,19,1179850
44077,8,-10,177,316508,8,316500
44078,6,17,14,1155539,6,1155533
44079,10,-5,501,478865,10,478855
44080,14,-16,157,148089,14,148075
44081,19,19,943,1248375,19,1248356
44082,8,-5,247,473449,8,473441
44083,20,16,628,1151555,20,1151535
44084,20,10,89,960545,20,960525
44085,17,1,401,683046,17,683029
44086,15,9,76,929621,15,929606
44087,11,10,757,965648,11,965637
44088,16,-4,277,524242,16,524226
44089,13,-17,904,122192,13,122179
44090,18,-12,342,275087,18,275069
44091,13,14,654,1090569,13,1090556
44092,15,-17,812,121614,15,121599
44093,5,13,41,1031649,5,1031644
44094,17,0,572,652591,17,652574
44095,15,-7,40,428635,15,428620
44096,20,12,964,1029563,20,1029543
44097,8,0,60,626581,8,626573
44098,13,-5,376,493814,13,493801
44099,12,-15,120,178686,12,178674
44100,17,13,66,1053730,17,1053713
44101,7,-14,211,191208,7,191201
44102,16,0,7,648238,16,648222
44103,9,-13,263,223965,9,223956
44104,15,16,206,1148611,15,1148596
44105,17,-8,934,404474,17,404457
44106,11,-1,465,620298,11,620287
44107,12,-9,7,366687,12,366675
44108,17,-14,274,211572,17,211555
44109,11,6,300,838058,11,838047
44110,20,10,611,964633,20,964613
44111,12,-16,580,151277,12,151265
44112,11,-1,132,617561,11,617550
44113,6,-17,593,106326,6,106320
44114,15,-14,850,216150,15,216135
44115,12,-19,348,56707,12,56695
44116,16,14,520,1089512,16,1089496
44117,14,7,405,870037,14,870023
44118,6,18,886,1205507,6,1205501
44119,6,-20,898,19911,6,19905
44120,7,9,303,913079,7,913072
44121,10,-12,730,265235,10,265225
44122,18,18,653,1213683,18,1213665
44123,13,-19,125,55010,13,54997
44124,9,-13,623,231717,9,231708
44125,16,12,395,1024945,16,1024929
44126,9,-12,555,261561,9,261552
44127,18,-3,672,559154,18,559136
44128,11,-19,333,56576,11,56565
44129,15,-15,635,182475,15,182460
44130,17,-13,178,242354,17,242337
44131,19,-9,411,369763,19,369744
44132,10,-11,90,283005,10,282995
44133,5,4,801,768054,5,768049
44134,7,12,878,1018346,7,1018339
44135,10,16,494,1135656,10,1135646
44136,10,12,12,999291,10,999281
44137,6,11,906,988021,6,988015
44138,6,15,592,1106971,6,1106965
44139,16,-11,619,308663,16,308647
44140,11,1,180,681302,11,681291
44141,7,-9,867,362997,7,362990
44142,8,2,538,700029,8,700021
44143,12,4,399,776070,12,776058
44144,5,10,513,948444,5,948439
44145,12,-16,227,148667,12,148655
44146,17,4,316,775453,17,775436
44147,17,-1,33,616819,17,616802
44148,16,16,153,1148171,16,1148155
44149,14,-18,986,92367,14,92353
44150,20,-18,75,85810,20,85790
44151,5,2,719,703810,5,703805
44152,11,9,955,936200,11,936189
44153,18,0,567,652512,18,652494
44154,20,9,906,935813,20,935793
44155,12,4,62,773710,12,773698
44156,20,-6,21,459318,20,459298
44157,7,10,356,945072,7,945065
44158,17,-9,810,372971,17,372954
44159,9,1,731,672932,9,672923
44160,11,4,886,779841,11,779830
44161,16,-4,342,524742,16,524726
44162,20,-2,313,587484,20,587464
44163,15,-6,321,461663,15,461648
44164,17,-6,455,462626,17,462609
44165,10,-6,163,440324,10,440314
44166,10,18,784,1203311,10,1203301
44167,7,12,416,1007976,7,1007969
44168,8,-20,721,15865,8,15857
44169,7,7,682,859262,7,859255
44170,13,0,369,650848,13,650835
44171,16,3,838,748123,16,748107
44172,5,-13,118,220928,5,220923
44173,13,-19,955,61191,13,61178
44174,8,7,918,864241,8,864233
44175,8,-19,419,40499,8,40491
44176,6,-6,766,453268,6,453262
44177,15,15,241,1118567,15,1118552
44178,16,-8,36,398180,16,398164
44179,16,-9,880,373567,16,373551
44180,5,3,762,735346,5,735341
44181,19,-10,991,342615,19,342596
44182,11,-2,114,585992,11,585981
44183,6,8,639,889235,6,889229
44184,13,-12,65,273006,13,272993
44185,15,-18,824,91254,15,91239
44186,16,-15,857,184271,16,184255
44187,9,1,229,662207,9,662198
44188,19,16,625,1151523,19,1151504
44189,7,14,27,1062381,7,1062374
44190,16,11,435,994065,16,994049
44191,14,-12,907,279369,14,279355
44192,9,9,716,921823,9,921814
44193,14,4,447,776455,14,776441
44194,16,-8,245,399643,16,399627
44195,12,-14,554,213750,12,213738
44196,6,16,537,1136595,6,1136589
44197,6,-17,201,97652,6,97646
44198,11,-19,558,58378,11,58367
44199,6,13,960,1051271,6,1051265
44200,19,-16,995,154275,19,154256
44201,6,3,753,735119,6,735113
44202,5,-6,392,445185,5,445180
44203,12,1,324,682472,12,682460
44204,7,5,56,782860,7,782853
44205,20,14,63,1085940,20,1085920
44206,13,-11,21,303824,13,303811
44207,11,3,956,749136,11,749125
44208,10,-13,708,233433,10,233423
44209,5,16,853,1142804,5,1142799
44210,15,-20,180,24182,15,24167
44211,12,-18,802,91100,12,91088
44212,8,5,515,792306,8,792298
44213,20,-10,862,341561,20,341541
44214,5,9,838,924607,5,924602
44215,15,16,46,1147416,15,1147401
44216,12,-17,458,118914,12,118902
44217,10,-4,64,500728,10,500718
44218,19,2,584,714957,19,714938
44219,20,-1,670,621708,20,621688
44220,17,7,762,872513,17,872496
44221,14,0,972,655730,14,655716
44222,13,4,600,777655,13,777642
44223,19,-16,233,148711,19,148692
44224,16,6,590,840536,16,840520
44225,18,2,691,715819,18,715801
44226,17,-5,919,497785,17,497768
44227,20,-11,102,304496,20,304476
44228,16,-18,478,88841,16,88825
44229,13,-3,683,559233,13,559220
44230,8,-16,170,127618,8,127610
44231,14,4,757,778846,14,778832
44232,17,4,408,776154,17,776137
44233,17,1,361,682744,17,682727
44234,17,4,351,775755,17,775738
44235,10,3,446,728410,10,728400
44236,8,5,331,788445,8,788437
44237,15,14,823,1091903,15,1091888
44238,8,-20,127,2820,8,2812
44239,12,-18,86,85863,12,85851
44240,13,-15,673,182772,13,182759
44241,20,-14,517,213537,20,213517
44242,16,-15,901,184592,16,184576
44243,14,-8,450,400993,14,400979
44244,11,7,921,873582,11,873571
44245,6,-16,823,141699,6,141693
44246,9,9,5,906801,9,906792
44247,7,17,433,1164513,7,1164506
44248,5,16,256,1130659,5,1130654
44249,18,-16,75,147405,18,147387
44250,5,-6,778,453562,5,453557
44251,10,14,518,1073387,10,1073377
44252,12,7,839,873087,12,873075
44253,7,-20,836,18551,7,18544
44254,14,9,967,936329,14,936315
44255,7,9,14,907042,7,907035
44256,16,-14,489,213265,16,213249
44257,14,-4,519,526031,14,526017
44258,10,-14,43,187472,10,187462
44259,5,11,634,981976,5,981971
44260,16,3,382,744739,16,744723
44261,19,-7,340,430929,19,430910
44262,19,12,133,1023005,19,1022986
44263,6,-14,522,197913,6,197907
44264,20,0,323,650424,20,650404
44265,17,17,901,1184721,17,1184704
44266,8,14,548,1074075,8,1074067
44267,14,14,449,1088957,14,1088943
44268,13,8,861,904656,13,904643
44269,6,-15,144,158543,6,158537
44270,20,-6,145,460234,20,460214
44271,10,-4,200,503799,10,503789
44272,7,14,576,1074642,7,1074635
44273,18,9,543,933023,18,933005
44274,19,15,621,1121341,19,1121322
44275,6,7,776,861184,6,861178
44276,16,4,327,775575,16,775559
44277,6,12,356,1006925,6,1006919
44278,14,15,961,1123848,14,1123834
44279,9,-15,109,157800,9,157791
44280,7,14,85,1063671,7,1063664
44281,15,-1,403,619764,15,619749
44282,16,16,979,1154124,16,1154108
44283,6,18,527,1198116,6,1198110
44284,14,-10,285,337108,14,337094
44285,11,15,267,1118768,11,1118757
44286,7,-3,355,538157,7,538150
44287,11,-11,306,306193,11,306182
44288,20,12,478,1025571,20,1025551
44289,8,16,414,1134150,8,1134142
44290,5,17,900,1174714,5,1174709
44291,10,-13,982,239594,10,239584
44292,10,14,950,1083115,10,1083105
44293,8,13,824,1048470,8,1048462
44294,20,13,637,1058066,20,1058046
44295,11,7,363,869641,11,869630
44296,11,7,189,868370,11,868359
44297,18,-12,321,274913,18,274895
44298,6,16,549,1136756,6,1136750
44299,10,19,973,1239063,10,1239053
44300,18,16,264,1149024,18,1149006
44301,7,17,15,1155571,7,1155564
44302,13,-1,249,618486,13,618473
44303,11,-9,216,368085,11,368074
44304,7,-12,382,257897,7,257890
44305,16,2,918,717305,16,717289
44306,7,-19,809,49115,7,49108
44307,9,5,846,799291,9,799282
44308,17,6,16,835925,17,835908
44309,13,-16,193,148357,13,148344
44310,16,13,482,1056793,16,1056777
44311,11,-15,563,181918,11,181907
44312,20,16,994,1154241,20,1154221
44313,13,-7,126,429207,13,429194
44314,9,17,844,1173546,9,1173537
44315,15,1,100,680621,15,680606
44316,9,10,665,951920,9,951911
44317,9,13,909,1050177,9,1050168
44318,16,12,764,1027728,16,1027712
44319,14,-1,255,618528,14,618514
44320,10,-19,676,46334,10,46324
44321,5,-6,167,440423,5,440418
44322,17,0,963,655647,17,655630
44323,14,2,658,715533,14,715519
44324,11,-10,501,338798,11,338787
44325,10,7,876,863437,10,863427
44326,18,-9,340,369190,18,369172
44327,14,-18,609,89640,14,89626
44328,17,-16,736,152298,17,152281
44329,15,-3,971,561550,15,561535
44330,17,-7,641,432993,17,432976
44331,7,7,612,857766,7,857759
44332,14,1,718,685414,14,685400
44333,20,4,539,777164,20,777144
44334,7,-9,132,346357,7,346350
44335,16,7,701,872147,16,872131
44336,19,-13,337,243528,19,243509
44337,7,-12,445,259165,7,259158
44338,10,-5,161,471614,10,471604
44339,14,4,840,779514,14,779500
44340,15,6,517,839977,15,839962
44341,14,-13,162,242206,14,242192
44342,7,7,912,864112,7,864105
44343,6,-5,478,478363,6,478357
44344,13,-14,758,215408,13,215395
44345,16,-15,298,179953,16,179937
44346,20,0,499,651970,20,651950
44347,8,-8,564,387274,8,387266
44348,14,9,224,930719,14,930705
44349,20,-16,60,147249,20,147229
44350,10,1,73,658582,10,658572
44351,5,6,866,831798,5,831793
44352,6,-13,42,219270,6,219264
44353,6,-6,283,442997,6,442991
44354,10,1,357,664998,10,664988
44355,6,-1,394,602592,6,602586
44356,15,-6,940,466271,15,466256
44357,6,-15,239,160473,6,160467
44358,15,-10,799,341142,15,341127
44359,12,8,643,903077,12,903065
44360,20,19,492,1244813,20,1244793
44361,20,-15,816,183905,20,183885
44362,20,-20,173,24088,20,24068
44363,11,-16,443,150293,11,150282
44364,11,-10,721,340473,11,340462
44365,9,6,739,829003,9,828994
44366,8,1,463,667313,8,667305
44367,19,-7,525,432317,19,432298
44368,14,-10,302,337242,14,337228
44369,14,9,759,934568,14,934554
44370,17,-11,261,305774,17,305757
44371,8,4,608,763806,8,763798
44372,20,10,263,961808,20,961788
44373,7,-5,502,478881,7,478874
44374,6,2,418,697660,6,697654
44375,16,15,16,1116896,16,1116880
44376,14,1,829,686264,14,686250
44377,11,11,962,997732,11,997721
44378,6,-19,959,52091,6,52085
44379,14,9,354,931631,14,931617
44380,10,1,44,658017,10,658007
44381,19,5,568,807919,19,807900
44382,19,15,311,1119073,19,1119054
44383,8,-10,158,316061,8,316053
44384,13,11,639,995393,13,995380
44385,12,-18,838,91282,12,91270
44386,11,0,367,650808,11,650797
44387,13,16,800,1152861,13,1152848
44388,14,-1,589,621172,14,621158
44389,5,7,494,855418,5,855413
44390,19,11,331,993283,19,993264
44391,13,3,237,743661,13,743648
44392,16,-9,508,370677,16,370661
44393,19,-10,21,335287,19,335268
44394,19,14,93,1086185,19,1086166
44395,7,11,847,986609,7,986602
44396,11,-10,27,335347,11,335336
44397,17,-19,528,58099,17,58082
44398,17,4,341,775697,17,775680
44399,20,6,334,838372,20,838352
44400,13,-9,343,369205,13,369192
44401,18,-15,888,184493,18,184475
44402,8,11,721,983868,8,983860
44403,6,-14,169,190153,6,190147
44404,10,4,817,768433,10,768423
44405,13,12,589,1026382,13,1026369
44406,18,13,896,1059914,18,1059896
44407,6,11,493,978982,6,978976
44408,10,-5,77,469637,10,469627
44409,13,-9,998,374237,13,374224
44410,13,13,671,1058305,13,1058292
44411,11,-17,800,121547,11,121536
44412,17,2,613,715149,17,715132
44413,10,-12,322,256639,10,256629
44414,8,14,140,1064969,8,1064961
44415,8,12,946,1019960,8,1019952
44416,14,-18,186,86726,14,86712
44417,6,18,185,1190994,6,1190988
44418,16,-17,114,116416,16,116400
44419,10,9,796,923653,10,923643
44420,13,3,171,743113,13,743100
44421,12,13,860,1059668,12,1059656
44422,9,-6,638,450528,9,450519
44423,8,7,355,852484,8,852476
44424,6,-18,75,64169,6,64163
44425,19,17,724,1183317,19,1183298
44426,19,-20,657,27819,19,27800
44427,20,-6,401,462177,20,462157
44428,9,12,516,1010108,9,1010099
44429,15,0,843,654666,15,654651
44430,9,3,442,728340,9,728331
44431,17,18,366,1211779,17,1211762
44432,16,-1,117,617442,16,617426
44433,19,-3,852,560596,19,560577
44434,15,-15,640,182552,15,182537
44435,6,-6,488,447263,6,447257
44436,18,5,626,808391,18,808373
44437,14,-12,157,273687,14,273673
44438,11,-1,828,622909,11,622898
44439,9,-4,227,504529,9,504520
44440,20,-17,190,116851,20,116831
44441,5,9,202,911016,5,911011
44442,12,0,332,650535,12,650523
44443,10,9,391,914910,10,914900
44444,14,-13,516,244859,14,244845
44445,8,-18,587,75065,8,75057
44446,13,17,787,1183744,13,1183731
44447,16,-14,463,213083,16,213067
44448,5,-4,545,511278,5,511273
44449,15,-16,289,149080,15,149065
44450,12,-12,636,277152,12,277140
44451,8,11,793,985410,8,985402
44452,15,12,694,1027299,15,1027284
44453,8,14,254,1067476,8,1067468
44454,16,8,636,903021,16,903005
44455,18,-8,76,398570,18,398552
44456,14,15,39,1117096,14,1117082
44457,11,5,455,807103,11,807092
44458,7,-16,343,131276,7,131269
44459,8,-5,101,470309,8,470301
44460,18,-20,578,27191,18,27173
44461,5,3,318,725891,5,725886
44462,18,-9,936,374013,18,373995
44463,12,7,277,868978,12,868966
44464,19,19,388,1243941,19,1243922
44465,18,2,200,712123,18,712105
44466,18,14,306,1087827,18,1087809
44467,19,15,696,1121909,19,1121890
44468,11,12,637,1026758,11,1026747
44469,11,-16,873,153399,11,153388
44470,18,-7,810,434196,18,434178
44471,9,4,964,771597,9,771588
44472,18,-9,155,367695,18,367677
44473,13,-14,526,213575,13,213562
44474,12,16,440,1150282,12,1150270
44475,18,3,576,746160,18,746142
44476,17,0,219,649901,17,649884
44477,19,15,920,1123506,19,1123487
44478,19,8,684,903413,19,903394
44479,5,0,882,644496,5,644491
44480,17,11,140,991846,17,991829
44481,11,15,818,1122770,11,1122759
44482,20,0,342,650642,20,650622
44483,11,14,227,1087189,11,1087178
44484,7,3,611,731837,7,731830
44485,17,8,404,901215,17,901198
44486,18,-9,449,370143,18,370125
44487,19,0,487,651870,19,651851
44488,16,-1,932,623698,16,623682
44489,10,-13,438,227564,10,227554
44490,12,-8,814,403732,12,403720
44491,9,0,595,638245,9,638236
44492,6,-16,210,128600,6,128594
44493,15,18,581,1213154,15,1213139
44494,11,13,230,1054916,11,1054905
44495,15,13,350,1055807,15,1055792
44496,16,-1,789,622640,16,622624
44497,15,-14,68,209816,15,209801
44498,18,-14,204,210893,18,210875
44499,17,-18,662,90115,17,90098
44500,8,10,344,944812,8,944804
44501,20,-18,29,85419,20,85399
44502,6,7,554,856568,6,856562
44503,8,18,449,1196378,8,1196370
44504,13,19,693,1246391,13,1246378
44505,13,-12,548,276584,13,276571
44506,12,-3,658,559043,12,559031
44507,6,-4,423,508827,6,508821
44508,7,-20,565,12334,7,12327
44509,14,14,665,1090645,14,1090631
44510,9,-4,623,512851,9,512842
44511,13,-12,264,274470,13,274457
44512,20,19,506,1244948,20,1244928
44513,18,13,80,1053816,18,1053798
44514,17,1,66,680280,17,680263
44515,8,4,882,769999,8,769991
44516,15,-14,476,213192,15,213177
44517,18,-15,938,184915,18,184897
44518,20,-2,189,586490,20,586470
44519,10,-10,576,325098,10,325088
44520,19,-15,178,179065,19,179046
44521,5,-4,207,504059,5,504054
44522,7,15,843,1112380,7,1112373
44523,13,-3,894,560950,13,560937
44524,17,19,360,1243697,17,1243680
44525,20,9,304,931189,20,931169
44526,18,-2,408,588162,18,588144
44527,15,-13,505,244763,15,244748
44528,8,6,508,823877,8,823869
44529,15,-18,47,85565,15,85550
44530,8,-1,134,596737,8,596729
44531,10,-20,647,14172,10,14162
44532,18,-6,902,465970,18,465952
44533,17,-16,10,146798,17,146781
44534,15,5,49,804164,15,804149
44535,6,19,80,1219264,6,1219258
44536,12,5,695,808861,12,808849
44537,16,-16,731,152275,16,152259
44538,14,-20,767,28705,14,28691
44539,5,-18,632,75933,5,75928
44540,18,12,293,1024288,18,1024270
44541,9,-17,11,93767,9,93758
44542,5,8,211,879785,5,879780
44543,12,-19,70,54420,12,54408
44544,19,0,494,651929,19,651910
44545,18,-13,493,244641,18,244623
44546,19,5,657,808568,19,808549
44547,7,-5,182,472097,7,472090
44548,6,6,267,818230,6,818224
44549,14,-14,851,216155,14,216141
44550,14,6,696,841403,14,841389
44551,20,-7,507,432136,20,432116
44552,5,-6,985,457758,5,457753
44553,7,4,934,771050,7,771043
44554,11,4,594,777590,11,777579
44555,10,7,366,852694,10,852684
44556,18,-9,841,373199,18,373181
44557,13,-3,874,560776,13,560763
44558,14,-12,180,273812,14,273798
44559,20,5,375,806541,20,806521
44560,20,-15,14,177936,20,177916
44561,15,-14,156,210512,15,210497
44562,14,16,273,1149101,14,1149087
44563,10,6,730,828879,10,828869
44564,17,15,212,1118403,17,1118386
44565,5,8,91,876967,5,876962
44566,15,-9,413,369776,15,369761
44567,11,-3,306,556018,11,556007
44568,5,2,264,694295,5,694290
44569,9,-7,901,425217,9,425208
44570,17,-2,214,586714,17,586697
44571,6,16,252,1130551,6,1130545
44572,8,-2,29,563398,8,563390
44573,5,-12,301,256182,5,256177
44574,12,6,974,843554,12,843542
44575,11,-6,835,465455,11,465444
44576,10,0,54,626421,10,626411
44577,14,-7,202,429800,14,429786
44578,6,7,946,864750,6,864744
44579,10,17,641,1169043,10,1169033
44580,7,-12,195,253650,7,253643
44581,12,-4,441,525477,12,525465
44582,9,-18,384,70665,9,70656
44583,7,-19,264,37347,7,37340
44584,5,15,253,1099968,5,1099963
44585,8,13,420,1039826,8,1039818
44586,20,18,749,1214391,20,1214371
44587,16,-14,929,216714,16,216698
44588,13,-8,852,403901,13,403888
44589,19,7,86,867651,19,867632
44590,7,-18,581,74945,7,74938
44591,14,18,254,1211041,14,1211027
44592,20,4,789,779042,20,779022
44593,14,16,57,1147501,14,1147487
44594,10,13,643,1044586,10,1044576
44595,16,8,35,898120,16,898104
44596,10,16,991,1145894,10,1145884
44597,19,-15,646,182593,19,182574
44598,15,18,374,1211816,15,1211801
44599,13,5,58,804257,13,804244
44600,18,-20,337,25448,18,25430
44601,20,-2,926,592185,20,592165
44602,14,9,453,932314,14,932300
44603,8,-6,836,454674,8,454666
44604,12,-11,740,309460,12,309448
44605,6,1,503,668286,6,668280
44606,5,2,949,708414,5,708409
44607,11,-10,180,336410,11,336399
44608,8,8,707,890812,8,890804
44609,15,-17,856,121855,15,121840
44610,5,5,505,792065,5,792060
44611,17,-1,173,617862,17,617845
44612,14,7,599,871443,14,871429
44613,9,7,972,865275,9,865266
44614,6,-19,581,44287,6,44281
44615,17,-1,424,619934,17,619917
44616,15,-4,573,526407,15,526392
44617,12,17,183,1179248,12,1179236
44618,14,-13,680,245953,14,245939
44619,17,14,400,1088564,17,1088547
44620,18,-11,908,310845,18,310827
44621,6,-8,363,382970,6,382964
44622,7,-15,955,175843,7,175836
44623,20,-13,616,245626,20,245606
44624,20,-15,927,184826,20,184806
44625,20,16,248,1148882,20,1148862
44626,6,17,376,1163371,6,1163365
44627,9,7,569,856926,9,856917
44628,6,6,541,824548,6,824542
44629,5,-9,973,365217,5,365212
44630,17,18,572,1213089,17,1213072
44631,8,-11,454,291268,8,291260
44632,11,-7,165,429520,11,429509
44633,14,12,833,1028286,14,1028272
44634,5,-13,936,238675,5,238670
44635,17,-12,59,272946,17,272929
44636,16,19,98,1241549,16,1241533
44637,19,-11,899,310746,19,310727
44638,12,-15,58,178214,12,178202
44639,8,-14,382,195146,8,195138
44640,19,10,660,965007,19,964988
44641,10,-4,72,500912,10,500902
44642,9,4,66,752037,9,752028
44643,9,-4,224,504431,9,504422
44644,6,-6,826,454536,6,454530
44645,10,17,444,1164797,10,1164787
44646,18,15,905,1123377,18,1123359
44647,9,1,412,666184,9,666175
44648,16,-1,103,617353,16,617337
44649,16,12,501,1025728,16,1025712
44650,16,4,433,776380,16,776364
44651,12,12,288,1024250,12,1024238
44652,11,19,991,1248723,11,1248712
44653,15,5,532,807680,15,807665
44654,20,-8,773,403369,20,403349
44655,10,-17,259,99017,10,99007
44656,19,-19,154,55302,19,55283
44657,9,14,141,1065011,9,1065002
44658,14,-1,101,617341,14,617327
44659,12,-1,168,617811,12,617799
44660,19,-8,401,400763,19,400744
44661,6,4,403,759363,6,759357
44662,13,-12,535,276518,13,276505
44663,18,6,267,837804,18,837786
44664,19,12,808,1028041,19,1028022
44665,8,7,471,854920,8,854912
44666,7,1,877,676041,7,676034
44667,12,16,37,1147337,12,1147325
44668,18,-17,207,116986,18,116968
44669,14,-5,510,494780,14,494766
44670,14,14,6,1085389,14,1085375
44671,14,-10,494,338731,14,338717
44672,16,11,772,996439,16,996423
44673,5,18,595,1199244,5,1199239
44674,9,-8,652,389352,9,389343
44675,15,-4,206,523718,15,523703
44676,13,10,220,961501,13,961488
44677,20,-19,542,58200,20,58180
44678,11,-6,94,459791,11,459780
44679,16,19,35,1240990,16,1240974
44680,10,-18,900,81984,10,81974
44681,8,-4,343,507016,8,507008
44682,8,-13,828,236275,8,236267
44683,7,-13,399,226692,7,226685
44684,9,-19,676,46343,9,46334
44685,16,4,295,775309,16,775293
44686,6,12,965,1020415,6,1020409
44687,9,-9,159,346984,9,346975
44688,14,-2,795,591106,14,591092
44689,8,-1,907,613532,8,613524
44690,10,-5,975,489253,10,489243
44691,17,-11,237,305538,17,305521
44692,9,7,896,863833,9,863824
44693,12,17,827,1184158,12,1184146
44694,20,15,368,1119459,20,1119439
44695,16,-5,784,496684,16,496668
44696,9,17,575,1167494,9,1167485
44697,20,-12,304,274794,20,274774
44698,19,8,622,902870,19,902851
44699,7,14,926,1082469,7,1082462
44700,9,11,135,971280,9,971271
44701,16,6,672,841158,16,841142
44702,7,-4,586,512059,7,512052
44703,5,-3,488,541512,5,541507
44704,17,6,149,836901,17,836884
44705,6,-9,984,365318,6,365312
44706,6,15,616,1107522,6,1107516
44707,20,12,828,1028217,20,1028197
44708,18,11,845,996990,18,996972
44709,9,-11,479,291816,9,291807
44710,20,-4,414,525322,20,525302
44711,7,8,235,880423,7,880416
44712,19,6,988,843653,19,843634
44713,16,17,394,1180881,16,1180865
44714,19,1,509,683868,19,683849
44715,9,-1,222,598624,9,598615
44716,7,-17,760,109784,7,109777
44717,17,3,996,749508,17,749491
44718,7,-2,629,576124,7,576117
44719,5,-20,869,19304,5,19299
44720,12,-11,424,307155,12,307143
44721,7,1,305,663812,7,663805
44722,18,15,567,1120892,18,1120874
44723,5,-14,499,197442,5,197437
44724,20,-12,743,277951,20,277931
44725,9,-11,134,284049,9,284040
44726,9,-18,805,79816,9,79807
44727,17,12,993,1029757,17,1029740
44728,15,13,960,1060373,15,1060358
44729,8,19,271,1223497,8,1223489
44730,17,-9,680,371805,17,371788
44731,17,16,494,1150618,17,1150601
44732,6,0,775,642334,6,642328
44733,13,-19,545,58229,13,58216
44734,14,-6,310,461566,14,461552
44735,9,4,763,767221,9,767212
44736,8,-4,496,510158,8,510150
44737,11,-5,579,495327,11,495316
44738,19,9,714,934342,19,934323
44739,13,6,519,840014,13,840001
44740,6,3,53,719980,6,719974
44741,20,13,339,1055720,20,1055700
44742,13,-3,958,561465,13,561452
44743,16,16,446,1150337,16,1150321
44744,13,-16,584,151313,13,151300
44745,14,10,60,960287,14,960273
44746,14,-16,496,150655,14,150641
44747,16,14,412,1088677,16,1088661
44748,10,17,362,1163082,10,1163072
44749,10,-8,213,380052,10,380042
44750,19,-14,71,209867,19,209848
44751,9,-5,588,480781,9,480772
44752,17,5,949,810775,17,810758
44753,14,8,980,905585,14,905571
44754,20,-9,569,371208,20,371188
44755,14,-15,97,178518,14,178504
44756,6,16,296,1131437,6,1131431
44757,20,9,533,932962,20,932942
44758,9,-11,498,292334,9,292325
44759,14,-4,874,528622,14,528608
44760,7,11,858,986865,7,986858
44761,20,1,383,682923,20,682903
44762,14,1,156,681107,14,681093
44763,7,-12,351,257282,7,257275
44764,10,0,731,641429,10,641419
44765,11,-9,685,371828,11,371817
44766,14,4,95,773980,14,773966
44767,8,14,509,1073195,8,1073187
44768,17,-11,580,308368,17,308351
44769,7,-8,436,384355,7,384348
44770,12,2,884,717082,12,717070
44771,18,9,93,929751,18,929733
44772,14,3,760,747593,14,747579
44773,8,3,803,736135,8,736127
44774,20,-20,429,26004,20,25984
44775,20,11,490,994433,20,994413
44776,6,7,105,847079,6,847073
44777,19,-20,442,26168,19,26149
44778,5,15,93,1096415,5,1096410
44779,5,8,716,891057,5,891052
44780,14,13,920,1060020,14,1060006
44781,15,14,167,1086741,15,1086726
44782,6,-5,594,480910,6,480904
44783,13,4,79,773828,13,773815
44784,16,6,937,843200,16,843184
44785,8,-1,749,609902,8,609894
44786,11,15,645,1121490,11,1121479
44787,12,10,766,965741,12,965729
44788,12,-17,681,120613,12,120601
44789,18,18,779,1214621,18,1214603
44790,18,18,230,1210821,18,1210803
44791,18,8,797,904267,18,904249
44792,18,-20,772,28762,18,28744
44793,8,4,130,753380,8,753372
44794,5,-1,35,594547,5,594542
44795,13,-11,739,309449,13,309436
44796,10,-13,533,229625,10,229615
44797,11,-19,695,59415,11,59404
44798,11,6,737,841742,11,841731
44799,11,-6,868,465663,11,465652
44800,12,5,171,805018,12,805006
44801,16,-10,645,339900,16,339884
44802,12,4,369,775902,12,775890
44803,13,15,313,1119084,13,1119071
44804,14,7,363,869645,14,869631
44805,7,-11,668,295862,7,295855
44806,19,-6,3,459168,19,459149
44807,13,-19,634,58996,13,58983
44808,16,1,967,687390,16,687374
44809,17,4,600,777662,17,777645
44810,7,-10,954,332936,7,332929
44811,12,18,59,1209391,12,1209379
44812,11,-5,340,493661,11,493650
44813,5,10,642,951385,5,951380
44814,13,9,861,935450,13,935437
44815,6,0,840,643586,6,643580
44816,20,-2,62,585625,20,585605
44817,13,-12,913,279443,13,279430
44818,20,15,244,1118608,20,1118588
44819,11,18,313,1211347,11,1211336
44820,16,-14,904,216543,16,216527
44821,15,-7,179,429663,15,429648
44822,8,-8,10,375538,8,375530
44823,5,9,500,917267,5,917262
44824,11,4,750,778787,11,778776
44825,10,-18,751,78703,10,78693
44826,16,-20,273,24860,16,24844
44827,17,-19,183,55497,17,55480
44828,15,-15,173,179020,15,179005
44829,12,-20,349,25536,12,25524
44830,18,3,384,744767,18,744749
44831,13,-14,788,215687,13,215674
44832,7,-7,476,416012,7,416005
44833,14,13,153,1054333,14,1054319
44834,18,10,92,960584,18,960566
44835,20,-5,215,492558,20,492538
44836,19,9,273,930924,19,930905
44837,9,-16,158,127422,9,127413
44838,15,10,111,960742,15,960727
44839,6,-10,546,324443,6,324437
44840,10,4,204,755044,10,755034
44841,15,3,75,742391,15,742376
44842,15,-2,916,592120,15,592105
44843,16,3,966,749260,16,749244
44844,12,-2,43,585473,12,585461
44845,15,8,627,902928,15,902913
44846,14,7,990,874059,14,874045
44847,7,-15,222,160065,7,160058
44848,6,9,102,908917,6,908911
44849,16,-8,35,398168,16,398152
44850,14,-18,41,85508,14,85494
44851,18,12,450,1025339,18,1025321
44852,19,-9,319,368938,19,368919
44853,11,6,248,837632,11,837621
44854,9,-9,941,364702,9,364693
44855,19,1,552,684263,19,684244
44856,6,15,228,1099431,6,1099425
44857,10,-11,593,294277,10,294267
44858,18,7,482,870618,18,870600
44859,16,-7,274,430372,16,430356
44860,12,-7,324,430805,12,430793
44861,20,-5,698,496130,20,496110
44862,8,-20,925,20390,8,20382
44863,16,18,303,1211295,16,1211279
44864,18,5,34,804000,18,803982
44865,16,1,269,682051,16,682035
44866,8,-8,516,386177,8,386169
44867,7,3,840,736888,7,736881
44868,10,14,15,1062100,10,1062090
44869,6,-13,502,228947,6,228941
44870,9,13,459,1040628,9,1040619
44871,20,-13,986,248485,20,248465
44872,13,-9,298,368742,13,368729
44873,20,9,594,933482,20,933462
44874,19,-6,949,466325,19,466306
44875,6,-8,445,384493,6,384487
44876,5,-16,647,138048,5,138043
44877,11,-12,250,274336,11,274325
44878,19,12,391,1024922,19,1024903
44879,11,-8,869,404048,11,404037
44880,17,6,875,842746,17,842729
44881,5,6,401,821404,5,821399
44882,9,-4,94,501418,9,501409
44883,15,-12,141,273585,15,273570
44884,15,-3,317,556097,15,556082
44885,6,-19,284,37773,6,37767
44886,19,1,383,682932,19,682913
44887,10,10,89,939528,10,939518
44888,16,14,532,1089612,16,1089596
44889,15,-12,970,279862,15,279847
44890,20,-14,549,213723,20,213703
44891,19,-16,868,153358,19,153339
44892,17,-19,242,55942,17,55925
44893,17,-10,208,336609,17,336592
44894,19,-8,762,403283,19,403264
44895,12,-18,160,86484,12,86472
44896,5,-13,220,223015,5,223010
44897,6,-7,128,408513,6,408507
44898,18,0,478,651743,18,651725
44899,18,11,161,991986,18,991968
44900,8,-17,822,110915,8,110907
44901,7,5,301,787867,7,787860
44902,6,-16,962,144732,6,144726
44903,7,6,347,820176,7,820169
44904,13,16,312,1149391,13,1149378
44905,10,6,699,828189,10,828179
44906,7,-12,16,249930,7,249923
44907,5,-16,364,131779,5,131774
44908,14,-7,403,431398,14,431384
44909,17,5,885,810219,17,810202
44910,17,-3,115,554631,17,554614
44911,11,-14,605,214284,11,214273
44912,19,10,98,960665,19,960646
44913,14,-16,307,149200,14,149186
44914,19,-20,727,28381,19,28362
44915,13,3,821,748009,13,747996
44916,17,18,995,1216268,17,1216251
44917,12,4,336,775641,12,775629
44918,13,-9,892,373653,13,373640
44919,13,0,444,651457,13,651444
44920,11,2,856,716854,11,716843
44921,7,2,981,709165,7,709158
44922,6,12,704,1014557,6,1014551
44923,18,3,353,744558,18,744540
44924,14,-4,303,524437,14,524423
44925,14,7,842,873109,14,873095
44926,20,-11,769,309725,20,309705
44927,9,16,473,1135324,9,1135315
44928,8,-15,556,167395,8,167387
44929,20,6,234,837542,20,837522
44930,10,-17,271,99256,10,99246
44931,8,14,946,1083027,8,1083019
44932,14,15,740,1122284,14,1122270
44933,20,-10,366,337680,20,337660
44934,7,-7,467,415811,7,415804
44935,17,3,128,742806,17,742789
44936,9,4,184,754533,9,754524
44937,18,-11,449,307353,18,307335
44938,7,6,2,812159,7,812152
44939,6,-4,461,509443,6,509437
44940,6,0,884,644563,6,644557
44941,10,10,517,948534,10,948524
44942,5,1,107,659414,5,659409
44943,17,1,25,679988,17,679971
44944,14,2,1,710514,14,710500
44945,5,1,387,665680,5,665675
44946,7,5,343,788687,7,788680
44947,7,14,792,1079678,7,1079671
44948,12,2,803,716464,12,716452
44949,13,-9,935,373985,13,373972
44950,17,2,253,712491,17,712474
44951,5,13,491,1041244,5,1041239
44952,20,-6,899,465939,20,465919
44953,20,-7,797,434068,20,434048
44954,19,5,893,810260,19,810241
44955,14,-6,720,464658,14,464644
44956,16,13,422,1056378,16,1056362
44957,12,13,44,1053543,12,1053531
44958,8,18,259,1192506,8,1192498
44959,6,12,485,1009556,6,1009550
44960,10,4,736,766617,10,766607
44961,13,-15,250,179589,13,179576
44962,11,6,959,843372,11,843361
44963,7,-18,549,74267,7,74260
44964,20,10,266,961842,20,961822
44965,16,15,373,1119506,16,1119490
44966,19,14,739,1091233,19,1091214
44967,18,1,77,680347,18,680329
44968,12,-13,947,248179,12,248167
44969,10,12,801,1016464,10,1016454
44970,16,19,468,1244630,16,1244614
44971,14,12,314,1024414,14,1024400
44972,9,10,882,956472,9,956463
44973,8,-4,883,518379,8,518371
44974,5,-19,303,38094,5,38089
44975,19,10,956,967186,19,967167
44976,10,-10,391,321011,10,321001
44977,16,19,743,1246830,16,1246814
44978,10,-15,301,161869,10,161859
44979,9,18,482,1197079,9,1197070
44980,20,-15,638,182505,20,182485
44981,17,2,470,714167,17,714150
44982,17,-20,91,23466,17,23449
44983,9,11,772,985021,9,985012
44984,11,7,395,869956,11,869945
44985,8,-11,845,299215,8,299207
44986,16,1,17,679865,16,679849
44987,7,17,921,1175053,7,1175046
44988,11,-12,347,275129,11,275118
44989,10,0,847,643722,10,643712
44990,20,-13,581,245344,20,245324
44991,15,10,159,961080,15,961065
44992,13,-6,87,459708,13,459695
44993,6,-19,564,43883,6,43877
44994,13,-9,772,372661,13,372648
44995,13,-2,35,585388,13,585375
44996,18,7,806,872844,18,872826
44997,7,4,884,770043,7,770036
44998,12,11,702,995821,12,995809
44999,12,-8,967,404768,12,404756
45000,12,19,219,1242479,12,1242467
45001,11,2,349,713213,11,713202
45002,20,-19,187,55547,20,55527
45003,17,9,901,935754,17,935737
45004,7,-9,675,358372,7,358365
45005,10,-9,68,345054,10,345044
45006,18,-16,319,149310,18,149292
45007,20,-1,722,622165,20,622145
45008,6,6,846,831359,6,831353
45009,9,18,877,1205267,9,1205258
45010,7,15,843,1112387,7,1112380
45011,12,-2,568,589418,12,589406
45012,10,-20,424,9039,10,9029
45013,8,-12,790,266594,8,266586
45014,8,-10,874,331305,8,331297
45015,14,-14,332,212023,14,212009
45016,10,-7,358,413637,10,413627
45017,10,-1,1,593736,10,593726
45018,19,18,860,1215220,19,1215201
45019,14,-11,941,311053,14,311039
45020,14,-7,759,433804,14,433790
45021,19,5,358,806388,19,806369
45022,10,-20,18,455,10,445
45023,14,-4,165,523332,14,523318
45024,11,6,689,841311,11,841300
45025,7,13,93,1032741,7,1032734
45026,17,6,562,840309,17,840292
45027,8,0,195,629783,8,629775
45028,18,-20,439,26147,18,26129
45029,17,-18,74,85791,17,85774
45030,8,-4,229,504592,8,504584
45031,14,7,330,869422,14,869408
45032,18,-19,775,60045,18,60027
45033,14,-15,542,181756,14,181742
45034,11,-17,619,120130,11,120119
45035,5,-7,634,419286,5,419281
45036,15,-15,379,180574,15,180559
45037,9,18,160,1190304,9,1190295
45038,7,7,855,862913,7,862906
45039,16,-7,669,433124,16,433108
45040,6,15,157,1097791,6,1097785
45041,15,-13,486,244574,15,244559
45042,10,1,333,664536,10,664526
45043,9,1,517,668610,9,668601
45044,9,-7,193,409922,9,409913
45045,12,-6,255,461165,12,461153
45046,20,-14,765,215489,20,215469
45047,7,6,240,817538,7,817531
45048,8,-4,461,509451,8,509443
45049,17,12,24,1022269,17,1022252
45050,19,-6,674,464271,19,464252
45051,16,4,199,774665,16,774649
45052,16,6,861,842636,16,842620
45053,6,12,448,1008654,6,1008648
45054,7,9,81,908410,7,908403
45055,15,0,735,653940,15,653925
45056,5,-4,99,501528,5,501523
45057,6,11,409,977271,6,977265
45058,5,14,684,1077426,5,1077421
45059,20,-4,104,522828,20,522808
45060,6,17,469,1165374,6,1165368
45061,5,7,893,863738,5,863733
45062,18,17,726,1183323,18,1183305
45063,18,12,226,1023724,18,1023706
45064,5,-12,897,269114,5,269109
45065,9,3,945,739358,9,739349
45066,13,4,67,773752,13,773739
45067,14,19,646,1246051,14,1246037
45068,14,14,276,1087566,14,1087552
45069,7,11,845,986560,7,986553
45070,8,12,591,1011783,8,1011775
45071,6,-20,802,17776,6,17770
45072,18,17,927,1184846,18,1184828
45073,14,16,324,1149462,14,1149448
45074,6,-15,949,175696,6,175690
45075,7,-20,547,11963,7,11956
45076,9,19,862,1236764,9,1236755
45077,19,13,906,1059955,19,1059936
45078,18,4,604,777700,18,777682
45079,5,19,600,1230969,5,1230964
45080,20,-6,575,463539,20,463519
45081,20,-7,891,434891,20,434871
45082,8,1,696,672181,8,672173
45083,20,15,602,1121203,20,1121183
45084,5,14,561,1074332,5,1074327
45085,18,2,282,712664,18,712646
45086,5,-5,507,478965,5,478960
45087,9,-18,836,80468,9,80459
45088,16,-14,320,211885,16,211869
45089,15,-3,351,556350,15,556335
45090,10,19,708,1233168,10,1233158
45091,8,17,39,1156177,8,1156169
45092,5,-10,380,320777,5,320772
45093,17,-17,452,118842,17,118825
45094,20,-10,638,339874,20,339854
45095,20,-13,485,244544,20,244524
45096,10,1,459,667225,10,667215
45097,8,-1,650,607928,8,607920
45098,13,12,944,1029376,13,1029363
45099,10,-11,30,281716,10,281706
45100,8,-8,397,383707,8,383699
45101,6,3,533,729985,6,729979
45102,10,-16,87,125818,10,125808
45103,9,0,607,638497,9,638488
45104,17,-18,247,87259,17,87242
45105,12,9,91,929707,12,929695
45106,18,8,698,903524,18,903506
45107,8,-3,458,540697,8,540689
45108,7,4,851,769447,7,769440
45109,11,8,39,898160,11,898149
45110,9,14,604,1075262,9,1075253
45111,10,0,820,643182,10,643172
45112,19,-13,155,242151,19,242132
45113,5,-5,325,475350,5,475345
45114,10,-8,120,377879,10,377869
45115,9,10,291,943669,9,943660
45116,19,9,790,934899,19,934880
45117,17,-8,580,401912,17,401895
45118,18,7,426,870184,18,870166
45119,8,-15,175,159160,8,159152
45120,16,17,354,1180618,16,1180602
45121,7,-6,382,445006,7,444999
45122,19,10,49,960225,19,960206
45123,5,0,996,647074,5,647069
45124,8,8,212,879792,8,879784
45125,14,-11,520,307871,14,307857
45126,13,18,239,1210896,13,1210883
45127,10,-13,567,230444,10,230434
45128,13,12,635,1026743,13,1026730
45129,15,0,530,652228,15,652213
45130,12,-20,511,26681,12,26669
45131,18,-7,628,432911,18,432893
45132,19,-11,88,304372,19,304353
45133,15,-6,362,461939,15,461924
45134,13,-5,610,495541,13,495528
45135,17,13,400,1056210,17,1056193
45136,6,-7,467,415817,6,415811
45137,11,-15,330,180147,11,180136
45138,19,8,553,902317,19,902298
45139,11,18,630,1213461,11,1213450
45140,9,2,171,692357,9,692348
45141,17,13,142,1054244,17,1054227
45142,10,0,619,638796,10,638786
45143,7,-6,134,439560,7,439553
45144,7,13,90,1032673,7,1032666
45145,20,-11,59,304139,20,304119
45146,14,10,184,961266,14,961252
45147,11,19,836,1247544,11,1247533
45148,9,-8,127,378062,9,378053
45149,16,-11,370,306723,16,306707
45150,6,-1,670,608274,6,608268
45151,14,19,711,1246529,14,1246515
45152,8,18,190,1191129,8,1191121
45153,19,5,503,807461,19,807442
45154,6,-11,124,283804,6,283798
45155,20,-6,521,463197,20,463177
45156,7,-17,157,96753,7,96746
45157,16,-19,728,59678,16,59662
45158,19,19,518,1245066,19,1245047
45159,10,12,119,1001732,10,1001722
45160,12,-1,269,618663,12,618651
45161,9,-12,948,270222,9,270213
45162,7,12,33,999810,7,999803
45163,16,10,399,962831,16,962815
45164,16,3,376,744695,16,744679
45165,18,-20,517,26710,18,26692
45166,15,-17,348,118084,15,118069
45167,8,-12,697,264584,8,264576
45168,7,-9,31,344295,7,344288
45169,14,1,339,682617,14,682603
45170,7,-13,675,232508,7,232501
45171,9,0,522,636602,9,636593
45172,10,6,12,812402,10,812392
45173,19,4,422,776292,19,776273
45174,8,0,932,645594,8,645586
45175,11,-6,565,463509,11,463498
45176,18,-18,5,85255,18,85237
45177,10,16,591,1137609,10,1137599
45178,16,-15,830,184028,16,184012
45179,15,15,296,1118980,15,1118965
45180,7,14,301,1068478,7,1068471
45181,18,16,989,1154176,18,1154158
45182,9,11,587,981087,9,981078
45183,8,-12,972,270809,8,270801
45184,16,-18,451,88655,16,88639
45185,16,-7,166,429541,16,429525
45186,14,13,703,1058506,14,1058492
45187,18,-13,855,247420,18,247402
45188,10,18,29,1187191,10,1187181
45189,19,-18,543,89243,19,89224
45190,14,-8,83,398592,14,398578
45191,15,3,387,744810,15,744795
45192,5,5,564,793244,5,793239
45193,10,-2,852,581032,10,581022
45194,7,0,442,634869,7,634862
45195,19,-3,516,557786,19,557767
45196,11,17,31,1178104,11,1178093
45197,11,-7,148,429359,11,429348
45198,11,-2,854,591634,11,591623
45199,18,-1,36,616854,18,616836
45200,20,-6,151,460282,20,460262
45201,16,-20,352,25551,16,25535
45202,20,17,842,1184326,20,1184306
45203,9,14,485,1072611,9,1072602
45204,5,-11,462,291477,5,291472
45205,13,6,169,837005,13,836992
45206,13,17,3,1177875,13,1177862
45207,9,-5,124,470785,9,470776
45208,12,0,460,651623,12,651611
45209,7,-16,88,125831,7,125824
45210,20,-12,617,277012,20,276992
45211,7,-16,68,125293,7,125286
45212,12,-4,208,523724,12,523712
45213,9,17,368,1163209,9,1163200
45214,11,-12,157,273688,11,273677
45215,13,-16,589,151324,13,151311
45216,12,-10,633,339781,12,339769
45217,11,-2,206,586646,11,586635
45218,7,7,806,861893,7,861886
45219,16,1,530,684067,16,684051
45220,20,-7,256,430184,20,430164
45221,13,8,347,900731,13,900718
45222,16,2,95,711313,16,711297
45223,15,6,228,837470,15,837455
45224,12,12,636,1026753,12,1026741
45225,9,-12,153,252856,9,252847
45226,17,-5,390,493877,17,493860
45227,7,-7,826,423259,7,423252
45228,11,6,754,841829,11,841818
45229,9,10,55,938711,9,938702
45230,14,2,508,714455,14,714441
45231,11,9,987,936423,11,936412
45232,9,-7,677,420137,9,420128
45233,19,-2,330,587579,19,587560
45234,6,13,650,1044771,6,1044765
45235,7,-19,885,50769,7,50762
45236,8,17,522,1166526,8,1166518
45237,11,-10,149,336211,11,336200
45238,15,13,892,1059902,15,1059887
45239,10,10,465,947517,10,947507
45240,16,5,951,810792,16,810776
45241,5,-7,549,417683,5,417678
45242,9,-10,351,320226,9,320217
45243,5,-11,911,300715,5,300710
45244,9,15,749,1110455,9,1110446
45245,8,16,577,1137292,8,1137284
45246,11,4,23,773414,11,773403
45247,19,-14,250,211380,19,211361
45248,11,-16,771,152564,11,152553
45249,11,-10,190,336488,11,336477
45250,13,3,383,744752,13,744739
45251,6,12,901,1018941,6,1018935
45252,12,-8,239,399595,12,399583
45253,12,-20,838,29292,12,29280
45254,20,6,694,841386,20,841366
45255,8,-5,655,482188,8,482180
45256,11,19,596,1245633,11,1245622
45257,17,1,44,680130,17,680113
45258,9,14,181,1065761,9,1065752
45259,15,4,172,774521,15,774506
45260,7,-4,915,519045,7,519038
45261,19,-8,64,398420,19,398401
45262,6,-10,814,330056,6,330050
45263,18,13,395,1056161,18,1056143
45264,9,-10,8,312710,9,312701
45265,12,2,362,713337,12,713325
45266,13,13,868,1059732,13,1059719
45267,16,-6,692,464457,16,464441
45268,17,-5,66,491339,17,491322
45269,12,12,558,1026136,12,1026124
45270,20,11,793,996595,20,996575
45271,14,-6,311,461576,14,461562
45272,17,-19,111,54863,17,54846
45273,15,-16,807,152831,15,152816
45274,14,17,388,1180846,14,1180832
45275,17,-8,627,402252,17,402235
45276,9,10,687,952340,9,952331
45277,18,17,690,1183031,18,1183013
45278,18,-14,362,212239,18,212221
45279,7,9,841,924702,7,924695
45280,6,16,862,1143008,6,1143002
45281,6,15,62,1095821,6,1095815
45282,17,-11,433,307239,17,307222
45283,17,8,713,903651,17,903634
45284,17,17,173,1179199,17,1179182
45285,14,7,221,868550,14,868536
45286,12,-11,232,305512,12,305500
45287,10,-7,882,424687,10,424677
45288,14,0,706,653653,14,653639
45289,14,5,318,806076,14,806062
45290,17,-9,247,368397,17,368380
45291,8,17,750,1171256,8,1171248
45292,9,-3,622,544379,9,544370
45293,12,4,529,777102,12,777090
45294,8,3,530,729937,8,729929
45295,17,-2,924,592164,17,592147
45296,19,16,534,1150890,19,1150871
45297,7,10,906,956959,7,956952
45298,9,15,82,1096200,9,1096191
45299,12,19,964,1248509,12,1248497
45300,14,13,438,1056518,14,1056504
45301,14,2,531,714611,14,714597
45302,7,-9,284,349778,7,349771
45303,7,-14,818,204415,7,204408
45304,14,5,233,805558,14,805544
45305,11,6,425,839171,11,839160
45306,18,-18,404,88315,18,88297
45307,8,-4,799,516460,8,516452
45308,17,13,535,1057207,17,1057190
45309,11,-6,659,464156,11,464145
45310,15,11,688,995720,15,995705
45311,14,3,953,749123,14,749109
45312,12,0,48,648607,12,648595
45313,5,10,935,957632,5,957627
45314,8,-3,277,536364,8,536356
45315,15,-18,310,87669,15,87654
45316,20,-3,463,557353,20,557333
45317,20,13,703,1058516,20,1058496
45318,18,6,451,839380,18,839362
45319,9,13,711,1045941,9,1045932
45320,9,-11,577,293943,9,293934
45321,5,4,888,770161,5,770156
45322,10,-19,937,51640,10,51630
45323,6,10,235,942486,6,942480
45324,16,14,925,1092652,16,1092636
45325,8,-10,244,317838,8,317830
45326,8,-20,929,20481,8,20473
45327,20,-19,574,58555,20,58535
45328,11,10,925,966965,11,966954
45329,11,3,177,743166,11,743155
45330,7,-4,605,512431,7,512424
45331,13,3,589,746235,13,746222
45332,7,-1,18,594093,7,594086
45333,12,-8,427,400855,12,400843
45334,13,-5,407,494002,13,493989
45335,12,1,259,681944,12,681932
45336,16,-10,349,337597,16,337581
45337,11,-3,216,555292,11,555281
45338,7,-3,816,548663,7,548656
45339,15,1,572,684421,15,684406
45340,5,16,681,1139453,5,1139448
45341,18,18,378,1211842,18,1211824
45342,6,7,254,850283,6,850277
45343,16,4,329,775587,16,775571
45344,13,1,6,679783,13,679770
45345,12,3,337,744436,12,744424
45346,14,1,739,685617,14,685603
45347,14,-6,27,459362,14,459348
45348,17,-14,465,213117,17,213100
45349,13,-13,284,243218,13,243205
45350,11,6,89,836401,11,836390
45351,9,11,879,987419,9,987410
45352,13,7,928,873611,13,873598
45353,8,2,539,700046,8,700038
45354,12,12,111,1022878,12,1022866
45355,6,4,28,751161,6,751155
45356,18,-19,855,60582,18,60564
45357,7,-16,991,145426,7,145419
45358,19,-4,549,526263,19,526244
45359,19,7,921,873591,19,873572
45360,15,0,5,648225,15,648210
45361,20,-1,132,617571,20,617551
45362,8,-2,832,580632,8,580624
45363,8,-9,34,344351,8,344343
45364,19,11,836,996880,19,996861
45365,11,9,419,932086,11,932075
45366,9,10,528,948822,9,948813
45367,17,-2,193,586529,17,586512
45368,13,-8,192,399247,13,399234
45369,16,-1,292,618881,16,618865
45370,20,0,827,654548,20,654528
45371,6,-7,797,422660,6,422654
45372,6,-19,468,41605,6,41599
45373,9,-20,679,15003,9,14994
45374,5,16,163,1128505,5,1128500
45375,5,0,931,645572,5,645567
45376,13,9,833,935243,13,935230
45377,11,19,389,1243950,11,1243939
45378,13,12,454,1025355,13,1025342
45379,19,11,509,994545,19,994526
45380,11,-13,809,247063,11,247052
45381,11,-15,916,184739,11,184728
45382,13,-5,369,493784,13,493771
45383,14,18,331,1211515,14,1211501
45384,19,-9,807,372942,19,372923
45385,13,10,762,965707,13,965694
45386,15,0,666,653349,15,653334
45387,8,7,614,857804,8,857796
45388,12,16,360,1149735,12,1149723
45389,12,8,881,904772,12,904760
45390,20,0,967,655691,20,655671
45391,11,2,539,714663,11,714652
45392,6,19,140,1220544,6,1220538
45393,12,-12,849,278813,12,278801
45394,13,-5,844,497139,13,497126
45395,10,-16,439,133674,10,133664
45396,15,-1,980,623985,15,623970
45397,9,8,255,880744,9,880735
45398,5,-15,207,159691,5,159686
45399,11,6,426,839171,11,839160
45400,9,4,964,771606,9,771597
45401,16,13,17,1053367,16,1053351
45402,20,1,156,681117,20,681097
45403,14,-6,369,461975,14,461961
45404,8,8,458,885188,8,885180
45405,7,-9,236,348705,7,348698
45406,6,2,815,705564,6,705558
45407,14,-9,346,369234,14,369220
45408,14,-14,398,212676,14,212662
45409,7,-3,917,550989,7,550982
45410,6,0,887,644648,6,644642
45411,19,-13,45,241394,19,241375
45412,19,1,303,682249,19,682230
45413,17,-9,299,368782,17,368765
45414,12,5,971,810944,12,810932
45415,18,-3,521,557841,18,557823
45416,16,-2,41,585433,16,585417
45417,15,15,277,1118837,15,1118822
45418,10,-15,405,164209,10,164199
45419,19,-13,502,244729,19,244710
45420,17,-3,804,560243,17,560226
45421,5,11,673,982763,5,982758
45422,6,1,91,658954,6,658948
45423,11,-9,718,372063,11,372052
45424,18,-20,82,23393,18,23375
45425,12,-16,972,154083,12,154071
45426,8,-12,949,270259,8,270251
45427,6,1,891,676363,6,676357
45428,8,-14,689,201831,8,201823
45429,15,5,178,805119,15,805104
45430,20,8,625,902912,20,902892
45431,17,-5,481,494610,17,494593
45432,12,12,646,1026888,12,1026876
45433,17,-15,597,182170,17,182153
45434,15,12,35,1022354,15,1022339
45435,17,-11,123,304682,17,304665
45436,7,-7,866,424227,7,424220
45437,11,2,967,717702,11,717691
45438,20,-20,972,30169,20,30149
45439,11,2,360,713325,11,713314
45440,9,9,135,909667,9,909658
45441,9,8,126,877754,9,877745
45442,6,-16,825,141743,6,141737
45443,9,8,702,890663,9,890654
45444,15,-6,361,461919,15,461904
45445,11,-3,870,560759,11,560748
45446,19,-13,522,244902,19,244883
45447,17,-10,220,336713,17,336696
45448,15,-4,78,522623,15,522608
45449,16,15,175,1118121,16,1118105
45450,7,-13,131,221165,7,221158
45451,9,-10,369,320557,9,320548
45452,13,19,881,1247923,13,1247910
45453,14,-18,956,92185,14,92171
45454,8,-18,498,73180,8,73172
45455,10,-9,777,360935,10,360925
45456,20,-13,744,246533,20,246513
45457,20,-6,217,460837,20,460817
45458,10,-9,876,363226,10,363216
45459,17,-10,193,336510,17,336493
45460,10,-13,32,219107,10,219097
45461,17,-14,760,215418,17,215401
45462,13,19,613,1245740,13,1245727
45463,19,5,848,809928,19,809909
45464,16,15,268,1118794,16,1118778
45465,10,0,90,627279,10,627269
45466,14,7,212,868477,14,868463
45467,10,-2,521,573861,10,573851
45468,10,5,964,802069,10,802059
45469,20,1,364,682790,20,682770
45470,13,18,952,1215975,13,1215962
45471,9,-17,937,113219,9,113210
45472,17,2,139,711652,17,711635
45473,17,19,50,1241108,17,1241091
45474,20,-18,642,89915,20,89895
45475,19,17,236,1179625,19,1179606
45476,6,11,107,970777,6,970771
45477,7,16,947,1144858,7,1144851
45478,10,-17,36,94341,10,94331
45479,12,-17,602,120051,12,120039
45480,18,-14,461,213073,18,213055
45481,7,0,101,627680,7,627673
45482,5,17,623,1168596,5,1168591
45483,13,-10,373,337753,13,337740
45484,17,-2,54,585567,17,585550
45485,8,-7,941,425905,8,425897
45486,14,-17,999,122759,14,122745
45487,14,10,450,963245,14,963231
45488,10,16,775,1141193,10,1141183
45489,7,-3,39,531372,7,531365
45490,16,-15,645,182585,16,182569
45491,16,14,396,1088525,16,1088509
45492,13,-6,522,463199,13,463186
45493,8,17,517,1166389,8,1166381
45494,17,15,214,1118421,17,1118404
45495,5,10,482,947751,5,947746
45496,16,5,339,806272,16,806256
45497,11,-9,151,367668,11,367657
45498,6,-10,931,332425,6,332419
45499,6,-6,704,451958,6,451952
45500,19,-10,634,339836,19,339817
45501,14,-5,533,494991,14,494977
45502,19,19,768,1247034,19,1247015
45503,19,14,914,1092572,19,1092553
45504,10,-8,934,395311,10,395301
45505,5,14,154,1065301,5,1065296
45506,7,-6,2,436881,7,436874
45507,12,4,192,774625,12,774613
45508,10,-9,519,355409,10,355399
45509,9,15,874,1113014,9,1113005
45510,19,12,473,1025520,19,1025501
45511,5,-13,535,229705,5,229700
45512,10,-11,294,287478,10,287468
45513,17,-8,59,398379,17,398362
45514,15,14,697,1090959,15,1090944
45515,6,15,81,1096157,6,1096151
45516,10,5,866,799812,10,799802
45517,12,-3,336,556260,12,556248
45518,7,13,147,1033793,7,1033786
45519,13,2,264,712541,13,712528
45520,11,-20,693,28162,11,28151
45521,20,-14,302,211746,20,211726
45522,18,-16,604,151459,18,151441
45523,7,2,422,697710,7,697703
45524,18,10,553,964085,18,964067
45525,15,14,706,1091009,15,1090994
45526,18,-8,765,403317,18,403299
45527,8,11,678,982891,8,982883
45528,5,6,411,821674,5,821669
45529,10,7,164,848299,10,848289
45530,5,4,67,752081,5,752076
45531,12,-2,667,590160,12,590148
45532,16,-11,33,303890,16,303874
45533,20,18,178,1210396,20,1210376
45534,17,-16,175,148174,17,148157
45535,15,6,123,836714,15,836699
45536,17,-11,949,311114,17,311097
45537,17,-6,271,461301,17,461284
45538,12,9,804,935026,12,935014
45539,9,4,392,759106,9,759097
45540,6,9,436,915854,6,915848
45541,7,-9,491,354746,7,354739
45542,19,1,220,681640,19,681621
45543,18,-3,450,557242,18,557224
45544,17,2,728,716076,17,716059
45545,15,-14,393,212631,15,212616
45546,7,-20,556,12180,7,12173
45547,19,10,409,962937,19,962918
45548,7,18,417,1195656,7,1195649
45549,5,18,536,1198320,5,1198315
45550,20,14,479,1089180,20,1089160
45551,19,1,177,681264,19,681245
45552,14,-12,482,276057,14,276043
45553,15,-3,975,561583,15,561568
45554,5,2,711,703634,5,703629
45555,13,6,332,838342,13,838329
45556,6,6,17,812590,6,812584
45557,12,14,557,1089806,12,1089794
45558,5,15,59,1095758,5,1095753
45559,5,-10,560,324813,5,324808
45560,15,-5,95,491647,15,491632
45561,19,12,996,1029791,19,1029772
45562,9,-4,229,504601,9,504592
45563,8,-4,126,502124,8,502116
45564,20,-20,617,27481,20,27461
45565,7,-16,258,129650,7,129643
45566,14,-8,325,400191,14,400177
45567,16,4,209,774736,16,774720
45568,15,11,770,996416,15,996401
45569,20,0,721,653848,20,653828
45570,20,8,12,897998,20,897978
45571,5,-3,797,548249,5,548244
45572,7,6,187,816270,7,816263
45573,20,8,726,903736,20,903716
45574,19,5,571,807943,19,807924
45575,8,-19,186,35698,8,35690
45576,11,4,765,778891,11,778880
45577,11,-9,676,371766,11,371755
45578,13,12,597,1026421,13,1026408
45579,16,6,219,837355,16,837339
45580,8,-18,265,68272,8,68264
45581,12,6,435,839251,12,839239
45582,8,17,387,1163602,8,1163594
45583,19,8,722,903712,19,903693
45584,17,2,241,712388,17,712371
45585,8,9,962,927228,8,927220
45586,10,-16,555,136077,10,136067
45587,15,-20,187,24275,15,24260
45588,12,15,253,1118669,12,1118657
45589,19,11,708,995875,19,995856
45590,11,19,658,1246110,11,1246099
45591,12,-19,108,54809,12,54797
45592,10,-12,183,253393,10,253383
45593,5,4,770,767368,5,767363
45594,14,12,599,1026445,14,1026431
45595,18,12,330,1024540,18,1024522
45596,9,0,329,632279,9,632270
45597,9,0,301,631734,9,631725
45598,6,-3,224,535170,6,535164
45599,15,6,808,842280,15,842265
45600,20,-4,573,526417,20,526397
45601,15,-15,48,178129,15,178114
45602,9,-5,661,482346,9,482337
45603,8,19,546,1229851,8,1229843
45604,8,-16,175,127718,8,127710
45605,18,18,960,1216038,18,1216020
45606,19,-11,398,306911,19,306892
45607,14,8,519,902101,14,902087
45608,6,11,229,973030,6,973024
45609,17,8,153,899140,17,899123
45610,16,19,157,1242034,16,1242018
45611,9,12,289,1005579,9,1005570
45612,19,-18,126,86184,19,86165
45613,7,2,470,698665,7,698658
45614,17,-5,874,497448,17,497431
45615,8,16,927,1144509,8,1144501
45616,13,16,445,1150327,13,1150314
45617,12,14,755,1091355,12,1091343
45618,6,15,363,1102137,6,1102131
45619,18,8,639,903057,18,903039
45620,17,-15,515,181562,17,181545
45621,5,17,292,1161651,5,1161646
45622,12,3,961,749202,12,749190
45623,6,-16,270,129887,6,129881
45624,6,2,751,704479,6,704473
45625,5,-16,806,141327,5,141322
45626,7,-4,995,520873,7,520866
45627,20,-3,886,560887,20,560867
45628,20,-3,978,561610,20,561590
45629,7,-16,956,144540,7,144533
45630,7,-14,422,196017,7,196010
45631,20,-5,457,494413,20,494393
45632,11,9,896,935691,11,935680
45633,10,9,411,915321,10,915311
45634,19,-3,358,556428,19,556409
45635,20,2,223,712266,20,712246
45636,14,9,506,932760,14,932746
45637,10,4,386,758954,10,758944
45638,16,6,476,839606,16,839590
45639,10,-6,355,444370,10,444360
45640,9,-17,467,103456,9,103447
45641,11,-12,653,277312,11,277301
45642,20,8,359,900791,20,900771
45643,15,9,825,935152,15,935137
45644,8,-11,264,286851,8,286843
45645,6,-19,318,38379,6,38373
45646,19,-11,276,305889,19,305870
45647,5,-11,462,291482,5,291477
45648,13,-11,139,304830,13,304817
45649,18,-10,758,340822,18,340804
45650,15,7,659,871848,15,871833
45651,7,-20,823,18289,7,18282
45652,20,1,311,682308,20,682288
45653,8,-3,626,544449,8,544441
45654,5,17,649,1169206,5,1169201
45655,7,9,131,909550,7,909543
45656,5,16,927,1144514,5,1144509
45657,12,-15,534,181694,12,181682
45658,11,13,626,1057999,11,1057988
45659,16,6,247,837614,16,837598
45660,15,-13,169,242280,15,242265
45661,7,2,284,694746,7,694739
45662,16,4,952,780282,16,780266
45663,6,4,203,755009,6,755003
45664,7,-12,151,252831,7,252824
45665,6,-4,69,500846,6,500840
45666,16,14,373,1088339,16,1088323
45667,20,-4,5,522086,20,522066
45668,6,-4,963,520139,6,520133
45669,14,-13,723,246359,14,246345
45670,15,-2,273,587175,15,587160
45671,11,7,75,867552,11,867541
45672,20,-8,7,397921,20,397901
45673,10,-16,358,131630,10,131620
45674,14,-19,524,58059,14,58045
45675,18,16,411,1150120,18,1150102
45676,5,-10,323,319530,5,319525
45677,14,-7,393,431330,14,431316
45678,18,3,69,742338,18,742320
45679,13,-6,320,461659,13,461646
45680,17,18,749,1214398,17,1214381
45681,14,-20,740,28461,14,28447
45682,16,12,20,1022239,16,1022223
45683,10,-5,176,471948,10,471938
45684,19,-5,427,494138,19,494119
45685,17,9,878,935599,17,935582
45686,6,19,230,1222603,6,1222597
45687,18,-11,34,303905,18,303887
45688,11,11,49,991208,11,991197
45689,10,-14,642,200875,10,200865
45690,17,10,221,961517,17,961500
45691,5,-19,283,37733,5,37728
45692,6,4,482,760930,6,760924
45693,19,-18,171,86599,19,86580
45694,20,0,16,648313,20,648293
45695,12,-12,605,276904,12,276892
45696,16,6,352,838515,16,838499
45697,8,-20,439,9430,8,9422
45698,12,-3,238,555445,12,555433
45699,12,-7,727,433593,12,433581
45700,12,2,902,717190,12,717178
45701,16,-2,483,588799,16,588783
45702,20,-9,926,373907,20,373887
45703,10,19,841,1236220,10,1236210
45704,10,-20,208,4813,10,4803
45705,13,-5,85,491544,13,491531
45706,6,13,8,1031037,6,1031031
45707,5,-4,174,503183,5,503178
45708,10,13,177,1034465,10,1034455
45709,5,17,215,1159773,5,1159768
45710,14,18,777,1214606,14,1214592
45711,17,2,462,714124,17,714107
45712,10,-2,177,566444,10,566434
45713,8,-12,274,255454,8,255446
45714,11,3,683,747042,11,747031
45715,9,-13,947,238905,9,238896
45716,12,-15,668,182745,12,182733
45717,8,-8,974,396264,8,396256
45718,17,14,209,1087039,17,1087022
45719,16,-14,248,211354,16,211338
45720,17,-17,640,120280,17,120263
45721,5,7,72,846348,5,846343
45722,7,-6,153,440050,7,440043
45723,18,-4,202,523667,18,523649
45724,7,14,278,1068023,7,1068016
45725,7,18,80,1188490,7,1188483
45726,17,-20,537,26894,17,26877
45727,10,12,814,1016767,10,1016757
45728,17,4,102,774044,17,774027
45729,6,7,684,859291,6,859285
45730,15,-18,139,86254,15,86239
45731,15,-20,276,24911,15,24896
45732,8,15,832,1112119,8,1112111
45733,16,-4,936,529073,16,529057
45734,19,1,947,687261,19,687242
45735,10,2,199,692961,10,692951
45736,13,10,70,960380,13,960367
45737,20,-13,907,247816,20,247796
45738,11,13,291,1055368,11,1055357
45739,7,14,552,1074154,7,1074147
45740,17,13,213,1054816,17,1054799
45741,5,1,508,668362,5,668357
45742,6,6,130,814947,6,814941
45743,17,11,497,994471,17,994454
45744,14,-7,352,431010,14,430996
45745,18,-11,720,309323,18,309305
45746,13,-2,504,588928,13,588915
45747,15,-19,53,54267,15,54252
45748,20,11,183,992106,20,992086
45749,18,-4,483,525704,18,525686
45750,11,18,173,1210333,11,1210322
45751,15,8,345,900720,15,900705
45752,10,5,31,782234,10,782224
45753,10,7,358,852539,10,852529
45754,8,19,640,1231761,8,1231753
45755,5,15,736,1110167,5,1110162
45756,19,-15,475,181288,19,181269
45757,6,-17,35,94302,6,94296
45758,8,-17,570,105816,8,105808
45759,6,4,982,771946,6,771940
45760,9,-9,485,354579,9,354570
45761,6,3,672,733281,6,733275
45762,7,-8,857,393634,7,393627
45763,9,-15,390,163821,9,163812
45764,5,3,788,735746,5,735741
45765,7,-18,114,64942,7,64935
45766,18,7,440,870317,18,870299
45767,14,19,232,1242559,14,1242545
45768,11,-12,467,275930,11,275919
45769,18,4,676,778220,18,778202
45770,6,18,78,1188475,6,1188469
45771,8,-18,976,83697,8,83689
45772,11,-15,212,179269,11,179258
45773,14,-1,125,617510,14,617496
45774,13,5,92,804483,13,804470
45775,13,-4,953,529239,13,529226
45776,7,5,910,800746,7,800739
45777,14,7,7,867074,14,867060
45778,9,-1,888,613000,9,612991
45779,17,-12,492,276137,17,276120
45780,6,-11,501,292372,6,292366
45781,17,-8,608,402136,17,402119
45782,14,6,884,842825,14,842811
45783,8,-5,673,482581,8,482573
45784,18,-8,283,399865,18,399847
45785,9,2,872,706733,9,706724
45786,20,4,33,773509,20,773489
45787,5,18,636,1200237,5,1200232
45788,12,-20,561,27075,12,27063
45789,13,-6,899,465942,13,465929
45790,12,5,57,804255,12,804243
45791,7,-5,383,476400,7,476393
45792,10,-5,783,484790,10,484780
45793,19,13,19,1053375,19,1053356
45794,19,-5,65,491333,19,491314
45795,18,-1,816,622847,18,622829
45796,10,-18,194,66696,10,66686
45797,8,4,203,755017,8,755009
45798,9,7,228,849643,9,849634
45799,16,-10,129,336081,16,336065
45800,17,9,391,931863,17,931846
45801,20,16,0,1147097,20,1147077
45802,15,16,765,1152518,15,1152503
45803,7,3,463,728753,7,728746
45804,14,-6,177,460530,14,460516
45805,20,-15,937,184908,20,184888
45806,17,1,862,686544,17,686527
45807,15,3,726,747344,15,747329
45808,7,-8,510,386052,7,386045
45809,9,6,657,827133,9,827124
45810,13,12,28,1022296,13,1022283
45811,10,-20,362,7954,10,7944
45812,6,16,881,1143406,6,1143400
45813,20,4,841,779523,20,779503
45814,8,-19,709,47082,8,47074
45815,19,11,136,991800,19,991781
45816,14,-2,625,589830,14,589816
45817,15,-15,162,178974,15,178959
45818,11,14,942,1092846,11,1092835
45819,12,-18,228,87080,12,87068
45820,8,-4,682,514202,8,514194
45821,20,-5,557,495146,20,495126
45822,18,4,713,778511,18,778493
45823,9,-18,262,68183,9,68174
45824,19,0,977,655778,19,655759
45825,15,-9,185,367866,15,367851
45826,14,-15,89,178473,14,178459
45827,6,-11,458,291364,6,291358
45828,18,-18,887,91655,18,91637
45829,19,-9,64,367117,19,367098
45830,13,15,519,1120537,13,1120524
45831,20,-16,121,147832,20,147812
45832,5,-9,850,362514,5,362509
45833,11,-4,139,523113,11,523102
45834,5,2,728,704010,5,704005
45835,13,-8,307,400040,13,400027
45836,9,12,118,1001717,9,1001708
45837,19,19,418,1244279,19,1244260
45838,20,-5,401,493972,20,493952
45839,16,-8,905,404328,16,404312
45840,20,18,746,1214363,20,1214343
45841,9,12,353,1006863,9,1006854
45842,5,-8,477,385169,5,385164
45843,9,-12,126,252333,9,252324
45844,9,15,794,1111239,9,1111230
45845,12,-20,673,27967,12,27955
45846,6,10,940,957749,6,957743
45847,18,-3,599,558519,18,558501
45848,10,-15,341,162845,10,162835
45849,9,-11,880,300032,9,300023
45850,20,-5,283,493139,20,493119
45851,12,17,922,1184830,12,1184818
45852,9,16,30,1125810,9,1125801
45853,9,-17,129,96137,9,96128
45854,9,7,280,850768,9,850759
45855,16,-18,719,90490,16,90474
45856,16,4,907,779954,16,779938
45857,9,-7,766,422089,9,422080
45858,6,16,108,1127340,6,1127334
45859,18,10,417,963030,18,963012
45860,6,19,807,1235340,6,1235334
45861,17,-20,48,23151,17,23134
45862,17,-20,187,24282,17,24265
45863,19,-5,581,495353,19,495334
45864,15,16,445,1150332,15,1150317
45865,14,10,761,965689,14,965675
45866,19,-1,186,617930,19,617911
45867,19,8,995,905684,19,905665
45868,13,16,968,1154051,13,1154038
45869,15,-14,245,211334,15,211319
45870,13,-11,552,308167,13,308154
45871,5,-10,106,314848,5,314843
45872,15,-10,868,341603,15,341588
45873,13,-6,268,461277,13,461264
45874,15,16,996,1154269,15,1154254
45875,13,-11,654,308960,13,308947
45876,10,13,394,1039195,10,1039185
45877,9,7,807,861916,9,861907
45878,10,-6,812,454314,10,454304
45879,12,15,789,1122566,12,1122554
45880,5,1,682,671959,5,671954
45881,8,-13,668,232434,8,232426
45882,10,12,919,1019334,10,1019324
45883,11,-14,220,211062,11,211051
45884,15,-16,230,148687,15,148672
45885,15,-4,236,523976,15,523961
45886,7,-3,235,535549,7,535542
45887,6,-2,931,582742,6,582736
45888,15,-1,17,616647,15,616632
45889,14,-12,947,279642,14,279628
45890,5,19,214,1222251,5,1222246
45891,15,-16,920,153689,15,153674
45892,10,-9,571,356547,10,356537
45893,18,-7,138,429311,18,429293
45894,16,2,759,716270,16,716254
45895,18,18,492,1212576,18,1212558
45896,5,19,905,1237674,5,1237669
45897,19,-17,158,116647,19,116628
45898,12,-1,68,617075,12,617063
45899,10,15,379,1102512,10,1102502
45900,15,18,140,1210107,15,1210092
45901,19,-11,258,305749,19,305730
45902,5,9,199,910914,5,910909
45903,10,11,350,975924,10,975914
45904,14,16,944,1153824,14,1153810
45905,19,7,568,871198,19,871179
45906,11,-12,889,279170,11,279159
45907,20,-4,541,526209,20,526189
45908,17,8,359,900798,17,900781
45909,6,5,247,786816,6,786810
45910,15,-9,831,373129,15,373114
45911,11,-9,718,372064,11,372053
45912,10,-6,43,437761,10,437751
45913,5,12,230,1004147,5,1004142
45914,5,-6,585,449381,5,449376
45915,16,15,619,1121334,16,1121318
45916,7,17,734,1170950,7,1170943
45917,15,-17,52,115921,15,115906
45918,19,-4,856,528377,19,528358
45919,16,9,530,932934,16,932918
45920,18,8,729,903750,18,903732
45921,15,-20,666,27927,15,27912
45922,8,18,264,1192632,8,1192624
45923,6,-12,754,265877,6,265871
45924,12,-3,102,554509,12,554497
45925,11,10,88,960521,11,960510
45926,6,1,299,663681,6,663675
45927,20,-9,164,367748,20,367728
45928,12,-11,854,310407,12,310395
45929,18,5,357,806370,18,806352
45930,12,-5,675,495919,12,495907
45931,13,11,144,991875,13,991862
45932,17,16,515,1150766,17,1150749
45933,17,-9,471,370345,17,370328
45934,9,14,999,1084299,9,1084290
45935,14,13,487,1056810,14,1056796
45936,5,7,274,850650,5,850645
45937,16,16,348,1149659,16,1149643
45938,14,-11,824,310155,14,310141
45939,8,10,600,950479,8,950471
45940,17,-15,696,182894,17,182877
45941,17,5,557,807824,17,807807
45942,5,5,274,787387,5,787382
45943,6,-6,15,437166,6,437160
45944,5,12,14,999381,5,999376
45945,18,7,95,867698,18,867680
45946,14,-2,936,592275,14,592261
45947,5,18,583,1199096,5,1199091
45948,14,6,490,839717,14,839703
45949,18,10,460,963346,18,963328
45950,6,8,920,895145,6,895139
45951,14,7,837,873064,14,873050
45952,20,-13,700,246131,20,246111
45953,6,10,920,957320,6,957314
45954,10,-15,502,166353,10,166343
45955,13,-2,12,585198,13,585185
45956,10,19,716,1233405,10,1233395
45957,16,-19,243,55947,16,55931
45958,10,-8,954,395774,10,395764
45959,12,-4,995,529574,12,529562
45960,12,-12,692,277589,12,277577
45961,10,10,254,942846,10,942836
45962,17,-13,610,245559,17,245542
45963,5,14,525,1073556,5,1073551
45964,6,-1,24,594197,6,594191
45965,5,18,20,1186952,5,1186947
45966,10,-13,223,223098,10,223088
45967,17,-9,603,371369,17,371352
45968,14,-3,107,554545,14,554531
45969,7,-20,203,4763,7,4756
45970,20,10,950,967140,20,967120
45971,18,-6,717,464608,18,464590
45972,12,-14,552,213733,12,213721
45973,16,5,938,810680,16,810664
45974,14,4,335,775631,14,775617
45975,13,-9,96,367335,13,367322
45976,5,1,983,678375,5,678370
45977,20,10,506,963736,20,963716
45978,16,3,691,747113,16,747097
45979,19,9,273,930933,19,930914
45980,10,-8,55,376622,10,376612
45981,6,-16,589,136816,6,136810
45982,16,15,283,1118897,16,1118881
45983,7,-8,204,379836,7,379829
45984,15,-8,547,401724,15,401709
45985,17,-16,488,150603,17,150586
45986,12,5,286,805947,12,805935
45987,17,17,231,1179573,17,1179556
45988,17,3,176,743165,17,743148
45989,5,-13,382,226361,5,226356
45990,5,10,965,958158,5,958153
45991,12,12,522,1025846,12,1025834
45992,5,-18,770,79116,5,79111
45993,12,11,43,991172,12,991160
45994,10,-9,508,355137,10,355127
45995,9,16,668,1139223,9,1139214
45996,9,11,66,969887,9,969878
45997,7,5,876,800029,7,800022
45998,12,6,329,838340,12,838328
45999,6,0,297,631670,6,631664
46000,6,0,878,644341,6,644335
46001,10,-9,1,343760,10,343750
46002,13,-19,567,58476,13,58463
46003,5,-20,52,1106,5,1101
46004,5,-14,303,193291,5,193286
46005,17,-13,729,246395,17,246378
46006,13,4,375,775920,13,775907
46007,9,-12,743,265544,9,265535
46008,15,19,279,1242991,15,1242976
46009,14,4,90,773919,14,773905
46010,19,4,694,778338,19,778319
46011,8,13,660,1045008,8,1045000
46012,14,-8,323,400178,14,400164
46013,18,-9,289,368702,18,368684
46014,7,19,384,1226182,7,1226175
46015,6,12,464,1009077,6,1009071
46016,14,-11,785,309855,14,309841
46017,15,2,934,717388,15,717373
46018,8,-4,823,516880,8,516872
46019,17,17,376,1180759,17,1180742
46020,15,-5,387,493864,15,493849
46021,19,18,22,1209064,19,1209045
46022,10,13,318,1037555,10,1037545
46023,16,-3,515,557769,16,557753
46024,13,11,550,994790,13,994777
46025,7,-3,643,544947,7,544940
46026,19,-15,586,182104,19,182085
46027,11,6,370,838642,11,838631
46028,11,-2,168,586301,11,586290
46029,17,18,549,1212986,17,1212969
46030,9,-17,191,97444,9,97435
46031,13,-15,731,183236,13,183223
46032,18,-4,366,524960,18,524942
46033,17,19,154,1242012,17,1241995
46034,9,-1,307,600705,9,600696
46035,17,-1,927,623661,17,623644
46036,11,-10,817,341237,11,341226
46037,19,-13,872,247545,19,247526
46038,11,-3,978,561611,11,561600
46039,8,11,199,972508,8,972500
46040,5,-10,839,330627,5,330622
46041,16,-14,31,209559,16,209543
46042,10,8,246,880636,10,880626
46043,13,-8,15,397996,13,397983
46044,18,6,386,838809,18,838791
46045,19,-19,40,54170,19,54151
46046,8,1,70,658530,8,658522
46047,7,-4,3,499423,7,499416
46048,10,9,468,916507,10,916497
46049,20,3,249,743744,20,743724
46050,19,16,576,1151165,19,1151146
46051,12,-3,905,561041,12,561029
46052,17,-11,386,306827,17,306810
46053,6,2,138,691543,6,691537
46054,12,-20,155,23926,12,23914
46055,16,-15,404,180731,16,180715
46056,10,-2,527,573951,10,573941
46057,7,16,539,1136610,7,1136603
46058,11,-8,896,404272,11,404261
46059,5,-4,455,509340,5,509335
46060,10,-17,321,100442,10,100432
46061,6,12,137,1002092,6,1002086
46062,9,15,1,1094371,9,1094362
46063,15,-12,966,279834,15,279819
46064,11,16,993,1154227,11,1154216
46065,18,-20,580,27209,18,27191
46066,17,9,751,934541,17,934524
46067,17,-4,352,524845,17,524828
46068,10,-9,193,347689,10,347679
46069,15,-10,661,340065,15,340050
46070,6,1,67,658476,6,658470
46071,16,-19,416,57201,16,57185
46072,6,19,781,1234773,6,1234767
46073,20,-6,905,465985,20,465965
46074,20,8,935,905229,20,905209
46075,10,12,255,1004774,10,1004764
46076,19,-13,711,246253,19,246234
46077,5,7,677,859192,5,859187
46078,9,4,496,761242,9,761233
46079,20,17,116,1178708,20,1178688
46080,7,3,867,737610,7,737603
46081,20,6,502,839847,20,839827
46082,13,-10,120,335987,13,335974
46083,9,6,469,823032,9,823023
46084,13,0,68,648742,13,648729
46085,9,16,229,1130122,9,1130113
46086,20,12,251,1023919,20,1023899
46087,5,-7,390,414358,5,414353
46088,19,19,535,1245187,19,1245168
46089,19,12,248,1023887,19,1023868
46090,14,2,461,714110,14,714096
46091,5,-16,52,124938,5,124933
46092,9,-15,539,167030,9,167021
46093,6,-10,936,332582,6,332576
46094,18,-2,28,585349,18,585331
46095,5,2,177,692499,5,692494
46096,16,-16,589,151330,16,151314
46097,13,-8,854,403925,13,403912
46098,15,-6,872,465678,15,465663
46099,5,-18,284,68664,5,68659
46100,6,1,364,665219,6,665213
46101,11,0,205,649798,11,649787
46102,20,-4,446,525494,20,525474
46103,15,-8,824,403764,15,403749
46104,14,-16,897,153535,14,153521
46105,5,2,738,704188,5,704183
46106,17,-17,267,117453,17,117436
46107,5,-4,17,499684,5,499679
46108,10,-5,233,473105,10,473095
46109,20,1,880,686626,20,686606
46110,14,12,80,1022620,14,1022606
46111,9,8,411,884253,9,884244
46112,17,14,69,1085998,17,1085981
46113,20,-6,771,465031,20,465011
46114,15,-4,269,524163,15,524148
46115,17,-11,259,305755,17,305738
46116,7,18,344,1194172,7,1194165
46117,13,10,935,967027,13,967014
46118,9,18,575,1198976,9,1198967
46119,12,-10,308,337274,12,337262
46120,12,3,722,747328,12,747316
46121,5,-19,408,40362,5,40357
46122,13,-1,940,623738,13,623725
46123,17,16,811,1152935,17,1152918
46124,5,1,792,674218,5,674213
46125,6,-16,366,131809,6,131803
46126,13,10,573,964308,13,964295
46127,20,-2,828,591430,20,591410
46128,13,8,775,904113,13,904100
46129,13,6,93,836448,13,836435
46130,14,19,214,1242444,14,1242430
46131,19,2,506,714443,19,714424
46132,7,-9,753,360259,7,360252
46133,20,-2,767,590859,20,590839
46134,18,-1,429,619963,18,619945
46135,13,-11,762,309668,13,309655
46136,13,16,97,1147736,13,1147723
46137,16,19,363,1243718,16,1243702
46138,12,-3,233,555391,12,555379
46139,16,-9,916,373855,16,373839
46140,11,16,291,1149233,11,1149222
46141,13,-13,52,241455,13,241442
46142,17,5,505,807487,17,807470
46143,5,1,119,659705,5,659700
46144,18,7,232,868652,18,868634
46145,18,-17,878,122025,18,122007
46146,8,14,210,1066336,8,1066328
46147,11,13,915,1059964,11,1059953
46148,9,-7,209,410310,9,410301
46149,18,13,860,1059676,18,1059658
46150,16,-13,591,245405,16,245389
46151,11,13,85,1053866,11,1053855
46152,15,3,674,746973,15,746958
46153,16,14,399,1088558,16,1088542
46154,20,3,855,748268,20,748248
46155,16,-17,534,119478,16,119462
46156,8,6,405,821550,8,821542
46157,20,-4,646,526932,20,526912
46158,20,-8,651,402459,20,402439
46159,19,6,143,836846,19,836827
46160,16,-9,706,372004,16,371988
46161,13,-16,225,148635,13,148622
46162,15,9,929,935999,15,935984
46163,20,-16,265,148937,20,148917
46164,7,6,882,832111,7,832104
46165,10,16,172,1128736,10,1128726
46166,19,-2,35,585397,19,585378
46167,5,-5,974,489229,5,489224
46168,16,-5,990,498278,16,498262
46169,8,-14,988,208051,8,208043
46170,12,4,390,776024,12,776012
46171,5,-7,891,424977,5,424972
46172,17,11,946,997675,17,997658
46173,17,-6,135,460121,17,460104
46174,18,-9,645,371636,18,371618
46175,20,19,363,1243728,20,1243708
46176,15,-15,973,185162,15,185147
46177,17,-11,581,308386,17,308369
46178,16,-14,355,212160,16,212144
46179,19,-1,870,623200,19,623181
46180,15,-17,73,116052,15,116037
46181,12,17,467,1181424,12,1181412
46182,6,-11,655,295570,6,295564
46183,17,-11,628,308729,17,308712
46184,15,6,170,837011,15,836996
46185,18,18,549,1212994,18,1212976
46186,10,0,446,635050,10,635040
46187,12,-17,84,116191,12,116179
46188,13,11,500,994485,13,994472
46189,19,-3,989,561686,19,561667
46190,14,-4,417,525356,14,525342
46191,9,-12,331,256855,9,256846
46192,14,-19,702,59438,14,59424
46193,17,-7,191,429722,17,429705
46194,6,7,438,854200,6,854194
46195,19,-20,83,23410,19,23391
46196,11,6,155,836935,11,836924
46197,6,-8,455,384728,6,384722
46198,11,14,145,1086606,11,1086595
46199,14,-16,250,148815,14,148801
46200,12,-20,955,30018,12,30006
46201,14,9,992,936472,14,936458
46202,19,-18,444,88583,19,88564
46203,11,-1,368,619551,11,619540
46204,15,19,985,1248674,15,1248659
46205,18,13,145,1054258,18,1054240
46206,6,11,579,980866,6,980860
46207,15,16,427,1150213,15,1150198
46208,14,-20,804,29049,14,29035
46209,9,0,940,645766,9,645757
46210,11,6,457,839422,11,839411
46211,5,6,201,816574,5,816569
46212,7,-19,557,43629,7,43622
46213,16,5,217,805463,16,805447
46214,19,9,840,935301,19,935282
46215,9,16,199,1129367,9,1129358
46216,15,11,388,993732,15,993717
46217,8,5,69,783115,8,783107
46218,8,-14,749,202962,8,202954
46219,13,-4,317,524571,13,524558
46220,5,12,730,1015049,5,1015044
46221,18,0,33,648506,18,648488
46222,10,3,822,736562,10,736552
46223,14,1,258,681939,14,681925
46224,5,-15,63,156644,5,156639
46225,19,9,614,933624,19,933605
46226,18,6,925,843123,18,843105
46227,15,0,710,653697,15,653682
46228,7,9,523,917797,7,917790
46229,8,-19,935,51595,8,51587
46230,6,15,852,1112607,6,1112601
46231,19,14,1,1085361,19,1085342
46232,14,-5,284,493146,14,493132
46233,13,3,284,744052,13,744039
46234,6,-17,669,107905,6,107899
46235,8,4,765,767274,8,767266
46236,17,8,724,903727,17,903710
46237,19,-13,675,245889,19,245870
46238,12,10,147,961005,12,960993
46239,6,-7,470,415881,6,415875
46240,10,15,419,1103152,10,1103142
46241,17,-8,501,401327,17,401310
46242,14,8,237,899915,14,899901
46243,18,13,615,1057949,18,1057931
46244,19,-5,127,491922,19,491903
46245,10,15,724,1109912,10,1109902
46246,16,6,389,838834,16,838818
46247,5,10,200,941776,5,941771
46248,17,5,923,810544,17,810527
46249,11,13,530,1057121,11,1057110
46250,7,19,479,1228436,7,1228429
46251,8,3,459,728648,8,728640
46252,19,9,585,933375,19,933356
46253,6,-15,968,176067,6,176061
46254,16,-20,99,23521,16,23505
46255,6,-10,832,330411,6,330405
46256,11,-13,924,247977,11,247966
46257,15,6,656,841042,15,841027
46258,6,-1,516,605246,6,605240
46259,14,-11,889,310657,14,310643
46260,15,3,835,748085,15,748070
46261,9,-5,922,488080,9,488071
46262,14,-20,998,30432,14,30418
46263,9,8,873,894129,9,894120
46264,13,-19,394,57077,13,57064
46265,17,-14,44,209661,17,209644
46266,18,11,251,992642,18,992624
46267,9,-13,575,230625,9,230616
46268,16,-20,887,29620,16,29604
46269,8,1,467,667397,8,667389
46270,11,14,117,1086392,11,1086381
46271,13,-11,65,304205,13,304192
46272,7,14,784,1079537,7,1079530
46273,7,11,568,980656,7,980649
46274,7,11,602,981354,7,981347
46275,11,9,478,932497,11,932486
46276,7,6,931,833169,7,833162
46277,18,-4,163,523309,18,523291
46278,16,17,333,1180480,16,1180464
46279,10,1,238,662433,10,662423
46280,5,8,104,877286,5,877281
46281,15,16,437,1150268,15,1150253
46282,9,-8,353,382850,9,382841
46283,10,-5,928,488221,10,488211
46284,19,-14,598,214245,19,214226
46285,17,7,961,873809,17,873792
46286,11,-4,125,523007,11,522996
46287,12,-14,708,215048,12,215036
46288,12,-16,305,149191,12,149179
46289,13,-6,985,466610,13,466597
46290,11,14,995,1093284,11,1093273
46291,11,-6,919,466103,11,466092
46292,12,18,933,1215804,12,1215792
46293,13,13,198,1054681,13,1054668
46294,5,-18,714,77780,5,77775
46295,13,-8,566,401859,13,401846
46296,9,15,875,1113060,9,1113051
46297,17,18,151,1210213,17,1210196
46298,17,-11,738,309446,17,309429
46299,13,3,745,747472,13,747459
46300,19,-2,823,591375,19,591356
46301,5,9,146,909838,5,909833
46302,13,-2,964,592476,13,592463
46303,10,6,648,826908,10,826898
46304,16,-11,93,304404,16,304388
46305,17,-12,722,277796,17,277779
46306,16,7,427,870206,16,870190
46307,7,-14,942,206943,7,206936
46308,19,1,352,682689,19,682670
46309,14,-14,875,216331,14,216317
46310,11,-7,117,429141,11,429130
46311,18,17,9,1177903,18,1177885
46312,8,-3,580,543516,8,543508
46313,10,-7,875,424442,10,424432
46314,16,19,172,1242137,16,1242121
46315,14,-5,14,490852,14,490838
46316,14,12,145,1023074,14,1023060
46317,10,-18,304,69167,10,69157
46318,14,14,975,1093084,14,1093070
46319,18,16,285,1149201,18,1149183
46320,18,-2,612,589732,18,589714
46321,15,9,266,930865,15,930850
46322,19,-18,646,89948,19,89929
46323,14,13,794,1059197,14,1059183
46324,12,-13,901,247724,12,247712
46325,16,18,438,1212262,16,1212246
46326,19,-1,518,620700,19,620681
46327,7,-2,211,567218,7,567211
46328,20,-2,614,589765,20,589745
46329,17,-14,668,214742,17,214725
46330,5,-9,894,363690,5,363685
46331,5,-13,736,234087,5,234082
46332,11,-15,22,177965,11,177954
46333,11,-14,992,217220,11,217209
46334,5,10,535,948920,5,948915
46335,6,-15,995,176646,6,176640
46336,19,-4,935,529060,19,529041
46337,5,-11,300,287661,5,287656
46338,13,16,801,1152867,13,1152854
46339,11,11,298,993091,11,993080
46340,14,16,428,1150223,14,1150209
46341,9,8,142,878151,9,878142
46342,16,-12,994,280061,16,280045
46343,15,12,308,1024390,15,1024375
46344,9,-1,227,598820,9,598811
46345,19,-6,207,460760,19,460741
46346,18,17,160,1179068,18,1179050
46347,6,11,428,977633,6,977627
46348,6,14,983,1083840,6,1083834
46349,11,-13,905,247784,11,247773
46350,8,3,177,722614,8,722606
46351,20,-10,987,342547,20,342527
46352,6,-17,536,104980,6,104974
46353,12,0,157,649406,12,649394
46354,19,-2,522,589087,19,589068
46355,11,10,227,961549,11,961538
46356,20,18,689,1213934,20,1213914
46357,12,-14,963,216959,12,216947
46358,16,-2,865,591729,16,591713
46359,18,5,974,810955,18,810937
46360,8,4,838,768999,8,768991
46361,14,-18,297,87547,14,87533
46362,5,14,408,1070877,5,1070872
46363,11,7,650,871761,11,871750
46364,13,-14,520,213556,13,213543
46365,15,8,479,901698,15,901683
46366,17,-8,834,403816,17,403799
46367,11,-19,970,61278,11,61267
46368,17,4,267,775128,17,775111
46369,19,-16,639,151707,19,151688
46370,9,19,625,1231500,9,1231491
46371,15,-19,799,60184,15,60169
46372,14,-4,403,525253,14,525239
46373,11,5,331,806221,11,806210
46374,10,1,32,657768,10,657758
46375,19,-14,489,213274,19,213255
46376,13,8,628,902949,13,902936
46377,13,-11,633,308749,13,308736
46378,10,-1,993,615378,10,615368
46379,15,5,354,806346,15,806331
46380,11,-5,641,495709,11,495698
46381,9,16,388,1133378,9,1133369
46382,16,-2,250,587010,16,586994
46383,6,-17,73,94965,6,94959
46384,9,-19,99,33664,9,33655
46385,16,-12,211,274034,16,274018
46386,12,-9,508,370679,12,370667
46387,16,-6,841,465512,16,465496
46388,7,-1,701,608975,7,608968
46389,6,-3,569,543335,6,543329
46390,17,2,821,716595,17,716578
46391,20,-19,300,56343,20,56323
46392,15,-18,309,87664,15,87649
46393,10,11,50,969559,10,969549
46394,6,1,445,666850,6,666844
46395,13,-20,885,29609,13,29596
46396,11,-15,2,177843,11,177832
46397,8,17,36,1156067,8,1156059
46398,5,10,749,953602,5,953597
46399,6,16,781,1141325,6,1141319
46400,15,-13,341,243565,15,243550
46401,12,18,617,1213367,12,1213355
46402,5,-11,467,291577,5,291572
46403,8,-9,948,364859,8,364851
46404,20,-17,239,117238,20,117218
46405,15,-3,359,556446,15,556431
46406,14,7,574,871257,14,871243
46407,10,-10,100,314745,10,314735
46408,20,-13,428,244154,20,244134
46409,5,11,483,978759,5,978754
46410,9,3,144,721947,9,721938
46411,18,8,600,902671,18,902653
46412,9,-19,861,50339,9,50330
46413,8,16,416,1134156,8,1134148
46414,20,-9,900,373741,20,373721
46415,13,-11,986,311441,13,311428
46416,19,9,741,934482,19,934463
46417,16,-19,681,59319,16,59303
46418,10,-10,334,319790,10,319780
46419,7,18,410,1195484,7,1195477
46420,7,19,992,1239422,7,1239415
46421,5,7,238,849861,5,849856
46422,19,-4,630,526841,19,526822
46423,10,-7,126,408466,10,408456
46424,18,16,474,1150504,18,1150486
46425,13,-7,60,428744,13,428731
46426,12,-18,196,86815,12,86803
46427,10,-8,974,396274,10,396264
46428,13,-18,819,91225,13,91212
46429,10,15,155,1097780,10,1097770
46430,5,-5,204,472422,5,472417
46431,15,13,172,1054470,15,1054455
46432,10,2,839,706140,10,706130
46433,20,-16,443,150303,20,150283
46434,7,6,278,818548,7,818541
46435,5,-2,265,568510,5,568505
46436,20,6,107,836573,20,836553
46437,5,0,47,626308,5,626303
46438,9,-9,231,348533,9,348524
46439,10,18,533,1198260,10,1198250
46440,13,13,453,1056619,13,1056606
46441,12,4,377,775952,12,775940
46442,12,-20,878,29576,12,29564
46443,19,3,159,743009,19,742990
46444,15,6,12,835861,15,835846
46445,11,-11,398,306912,11,306901
46446,10,7,381,853017,10,853007
46447,13,-4,782,527903,13,527890
46448,18,9,987,936431,18,936413
46449,14,-4,122,522957,14,522943
46450,7,7,854,862877,7,862870
46451,13,-3,124,554695,13,554682
46452,5,-18,741,78402,5,78397
46453,17,-9,454,370180,17,370163
46454,17,9,871,935509,17,935492
46455,12,-18,476,88825,12,88813
46456,14,8,942,905280,14,905266
46457,5,-4,453,509298,5,509293
46458,8,-15,773,171957,8,171949
46459,15,-2,428,588347,15,588332
46460,14,-12,766,278173,14,278159
46461,16,-3,558,558184,16,558168
46462,8,-6,185,440929,8,440921
46463,20,2,89,711217,20,711197
46464,14,-12,539,276538,14,276524
46465,10,-2,577,574992,10,574982
46466,10,-9,441,353419,10,353409
46467,19,16,325,1149470,19,1149451
46468,16,19,997,1248771,16,1248755
46469,14,9,752,934544,14,934530
46470,17,15,394,1119650,17,1119633
46471,17,-10,532,339013,17,338996
46472,9,-16,934,144111,9,144102
46473,7,-11,582,294113,7,294106
46474,16,-6,543,463376,16,463360
46475,9,9,477,916688,9,916679
46476,13,-5,894,497594,13,497581
46477,10,-3,408,539428,10,539418
46478,9,0,611,638602,9,638593
46479,6,8,614,888575,6,888569
46480,17,9,493,932655,17,932638
46481,12,9,60,929507,12,929495
46482,14,13,553,1057416,14,1057402
46483,19,6,9,835799,19,835780
46484,14,0,275,650189,14,650175
46485,9,-15,689,170095,9,170086
46486,19,-9,253,368439,19,368420
46487,12,17,343,1180554,12,1180542
46488,8,-13,855,236903,8,236895
46489,17,-6,502,463036,17,463019
46490,5,8,315,882150,5,882145
46491,14,9,290,931035,14,931021
46492,7,-18,969,83526,7,83519
46493,17,-16,378,149666,17,149649
46494,16,-5,471,494528,16,494512
46495,15,-18,872,91564,15,91549
46496,13,-2,855,591642,13,591629
46497,20,-14,938,216791,20,216771
46498,19,-15,79,178332,19,178313
46499,19,0,740,653975,19,653956
46500,17,-5,379,493823,17,493806
46501,16,-10,684,340243,16,340227
46502,17,-2,263,587115,17,587098
46503,14,-6,757,464931,14,464917
46504,17,4,416,776227,17,776210
46505,18,-15,702,182987,18,182969
46506,17,7,414,870086,17,870069
46507,16,-4,406,525270,16,525254
46508,12,-17,59,115959,12,115947
46509,12,14,988,1093205,12,1093193
46510,15,-16,461,150466,15,150451
46511,9,12,633,1012840,9,1012831
46512,18,-11,84,304316,18,304298
46513,6,-10,826,330317,6,330311
46514,10,-17,864,111727,10,111717
46515,20,-17,703,120787,20,120767
46516,10,0,972,646486,10,646476
46517,13,-9,483,370491,13,370478
46518,11,8,379,900938,11,900927
46519,14,-12,994,280065,14,280051
46520,9,-8,515,386160,9,386151
46521,6,-15,196,159483,6,159477
46522,6,-15,472,165662,6,165656
46523,8,-5,976,489260,8,489252
46524,8,-10,539,324245,8,324237
46525,5,12,788,1016164,5,1016159
46526,20,8,895,904914,20,904894
46527,5,1,160,660685,5,660680
46528,7,-16,749,140105,7,140098
46529,9,-12,295,255966,9,255957
46530,14,12,978,1029657,14,1029643
46531,6,2,724,703917,6,703911
46532,8,-1,447,603774,8,603766
46533,9,4,576,762984,9,762975
46534,9,-9,421,352840,9,352831
46535,12,-4,55,522444,12,522432
46536,18,6,212,837292,18,837274
46537,16,1,312,682319,16,682303
46538,15,11,338,993341,15,993326
46539,11,-3,674,559160,11,559149
46540,6,-14,81,188363,6,188357
46541,11,-7,883,434785,11,434774
46542,15,-1,354,619438,15,619423
46543,9,1,877,676050,9,676041
46544,6,11,915,988232,6,988226
46545,14,-12,815,278490,14,278476
46546,14,17,913,1184780,14,1184766
46547,19,-2,727,590596,19,590577
46548,11,17,851,1184391,11,1184380
46549,12,7,123,867912,12,867900
46550,12,-19,142,55137,12,55125
46551,8,-2,236,567819,8,567811
46552,7,-10,171,316384,7,316377
46553,15,-2,872,591768,15,591753
46554,10,2,57,689880,10,689870
46555,12,8,536,902190,12,902178
46556,11,-20,151,23916,11,23905
46557,5,0,864,644099,5,644094
46558,14,-3,879,560818,14,560804
46559,11,7,321,869350,11,869339
46560,7,16,905,1143941,7,1143934
46561,18,-15,697,182919,18,182901
46562,6,-13,774,235206,6,235200
46563,20,3,577,746172,20,746152
46564,15,10,692,965241,15,965226
46565,8,-12,656,263786,8,263778
46566,9,-19,390,39968,9,39959
46567,8,15,897,1113536,8,1113528
46568,12,4,365,775854,12,775842
46569,20,-13,245,242851,20,242831
46570,5,-9,48,344683,5,344678
46571,10,-9,595,356954,10,356944
46572,18,-3,783,560096,18,560078
46573,10,13,679,1045345,10,1045335
46574,8,-16,605,137197,8,137189
46575,13,1,941,687195,13,687182
46576,16,-4,331,524656,16,524640
46577,16,-11,307,306223,16,306207
46578,20,-15,638,182515,20,182495
46579,10,-10,235,317669,10,317659
46580,5,12,577,1011467,5,1011462
46581,6,1,456,667154,6,667148
46582,10,17,903,1174778,10,1174768
46583,11,5,508,807495,11,807484
46584,9,19,746,1234073,9,1234064
46585,16,14,276,1087572,16,1087556
46586,7,6,116,814726,7,814719
46587,12,-6,387,462108,12,462096
46588,9,13,520,1041864,9,1041855
46589,8,-4,985,520679,8,520671
46590,8,11,155,971638,8,971630
46591,12,4,765,778893,12,778881
46592,11,-10,951,342235,11,342224
46593,12,12,930,1029211,12,1029199
46594,5,3,422,727860,5,727855
46595,20,-13,425,244108,20,244088
46596,14,-14,486,213252,14,213238
46597,14,-20,774,28782,14,28768
46598,8,-12,476,259890,8,259882
46599,16,-1,724,622185,16,622169
46600,20,-20,872,29525,20,29505
46601,14,6,300,838062,14,838048
46602,20,10,635,964825,20,964805
46603,13,-14,483,213221,13,213208
46604,16,9,841,935322,16,935306
46605,7,-11,462,291489,7,291482
46606,8,5,797,798252,8,798244
46607,14,-7,569,432590,14,432576
46608,16,-20,776,28789,16,28773
46609,14,-18,940,92048,14,92034
46610,6,10,268,943233,6,943227
46611,20,14,514,1089471,20,1089451
46612,6,14,733,1078499,6,1078493
46613,16,12,398,1024986,16,1024970
46614,19,19,657,1246094,19,1246075
46615,8,12,396,1007647,8,1007639
46616,7,17,525,1166577,7,1166570
46617,5,-10,653,326711,5,326706
46618,13,10,974,967280,13,967267
46619,13,-4,590,526528,13,526515
46620,19,-17,418,118523,19,118504
46621,10,-14,239,191940,10,191930
46622,11,-7,232,430024,11,430013
46623,6,6,704,828299,6,828293
46624,18,-11,225,305465,18,305447
46625,6,17,967,1176124,6,1176118
46626,16,5,278,805867,16,805851
46627,8,-20,478,10247,8,10239
46628,6,-7,601,418685,6,418679
46629,5,-2,375,570676,5,570671
46630,20,17,24,1178039,20,1178019
46631,16,7,676,872004,16,871988
46632,15,1,67,680290,15,680275
46633,12,-5,165,492251,12,492239
46634,6,7,52,845992,6,845986
46635,20,18,93,1209681,20,1209661
46636,9,-6,914,456308,9,456299
46637,19,12,919,1029120,19,1029101
46638,8,-8,795,392376,8,392368
46639,5,-7,830,423362,5,423357
46640,17,-10,191,336494,17,336477
46641,5,8,301,881815,5,881810
46642,8,10,703,952701,8,952693
46643,10,4,579,763044,10,763034
46644,6,4,998,772280,6,772274
46645,5,-6,995,458022,5,458017
46646,6,3,472,728935,6,728929
46647,19,7,824,872983,19,872964
46648,18,14,86,1086111,18,1086093
46649,12,-2,533,589128,12,589116
46650,8,-12,351,257290,8,257282
46651,11,-12,815,278491,11,278480
46652,20,6,521,840041,20,840021
46653,7,4,339,757832,7,757825
46654,19,-6,609,463797,19,463778
46655,11,-1,244,618477,11,618466
46656,17,-19,835,60408,17,60391
46657,16,-7,885,434827,16,434811
46658,6,-17,905,112663,6,112657
46659,7,-9,866,362952,7,362945
46660,19,2,106,711389,19,711370
46661,13,3,331,744405,13,744392
46662,12,-6,959,466391,12,466379
46663,14,3,133,742840,14,742826
46664,9,11,949,988794,9,988785
46665,20,2,196,712073,20,712053
46666,9,-4,424,508855,9,508846
46667,18,12,153,1023143,18,1023125
46668,12,4,762,778879,12,778867
46669,20,7,129,867937,20,867917
46670,19,9,785,934846,19,934827
46671,10,-3,533,542536,10,542526
46672,19,5,396,806687,19,806668
46673,11,-2,922,592146,11,592135
46674,15,3,123,742775,15,742760
46675,17,-1,41,616909,17,616892
46676,17,-15,720,183166,17,183149
46677,9,-4,509,510491,9,510482
46678,13,15,52,1117183,13,1117170
46679,13,13,313,1055489,13,1055476
46680,11,-7,849,434508,11,434497
46681,15,18,430,1212202,15,1212187
46682,20,-16,47,147128,20,147108
46683,7,11,969,989192,7,989185
46684,13,1,303,682252,13,682239
46685,5,-6,376,444882,5,444877
46686,5,-6,665,451043,5,451038
46687,8,9,69,908201,8,908193
46688,17,-5,70,491383,17,491366
46689,20,13,799,1059241,20,1059221
46690,9,-13,75,220005,9,219996
46691,14,9,274,930951,14,930937
46692,7,11,461,978286,7,978279
46693,16,0,230,649986,16,649970
46694,19,-14,235,211259,19,211240
46695,13,-12,689,277573,13,277560
46696,17,2,932,717384,17,717367
46697,9,17,696,1170159,9,1170150
46698,5,15,659,1108419,5,1108414
46699,8,-10,118,315146,8,315138
46700,9,7,201,849051,9,849042
46701,13,14,883,1092358,13,1092345
46702,10,17,136,1158137,10,1158127
46703,16,-15,350,180337,16,180321
46704,6,4,17,750836,6,750830
46705,5,-2,88,564708,5,564703
46706,8,-10,1000,334134,8,334126
46707,8,-14,533,198065,8,198057
46708,10,-4,530,510949,10,510939
46709,10,-15,701,170380,10,170370
46710,11,-7,404,431403,11,431392
46711,7,-14,144,189621,7,189614
46712,12,-14,246,211343,12,211331
46713,16,16,301,1149320,16,1149304
46714,7,-19,112,33999,7,33992
46715,10,-9,308,350316,10,350306
46716,18,1,149,681040,18,681022
46717,7,-12,269,255347,7,255340
46718,14,-1,276,618701,14,618687
46719,17,15,480,1120191,17,1120174
46720,16,-16,664,151812,16,151796
46721,10,5,878,800129,10,800119
46722,18,-13,829,247172,18,247154
46723,15,-13,412,244009,15,243994
46724,11,5,833,809863,11,809852
46725,16,15,4,1116758,16,1116742
46726,9,-2,611,575789,9,575780
46727,9,14,410,1070944,9,1070935
46728,15,18,608,1213293,15,1213278
46729,18,12,95,1022744,18,1022726
46730,11,-4,524,526089,11,526078
46731,10,-16,343,131286,10,131276
46732,19,-5,872,497406,19,497387
46733,15,19,798,1247225,15,1247210
46734,16,-6,733,464757,16,464741
46735,16,-19,237,55901,16,55885
46736,20,10,27,960039,20,960019
46737,6,17,842,1173492,6,1173486
46738,19,17,718,1183257,19,1183238
46739,18,-12,908,279398,18,279380
46740,11,0,124,649194,11,649183
46741,5,8,940,895618,5,895613
46742,8,-4,186,503491,8,503483
46743,20,-2,642,589939,20,589919
46744,8,13,831,1048614,8,1048606
46745,12,-4,858,528408,12,528396
46746,15,16,389,1149922,15,1149907
46747,6,-1,661,608155,6,608149
46748,17,3,214,743501,17,743484
46749,17,13,865,1059717,17,1059700
46750,15,9,747,934509,15,934494
46751,12,7,788,872725,12,872713
46752,20,3,461,745286,20,745266
46753,19,-12,902,279303,19,279284
46754,13,-17,799,121546,13,121533
46755,5,0,923,645425,5,645420
46756,8,10,418,946472,8,946464
46757,15,-20,539,26919,15,26904
46758,16,2,945,717512,16,717496
46759,19,-1,650,621610,19,621591
46760,11,-17,797,121518,11,121507
46761,14,-7,830,434319,14,434305
46762,8,-1,433,603424,8,603416
46763,5,-8,986,396505,5,396500
46764,6,15,243,1099693,6,1099687
46765,18,10,543,964010,18,963992
46766,10,-9,437,353277,10,353267
46767,19,-20,306,25210,19,25191
46768,13,11,604,995194,13,995181
46769,8,0,960,646249,8,646241
46770,10,15,46,1095460,10,1095450
46771,19,17,947,1184997,19,1184978
46772,14,-19,458,57497,14,57483
46773,17,-1,817,622853,17,622836
46774,8,-10,452,322445,8,322437
46775,8,16,78,1126798,8,1126790
46776,5,-7,742,421561,5,421556
46777,10,18,918,1206116,10,1206106
46778,17,-13,216,242618,17,242601
46779,5,0,610,638577,5,638572
46780,5,9,547,918287,5,918282
46781,17,1,39,680093,17,680076
46782,5,10,944,957808,5,957803
46783,10,4,543,762305,10,762295
46784,17,2,675,715703,17,715686
46785,10,-7,367,413851,10,413841
46786,17,8,618,902829,17,902812
46787,15,-5,525,494937,15,494922
46788,11,-6,582,463600,11,463589
46789,20,4,320,775501,20,775481
46790,18,-18,180,86702,18,86684
46791,19,-18,648,89965,19,89946
46792,18,-18,541,89203,18,89185
46793,11,13,88,1053882,11,1053871
46794,13,-17,910,122244,13,122231
46795,9,-12,314,256458,9,256449
46796,18,-16,26,146944,18,146926
46797,9,3,845,737052,9,737043
46798,16,-14,763,215441,16,215425
46799,11,-18,935,92014,11,92003
46800,18,-12,760,278112,18,278094
46801,19,12,948,1029390,19,1029371
46802,12,13,244,1055009,12,1054997
46803,12,-12,775,278203,12,278191
46804,9,-16,79,125571,9,125562
46805,9,-7,17,406429,9,406420
46806,6,2,547,700208,6,700202
46807,18,-19,728,59686,18,59668
46808,20,12,781,1027867,20,1027847
46809,18,-10,55,335569,18,335551
46810,12,-11,23,303834,12,303822
46811,12,-16,513,150782,12,150770
46812,12,-12,613,276949,12,276937
46813,9,-19,661,45996,9,45987
46814,19,-1,638,621492,19,621473
46815,6,-14,21,186942,6,186936
46816,5,-2,285,568889,5,568884
46817,12,-13,206,242555,12,242543
46818,20,-12,864,278991,20,278971
46819,7,-11,709,296496,7,296489
46820,9,-13,676,232566,9,232557
46821,5,-9,367,351704,5,351699
46822,16,-10,443,338333,16,338317
46823,17,-8,941,404538,17,404521
46824,13,11,174,992068,13,992055
46825,15,8,181,899348,15,899333
46826,11,15,202,1118308,11,1118297
46827,8,-4,78,501037,8,501029
46828,18,3,913,748723,18,748705
46829,20,-4,630,526851,20,526831
46830,10,15,694,1109197,10,1109187
46831,7,11,566,980577,7,980570
46832,20,-19,353,56769,20,56749
46833,9,-13,983,239622,9,239613
46834,10,16,351,1132634,10,1132624
46835,20,12,198,1023489,20,1023469
46836,9,15,407,1102997,9,1102988
46837,9,-1,440,603622,9,603613
46838,9,16,866,1143059,9,1143050
46839,5,19,475,1228357,5,1228352
46840,7,15,396,1102836,7,1102829
46841,20,3,412,744962,20,744942
46842,10,7,249,850176,10,850166
46843,12,18,248,1210966,12,1210954
46844,6,3,968,740019,6,740013
46845,19,-20,726,28373,19,28354
46846,12,16,516,1150777,12,1150765
46847,18,4,219,774863,18,774845
46848,19,-15,137,178846,19,178827
46849,9,18,623,1199912,9,1199903
46850,12,4,378,775970,12,775958
46851,7,12,323,1006258,7,1006251
46852,7,-7,974,426681,7,426674
46853,12,1,416,683134,12,683122
46854,10,5,709,796420,10,796410
46855,9,-8,863,393771,9,393762
46856,9,-20,501,10751,9,10742
46857,10,11,198,972501,10,972491
46858,11,4,13,773362,11,773351
46859,15,-8,352,400373,15,400358
46860,10,13,195,1034911,10,1034901
46861,14,-10,382,337813,14,337799
46862,6,-17,545,105255,6,105249
46863,10,-15,635,169131,10,169121
46864,13,-18,919,91886,13,91873
46865,10,-20,113,2476,10,2466
46866,12,-1,261,618578,12,618566
46867,16,0,338,650586,16,650570
46868,5,3,881,737837,5,737832
46869,10,14,31,1062476,10,1062466
46870,9,13,613,1043987,9,1043978
46871,8,-5,615,481333,8,481325
46872,5,-2,855,581115,5,581110
46873,13,-14,169,210590,13,210577
46874,12,16,734,1152332,12,1152320
46875,20,-20,2,2046,20,2026
46876,12,6,249,837643,12,837631
46877,20,-6,986,466634,20,466614
46878,16,-13,259,242979,16,242963
46879,12,18,988,1216217,12,1216205
46880,5,0,986,646761,5,646756
46881,13,1,241,681791,13,681778
46882,8,-18,388,70748,8,70740
46883,16,-3,585,558397,16,558381
46884,18,-14,886,216403,18,216385
46885,13,-17,614,120096,13,120083
46886,5,5,672,795497,5,795492
46887,9,18,500,1197377,9,1197368
46888,19,4,400,776079,19,776060
46889,17,18,501,1212616,17,1212599
46890,7,-5,360,476035,7,476028
46891,16,7,729,872306,16,872290
46892,18,-20,723,28341,18,28323
46893,16,-16,632,151663,16,151647
46894,17,4,698,778358,17,778341
46895,6,5,537,792769,6,792763
46896,13,6,305,838094,13,838081
46897,9,-16,117,126620,9,126611
46898,14,-20,583,27240,14,27226
46899,10,-1,865,612462,10,612452
46900,14,-7,633,432923,14,432909
46901,7,17,500,1166024,7,1166017
46902,5,11,737,984186,5,984181
46903,19,8,960,905417,19,905398
46904,13,10,589,964431,13,964418
46905,17,-14,205,210915,17,210898
46906,20,-11,949,311124,20,311104
46907,20,-19,628,58961,20,58941
46908,16,11,216,992330,16,992314
46909,16,-14,848,216136,16,216120
46910,18,10,866,966478,18,966460
46911,10,-1,969,614767,10,614757
46912,7,-17,697,108420,7,108413
46913,9,-18,715,77797,9,77788
46914,12,1,993,687518,12,687506
46915,16,-2,52,585554,16,585538
46916,13,-3,326,556153,13,556140
46917,10,10,312,944150,10,944140
46918,5,-19,642,45682,5,45677
46919,18,-7,224,429977,18,429959
46920,5,-11,72,282678,5,282673
46921,6,-16,368,131871,6,131865
46922,7,3,601,731668,7,731661
46923,9,16,568,1137171,9,1137162
46924,13,-7,167,429553,13,429540
46925,5,-2,132,565692,5,565687
46926,6,5,772,797771,6,797765
46927,17,12,396,1024970,17,1024953
46928,15,4,837,779487,15,779472
46929,17,-2,507,588964,17,588947
46930,9,-19,640,45620,9,45611
46931,17,12,311,1024395,17,1024378
46932,11,4,279,775202,11,775191
46933,14,-12,856,278878,14,278864
46934,9,4,527,762010,9,762001
46935,6,-20,442,9471,6,9465
46936,18,-10,821,341260,18,341242
46937,10,-10,231,317602,10,317592
46938,12,-2,102,585897,12,585885
46939,14,7,919,873581,14,873567
46940,19,-18,521,89105,19,89086
46941,6,11,731,984071,6,984065
46942,12,-8,790,403537,12,403525
46943,18,-15,71,178288,18,178270
46944,20,-8,794,403562,20,403542
46945,12,-10,152,336226,12,336214
46946,6,3,545,730243,6,730237
46947,20,2,116,711475,20,711455
46948,19,8,140,899045,19,899026
46949,12,1,897,686789,12,686777
46950,8,-10,120,315185,8,315177
46951,19,17,468,1181436,19,1181417
46952,14,1,918,687020,14,687006
46953,10,6,656,827089,10,827079
46954,13,3,504,745593,13,745580
46955,14,-15,532,181692,14,181678
46956,14,-16,730,152270,14,152256
46957,9,9,704,921586,9,921577
46958,20,13,349,1055803,20,1055783
46959,17,-15,992,185272,17,185255
46960,12,14,494,1089304,12,1089292
46961,8,-4,35,500043,8,500035
46962,17,4,185,774579,17,774562
46963,15,-5,139,491989,15,491974
46964,11,-7,203,429828,11,429817
46965,19,-18,88,85882,19,85863
46966,5,-16,767,140532,5,140527
46967,9,3,746,734988,9,734979
46968,17,-16,215,148546,17,148529
46969,9,-1,383,602375,9,602366
46970,13,13,341,1055744,13,1055731
46971,14,10,391,962759,14,962745
46972,15,15,481,1120205,15,1120190
46973,12,-11,635,308761,12,308749
46974,15,5,167,805000,15,804985
46975,8,-15,830,173140,8,173132
46976,8,17,180,1159041,8,1159033
46977,11,3,241,743694,11,743683
46978,6,-10,672,327260,6,327254
46979,6,17,163,1158683,6,1158677
46980,19,-7,400,431384,19,431365
46981,18,-2,216,586749,18,586731
46982,8,-10,252,318059,8,318051
46983,5,-8,98,377456,5,377451
46984,19,-14,190,210759,19,210740
46985,12,-7,893,434924,12,434912
46986,16,5,569,807924,16,807908
46987,18,16,549,1150986,18,1150968
46988,17,11,350,993428,17,993411
46989,14,-15,638,182519,14,182505
46990,8,-13,369,226064,8,226056
46991,5,12,127,1001889,5,1001884
46992,15,12,523,1025855,15,1025840
46993,20,19,879,1247882,20,1247862
46994,8,-10,870,331211,8,331203
46995,12,9,962,936262,12,936250
46996,17,17,697,1183080,17,1183063
46997,20,15,27,1117003,20,1116983
46998,18,11,504,994507,18,994489
46999,14,4,282,775208,14,775194
47000,9,-1,509,605081,9,605072
47001,12,-16,247,148775,12,148763
47002,11,7,17,867144,11,867133
47003,17,-15,540,181730,17,181713
47004,8,-2,875,581538,8,581530
47005,18,-1,706,622010,18,621992
47006,10,-1,467,604284,10,604274
47007,20,-4,321,524604,20,524584
47008,5,10,902,956839,5,956834
47009,19,13,664,1058263,19,1058244
47010,6,-8,128,378077,6,378071
47011,12,4,661,778062,12,778050
47012,8,8,273,881120,8,881112
47013,10,14,148,1065155,10,1065145
47014,11,-1,309,619042,11,619031
47015,14,3,559,745930,14,745916
47016,15,-11,917,310870,15,310855
47017,18,-9,141,367610,18,367592
47018,17,-8,460,401046,17,401029
47019,6,3,90,720759,6,720753
47020,7,3,586,731270,7,731263
47021,14,-15,174,179032,14,179018
47022,5,1,231,662240,5,662235
47023,12,-14,843,216070,12,216058
47024,10,12,283,1005462,10,1005452
47025,14,-17,503,119245,14,119231
47026,8,-4,277,505614,8,505606
47027,12,2,348,713210,12,713198
47028,12,16,130,1147985,12,1147973
47029,16,-16,271,148974,16,148958
47030,7,7,487,855292,7,855285
47031,17,4,869,779738,17,779721
47032,15,13,233,1054954,15,1054939
47033,15,19,497,1244864,15,1244849
47034,8,6,361,820376,8,820368
47035,7,-2,22,563248,7,563241
47036,19,18,498,1212601,19,1212582
47037,5,-18,832,80395,5,80390
47038,8,-9,140,346565,8,346557
47039,11,-20,902,29758,11,29747
47040,13,-8,368,400454,13,400441
47041,17,9,178,930390,17,930373
47042,20,-1,225,618342,20,618322
47043,6,18,788,1203471,6,1203465
47044,17,-17,68,116002,17,115985
47045,17,-10,358,337632,17,337615
47046,20,0,180,649607,20,649587
47047,5,16,52,1126246,5,1126241
47048,9,18,150,1190131,9,1190122
47049,14,-6,971,466453,14,466439
47050,18,-1,265,618625,18,618607
47051,20,14,931,1092726,20,1092706
47052,8,-17,218,98121,8,98113
47053,16,-11,19,303817,16,303801
47054,17,-7,140,429317,17,429300
47055,6,16,264,1130834,6,1130828
47056,20,8,408,901240,20,901220
47057,7,-3,650,545117,7,545110
47058,9,-20,986,21805,9,21796
47059,16,17,189,1179320,16,1179304
47060,10,-1,564,606220,10,606210
47061,12,-16,471,150525,12,150513
47062,19,8,660,903156,19,903137
47063,16,0,652,653252,16,653236
47064,6,16,845,1142653,6,1142647
47065,12,5,172,805027,12,805015
47066,5,-17,35,94307,5,94302
47067,13,1,137,680957,13,680944
47068,20,6,364,838574,20,838554
47069,14,-1,157,617728,14,617714
47070,9,5,674,795544,9,795535
47071,10,11,607,981468,10,981458
47072,13,14,466,1089085,13,1089072
47073,20,-3,815,560338,20,560318
47074,11,9,166,930294,11,930283
47075,12,-9,627,371495,12,371483
47076,19,-12,632,277103,19,277084
47077,16,-5,337,493647,16,493631
47078,5,-6,410,445548,5,445543
47079,15,-8,937,404510,15,404495
47080,12,10,817,966195,12,966183
47081,19,-2,382,587930,19,587911
47082,14,-10,655,339998,14,339984
47083,17,12,165,1023255,17,1023238
47084,19,-4,868,528513,19,528494
47085,16,-2,902,592013,16,591997
47086,13,-8,841,403860,13,403847
47087,5,-4,494,510086,5,510081
47088,12,3,208,743460,12,743448
47089,18,13,629,1058031,18,1058013
47090,16,-1,844,623033,16,623017
47091,13,-16,685,151928,13,151915
47092,19,-1,256,618538,19,618519
47093,8,6,424,821959,8,821951
47094,18,-13,927,248011,18,247993
47095,17,-17,388,118361,17,118344
47096,13,-9,930,373928,13,373915
47097,17,0,586,652720,17,652703
47098,15,-20,981,30271,15,30256
47099,6,-16,654,138154,6,138148
47100,20,-19,467,57558,20,57538
47101,14,4,949,780262,14,780248
47102,15,-1,8,616556,15,616541
47103,16,17,896,1184685,16,1184669
47104,17,-9,221,368139,17,368122
47105,19,-20,804,29058,19,29039
47106,13,4,476,776677,13,776664
47107,20,18,269,1211138,20,1211118
47108,6,13,369,1038644,6,1038638
47109,11,13,64,1053690,11,1053679
47110,14,19,916,1248177,14,1248163
47111,11,0,206,649807,11,649796
47112,8,10,406,946207,8,946199
47113,6,8,448,885003,6,884997
47114,12,-2,369,587812,12,587800
47115,12,-3,393,556679,12,556667
47116,8,-17,254,98871,8,98863
47117,16,12,501,1025734,16,1025718
47118,14,-10,440,338281,14,338267
47119,12,19,855,1247696,12,1247684
47120,15,8,251,899968,15,899953
47121,19,3,471,745371,19,745352
47122,7,-10,455,322493,7,322486
47123,14,-13,459,244333,14,244319
47124,11,16,753,1152419,11,1152408
47125,17,0,481,651788,17,651771
47126,17,13,396,1056176,17,1056159
47127,19,-7,773,433948,19,433929
47128,17,0,896,655085,17,655068
47129,12,11,52,991260,12,991248
47130,15,-10,406,338005,15,337990
47131,18,-11,642,308856,18,308838
47132,5,8,70,876521,5,876516
47133,11,15,388,1119610,11,1119599
47134,9,15,923,1114079,9,1114070
47135,15,-11,813,310048,15,310033
47136,16,1,714,685372,16,685356
47137,12,1,584,684506,12,684494
47138,14,-3,641,558914,14,558900
47139,11,-14,814,215892,11,215881
47140,8,-20,224,5083,8,5075
47141,15,0,759,654101,15,654086
47142,5,19,905,1237679,5,1237674
47143,16,-2,755,590775,16,590759
47144,15,17,387,1180837,15,1180822
47145,14,-7,225,429991,14,429977
47146,14,5,310,806031,14,806017
47147,19,-13,456,244325,19,244306
47148,15,-18,804,91109,15,91094
47149,5,-3,166,533937,5,533932
47150,8,18,308,1193415,8,1193407
47151,9,-7,785,422440,9,422431
47152,14,4,591,777573,14,777559
47153,13,-3,894,560953,13,560940
47154,8,19,323,1224773,8,1224765
47155,18,7,36,867309,18,867291
47156,17,-8,131,398815,17,398798
47157,16,-5,869,497364,16,497348
47158,13,3,672,746930,13,746917
47159,19,-19,550,58300,19,58281
47160,9,0,906,645021,9,645012
47161,17,-16,5,146754,17,146737
47162,12,-8,561,401781,12,401769
47163,6,-8,991,396562,6,396556
47164,20,18,944,1215897,20,1215877
47165,8,-16,509,135113,8,135105
47166,17,-8,162,399052,17,399035
47167,8,0,124,628161,8,628153
47168,5,12,689,1014254,5,1014249
47169,5,14,28,1062395,5,1062390
47170,18,-8,957,404684,18,404666
47171,10,-12,658,263834,10,263824
47172,12,10,258,961756,12,961744
47173,5,-15,975,176229,5,176224
47174,10,-19,86,33290,10,33280
47175,6,9,549,918343,6,918337
47176,5,-6,18,437215,5,437210
47177,7,9,663,920707,7,920700
47178,7,14,137,1064904,7,1064897
47179,17,19,718,1246598,17,1246581
47180,15,9,422,932100,15,932085
47181,5,-4,365,507561,5,507556
47182,5,-10,913,332027,5,332022
47183,18,-19,333,56584,18,56566
47184,12,14,935,1092744,12,1092732
47185,8,-11,101,283296,8,283288
47186,5,12,983,1020751,5,1020746
47187,7,5,572,793412,7,793405
47188,7,-12,473,259832,7,259825
47189,19,17,754,1183488,19,1183469
47190,7,16,738,1140440,7,1140433
47191,14,3,681,747017,14,747003
47192,11,-7,519,432264,11,432253
47193,17,-19,276,56162,17,56145
47194,5,-2,203,567104,5,567099
47195,20,-7,864,434645,20,434625
47196,5,-1,610,607114,5,607109
47197,9,2,458,698418,9,698409
47198,11,-15,463,181192,11,181181
47199,13,-13,214,242588,13,242575
47200,16,-4,718,527462,16,527446
47201,5,-15,283,161456,5,161451
47202,7,14,5,1061797,7,1061790
47203,9,-18,733,78192,9,78183
47204,20,-10,569,339334,20,339314
47205,13,18,323,1211447,13,1211434
47206,6,-8,870,393900,6,393894
47207,8,-16,995,145538,8,145530
47208,5,16,752,1140687,5,1140682
47209,16,19,138,1241862,16,1241846
47210,20,-12,251,274351,20,274331
47211,11,-14,483,213222,11,213211
47212,13,14,689,1090895,13,1090882
47213,20,-11,413,307047,20,307027
47214,20,4,20,773403,20,773383
47215,13,7,25,867175,13,867162
47216,15,3,318,744343,15,744328
47217,15,12,680,1027184,15,1027169
47218,19,-20,608,27428,19,27409
47219,14,-19,343,56691,14,56677
47220,15,11,114,991651,15,991636
47221,19,-4,390,525141,19,525122
47222,16,12,316,1024424,16,1024408
47223,19,12,839,1028339,19,1028320
47224,18,13,788,1059150,18,1059132
47225,20,-1,971,623925,20,623905
47226,16,-19,504,57857,16,57841
47227,12,15,569,1120907,12,1120895
47228,7,-13,632,231877,7,231870
47229,6,-19,419,40505,6,40499
47230,12,18,306,1211297,12,1211285
47231,10,-13,817,236020,10,236010
47232,14,16,879,1153340,14,1153326
47233,15,16,705,1152133,15,1152118
47234,18,8,575,902476,18,902458
47235,11,-2,979,592602,11,592591
47236,14,-20,339,25452,14,25438
47237,12,-10,340,337527,12,337515
47238,11,-6,1,459145,11,459134
47239,12,2,415,713774,12,713762
47240,20,-7,102,429006,20,428986
47241,15,-6,962,466395,15,466380
47242,17,-14,241,211294,17,211277
47243,6,15,743,1110304,6,1110298
47244,18,-9,135,367561,18,367543
47245,7,-8,246,380746,7,380739
47246,16,15,876,1123174,16,1123158
47247,10,-16,457,134072,10,134062
47248,17,-19,677,59257,17,59240
47249,13,-12,875,279035,13,279022
47250,18,10,504,963695,18,963677
47251,19,-8,775,403389,19,403370
47252,18,-16,868,153366,18,153348
47253,15,-13,220,242656,15,242641
47254,12,-2,675,590203,12,590191
47255,14,3,784,747735,14,747721
47256,10,-4,100,501544,10,501534
47257,15,12,414,1025065,15,1025050
47258,12,-13,696,246074,12,246062
47259,7,9,588,919232,7,919225
47260,15,-4,558,526308,15,526293
47261,8,0,727,641352,8,641344
47262,7,13,556,1042698,7,1042691
47263,19,18,181,1210426,19,1210407
47264,11,-13,91,241692,11,241681
47265,11,9,994,936491,11,936480
47266,16,-13,743,246521,16,246505
47267,18,-6,484,462887,18,462869
47268,10,-19,62,32787,10,32777
47269,14,15,431,1119835,14,1119821
47270,5,-9,345,351239,5,351234
47271,20,-3,668,559105,20,559085
47272,12,14,96,1086225,12,1086213
47273,7,16,963,1145281,7,1145274
47274,19,-2,785,591040,19,591021
47275,18,9,351,931598,18,931580
47276,5,18,27,1187133,5,1187128
47277,13,17,389,1180854,13,1180841
47278,10,10,122,940362,10,940352
47279,18,18,310,1211336,18,1211318
47280,5,-7,36,406879,5,406874
47281,13,-10,227,336742,13,336729
47282,11,-8,719,402966,11,402955
47283,13,-18,656,90063,13,90050
47284,16,6,614,840701,16,840685
47285,10,-11,662,295733,10,295723
47286,20,-1,777,622563,20,622543
47287,8,3,436,728174,8,728166
47288,6,18,660,1200632,6,1200626
47289,8,4,794,767930,8,767922
47290,7,-9,798,361433,7,361426
47291,13,6,255,837695,13,837682
47292,13,-17,740,121105,13,121092
47293,6,-17,529,104825,6,104819
47294,7,9,264,912171,7,912164
47295,8,-13,499,228865,8,228857
47296,5,-16,342,131245,5,131240
47297,12,-19,463,57524,12,57512
47298,19,8,755,903899,19,903880
47299,12,2,931,717378,12,717366
47300,13,9,312,931288,13,931275
47301,16,-7,573,432615,16,432599
47302,5,-8,188,379544,5,379539
47303,13,-8,288,399904,13,399891
47304,17,-19,494,57772,17,57755
47305,16,-1,212,618194,16,618178
47306,12,-16,286,149056,12,149044
47307,18,-4,64,522534,18,522516
47308,17,17,671,1182873,17,1182856
47309,8,0,99,627594,8,627586
47310,20,-3,563,558253,20,558233
47311,12,1,360,682736,12,682724
47312,20,14,976,1093096,20,1093076
47313,16,19,885,1247963,16,1247947
47314,12,-19,909,60869,12,60857
47315,13,4,579,777454,13,777441
47316,20,-7,509,432154,20,432134
47317,9,-17,583,106088,9,106079
47318,9,17,60,1156633,9,1156624
47319,12,-5,906,497681,12,497669
47320,13,-9,20,366743,13,366730
47321,6,-18,705,77551,6,77545
47322,12,15,803,1122639,12,1122627
47323,16,-13,596,245417,16,245401
47324,18,-5,830,497037,18,497019
47325,15,0,907,655177,15,655162
47326,7,14,493,1072803,7,1072796
47327,11,-7,969,435482,11,435471
47328,20,0,570,652547,20,652527
47329,6,18,904,1205854,6,1205848
47330,20,-2,51,585539,20,585519
47331,17,10,465,963411,17,963394
47332,8,13,588,1043449,8,1043441
47333,15,-10,156,336247,15,336232
47334,11,-10,579,339363,11,339352
47335,10,-16,479,134541,10,134531
47336,14,17,471,1181457,14,1181443
47337,17,6,181,837116,17,837099
47338,8,-14,596,199736,8,199728
47339,12,11,909,997479,12,997467
47340,9,4,715,766049,9,766040
47341,15,-11,129,304706,15,304691
47342,20,12,898,1028880,20,1028860
47343,7,-14,413,195862,7,195855
47344,16,17,956,1185046,16,1185030
47345,14,-9,719,372067,14,372053
47346,17,16,163,1148230,17,1148213
47347,5,2,779,704887,5,704882
47348,20,3,331,744415,20,744395
47349,5,5,235,786577,5,786572
47350,6,-14,259,192468,6,192462
47351,7,-18,398,70978,7,70971
47352,17,7,836,873053,17,873036
47353,12,-6,909,466024,12,466012
47354,9,-1,71,595341,9,595332
47355,11,12,625,1026677,11,1026666
47356,17,-19,729,59699,17,59682
47357,10,18,971,1207321,10,1207311
47358,12,-18,443,88573,12,88561
47359,18,9,455,932351,18,932333
47360,6,14,978,1083749,6,1083743
47361,20,6,643,840956,20,840936
47362,12,-7,919,435107,12,435095
47363,15,17,635,1182566,15,1182551
47364,10,-8,99,377479,10,377469
47365,6,18,270,1192782,6,1192776
47366,13,14,595,1090023,13,1090010
47367,7,-9,902,363910,7,363903
47368,16,-15,769,183518,16,183502
47369,18,-19,532,58136,18,58118
47370,9,17,820,1172930,9,1172921
47371,9,-13,95,220455,9,220446
47372,13,-19,652,59117,13,59104
47373,10,10,908,957017,10,957007
47374,12,19,55,1241167,12,1241155
47375,7,5,102,783713,7,783706
47376,14,7,778,872618,14,872604
47377,20,9,919,935922,20,935902
47378,13,12,457,1025390,13,1025377
47379,15,-11,895,310699,15,310684
47380,13,-4,136,523102,13,523089
47381,14,-20,124,23687,14,23673
47382,13,-15,405,180753,13,180740
47383,17,-1,166,617810,17,617793
47384,11,15,750,1122375,11,1122364
47385,16,-7,261,430239,16,430223
47386,20,-12,970,279872,20,279852
47387,13,15,299,1119016,13,1119003
47388,17,10,316,962213,17,962196
47389,5,-2,50,563956,5,563951
47390,18,-19,914,60898,18,60880
47391,13,-2,293,587361,13,587348
47392,13,10,61,960289,13,960276
47393,7,11,642,982130,7,982123
47394,9,-15,14,155636,9,155627
47395,17,1,569,684380,17,684363
47396,20,-18,926,91955,20,91935
47397,14,-2,262,587102,14,587088
47398,17,-7,834,434373,17,434356
47399,14,8,796,904254,14,904240
47400,15,12,472,1025507,15,1025492
47401,18,7,31,867233,18,867215
47402,16,15,57,1117229,16,1117213
47403,12,-10,273,337048,12,337036
47404,20,9,501,932719,20,932699
47405,18,-13,960,248304,18,248286
47406,20,-12,920,279470,20,279450
47407,20,-18,974,92315,20,92295
47408,15,-8,866,404035,15,404020
47409,19,8,668,903243,19,903224
47410,7,6,934,833268,7,833261
47411,18,18,962,1216057,18,1216039
47412,9,15,928,1114228,9,1114219
47413,13,13,662,1058241,13,1058228
47414,7,-20,741,16262,7,16255
47415,11,2,178,711937,11,711926
47416,11,-7,226,429993,11,429982
47417,16,-2,56,585576,16,585560
47418,11,15,190,1118228,11,1118217
47419,16,-4,62,522520,16,522504
47420,5,5,429,790427,5,790422
47421,20,18,625,1213428,20,1213408
47422,8,19,943,1238426,8,1238418
47423,10,-20,195,4588,10,4578
47424,11,-7,643,433008,11,432997
47425,5,-4,139,502430,5,502425
47426,18,1,653,685009,18,684991
47427,10,-19,9,31621,10,31611
47428,5,10,114,940128,5,940123
47429,19,5,903,810377,19,810358
47430,19,10,743,965597,19,965578
47431,17,-5,496,494704,17,494687
47432,10,-10,952,332906,10,332896
47433,5,16,547,1136732,5,1136727
47434,19,-6,697,464494,19,464475
47435,12,-11,772,309778,12,309766
47436,19,9,152,930158,19,930139
47437,19,10,955,967169,19,967150
47438,19,16,776,1152615,19,1152596
47439,13,-1,940,623741,13,623728
47440,8,13,715,1046051,8,1046043
47441,9,2,523,699785,9,699776
47442,16,17,158,1179029,16,1179013
47443,15,-12,402,275453,15,275438
47444,14,-12,572,276750,14,276736
47445,10,15,958,1114915,10,1114905
47446,18,3,329,744383,18,744365
47447,10,12,12,999301,10,999291
47448,15,8,671,903290,15,903275
47449,11,14,830,1091960,11,1091949
47450,15,-17,281,117588,15,117573
47451,11,-1,379,619590,11,619579
47452,11,-6,97,459794,11,459783
47453,14,-9,766,372590,14,372576
47454,13,8,318,900461,13,900448
47455,15,7,182,868328,15,868313
47456,16,-4,144,523132,16,523116
47457,12,0,803,654419,12,654407
47458,16,-5,335,493643,16,493627
47459,11,11,465,994246,11,994235
47460,9,0,178,629391,9,629382
47461,8,-13,137,221282,8,221274
47462,13,3,680,747013,13,747000
47463,5,0,124,628166,5,628161
47464,6,18,758,1202683,6,1202677
47465,10,11,367,976307,10,976297
47466,6,-19,371,39518,6,39512
47467,19,-2,177,586340,19,586321
47468,12,-8,388,400621,12,400609
47469,5,-16,369,131903,5,131898
47470,12,-16,748,152363,12,152351
47471,12,19,484,1244758,12,1244746
47472,9,-13,203,222732,9,222723
47473,18,-7,823,434285,18,434267
47474,16,-1,728,622198,16,622182
47475,8,17,940,1175431,8,1175423
47476,17,9,400,931947,17,931930
47477,7,-12,143,252656,7,252649
47478,20,18,129,1209972,20,1209952
47479,5,-1,313,600846,5,600841
47480,10,-16,104,126262,10,126252
47481,5,8,368,883194,5,883189
47482,16,19,644,1246016,16,1246000
47483,18,-19,6,53930,18,53912
47484,5,17,721,1170650,5,1170645
47485,8,19,739,1233913,8,1233905
47486,5,-19,627,45324,5,45319
47487,14,4,744,778738,14,778724
47488,6,16,839,1142585,6,1142579
47489,8,19,726,1233653,8,1233645
47490,8,8,675,890005,8,889997
47491,14,-20,379,25715,14,25701
47492,18,-13,385,243849,18,243831
47493,15,15,645,1121495,15,1121480
47494,8,10,248,942686,8,942678
47495,5,4,49,751613,5,751608
47496,20,-14,786,215678,20,215658
47497,19,-16,817,152909,19,152890
47498,13,3,90,742477,13,742464
47499,8,-6,901,456049,8,456041
47500,20,-4,88,522707,20,522687
47501,9,-14,454,196525,9,196516
47502,11,17,758,1183522,11,1183511
47503,9,11,661,982576,9,982567
47504,13,-18,447,88622,13,88609
47505,11,-8,670,402643,11,402632
47506,11,4,532,777118,11,777107
47507,8,3,569,730915,8,730907
47508,10,-2,734,578398,10,578388
47509,10,1,423,666370,10,666360
47510,11,-1,461,620241,11,620230
47511,7,-6,23,437351,7,437344
47512,8,6,278,818556,8,818548
47513,16,-8,788,403517,16,403501
47514,6,-4,353,507263,6,507257
47515,17,-13,245,242858,17,242841
47516,18,3,755,747536,18,747518
47517,11,-1,166,617811,11,617800
47518,15,16,801,1152872,15,1152857
47519,13,-14,27,209547,13,209534
47520,11,5,221,805512,11,805501
47521,6,-19,985,52612,6,52606
47522,15,-13,247,242871,15,242856
47523,16,-6,942,466287,16,466271
47524,20,-19,617,58861,20,58841
47525,13,4,509,776909,13,776896
47526,20,10,153,961044,20,961024
47527,20,14,319,1087927,20,1087907
47528,9,-17,443,102835,9,102826
47529,18,10,522,963891,18,963873
47530,18,6,416,839114,18,839096
47531,8,9,860,925037,8,925029
47532,11,3,280,744010,11,743999
47533,15,17,308,1180299,15,1180284
47534,17,-3,846,560547,17,560530
47535,17,-18,573,89391,17,89374
47536,9,8,904,894814,9,894805
47537,19,-1,2,616517,19,616498
47538,7,-16,220,128868,7,128861
47539,8,-1,976,614921,8,614913
47540,18,10,562,964186,18,964168
47541,8,-18,762,78966,8,78958
47542,15,-16,262,148889,15,148874
47543,17,-6,474,462779,17,462762
47544,14,-5,445,494293,14,494279
47545,15,-14,313,211826,15,211811
47546,16,14,20,1085526,16,1085510
47547,9,-5,761,484400,9,484391
47548,20,-1,67,617056,20,617036
47549,8,-18,970,83561,8,83553
47550,7,15,531,1105803,7,1105796
47551,19,14,781,1091607,19,1091588
47552,15,1,280,682094,15,682079
47553,10,2,923,707792,10,707782
47554,9,-15,528,166839,9,166830
47555,7,11,602,981361,7,981354
47556,19,0,553,652403,19,652384
47557,16,-11,306,306199,16,306183
47558,14,12,141,1023049,14,1023035
47559,5,15,486,1104748,5,1104743
47560,7,6,445,822490,7,822483
47561,15,-8,597,402025,15,402010
47562,16,-15,103,178574,16,178558
47563,12,-16,511,150772,12,150760
47564,7,17,437,1164602,7,1164595
47565,7,-10,931,332432,7,332425
47566,9,8,866,893985,9,893976
47567,17,6,517,839984,17,839967
47568,15,4,937,780157,15,780142
47569,12,-8,371,400503,12,400491
47570,15,6,837,842509,15,842494
47571,11,-8,808,403663,11,403652
47572,14,8,229,899817,14,899803
47573,13,-5,731,496403,13,496390
47574,15,0,896,655090,15,655075
47575,12,4,701,778364,12,778352
47576,9,-20,65,1388,9,1379
47577,16,-7,819,434262,16,434246
47578,19,1,129,680864,19,680845
47579,16,16,529,1150855,16,1150839
47580,18,10,459,963321,18,963303
47581,13,9,686,934101,13,934088
47582,11,13,547,1057356,11,1057345
47583,10,0,617,638757,10,638747
47584,16,18,688,1213925,16,1213909
47585,12,-10,973,342424,12,342412
47586,13,11,371,993578,13,993565
47587,6,6,435,822250,6,822244
47588,14,-16,18,146904,14,146890
47589,9,17,283,1161434,9,1161425
47590,19,19,460,1244599,19,1244580
47591,16,18,448,1212324,16,1212308
47592,5,-14,373,194908,5,194903
47593,13,-19,96,54685,13,54672
47594,7,-6,950,457056,7,457049
47595,12,10,734,965520,12,965508
47596,13,19,309,1243262,13,1243249
47597,13,0,246,650044,13,650031
47598,7,2,755,704585,7,704578
47599,6,-7,732,421357,6,421351
47600,15,-14,650,214595,15,214580
47601,19,-9,67,367136,19,367117
47602,16,18,30,1209115,16,1209099
47603,5,-1,172,597462,5,597457
47604,11,14,605,1090121,11,1090110
47605,10,-17,273,99304,10,99294
47606,6,3,256,724353,6,724347
47607,14,1,18,679892,14,679878
47608,5,18,693,1201270,5,1201265
47609,20,-1,35,616847,20,616827
47610,7,-13,428,227314,7,227307
47611,16,11,377,993604,16,993588
47612,16,-8,426,400844,16,400828
47613,9,19,656,1232069,9,1232060
47614,19,-4,346,524806,19,524787
47615,12,-5,98,491678,12,491666
47616,19,-3,945,561365,19,561346
47617,17,-15,711,183064,17,183047
47618,11,5,977,810965,11,810954
47619,16,-14,8,209403,16,209387
47620,19,8,676,903344,19,903325
47621,10,9,979,927647,10,927637
47622,14,2,67,711057,14,711043
47623,11,18,663,1213769,11,1213758
47624,12,5,435,806930,12,806918
47625,11,-5,19,490913,11,490902
47626,11,-8,372,400519,11,400508
47627,5,-15,17,155704,5,155699
47628,5,0,638,639233,5,639228
47629,13,-3,59,554189,13,554176
47630,18,0,71,648769,18,648751
47631,18,-14,545,213682,18,213664
47632,13,11,302,993110,13,993097
47633,14,16,441,1150294,14,1150280
47634,9,-8,856,393592,9,393583
47635,14,18,175,1210352,14,1210338
47636,18,-5,599,495463,18,495445
47637,20,-15,320,180103,20,180083
47638,8,19,7,1217587,8,1217579
47639,11,-1,37,616864,11,616853
47640,15,18,283,1211192,15,1211177
47641,10,-7,608,418797,10,418787
47642,10,11,909,988096,10,988086
47643,20,-14,212,210976,20,210956
47644,19,-5,625,495604,19,495585
47645,9,19,900,1237536,9,1237527
47646,17,-13,943,248154,17,248137
47647,19,-14,326,211945,19,211926
47648,9,-8,991,396571,9,396562
47649,14,-11,262,305796,14,305782
47650,15,-3,588,558445,15,558430
47651,13,-14,166,210558,13,210545
47652,17,1,452,683406,17,683389
47653,16,3,654,746805,16,746789
47654,19,13,853,1059625,19,1059606
47655,13,-7,728,433603,13,433590
47656,18,12,123,1022949,18,1022931
47657,16,-12,811,278443,16,278427
47658,7,4,805,768137,7,768130
47659,5,12,42,1000058,5,1000053
47660,16,-9,753,372404,16,372388
47661,20,6,249,837653,20,837633
47662,19,2,902,717199,19,717180
47663,13,9,247,930808,13,930795
47664,17,-17,249,117311,17,117294
47665,13,-13,431,244173,13,244160
47666,7,10,903,956882,7,956875
47667,15,-7,454,431748,15,431733
47668,9,-12,747,265668,9,265659
47669,17,10,998,967417,17,967400
47670,8,-16,591,136852,8,136844
47671,11,17,70,1178395,11,1178384
47672,11,-7,882,434785,11,434774
47673,11,-16,185,148279,11,148268
47674,17,8,833,904441,17,904424
47675,19,-4,921,528964,19,528945
47676,17,-16,15,146871,17,146854
47677,13,7,48,867395,13,867382
47678,10,-19,625,45282,10,45272
47679,11,2,254,712498,11,712487
47680,9,-5,140,471084,9,471075
47681,12,-5,153,492131,12,492119
47682,15,-18,725,90541,15,90526
47683,17,-3,500,557650,17,557633
47684,13,6,232,837514,13,837501
47685,8,-16,505,135067,8,135059
47686,13,-1,234,618422,13,618409
47687,8,-16,583,136678,8,136670
47688,8,13,761,1047073,8,1047065
47689,17,18,63,1209461,17,1209444
47690,16,-18,131,86211,16,86195
47691,9,2,739,704203,9,704194
47692,17,3,567,746049,17,746032
47693,13,2,798,716446,13,716433
47694,17,-20,476,26335,17,26318
47695,20,4,981,780457,20,780437
47696,8,14,625,1075844,8,1075836
47697,18,-20,90,23453,18,23435
47698,15,16,913,1153645,15,1153630
47699,9,-4,199,503770,9,503761
47700,15,-17,434,118684,15,118669
47701,12,11,176,992072,12,992060
47702,10,-15,725,170981,10,170971
47703,8,17,615,1168392,8,1168384
47704,9,17,983,1176465,9,1176456
47705,7,-1,782,610673,7,610666
47706,14,-6,275,461322,14,461308
47707,9,-7,573,418166,9,418157
47708,11,-17,110,116373,11,116362
47709,12,9,427,932133,12,932121
47710,16,-15,847,184141,16,184125
47711,15,-17,620,120143,15,120128
47712,18,-5,82,491508,18,491490
47713,16,12,878,1028664,16,1028648
47714,5,19,263,1223254,5,1223249
47715,7,-13,252,223715,7,223708
47716,12,9,252,930831,12,930819
47717,10,-5,695,483038,10,483028
47718,6,-10,3,312568,6,312562
47719,14,19,788,1247183,14,1247169
47720,11,13,725,1058618,11,1058607
47721,19,1,715,685388,19,685369
47722,18,6,383,838773,18,838755
47723,16,-8,364,400418,16,400402
47724,7,3,995,740660,7,740653
47725,18,-9,476,370423,18,370405
47726,15,-17,53,115933,15,115918
47727,7,-20,255,5689,7,5682
47728,8,-18,705,77559,8,77551
47729,15,1,565,684354,15,684339
47730,17,12,684,1027214,17,1027197
47731,8,8,264,880939,8,880931
47732,18,16,141,1148090,18,1148072
47733,7,-20,465,9930,7,9923
47734,16,8,547,902257,16,902241
47735,15,15,987,1124043,15,1124028
47736,13,-14,588,214151,13,214138
47737,14,5,678,808717,14,808703
47738,7,1,989,678467,7,678460
47739,11,-3,977,561601,11,561590
47740,9,4,880,769968,9,769959
47741,13,-19,842,60497,13,60484
47742,19,-16,75,147414,19,147395
47743,19,-18,597,89560,19,89541
47744,5,18,323,1193731,5,1193726
47745,7,3,113,721298,7,721291
47746,15,16,993,1154232,15,1154217
47747,19,5,855,809981,19,809962
47748,8,3,252,724341,8,724333
47749,19,-16,127,147897,19,147878
47750,12,6,740,841742,12,841730
47751,15,15,956,1123812,15,1123797
47752,14,-1,203,618115,14,618101
47753,9,16,397,1133677,9,1133668
47754,10,-19,74,33055,10,33045
47755,13,-1,982,624023,13,624010
47756,20,5,860,810023,20,810003
47757,13,7,32,867241,13,867228
47758,13,-15,573,182019,13,182006
47759,10,3,804,736174,10,736164
47760,14,-11,65,304209,14,304195
47761,6,12,181,1003114,6,1003108
47762,13,5,258,805728,13,805715
47763,14,-5,539,495023,14,495009
47764,13,-8,169,399101,13,399088
47765,9,12,13,999358,9,999349
47766,5,-7,564,418008,5,418003
47767,8,13,292,1036992,8,1036984
47768,16,5,382,806599,16,806583
47769,7,2,215,693227,7,693220
47770,18,4,195,774651,18,774633
47771,10,-10,775,329148,10,329138
47772,8,-13,228,223216,8,223208
47773,19,-4,501,525878,19,525859
47774,12,5,612,808297,12,808285
47775,9,3,938,739216,9,739207
47776,20,7,80,867621,20,867601
47777,13,-17,488,119109,13,119096
47778,7,-2,803,579897,7,579890
47779,20,-8,874,404081,20,404061
47780,14,8,526,902141,14,902127
47781,6,0,886,644623,6,644617
47782,20,-2,429,588356,20,588336
47783,12,-11,608,308599,12,308587
47784,20,4,822,779312,20,779292
47785,14,-13,448,244285,14,244271
47786,20,15,655,1121605,20,1121585
47787,11,-8,216,399429,11,399418
47788,12,-2,124,586037,12,586025
47789,6,-19,466,41529,6,41523
47790,17,-1,445,620092,17,620075
47791,8,-20,862,19068,8,19060
47792,14,17,958,1185083,14,1185069
47793,20,-6,371,462004,20,461984
47794,20,16,174,1148351,20,1148331
47795,19,1,318,682380,19,682361
47796,18,19,138,1241870,18,1241852
47797,6,2,507,699411,6,699405
47798,7,0,225,630354,7,630347
47799,7,4,822,768551,7,768544
47800,19,-20,441,26154,19,26135
47801,10,9,384,914773,10,914763
47802,17,-16,944,153865,17,153848
47803,11,-6,838,465499,11,465488
47804,18,-19,109,54816,18,54798
47805,18,6,90,836422,18,836404
47806,18,0,661,653308,18,653290
47807,18,3,956,749144,18,749126
47808,8,4,372,758640,8,758632
47809,16,-12,636,277158,16,277142
47810,6,-9,856,362715,6,362709
47811,14,3,709,747261,14,747247
47812,20,11,105,991618,20,991598
47813,17,8,935,905236,17,905219
47814,11,15,756,1122423,11,1122412
47815,20,-10,28,335365,20,335345
47816,8,18,918,1206124,8,1206116
47817,18,5,9,803852,18,803834
47818,5,13,158,1034036,5,1034031
47819,19,9,99,929814,19,929795
47820,10,-16,180,127893,10,127883
47821,9,-12,678,264182,9,264173
47822,14,9,307,931244,14,931230
47823,13,15,289,1118937,13,1118924
47824,11,8,734,903794,11,903783
47825,6,4,201,754993,6,754987
47826,19,9,718,934358,19,934339
47827,16,13,193,1054638,16,1054622
47828,18,1,237,681769,18,681751
47829,8,5,429,790435,8,790427
47830,12,-7,165,429522,12,429510
47831,6,14,200,1066158,6,1066152
47832,9,-10,157,316044,9,316035
47833,8,-18,711,77706,8,77698
47834,17,19,588,1245578,17,1245561
47835,17,-15,650,182648,17,182631
47836,16,-18,54,85611,16,85595
47837,17,16,389,1149929,17,1149912
47838,10,-6,523,448108,10,448098
47839,19,18,441,1212284,19,1212265
47840,14,-5,109,491765,14,491751
47841,7,11,611,981578,7,981571
47842,9,6,579,825396,9,825387
47843,6,6,340,820027,6,820021
47844,9,-4,539,511127,9,511118
47845,16,9,468,932426,16,932410
47846,10,-2,394,571042,10,571032
47847,20,14,113,1086369,20,1086349
47848,15,12,2,1022121,15,1022106
47849,9,7,883,863541,9,863532
47850,14,-9,545,371032,14,371018
47851,20,-13,485,244554,20,244534
47852,20,13,955,1060335,20,1060315
47853,15,11,642,995405,15,995390
47854,8,0,60,626589,8,626581
47855,8,-18,855,80883,8,80875
47856,14,0,639,653085,14,653071
47857,10,-8,730,391009,10,390999
47858,9,-10,161,316168,9,316159
47859,7,-9,676,358408,7,358401
47860,13,16,738,1152356,13,1152343
47861,15,-19,233,55860,15,55845
47862,15,-18,924,91926,15,91911
47863,18,6,714,841564,18,841546
47864,14,-8,168,399092,14,399078
47865,6,-15,282,161447,6,161441
47866,19,-9,507,370672,19,370653
47867,19,-8,659,402557,19,402538
47868,19,15,622,1121352,19,1121333
47869,14,13,797,1059225,14,1059211
47870,15,12,391,1024927,15,1024912
47871,9,0,150,628696,9,628687
47872,20,-9,336,369122,20,369102
47873,9,3,286,725114,9,725105
47874,5,3,94,720855,5,720850
47875,6,-2,747,578612,6,578606
47876,19,-10,97,335853,19,335834
47877,12,-3,891,560903,12,560891
47878,18,-15,451,181110,18,181092
47879,8,-12,227,254466,8,254458
47880,14,14,305,1087804,14,1087790
47881,8,-6,937,456793,8,456785
47882,15,7,172,868230,15,868215
47883,15,-10,312,337341,15,337326
47884,20,-17,801,121563,20,121543
47885,19,14,758,1091398,19,1091379
47886,9,-19,405,40330,9,40321
47887,12,-13,326,243472,12,243460
47888,11,-17,864,121920,11,121909
47889,11,2,630,715306,11,715295
47890,20,0,525,652170,20,652150
47891,5,3,186,722902,5,722897
47892,14,15,341,1119287,14,1119273
47893,5,-18,671,76806,5,76801
47894,15,18,446,1212304,15,1212289
47895,10,-1,78,595498,10,595488
47896,8,-1,134,596745,8,596737
47897,15,12,791,1027951,15,1027936
47898,6,-15,6,155435,6,155429
47899,5,-8,379,383322,5,383317
47900,13,-20,84,23422,13,23409
47901,19,-15,183,179087,19,179068
47902,17,-15,39,178078,17,178061
47903,15,10,458,963311,15,963296
47904,7,14,246,1067285,7,1067278
47905,5,7,237,849813,5,849808
47906,8,4,45,751525,8,751517
47907,6,13,507,1041620,6,1041614
47908,6,4,124,753237,6,753231
47909,13,-11,194,305265,13,305252
47910,17,12,426,1025161,17,1025144
47911,17,17,676,1182887,17,1182870
47912,15,-8,741,403113,15,403098
47913,18,7,673,871988,18,871970
47914,9,15,653,1108296,9,1108287
47915,6,-6,769,453349,6,453343
47916,19,7,392,869909,19,869890
47917,16,-6,342,461822,16,461806
47918,10,-5,487,478529,10,478519
47919,19,12,723,1027479,19,1027460
47920,15,-3,754,559811,15,559796
47921,11,19,133,1241821,11,1241810
47922,9,4,272,756492,9,756483
47923,9,5,469,791361,9,791352
47924,14,-6,202,460710,14,460696
47925,9,-3,240,535670,9,535661
47926,14,12,717,1027431,14,1027417
47927,16,-11,709,309264,16,309248
47928,16,-18,619,89707,16,89691
47929,17,-9,42,366921,17,366904
47930,6,3,835,736799,6,736793
47931,7,-18,401,71018,7,71011
47932,9,15,165,1097975,9,1097966
47933,11,14,337,1088080,11,1088069
47934,20,2,577,714908,20,714888
47935,10,-19,160,35254,10,35244
47936,9,-8,838,393252,9,393243
47937,6,-3,41,531384,6,531378
47938,9,-7,599,418671,9,418662
47939,20,4,189,774605,20,774585
47940,17,5,770,809388,17,809371
47941,6,14,580,1074719,6,1074713
47942,9,-3,562,543114,9,543105
47943,11,5,881,810191,11,810180
47944,6,7,217,849359,6,849353
47945,18,-1,860,623150,18,623132
47946,8,19,156,1220954,8,1220946
47947,6,1,530,668961,6,668955
47948,11,4,53,773632,11,773621
47949,13,-20,472,26326,13,26313
47950,15,3,869,748383,15,748368
47951,14,18,702,1214026,14,1214012
47952,7,15,465,1104301,7,1104294
47953,12,-9,548,371063,12,371051
47954,13,16,376,1149866,13,1149853
47955,16,-6,845,465537,16,465521
47956,6,18,762,1202798,6,1202792
47957,12,10,144,960988,12,960976
47958,17,1,368,682806,17,682789
47959,6,-19,150,34999,6,34993
47960,6,-9,483,354528,6,354522
47961,12,-3,735,559614,12,559602
47962,10,3,554,730491,10,730481
47963,20,-6,910,466033,20,466013
47964,20,9,325,931378,20,931358
47965,18,-2,393,587998,18,587980
47966,18,5,990,811062,18,811044
47967,8,-11,689,296240,8,296232
47968,11,6,470,839544,11,839533
47969,13,-14,324,211919,13,211906
47970,11,-18,121,86123,11,86112
47971,11,14,674,1090739,11,1090728
47972,17,14,478,1089171,17,1089154
47973,15,19,698,1246454,15,1246439
47974,18,17,386,1180792,18,1180774
47975,8,-2,124,565500,8,565492
47976,5,8,302,881838,5,881833
47977,17,-14,230,211223,17,211206
47978,5,9,802,923741,5,923736
47979,9,0,906,645030,9,645021
47980,11,-8,975,404840,11,404829
47981,13,-6,228,460938,13,460925
47982,15,-12,652,277308,15,277293
47983,8,8,543,887073,8,887065
47984,20,-12,946,279639,20,279619
47985,15,-18,349,87961,15,87946
47986,16,1,367,682795,16,682779
47987,11,4,738,778694,11,778683
47988,11,-10,490,338715,11,338704
47989,20,-14,222,211090,20,211070
47990,11,-15,445,181063,11,181052
47991,18,13,491,1056855,18,1056837
47992,15,-3,976,561587,15,561572
47993,9,10,506,948320,9,948311
47994,20,7,775,872608,20,872588
47995,16,19,351,1243605,16,1243589
47996,7,-14,895,205927,7,205920
47997,20,0,454,651563,20,651543
47998,7,-6,528,448196,7,448189
47999,12,13,170,1054454,12,1054442
48000,12,-18,815,91179,12,91167
48001,5,-9,285,349802,5,349797
48002,20,-17,72,116045,20,116025
48003,20,3,128,742816,20,742796
48004,7,-8,652,389359,7,389352
48005,17,2,704,715934,17,715917
48006,7,12,954,1020121,7,1020114
48007,13,-16,896,153526,13,153513
48008,19,18,889,1215494,19,1215475
48009,7,-19,22,31950,7,31943
48010,12,-2,16,585242,12,585230
48011,17,17,111,1178642,17,1178625
48012,7,-1,185,597654,7,597647
48013,10,4,568,762841,10,762831
48014,5,1,566,669694,5,669689
48015,11,11,758,996314,11,996303
48016,5,-13,510,229190,5,229185
48017,17,-18,749,90741,17,90724
48018,16,-9,22,366763,16,366747
48019,18,-4,908,528897,18,528879
48020,20,-1,622,621383,20,621363
48021,14,-4,271,524184,14,524170
48022,18,4,147,774331,18,774313
48023,17,-20,745,28515,17,28498
48024,18,8,500,901936,18,901918
48025,5,-3,475,541126,5,541121
48026,17,12,658,1026925,17,1026908
48027,10,-13,971,239386,10,239376
48028,16,2,60,710979,16,710963
48029,12,-17,618,120130,12,120118
48030,8,8,365,883149,8,883141
48031,5,2,202,693028,5,693023
48032,13,16,173,1148319,13,1148306
48033,18,14,390,1088470,18,1088452
48034,12,-10,924,342021,12,342009
48035,20,8,616,902812,20,902792
48036,7,5,719,796577,7,796570
48037,13,-6,387,462111,13,462098
48038,16,-20,447,26204,16,26188
48039,12,1,337,682580,12,682568
48040,14,-6,893,465899,14,465885
48041,17,-13,120,241904,17,241887
48042,19,17,973,1185243,19,1185224
48043,19,-4,345,524778,19,524759
48044,11,-12,562,276669,11,276658
48045,12,-13,229,242730,12,242718
48046,18,14,890,1092411,18,1092393
48047,7,9,829,924367,7,924360
48048,14,11,983,997936,14,997922
48049,19,-8,920,404398,19,404379
48050,16,4,347,775725,16,775709
48051,9,3,931,739044,9,739035
48052,14,18,388,1211912,14,1211898
48053,12,-15,963,185111,12,185099
48054,13,-20,862,29406,13,29393
48055,9,-12,601,262516,9,262507
48056,13,8,105,898753,13,898740
48057,12,18,694,1213987,12,1213975
48058,20,13,418,1056345,20,1056325
48059,18,15,873,1123149,18,1123131
48060,19,-6,451,462590,19,462571
48061,17,2,727,716069,17,716052
48062,7,0,366,633172,7,633165
48063,16,2,812,716534,16,716518
48064,9,0,764,642170,9,642161
48065,16,-7,337,430908,16,430892
48066,20,19,796,1247222,20,1247202
48067,5,3,261,724530,5,724525
48068,8,11,126,971100,8,971092
48069,18,1,504,683837,18,683819
48070,5,-14,243,192031,5,192026
48071,12,15,941,1123659,12,1123647
48072,8,3,15,719161,8,719153
48073,14,11,810,996751,14,996737
48074,13,-10,87,335820,13,335807
48075,15,-15,144,178880,15,178865
48076,6,-19,990,52660,6,52654
48077,16,-1,749,622329,16,622313
48078,6,5,110,783850,6,783844
48079,19,15,885,1123245,19,1123226
48080,18,14,613,1090185,18,1090167
48081,13,-10,257,336979,13,336966
48082,15,17,531,1181831,15,1181816
48083,17,-9,273,368574,17,368557
48084,6,14,597,1075102,6,1075096
48085,11,-17,88,116211,11,116200
48086,17,17,514,1181754,17,1181737
48087,19,15,504,1120403,19,1120384
48088,5,-10,703,327815,5,327810
48089,19,18,932,1215799,19,1215780
48090,5,-20,227,5134,5,5129
48091,20,5,960,810899,20,810879
48092,19,7,877,873346,19,873327
48093,7,0,609,638543,7,638536
48094,14,14,853,1092040,14,1092026
48095,16,-18,228,87086,16,87070
48096,17,-5,235,492719,17,492702
48097,17,-17,359,118144,17,118127
48098,7,16,509,1136026,7,1136019
48099,7,12,109,1001484,7,1001477
48100,16,12,640,1026817,16,1026801
48101,14,-19,42,54182,14,54168
48102,15,4,446,776439,15,776424
48103,11,1,947,687262,11,687251
48104,10,-18,154,65850,10,65840
48105,17,-9,839,373157,17,373140
48106,11,8,616,902813,11,902802
48107,5,12,120,1001746,5,1001741
48108,16,17,914,1184795,16,1184779
48109,7,-16,792,141043,7,141036
48110,12,-3,238,555447,12,555435
48111,9,15,725,1109955,9,1109946
48112,19,-6,617,463867,19,463848
48113,14,0,36,648536,14,648522
48114,9,11,79,970156,9,970147
48115,6,-6,973,457501,6,457495
48116,10,-7,655,419659,10,419649
48117,11,-10,198,336529,11,336518
48118,12,-4,965,529343,12,529331
48119,16,17,271,1179955,16,1179939
48120,14,-6,797,465239,14,465225
48121,14,17,467,1181428,14,1181414
48122,15,-14,592,214198,15,214183
48123,15,-18,739,90658,15,90643
48124,15,-12,458,275812,15,275797
48125,6,17,648,1169158,6,1169152
48126,17,-6,259,461197,17,461180
48127,13,-3,670,559130,13,559117
48128,14,8,598,902639,14,902625
48129,5,11,689,983092,5,983087
48130,12,6,754,841831,12,841819
48131,10,2,511,699532,10,699522
48132,14,0,283,650213,14,650199
48133,6,-8,639,389056,6,389050
48134,14,-6,461,462705,14,462691
48135,9,-3,273,536306,9,536297
48136,6,0,514,636455,6,636449
48137,5,8,864,893946,5,893941
48138,9,4,331,757679,9,757670
48139,12,16,638,1151661,12,1151649
48140,15,2,454,714058,15,714043
48141,6,10,319,944319,6,944313
48142,12,-6,744,464850,12,464838
48143,20,-17,88,116221,20,116201
48144,9,0,281,631355,9,631346
48145,7,-4,122,502000,7,501993
48146,5,-18,430,71670,5,71665
48147,13,-18,291,87491,13,87478
48148,11,13,336,1055710,11,1055699
48149,10,15,884,1113244,10,1113234
48150,12,13,576,1057617,12,1057605
48151,18,-16,979,154123,18,154105
48152,20,-7,578,432681,20,432661
48153,13,-7,433,431571,13,431558
48154,20,18,769,1214532,20,1214512
48155,11,16,444,1150325,11,1150314
48156,5,-4,634,513088,5,513083
48157,5,13,442,1040333,5,1040328
48158,11,14,634,1090378,11,1090367
48159,15,11,245,992594,15,992579
48160,11,-17,44,115879,11,115868
48161,18,5,446,807050,18,807032
48162,14,-17,357,118126,14,118112
48163,9,16,339,1132339,9,1132330
48164,17,12,33,1022343,17,1022326
48165,13,-12,648,277275,13,277262
48166,19,-9,423,369898,19,369879
48167,5,6,332,819785,5,819780
48168,6,-9,163,347040,6,347034
48169,18,-2,687,590334,18,590316
48170,8,0,256,630944,8,630936
48171,11,8,708,903582,11,903571
48172,11,-5,999,498339,11,498328
48173,8,-16,684,138679,8,138671
48174,6,14,927,1082493,6,1082487
48175,16,17,311,1180309,16,1180293
48176,7,-9,912,364166,7,364159
48177,14,-15,364,180443,14,180429
48178,13,-15,400,180678,13,180665
48179,18,8,1000,905711,18,905693
48180,5,-4,331,506710,5,506705
48181,18,3,783,747732,18,747714
48182,15,-16,335,149384,15,149369
48183,16,-14,206,210923,16,210907
48184,11,15,115,1117647,11,1117636
48185,8,-2,268,568562,8,568554
48186,12,-2,893,591965,12,591953
48187,17,6,538,840117,17,840100
48188,5,-13,906,237885,5,237880
48189,18,10,414,963007,18,962989
48190,14,17,354,1180622,14,1180608
48191,8,-18,613,75545,8,75537
48192,14,-7,888,434865,14,434851
48193,19,8,827,904407,19,904388
48194,6,6,671,827442,6,827436
48195,19,11,2,990863,19,990844
48196,8,-9,119,346124,8,346116
48197,20,18,6,1208962,20,1208942
48198,11,18,68,1209501,11,1209490
48199,9,10,365,945315,9,945306
48200,13,-6,509,463089,13,463076
48201,7,8,799,892745,7,892738
48202,12,-18,760,90814,12,90802
48203,17,6,791,842100,17,842083
48204,15,16,256,1148960,15,1148945
48205,5,12,582,1011566,5,1011561
48206,12,1,187,681371,12,681359
48207,13,10,303,962074,13,962061
48208,13,2,287,712754,13,712741
48209,10,-19,642,45692,10,45682
48210,7,6,987,834453,7,834446
48211,5,6,726,828803,5,828798
48212,8,-14,40,187387,8,187379
48213,16,4,943,780208,16,780192
48214,12,-2,440,588430,12,588418
48215,16,3,477,745396,16,745380
48216,5,-14,778,203670,5,203665
48217,8,-8,301,381754,8,381746
48218,8,-20,586,12777,8,12769
48219,18,8,464,901644,18,901626
48220,11,13,289,1055334,11,1055323
48221,15,7,289,869102,15,869087
48222,20,-12,989,280024,20,280004
48223,7,-18,572,74722,7,74715
48224,9,4,988,772074,9,772065
48225,20,1,154,681092,20,681072
48226,14,10,93,960608,14,960594
48227,18,14,5,1085386,18,1085368
48228,9,-7,81,407576,9,407567
48229,17,19,495,1244826,17,1244809
48230,20,-1,959,623838,20,623818
48231,7,9,639,920331,7,920324
48232,10,14,432,1071502,10,1071492
48233,11,-8,142,398895,11,398884
48234,12,-1,922,623613,12,623601
48235,9,8,668,889810,9,889801
48236,19,-2,923,592158,19,592139
48237,15,-15,591,182127,15,182112
48238,6,-16,749,140111,6,140105
48239,10,-18,913,82341,10,82331
48240,20,-14,945,216831,20,216811
48241,16,-20,43,23117,16,23101
48242,19,-6,884,465796,19,465777
48243,10,-6,625,450228,10,450218
48244,6,16,404,1133845,6,1133839
48245,8,-4,265,505376,8,505368
48246,5,-20,474,10150,5,10145
48247,9,15,427,1103443,9,1103434
48248,6,19,33,1218146,6,1218140
48249,13,18,966,1216072,13,1216059
48250,18,8,284,900244,18,900226
48251,9,-15,219,159973,9,159964
48252,15,-7,769,433912,15,433897
48253,11,6,142,836824,11,836813
48254,7,-15,525,166718,7,166711
48255,12,-13,107,241837,12,241825
48256,11,19,795,1247203,11,1247192
48257,9,-19,150,35008,9,34999
48258,16,-5,543,495042,16,495026
48259,13,-9,926,373910,13,373897
48260,9,-1,95,595906,9,595897
48261,16,-8,886,404145,16,404129
48262,14,-5,281,493099,14,493085
48263,17,-11,261,305781,17,305764
48264,13,2,330,713074,13,713061
48265,5,16,195,1129325,5,1129320
48266,17,-11,652,308936,17,308919
48267,11,2,746,716177,11,716166
48268,17,-3,35,554075,17,554058
48269,14,-20,192,24357,14,24343
48270,16,2,671,715639,16,715623
48271,6,-18,145,65613,6,65607
48272,17,6,621,840758,17,840741
48273,7,-2,153,566057,7,566050
48274,5,16,688,1139545,5,1139540
48275,9,4,397,759193,9,759184
48276,8,-9,266,349423,8,349415
48277,19,4,666,778099,19,778080
48278,20,-6,986,466644,20,466624
48279,13,5,466,807230,13,807217
48280,12,-9,479,370455,12,370443
48281,19,2,785,716365,19,716346
48282,15,-17,376,118270,15,118255
48283,10,-20,120,2690,10,2680
48284,5,-7,264,411425,5,411420
48285,19,-12,618,277021,19,277002
48286,7,-18,955,83206,7,83199
48287,10,-15,157,158808,10,158798
48288,20,4,92,773939,20,773919
48289,14,6,960,843378,14,843364
48290,6,-8,753,391478,6,391472
48291,9,-13,931,238522,9,238513
48292,8,3,45,719783,8,719775
48293,10,2,919,707712,10,707702
48294,8,-7,432,415148,8,415140
48295,11,-7,374,431205,11,431194
48296,16,2,441,713967,16,713951
48297,10,-16,812,141465,10,141455
48298,6,0,783,642481,6,642475
48299,16,10,908,966779,16,966763
48300,20,-2,42,585462,20,585442
48301,8,-7,855,423977,8,423969
48302,9,12,988,1020876,9,1020867
48303,8,5,266,787224,8,787216
48304,8,-9,379,351902,8,351894
48305,13,-2,914,592103,13,592090
48306,15,1,91,680475,15,680460
48307,12,-6,816,465375,12,465363
48308,15,0,743,654004,15,653989
48309,11,18,471,1212437,11,1212426
48310,14,-13,547,245052,14,245038
48311,9,-8,815,392850,9,392841
48312,16,15,277,1118843,16,1118827
48313,16,-20,248,24666,16,24650
48314,15,-12,847,278785,15,278770
48315,11,-12,209,274003,11,273992
48316,7,15,328,1101500,7,1101493
48317,6,10,704,952706,6,952700
48318,14,-9,424,369920,14,369906
48319,19,15,164,1118004,19,1117985
48320,14,12,588,1026380,14,1026366
48321,14,-7,531,432342,14,432328
48322,14,5,306,806011,14,805997
48323,20,14,423,1088794,20,1088774
48324,5,10,709,952832,5,952827
48325,10,0,920,645319,10,645309
48326,5,15,192,1098588,5,1098583
48327,16,-14,554,213756,16,213740
48328,18,-4,34,522283,18,522265
48329,7,14,521,1073464,7,1073457
48330,14,15,811,1122723,14,1122709
48331,12,-18,705,90373,12,90361
48332,8,-9,396,352317,8,352309
48333,18,0,85,648849,18,648831
48334,14,-15,941,184957,14,184943
48335,14,5,311,806034,14,806020
48336,13,-14,936,216759,13,216746
48337,5,-9,543,355897,5,355892
48338,17,10,254,961735,17,961718
48339,12,-1,58,616979,12,616967
48340,11,11,986,997941,11,997930
48341,6,19,795,1235102,6,1235096
48342,16,16,68,1147570,16,1147554
48343,11,-17,742,121138,11,121127
48344,14,-18,911,91843,14,91829
48345,15,-20,252,24704,15,24689
48346,12,-16,707,152093,12,152081
48347,17,3,807,747936,17,747919
48348,17,-1,333,619239,17,619222
48349,8,-4,134,502344,8,502336
48350,12,-20,572,27165,12,27153
48351,20,-16,468,150495,20,150475
48352,14,19,956,1248468,14,1248454
48353,19,19,922,1248198,19,1248179
48354,20,-19,73,54440,20,54420
48355,7,17,68,1156776,7,1156769
48356,11,2,858,716885,11,716874
48357,11,3,493,745489,11,745478
48358,15,-20,708,28237,15,28222
48359,17,19,168,1242090,17,1242073
48360,12,2,50,710897,12,710885
48361,16,-2,862,591690,16,591674
48362,8,15,422,1103316,8,1103308
48363,13,17,521,1181793,13,1181780
48364,15,15,748,1122366,15,1122351
48365,7,-12,70,251130,7,251123
48366,14,17,26,1178054,14,1178040
48367,20,-17,574,119857,20,119837
48368,5,-15,82,157126,5,157121
48369,13,-8,567,401865,13,401852
48370,7,-13,242,223501,7,223494
48371,19,18,439,1212273,19,1212254
48372,8,3,801,736109,8,736101
48373,9,4,17,750845,9,750836
48374,6,6,358,820336,6,820330
48375,6,-17,491,104029,6,104023
48376,13,5,672,808675,13,808662
48377,11,15,313,1119085,11,1119074
48378,11,15,325,1119193,11,1119182
48379,14,7,394,869939,14,869925
48380,5,-1,898,613264,5,613259
48381,14,11,414,993889,14,993875
48382,7,-1,411,602973,7,602966
48383,5,9,684,921108,5,921103
48384,17,2,112,711421,17,711404
48385,17,18,710,1214059,17,1214042
48386,6,-14,923,206607,6,206601
48387,18,-7,796,434051,18,434033
48388,9,-20,470,10043,9,10034
48389,14,16,175,1148364,14,1148350
48390,8,-1,783,610690,8,610682
48391,17,-1,892,623395,17,623378
48392,19,-12,201,273918,19,273899
48393,8,-9,391,352215,8,352207
48394,10,8,636,889157,10,889147
48395,18,14,562,1089833,18,1089815
48396,18,-12,616,276983,18,276965
48397,6,4,790,767829,6,767823
48398,17,-20,721,28325,17,28308
48399,8,4,293,756872,8,756864
48400,5,-19,247,37031,5,37026
48401,10,18,702,1201446,10,1201436
48402,7,-12,403,258339,7,258332
48403,17,-18,849,91334,17,91317
48404,5,-15,169,159019,5,159014
48405,13,-9,416,369818,13,369805
48406,13,-13,276,243134,13,243121
48407,9,-1,951,614491,9,614482
48408,18,1,600,684554,18,684536
48409,15,-5,600,495467,15,495452
48410,8,-12,591,262274,8,262266
48411,19,17,903,1184746,19,1184727
48412,9,8,682,890205,9,890196
48413,20,4,130,774187,20,774167
48414,11,-9,469,370310,11,370299
48415,15,-17,40,115847,15,115832
48416,16,0,259,650116,16,650100
48417,5,-3,580,543521,5,543516
48418,8,16,675,1139341,8,1139333
48419,6,5,775,797788,6,797782
48420,5,13,548,1042526,5,1042521
48421,14,18,596,1213195,14,1213181
48422,5,-20,982,21670,5,21665
48423,18,-4,574,526453,18,526435
48424,15,-20,31,17800,15,17785
48425,15,-5,322,493504,15,493489
48426,16,-19,941,61080,16,61064
48427,14,15,368,1119463,14,1119449
48428,6,-8,433,384274,6,384268
48429,10,10,769,954053,10,954043
48430,20,12,663,1027024,20,1027004
48431,10,9,182,910611,10,910601
48432,11,11,725,996055,11,996044
48433,13,2,975,717723,13,717710
48434,16,13,357,1055872,16,1055856
48435,5,-6,225,441764,5,441759
48436,7,-8,794,392341,7,392334
48437,6,17,700,1170251,6,1170245
48438,10,-20,577,12566,10,12556
48439,6,-9,514,355236,6,355230
48440,17,3,384,744774,17,744757
48441,5,-8,60,376732,5,376727
48442,20,-9,388,369592,20,369572
48443,9,-4,181,503356,9,503347
48444,7,-8,762,391706,7,391699
48445,16,-14,385,212555,16,212539
48446,20,16,549,1150996,20,1150976
48447,17,4,860,779693,17,779676
48448,18,-11,675,309092,18,309074
48449,12,-2,971,592513,12,592501
48450,10,-17,871,111860,10,111850
48451,18,-6,626,463939,18,463921
48452,15,-11,552,308172,15,308157
48453,14,-1,66,617037,14,617023
48454,19,7,364,869653,19,869634
48455,11,-14,186,210727,11,210716
48456,5,-19,756,48174,5,48169
48457,17,-9,790,372816,17,372799
48458,6,3,428,727989,6,727983
48459,5,-8,327,382366,5,382361
48460,16,12,438,1025280,16,1025264
48461,8,-3,692,546034,8,546026
48462,5,-15,401,164062,5,164057
48463,19,-19,976,61303,19,61284
48464,6,14,185,1065870,6,1065864
48465,14,2,478,714259,14,714245
48466,10,18,106,1189149,10,1189139
48467,10,-18,636,76074,10,76064
48468,12,-8,511,401442,12,401430
48469,12,1,121,680774,12,680762
48470,11,14,361,1088233,11,1088222
48471,17,13,92,1053899,17,1053882
48472,15,19,805,1247301,15,1247286
48473,11,15,835,1122898,11,1122887
48474,14,-1,466,620301,14,620287
48475,16,-6,940,466277,16,466261
48476,10,14,716,1078165,10,1078155
48477,10,6,965,833959,10,833949
48478,15,-1,535,620830,15,620815
48479,18,-9,894,373664,18,373646
48480,13,18,438,1212265,13,1212252
48481,12,9,480,932533,12,932521
48482,17,11,191,992181,17,992164
48483,12,18,175,1210354,12,1210342
48484,18,-3,928,561208,18,561190
48485,15,-5,233,492696,15,492681
48486,14,3,921,748803,14,748789
48487,20,-5,407,494012,20,493992
48488,6,-8,6,375432,6,375426
48489,15,1,906,686900,15,686885
48490,20,0,113,649129,20,649109
48491,6,-7,250,411101,6,411095
48492,17,-19,379,56970,17,56953
48493,10,6,846,831369,10,831359
48494,13,-7,158,429462,13,429449
48495,13,14,346,1088116,13,1088103
48496,20,-11,752,309566,20,309546
48497,14,18,42,1209203,14,1209189
48498,19,5,959,810858,19,810839
48499,11,-8,687,402769,11,402758
48500,10,16,974,1145613,10,1145603
48501,9,19,579,1230597,9,1230588
48502,12,-13,33,241328,12,241316
48503,18,-20,561,27083,18,27065
48504,12,-11,327,306360,12,306348
48505,20,-15,734,183275,20,183255
48506,10,-10,770,329041,10,329031
48507,7,11,241,973372,7,973365
48508,13,-15,772,183525,13,183512
48509,15,-10,169,336375,15,336360
48510,8,12,694,1014350,8,1014342
48511,11,-15,706,183022,11,183011
48512,6,-10,208,317164,6,317158
48513,17,0,164,649478,17,649461
48514,16,3,973,749319,16,749303
48515,9,-5,318,475165,9,475156
48516,13,-8,772,403350,13,403337
48517,18,-2,271,587158,18,587140
48518,5,-20,38,907,5,902
48519,17,18,511,1212732,17,1212715
48520,10,14,350,1069498,10,1069488
48521,10,5,945,801638,10,801628
48522,15,-5,866,497335,15,497320
48523,9,12,511,1010012,9,1010003
48524,7,-14,701,202046,7,202039
48525,6,14,229,1066873,6,1066867
48526,16,-7,10,428335,16,428319
48527,7,14,568,1074433,7,1074426
48528,16,14,489,1089250,16,1089234
48529,9,-17,30,94160,9,94151
48530,18,-17,575,119879,18,119861
48531,11,5,991,811066,11,811055
48532,19,10,903,966715,19,966696
48533,19,8,883,904795,19,904776
48534,16,-1,477,620394,16,620378
48535,17,-9,521,370814,17,370797
48536,15,-8,3,397851,15,397836
48537,17,9,499,932682,17,932665
48538,15,5,144,804846,15,804831
48539,15,-18,410,88354,15,88339
48540,18,-18,402,88306,18,88288
48541,17,13,443,1056576,17,1056559
48542,9,-14,9,186640,9,186631
48543,18,-3,395,556694,18,556676
48544,15,-2,296,587385,15,587370
48545,10,-4,128,502197,10,502187
48546,17,-16,216,148558,17,148541
48547,5,4,913,770669,5,770664
48548,17,10,408,962929,17,962912
48549,20,-9,219,368123,20,368103
48550,11,-7,605,432781,11,432770
48551,5,-20,155,3413,5,3408
48552,12,2,936,717426,12,717414
48553,8,-9,977,365260,8,365252
48554,20,-5,349,493693,20,493673
48555,9,5,640,794881,9,794872
48556,17,-5,483,494633,17,494616
48557,13,17,775,1183619,13,1183606
48558,5,12,480,1009395,5,1009390
48559,19,2,409,713766,19,713747
48560,16,-1,23,616699,16,616683
48561,15,9,696,934175,15,934160
48562,18,-16,712,152128,18,152110
48563,19,-12,733,277858,19,277839
48564,5,-8,437,384394,5,384389
48565,14,-17,346,118073,14,118059
48566,15,-17,139,116509,15,116494
48567,15,12,783,1027880,15,1027865
48568,8,6,34,812947,8,812939
48569,18,7,246,868773,18,868755
48570,5,5,770,797744,5,797739
48571,18,-9,429,369961,18,369943
48572,17,10,79,960451,17,960434
48573,11,-7,389,431291,11,431280
48574,12,-15,847,184143,12,184131
48575,17,-15,848,184181,17,184164
48576,10,-15,87,157267,10,157257
48577,9,12,700,1014488,9,1014479
48578,20,-20,327,25409,20,25389
48579,9,-10,441,322169,9,322160
48580,19,-4,251,524076,19,524057
48581,20,1,135,680928,20,680908
48582,17,-14,459,213038,17,213021
48583,6,-16,139,127045,6,127039
48584,13,1,153,681076,13,681063
48585,11,-14,816,215915,11,215904
48586,6,-12,106,251822,6,251816
48587,9,2,382,696875,9,696866
48588,8,6,426,822005,8,821997
48589,14,15,808,1122682,14,1122668
48590,16,-16,964,154040,16,154024
48591,16,-10,837,341381,16,341365
48592,15,6,490,839722,15,839707
48593,9,-7,766,422098,9,422089
48594,8,-20,73,1628,8,1620
48595,9,9,994,927982,9,927973
48596,9,14,34,1062587,9,1062578
48597,9,10,813,955140,9,955131
48598,10,16,113,1127434,10,1127424
48599,5,-5,481,478428,5,478423
48600,13,9,139,930079,13,930066
48601,16,-10,862,341567,16,341551
48602,5,-1,38,594609,5,594604
48603,5,11,435,977805,5,977800
48604,12,11,323,993228,12,993216
48605,5,-5,183,472111,5,472106
48606,6,-13,981,239569,6,239563
48607,15,0,126,649216,15,649201
48608,20,9,588,933420,20,933400
48609,17,4,883,779822,17,779805
48610,13,-9,730,372136,13,372123
48611,18,16,978,1154119,18,1154101
48612,10,-18,65,63806,10,63796
48613,16,17,665,1182811,16,1182795
48614,11,-6,963,466415,11,466404
48615,6,1,863,675802,6,675796
48616,17,-10,921,341999,17,341982
48617,17,17,945,1184969,17,1184952
48618,16,15,3,1116753,16,1116737
48619,7,-11,481,291869,7,291862
48620,13,6,601,840607,13,840594
48621,20,8,70,898421,20,898401
48622,7,-2,706,577899,7,577892
48623,15,-11,652,308941,15,308926
48624,18,14,879,1092308,18,1092290
48625,17,11,378,993628,17,993611
48626,11,12,506,1025764,11,1025753
48627,9,-5,84,469840,9,469831
48628,9,-5,160,471564,9,471555
48629,20,-18,974,92325,20,92305
48630,16,8,35,898126,16,898110
48631,15,-20,676,27994,15,27979
48632,9,3,626,732220,9,732211
48633,5,8,376,883367,5,883362
48634,14,8,89,898619,14,898605
48635,17,10,119,960840,17,960823
48636,13,0,555,652417,13,652404
48637,18,-11,313,306291,18,306273
48638,17,19,468,1244637,17,1244620
48639,6,-3,982,552413,6,552407
48640,5,-4,108,501702,5,501697
48641,13,9,127,930033,13,930020
48642,14,18,94,1209684,14,1209670
48643,13,-12,385,275341,13,275328
48644,11,0,309,650370,11,650359
48645,20,2,546,714725,20,714705
48646,12,-11,844,310287,12,310275
48647,20,7,724,872268,20,872248
48648,12,-19,35,54129,12,54117
48649,13,8,25,898075,13,898062
48650,7,-1,459,604050,7,604043
48651,6,-11,238,286197,6,286191
48652,13,-20,351,25546,13,25533
48653,12,2,298,712836,12,712824
48654,6,13,643,1044592,6,1044586
48655,16,-15,354,180361,16,180345
48656,7,3,469,728889,7,728882
48657,8,-19,17,31836,8,31828
48658,16,8,335,900619,16,900603
48659,14,-11,636,308791,14,308777
48660,16,-2,101,585883,16,585867
48661,8,-2,620,575980,8,575972
48662,7,13,536,1042174,7,1042167
48663,20,-20,966,30098,20,30078
48664,12,19,769,1247038,12,1247026
48665,16,9,844,935336,16,935320
48666,19,14,648,1090506,19,1090487
48667,18,-15,502,181479,18,181461
48668,16,17,56,1178314,16,1178298
48669,13,5,466,807233,13,807220
48670,13,-15,93,178487,13,178474
48671,11,0,935,655360,11,655349
48672,12,13,875,1059788,12,1059776
48673,16,11,950,997697,16,997681
48674,17,-14,249,211371,17,211354
48675,9,-12,735,265320,9,265311
48676,20,-1,453,620161,20,620141
48677,15,-19,801,60194,15,60179
48678,9,-18,301,69069,9,69060
48679,20,-13,415,244029,20,244009
48680,17,15,785,1122530,17,1122513
48681,5,-11,455,291298,5,291293
48682,5,12,88,1001095,5,1001090
48683,19,-17,584,119935,19,119916
48684,5,8,531,886902,5,886897
48685,5,-3,32,531266,5,531261
48686,15,-1,282,618767,15,618752
48687,10,17,352,1162881,10,1162871
48688,18,-8,392,400674,18,400656
48689,13,-15,675,182792,13,182779
48690,19,13,835,1059491,19,1059472
48691,8,-16,1,123800,8,123792
48692,7,-2,377,570723,7,570716
48693,6,-8,977,396369,6,396363
48694,5,-13,322,225208,5,225203
48695,8,13,808,1048199,8,1048191
48696,9,1,499,668223,9,668214
48697,18,10,892,966643,18,966625
48698,10,-19,98,33632,10,33622
48699,13,-7,793,434032,13,434019
48700,20,8,767,904029,20,904009
48701,20,3,447,745192,20,745172
48702,16,-2,447,588491,16,588475
48703,9,18,938,1206567,9,1206558
48704,17,-1,69,617081,17,617064
48705,9,4,561,762657,9,762648
48706,6,-1,534,605663,6,605657
48707,11,7,407,870056,11,870045
48708,15,-2,288,587297,15,587282
48709,15,1,492,683755,15,683740
48710,16,14,903,1092523,16,1092507
48711,9,10,891,956653,9,956644
48712,15,-6,639,464068,15,464053
48713,13,7,786,872680,13,872667
48714,17,-6,664,464203,17,464186
48715,10,-19,607,44850,10,44840
48716,8,-3,221,535132,8,535124
48717,11,10,206,961388,11,961377
48718,13,-2,287,587278,13,587265
48719,8,13,986,1051762,8,1051754
48720,20,11,612,995262,20,995242
48721,11,6,339,838420,11,838409
48722,11,9,637,933798,11,933787
48723,6,-9,589,356835,6,356829
48724,17,11,10,990945,17,990928
48725,9,2,447,698172,9,698163
48726,5,14,974,1083575,5,1083570
48727,11,-2,300,587391,11,587380
48728,11,-10,958,342276,11,342265
48729,12,18,715,1214061,12,1214049
48730,6,10,874,956290,6,956284
48731,15,10,398,962812,15,962797
48732,19,-7,875,434705,19,434686
48733,6,-6,135,439595,6,439589
48734,17,12,738,1027554,17,1027537
48735,12,-18,390,88223,12,88211
48736,12,17,138,1178882,12,1178870
48737,15,-5,828,497000,15,496985
48738,7,-12,564,261721,7,261714
48739,16,12,838,1028325,16,1028309
48740,11,7,440,870318,11,870307
48741,19,-15,790,183620,19,183601
48742,9,2,695,703298,9,703289
48743,7,-10,950,332858,7,332851
48744,15,13,63,1053690,15,1053675
48745,5,-16,834,141890,5,141885
48746,11,-5,808,496863,11,496852
48747,16,-13,723,246365,16,246349
48748,16,-4,749,527642,16,527626
48749,6,9,173,910479,6,910473
48750,15,-1,213,618205,15,618190
48751,17,-10,971,342404,17,342387
48752,18,6,467,839537,18,839519
48753,20,15,740,1122294,20,1122274
48754,19,14,960,1092938,19,1092919
48755,5,-17,50,94550,5,94545
48756,8,-7,675,420080,8,420072
48757,10,13,480,1041027,10,1041017
48758,10,7,327,851862,10,851852
48759,9,13,333,1037948,9,1037939
48760,11,-11,949,311125,11,311114
48761,16,-17,610,120085,16,120069
48762,19,-19,526,58082,19,58063
48763,7,17,765,1171519,7,1171512
48764,12,17,56,1178316,12,1178304
48765,8,8,299,881746,8,881738
48766,15,0,545,652357,15,652342
48767,20,3,43,742130,20,742110
48768,12,-12,307,274803,12,274791
48769,8,6,115,814685,8,814677
48770,5,-14,44,187512,5,187507
48771,18,6,777,841980,18,841962
48772,8,-6,941,456877,8,456869
48773,7,6,318,819427,7,819420
48774,16,10,214,961469,16,961453
48775,8,13,385,1038999,8,1038991
48776,6,-3,369,538468,6,538462
48777,7,2,8,688659,7,688652
48778,14,-8,122,398734,14,398720
48779,16,4,61,773703,16,773687
48780,8,-3,553,542930,8,542922
48781,8,6,609,826062,8,826054
48782,7,-5,220,472827,7,472820
48783,17,10,170,961179,17,961162
48784,12,10,688,965229,12,965217
48785,6,3,546,730286,6,730280
48786,6,-15,316,162232,6,162226
48787,13,18,42,1209206,13,1209193
48788,17,-19,544,58227,17,58210
48789,17,-5,684,496018,17,496001
48790,16,-5,554,495119,16,495103
48791,10,-11,345,288736,10,288726
48792,10,1,314,664040,10,664030
48793,19,-10,81,335805,19,335786
48794,9,10,462,947422,9,947413
48795,12,6,917,843094,12,843082
48796,6,0,488,636019,6,636013
48797,9,-17,498,104228,9,104219
48798,9,1,816,674715,9,674706
48799,6,-13,922,238295,6,238289
48800,12,-7,516,432235,12,432223
48801,8,10,17,937842,8,937834
48802,13,-4,175,523391,13,523378
48803,15,-11,209,305354,15,305339
48804,17,-18,457,88718,17,88701
48805,16,2,85,711172,16,711156
48806,9,-10,336,319851,9,319842
48807,7,-1,763,610219,7,610212
48808,6,-4,177,503266,6,503260
48809,11,-18,409,88350,11,88339
48810,11,18,376,1211822,11,1211811
48811,11,16,370,1149805,11,1149794
48812,15,7,206,868458,15,868443
48813,16,17,534,1181856,16,1181840
48814,16,18,433,1212242,16,1212226
48815,14,2,924,717338,14,717324
48816,16,14,422,1088779,16,1088763
48817,9,-7,571,418109,9,418100
48818,12,8,884,904796,12,904784
48819,11,-17,938,122410,11,122399
48820,10,-11,717,296618,10,296608
48821,8,18,249,1192259,8,1192251
48822,20,-3,579,558382,20,558362
48823,18,-15,918,184757,18,184739
48824,13,11,695,995746,13,995733
48825,5,8,549,887243,5,887238
48826,13,8,14,898025,13,898012
48827,8,-20,767,16865,8,16857
48828,8,-17,977,114068,8,114060
48829,11,19,322,1243346,11,1243335
48830,10,-6,618,450095,10,450085
48831,13,-16,946,153875,13,153862
48832,12,14,26,1085565,12,1085553
48833,20,1,558,684293,20,684273
48834,14,-18,632,89825,14,89811
48835,10,-20,66,1407,10,1397
48836,15,8,473,901661,15,901646
48837,18,11,774,996468,18,996450
48838,9,-20,546,11900,9,11891
48839,9,5,578,793601,9,793592
48840,7,5,57,782893,7,782886
48841,17,-17,430,118638,17,118621
48842,12,7,6,867057,12,867045
48843,6,8,233,880360,6,880354
48844,11,-19,750,59891,11,59880
48845,17,-20,331,25436,17,25419
48846,9,-4,872,518094,9,518085
48847,10,0,999,647174,10,647164
48848,20,-16,724,152222,20,152202
48849,12,-3,544,558111,12,558099
48850,20,9,559,933178,20,933158
48851,13,-2,505,588945,13,588932
48852,12,4,633,777880,12,777868
48853,19,16,240,1148816,19,1148797
48854,19,18,724,1214121,19,1214102
48855,12,-4,183,523496,12,523484
48856,6,5,486,791692,6,791686
48857,13,-16,429,150127,13,150114
48858,11,-14,705,215021,11,215010
48859,5,-20,989,21863,5,21858
48860,17,14,29,1085597,17,1085580
48861,6,-17,29,94126,6,94120
48862,16,-20,391,25777,16,25761
48863,6,-20,218,4955,6,4949
48864,6,-9,149,346784,6,346778
48865,17,-17,442,118749,17,118732
48866,14,-5,449,494314,14,494300
48867,6,-11,956,301758,6,301752
48868,7,12,765,1015724,7,1015717
48869,5,15,182,1098330,5,1098325
48870,11,-2,267,587139,11,587128
48871,12,-6,921,466117,12,466105
48872,8,7,642,858377,8,858369
48873,12,2,405,713721,12,713709
48874,17,1,33,680064,17,680047
48875,11,12,149,1023098,11,1023087
48876,17,0,528,652210,17,652193
48877,8,-15,996,176713,8,176705
48878,12,-13,509,244791,12,244779
48879,6,15,470,1104381,6,1104375
48880,15,3,363,744614,15,744599
48881,16,6,380,838734,16,838718
48882,6,-1,83,595608,6,595602
48883,10,4,193,754772,10,754762
48884,19,16,277,1149119,19,1149100
48885,18,-12,709,277738,18,277720
48886,6,-3,149,533634,6,533628
48887,17,7,43,867360,17,867343
48888,19,-9,286,368677,19,368658
48889,14,-8,245,399647,14,399633
48890,10,1,911,676815,10,676805
48891,6,15,661,1108453,6,1108447
48892,10,5,245,786782,10,786772
48893,5,11,922,988417,5,988412
48894,7,-20,959,21088,7,21081
48895,6,19,898,1237462,6,1237456
48896,15,-14,655,214620,15,214605
48897,16,5,152,804900,16,804884
48898,7,-9,733,359761,7,359754
48899,19,19,682,1246307,19,1246288
48900,13,11,637,995388,13,995375
48901,19,-11,647,308891,19,308872
48902,15,-18,145,86336,15,86321
48903,14,7,871,873315,14,873301
48904,5,10,812,955112,5,955107
48905,10,8,828,893195,10,893185
48906,9,15,430,1103545,9,1103536
48907,7,9,132,909596,7,909589
48908,16,-12,907,279375,16,279359
48909,7,-13,709,233449,7,233442
48910,13,5,68,804306,13,804293
48911,12,-15,764,183455,12,183443
48912,6,-10,849,330797,6,330791
48913,13,17,169,1179156,13,1179143
48914,20,3,669,746893,20,746873
48915,18,1,736,685584,18,685566
48916,5,14,789,1079622,5,1079617
48917,16,4,169,774496,16,774480
48918,9,-7,557,417832,9,417823
48919,9,-3,477,541174,9,541165
48920,10,-3,377,538699,10,538689
48921,16,-3,451,557252,16,557236
48922,11,-7,117,429142,11,429131
48923,12,-12,141,273587,12,273575
48924,9,8,50,876126,9,876117
48925,12,-17,348,118086,12,118074
48926,18,19,952,1248448,18,1248430
48927,15,10,975,967294,15,967279
48928,20,-16,76,147440,20,147420
48929,10,-2,160,566161,10,566151
48930,11,12,618,1026620,11,1026609
48931,9,-4,325,506637,9,506628
48932,20,7,541,871031,20,871011
48933,5,-13,44,219321,5,219316
48934,17,18,104,1209778,17,1209761
48935,12,-11,256,305710,12,305698
48936,13,2,403,713695,13,713682
48937,11,7,656,871817,11,871806
48938,10,14,199,1066123,10,1066113
48939,14,-1,47,616930,14,616916
48940,19,7,712,872194,19,872175
48941,11,3,372,744669,11,744658
48942,7,-1,971,614807,7,614800
48943,13,-20,14,7767,13,7754
48944,10,-19,595,44548,10,44538
48945,17,17,710,1183173,17,1183156
48946,6,0,809,643055,6,643049
48947,8,8,288,881512,8,881504
48948,10,-14,490,197261,10,197251
48949,11,14,562,1089834,11,1089823
48950,10,-19,259,37216,10,37206
48951,8,0,279,631338,8,631330
48952,12,-2,254,587043,12,587031
48953,12,-20,186,24269,12,24257
48954,19,-15,463,181201,19,181182
48955,10,-9,381,351946,10,351936
48956,20,0,523,652142,20,652122
48957,17,-2,538,589163,17,589146
48958,6,-7,802,422748,6,422742
48959,11,6,88,836390,11,836379
48960,18,19,507,1244958,18,1244940
48961,13,-3,415,556858,13,556845
48962,14,-4,525,526092,14,526078
48963,15,14,809,1091814,15,1091799
48964,5,-16,791,141024,5,141019
48965,12,-17,412,118496,12,118484
48966,20,-13,418,244049,20,244029
48967,13,16,58,1147513,13,1147500
48968,6,11,801,985598,6,985592
48969,9,7,531,856099,9,856090
48970,19,4,383,775993,19,775974
48971,17,2,408,713750,17,713733
48972,18,4,831,779439,18,779421
48973,11,-19,561,58403,11,58392
48974,13,-18,301,87573,13,87560
48975,9,-9,454,353690,9,353681
48976,18,16,916,1153685,18,1153667
48977,6,-8,856,393598,6,393592
48978,5,9,445,916032,5,916027
48979,5,-8,680,389971,5,389966
48980,12,-1,341,619318,12,619306
48981,16,-10,375,337782,16,337766
48982,20,14,626,1090292,20,1090272
48983,6,10,224,942285,6,942279
48984,7,10,438,946887,7,946880
48985,10,-19,272,37461,10,37451
48986,13,-6,350,461869,13,461856
48987,14,12,184,1023393,14,1023379
48988,10,-17,24,94079,10,94069
48989,10,-14,414,195881,10,195871
48990,15,13,58,1053656,15,1053641
48991,17,-8,13,397975,17,397958
48992,17,10,140,960971,17,960954
48993,6,10,213,942060,6,942054
48994,8,14,720,1078247,8,1078239
48995,12,5,29,803939,12,803927
48996,14,19,836,1247548,14,1247534
48997,5,0,98,627562,5,627557
48998,19,-11,248,305655,19,305636
48999,18,13,536,1057219,18,1057201
49000,12,-18,572,89385,12,89373
49001,10,14,848,1080837,10,1080827
49002,18,5,384,806608,18,806590
49003,6,-16,348,131432,6,131426
49004,13,-20,327,25412,13,25399
49005,7,-3,729,546784,7,546777
49006,17,10,428,963113,17,963096
49007,20,9,431,932150,20,932130
49008,12,-14,478,213197,12,213185
49009,16,1,853,686446,16,686430
49010,6,-11,34,281777,6,281771
49011,11,18,525,1212833,11,1212822
49012,9,4,442,760142,9,760133
49013,10,1,657,671563,10,671553
49014,7,-5,172,471861,7,471854
49015,17,11,613,995268,17,995251
49016,13,5,188,805220,13,805207
49017,10,17,654,1169330,10,1169320
49018,19,3,736,747417,19,747398
49019,6,-20,830,18411,6,18405
49020,11,-9,292,368722,11,368711
49021,17,6,228,837477,17,837460
49022,5,-18,688,77098,5,77093
49023,8,8,241,880545,8,880537
49024,14,-5,521,494900,14,494886
49025,9,-13,849,236742,9,236733
49026,13,-16,367,149576,13,149563
49027,14,-11,680,309122,14,309108
49028,5,0,387,633772,5,633767
49029,13,-12,22,272664,13,272651
49030,10,2,448,698191,10,698181
49031,20,7,381,869824,20,869804
49032,7,10,848,955718,7,955711
49033,7,-2,221,567512,7,567505
49034,9,0,795,642722,9,642713
49035,7,-14,597,199749,7,199742
49036,14,12,614,1026556,14,1026542
49037,8,5,140,784482,8,784474
49038,5,-14,517,197810,5,197805
49039,12,-5,782,496680,12,496668
49040,7,-15,279,161344,7,161337
49041,12,-16,32,146970,12,146958
49042,20,16,898,1153479,20,1153459
49043,15,0,21,648381,15,648366
49044,5,-10,709,327920,5,327915
49045,12,0,762,654138,12,654126
49046,14,15,874,1123159,14,1123145
49047,10,5,663,795318,10,795308
49048,7,8,774,892262,7,892255
49049,15,-17,984,122708,15,122693
49050,12,-13,445,244259,12,244247
49051,10,10,973,958325,10,958315
49052,19,-7,581,432709,19,432690
49053,17,-4,362,524949,17,524932
49054,6,4,353,758148,6,758142
49055,8,13,717,1046087,8,1046079
49056,12,8,191,899440,12,899428
49057,12,16,616,1151446,12,1151434
49058,13,-2,600,589621,13,589608
49059,8,-16,833,141880,8,141872
49060,13,-6,630,463963,13,463950
49061,10,-2,747,578622,10,578612
49062,18,-10,413,338089,18,338071
49063,6,-2,317,569600,6,569594
49064,12,-12,283,274601,12,274589
49065,16,-15,642,182582,16,182566
49066,19,9,592,933470,19,933451
49067,8,-10,355,320276,8,320268
49068,14,4,319,775479,14,775465
49069,9,-7,163,409234,9,409225
49070,19,-14,135,210369,19,210350
49071,11,-5,914,497737,11,497726
49072,17,2,825,716644,17,716627
49073,15,-8,526,401558,15,401543
49074,6,-2,960,583408,6,583402
49075,5,-7,865,424216,5,424211
49076,9,-14,472,196910,9,196901
49077,14,-2,184,586428,14,586414
49078,12,-4,65,522541,12,522529
49079,12,11,17,990980,12,990968
49080,7,-12,534,261204,7,261197
49081,10,-2,658,576759,10,576749
49082,7,-4,656,513527,7,513520
49083,8,-13,429,227354,8,227346
49084,12,-5,707,496204,12,496192
49085,9,0,194,629737,9,629728
49086,11,-3,652,558990,11,558979
49087,6,2,818,705628,6,705622
49088,9,16,80,1126835,9,1126826
49089,6,-3,245,535736,6,535730
49090,5,6,530,824387,5,824382
49091,12,12,888,1028756,12,1028744
49092,6,-12,173,253226,6,253220
49093,9,4,269,756383,9,756374
49094,12,-18,747,90695,12,90683
49095,10,-15,963,176011,10,176001
49096,19,4,996,780554,19,780535
49097,14,8,728,903743,14,903729
49098,17,18,771,1214553,17,1214536
49099,5,-9,434,353205,5,353200
49100,10,10,355,945036,10,945026
49101,16,-16,205,148455,16,148439
49102,14,19,540,1245219,14,1245205
49103,7,-20,548,11988,7,11981
49104,13,12,958,1029472,13,1029459
49105,15,-16,16,146899,15,146884
49106,20,-16,361,149542,20,149522
49107,5,-6,4,436935,5,436930
49108,15,-15,139,178858,15,178843
49109,16,1,14,679829,16,679813
49110,10,-16,563,136268,10,136258
49111,19,2,902,717208,19,717189
49112,12,11,747,996196,12,996184
49113,5,-9,915,364217,5,364212
49114,9,15,403,1102907,9,1102898
49115,16,-9,363,369360,16,369344
49116,15,-14,945,216836,15,216821
49117,11,-14,727,215157,11,215146
49118,12,-5,784,496686,12,496674
49119,8,-18,776,79241,8,79233
49120,6,18,82,1188563,6,1188557
49121,9,-9,308,350325,9,350316
49122,17,2,286,712728,17,712711
49123,19,-9,485,370502,19,370483
49124,18,11,45,991181,18,991163
49125,13,-9,970,374148,13,374135
49126,20,15,261,1118719,20,1118699
49127,8,-20,257,5743,8,5735
49128,15,1,753,685706,15,685691
49129,20,10,19,959984,20,959964
49130,19,-16,34,146986,19,146967
49131,14,-10,923,342020,14,342006
49132,19,-7,149,429389,19,429370
49133,7,-14,384,195181,7,195174
49134,12,4,127,774149,12,774137
49135,18,-6,403,462208,18,462190
49136,16,13,607,1057874,16,1057858
49137,20,17,841,1184297,20,1184277
49138,19,11,550,994799,19,994780
49139,12,-6,923,466129,12,466117
49140,11,-4,320,524585,11,524574
49141,19,6,542,840144,19,840125
49142,17,15,864,1123097,17,1123080
49143,8,-14,132,189351,8,189343
49144,15,-15,538,181711,15,181696
49145,7,-18,415,71320,7,71313
49146,5,-8,454,384713,5,384708
49147,13,18,886,1215450,13,1215437
49148,7,-10,400,321276,7,321269
49149,12,-1,811,622812,12,622800
49150,14,16,314,1149403,14,1149389
49151,9,-16,92,126000,9,125991
49152,18,9,427,932141,18,932123
49153,20,-17,193,116887,20,116867
49154,17,17,860,1184471,17,1184454
49155,19,11,218,992388,19,992369
49156,6,-2,489,573215,6,573209
49157,17,-16,597,151387,17,151370
49158,11,5,489,807381,11,807370
49159,18,0,176,649571,18,649553
49160,5,14,183,1065826,5,1065821
49161,17,6,566,840353,17,840336
49162,18,14,858,1092125,18,1092107
49163,14,18,723,1214107,14,1214093
49164,13,-19,932,61010,13,60997
49165,19,8,826,904399,19,904380
49166,5,-20,588,12862,5,12857
49167,13,8,661,903173,13,903160
49168,14,14,226,1087175,14,1087161
49169,11,-8,601,402048,11,402037
49170,15,14,289,1087649,15,1087634
49171,14,4,763,778888,14,778874
49172,8,15,950,1114720,8,1114712
49173,9,2,648,702317,9,702308
49174,5,-1,974,614865,5,614860
49175,9,19,60,1218755,9,1218746
49176,11,1,850,686425,11,686414
49177,10,4,502,761371,10,761361
49178,15,-10,613,339665,15,339650
49179,6,11,301,974812,6,974806
49180,14,-8,862,403991,14,403977
49181,20,-20,942,29948,20,29928
49182,11,-14,525,213569,11,213558
49183,13,16,367,1149798,13,1149785
49184,13,6,336,838412,13,838399
49185,19,15,890,1123261,19,1123242
49186,10,-8,698,390451,10,390441
49187,10,-7,248,411087,10,411077
49188,16,-17,826,121683,16,121667
49189,13,-11,47,303969,13,303956
49190,5,12,488,1009624,5,1009619
49191,7,6,953,833640,7,833633
49192,8,-20,641,14048,8,14040
49193,8,8,131,877891,8,877883
49194,12,-4,770,527799,12,527787
49195,14,4,723,778576,14,778562
49196,5,6,634,826612,5,826607
49197,13,-11,823,310128,13,310115
49198,6,4,368,758507,6,758501
49199,19,13,0,1053254,19,1053235
49200,8,-9,993,365452,8,365444
49201,7,-14,414,195888,7,195881
49202,15,3,818,747986,15,747971
49203,19,5,159,804939,19,804920
49204,6,19,667,1232306,6,1232300
49205,9,13,964,1051334,9,1051325
49206,12,12,454,1025357,12,1025345
49207,10,-11,192,285313,10,285303
49208,14,-6,604,463766,14,463752
49209,15,-14,632,214470,15,214455
49210,19,6,370,838651,19,838632
49211,8,-16,492,134801,8,134793
49212,5,-9,875,363173,5,363168
49213,13,15,897,1123342,13,1123329
49214,14,3,441,745140,14,745126
49215,11,4,55,773650,11,773639
49216,9,-1,357,601968,9,601959
49217,8,-16,29,124452,8,124444
49218,18,13,627,1058006,18,1057988
49219,15,16,379,1149869,15,1149854
49220,5,1,327,664415,5,664410
49221,20,9,27,929256,20,929236
49222,12,-13,81,241624,12,241612
49223,18,0,536,652288,18,652270
49224,13,9,207,930602,13,930589
49225,16,5,421,806817,16,806801
49226,7,-18,901,82000,7,81993
49227,11,14,232,1087233,11,1087222
49228,16,7,244,868760,16,868744
49229,14,-15,302,179975,14,179961
49230,16,10,664,965034,16,965018
49231,18,-10,618,339684,18,339666
49232,10,4,787,767780,10,767770
49233,13,9,400,931950,13,931937
49234,20,-17,457,118913,20,118893
49235,7,-12,155,252871,7,252864
49236,14,0,922,655285,14,655271
49237,6,-15,728,171046,6,171040
49238,10,-17,824,110943,10,110933
49239,16,12,280,1024189,16,1024173
49240,18,1,882,686656,18,686638
49241,10,-3,788,548095,10,548085
49242,12,3,382,744741,12,744729
49243,17,-10,876,341684,17,341667
49244,10,6,439,822360,10,822350
49245,11,-15,934,184868,11,184857
49246,10,-3,962,552067,10,552057
49247,13,14,317,1087885,13,1087872
49248,8,17,627,1168697,8,1168689
49249,10,15,240,1099624,10,1099614
49250,14,10,763,965716,14,965702
49251,19,19,738,1246796,19,1246777
49252,18,19,3,1240673,18,1240655
49253,18,16,801,1152880,18,1152862
49254,13,11,709,995886,13,995873
49255,13,-17,837,121773,13,121760
49256,15,-3,742,559668,15,559653
49257,18,1,39,680101,18,680083
49258,9,-12,940,270030,9,270021
49259,19,-7,257,430201,19,430182
49260,5,17,419,1164218,5,1164213
49261,12,16,167,1148273,12,1148261
49262,15,-8,376,400543,15,400528
49263,6,6,662,827227,6,827221
49264,6,-19,426,40705,6,40699
49265,14,18,367,1211799,14,1211785
49266,17,-19,483,57670,17,57653
49267,14,4,811,779225,14,779211
49268,9,8,359,883045,9,883036
49269,9,3,644,732664,9,732655
49270,15,0,232,649989,15,649974
49271,6,-6,2,436887,6,436881
49272,20,8,929,905188,20,905168
49273,16,19,856,1247730,16,1247714
49274,17,10,572,964297,17,964280
49275,16,-1,53,616973,16,616957
49276,12,17,136,1178876,12,1178864
49277,8,10,821,955293,8,955285
49278,19,16,440,1150291,19,1150272
49279,13,-2,707,590470,13,590457
49280,12,14,126,1086481,12,1086469
49281,16,-14,88,210008,16,209992
49282,16,1,406,683077,16,683061
49283,7,15,259,1100090,7,1100083
49284,13,-18,659,90077,13,90064
49285,6,15,797,1111318,6,1111312
49286,14,18,133,1210001,14,1209987
49287,8,-18,565,74536,8,74528
49288,19,-14,328,211970,19,211951
49289,13,-3,838,560483,13,560470
49290,15,12,436,1025265,15,1025250
49291,17,4,974,780396,17,780379
49292,5,-15,957,175880,5,175875
49293,20,19,495,1244836,20,1244816
49294,5,-6,580,449247,5,449242
49295,20,14,665,1090655,20,1090635
49296,12,0,169,649522,12,649510
49297,19,-15,438,181028,19,181009
49298,9,12,820,1016881,9,1016872
49299,14,-9,829,373096,14,373082
49300,5,17,723,1170693,5,1170688
49301,10,-9,280,349715,10,349705
49302,19,-9,1000,374259,19,374240
49303,19,9,701,934229,19,934210
49304,11,-8,431,400879,11,400868
49305,16,-11,962,311263,16,311247
49306,18,-13,68,241528,18,241510
49307,18,-18,163,86500,18,86482
49308,10,-15,40,156183,10,156173
49309,5,-4,741,515301,5,515296
49310,8,-4,680,514166,8,514158
49311,8,-13,898,237716,8,237708
49312,9,-17,968,113872,9,113863
49313,17,0,874,654851,17,654834
49314,6,11,432,977699,6,977693
49315,9,-14,606,199990,9,199981
49316,20,-13,20,241198,20,241178
49317,20,8,221,899724,20,899704
49318,6,16,635,1138570,6,1138564
49319,12,12,984,1029713,12,1029701
49320,20,-3,354,556374,20,556354
49321,18,9,43,929377,18,929359
49322,7,-6,631,450333,7,450326
49323,19,-6,27,459371,19,459352
49324,13,5,679,808734,13,808721
49325,19,-20,347,25532,19,25513
49326,13,-7,812,434214,13,434201
49327,6,-15,13,155594,6,155588
49328,6,-20,373,8189,6,8183
49329,18,-15,505,181492,18,181474
49330,20,-6,7,459200,20,459180
49331,12,12,414,1025067,12,1025055
49332,16,-7,842,434430,16,434414
49333,8,-19,532,43065,8,43057
49334,6,-3,480,541215,6,541209
49335,12,-18,751,90747,12,90735
49336,18,11,333,993325,18,993307
49337,17,3,690,747094,17,747077
49338,18,14,211,1087053,18,1087035
49339,9,14,613,1075520,9,1075511
49340,20,18,297,1211271,20,1211251
49341,20,9,238,930752,20,930732
49342,15,8,807,904315,15,904300
49343,11,9,774,934753,11,934742
49344,12,-6,815,465374,12,465362
49345,17,-10,674,340180,17,340163
49346,8,-9,644,357829,8,357821
49347,12,-4,536,526161,12,526149
49348,15,-3,347,556334,15,556319
49349,8,9,31,907470,8,907462
49350,17,9,445,932276,17,932259
49351,12,-15,532,181694,12,181682
49352,15,-10,33,335410,15,335395
49353,13,9,443,932252,13,932239
49354,11,-6,600,463727,11,463716
49355,20,9,605,933536,20,933516
49356,11,9,35,929316,11,929305
49357,15,-4,110,522852,15,522837
49358,13,-14,252,211392,13,211379
49359,17,19,680,1246282,17,1246265
49360,14,-19,874,60721,14,60707
49361,13,10,563,964198,13,964185
49362,20,12,578,1026300,20,1026280
49363,9,-1,424,603234,9,603225
49364,13,9,600,933517,13,933504
49365,6,14,13,1062032,6,1062026
49366,11,19,814,1247370,11,1247359
49367,19,-13,686,245994,19,245975
49368,5,2,694,703276,5,703271
49369,6,0,986,646767,6,646761
49370,17,2,292,712819,17,712802
49371,5,0,269,631176,5,631171
49372,11,0,987,655813,11,655802
49373,13,8,326,900558,13,900545
49374,16,15,912,1123451,16,1123435
49375,5,-2,570,574896,5,574891
49376,6,-12,981,271043,6,271037
49377,7,-17,773,110058,7,110051
49378,14,-7,312,430668,14,430654
49379,9,-2,602,575597,9,575588
49380,18,-6,683,464329,18,464311
49381,11,-8,179,399176,11,399165
49382,9,-4,397,508292,9,508283
49383,12,0,153,649351,12,649339
49384,18,-8,748,403184,18,403166
49385,5,-6,173,440561,5,440556
49386,19,19,485,1244774,19,1244755
49387,10,1,514,668551,10,668541
49388,8,4,194,754789,8,754781
49389,18,14,772,1091550,18,1091532
49390,17,2,855,716854,17,716837
49391,10,-13,113,220855,10,220845
49392,6,-9,831,362094,6,362088
49393,12,2,224,712267,12,712255
49394,15,-20,447,26209,15,26194
49395,19,-16,367,149585,19,149566
49396,10,7,479,855156,10,855146
49397,7,-9,796,361394,7,361387
49398,5,16,451,1134944,5,1134939
49399,17,12,617,1026610,17,1026593
49400,6,-1,260,599506,6,599500
49401,7,-14,51,187642,7,187635
49402,6,-2,649,576570,6,576564
49403,12,-19,17,54012,12,54000
49404,12,13,623,1057966,12,1057954
49405,7,9,105,908956,7,908949
49406,7,-4,587,512085,7,512078
49407,13,-9,490,370533,13,370520
49408,14,16,759,1152478,14,1152464
49409,14,-7,238,430053,14,430039
49410,20,-7,584,432727,20,432707
49411,10,16,841,1142618,10,1142608
49412,16,3,572,746094,16,746078
49413,20,-5,434,494211,20,494191
49414,14,11,322,993219,14,993205
49415,8,17,91,1157237,8,1157229
49416,9,-11,979,302215,9,302206
49417,9,19,371,1225905,9,1225896
49418,7,4,869,769734,7,769727
49419,7,-6,250,442278,7,442271
49420,5,6,344,820112,5,820107
49421,9,-18,434,71730,9,71721
49422,14,-6,480,462844,14,462830
49423,10,9,754,922514,10,922504
49424,14,-20,708,28241,14,28227
49425,5,-11,282,287199,5,287194
49426,15,9,675,934031,15,934016
49427,11,-9,498,370609,11,370598
49428,11,-5,669,495852,11,495841
49429,7,6,650,826953,7,826946
49430,19,-2,699,590426,19,590407
49431,7,-15,978,176298,7,176291
49432,8,-5,894,487519,8,487511
49433,20,6,98,836485,20,836465
49434,5,1,332,664491,5,664486
49435,14,1,89,680472,14,680458
49436,16,16,549,1151002,16,1150986
49437,20,-18,952,92125,20,92105
49438,20,-13,281,243190,20,243170
49439,20,-1,543,620876,20,620856
49440,16,5,231,805553,16,805537
49441,10,-5,491,478643,10,478633
49442,12,2,622,715203,12,715191
49443,13,-16,143,147978,13,147965
49444,20,17,838,1184250,20,1184230
49445,12,13,253,1055044,12,1055032
49446,9,9,208,911192,9,911183
49447,5,-7,793,422547,5,422542
49448,14,13,822,1059401,14,1059387
49449,10,-11,423,290575,10,290565
49450,19,-12,739,277924,19,277905
49451,17,-1,601,621249,17,621232
49452,15,-10,161,336294,15,336279
49453,12,-9,463,370227,12,370215
49454,18,-1,629,621432,18,621414
49455,14,-9,497,370604,14,370590
49456,8,2,168,692266,8,692258
49457,19,5,610,808261,19,808242
49458,5,18,525,1198056,5,1198051
49459,20,-5,593,495425,20,495405
49460,19,4,271,775157,19,775138
49461,20,-9,777,372697,20,372677
49462,5,0,435,634713,5,634708
49463,11,6,930,843166,11,843155
49464,6,2,979,709101,6,709095
49465,16,-10,681,340213,16,340197
49466,20,4,565,777359,20,777339
49467,16,-19,578,58595,16,58579
49468,5,3,94,720860,5,720855
49469,12,-10,756,340784,12,340772
49470,5,-12,819,267309,5,267304
49471,10,8,187,879123,10,879113
49472,19,-11,938,311022,19,311003
49473,19,-5,979,498231,19,498212
49474,7,-19,711,47139,7,47132
49475,20,13,760,1058902,20,1058882
49476,17,8,977,905558,17,905541
49477,9,-3,335,537787,9,537778
49478,16,-5,588,495381,16,495365
49479,10,4,963,771582,10,771572
49480,19,-10,473,338629,19,338610
49481,17,12,794,1027967,17,1027950
49482,7,13,678,1045326,7,1045319
49483,16,-18,890,91686,16,91670
49484,15,-5,171,492271,15,492256
49485,12,15,880,1123190,12,1123178
49486,19,-15,772,183534,19,183515
49487,5,-13,216,222935,5,222930
49488,12,-18,649,89970,12,89958
49489,15,-16,224,148623,15,148608
49490,14,17,958,1185087,14,1185073
49491,5,-13,506,229055,5,229050
49492,7,-16,233,129204,7,129197
49493,10,5,394,789746,10,789736
49494,13,-4,510,525975,13,525962
49495,17,-11,562,308209,17,308192
49496,5,-7,294,412224,5,412219
49497,12,-18,868,91507,12,91495
49498,14,17,593,1182240,14,1182226
49499,15,2,403,713700,15,713685
49500,20,3,690,747104,20,747084
49501,10,-12,615,262763,10,262753
49502,20,17,138,1178892,20,1178872
49503,5,13,292,1036997,5,1036992
49504,9,-11,907,300666,9,300657
49505,17,-12,506,276318,17,276301
49506,15,-18,708,90395,15,90380
49507,19,6,423,839151,19,839132
49508,15,-1,477,620399,15,620384
49509,10,-2,874,581511,10,581501
49510,9,-19,653,45901,9,45892
49511,14,0,992,655860,14,655846
49512,14,-11,596,308461,14,308447
49513,12,18,959,1216024,12,1216012
49514,5,14,22,1062259,5,1062254
49515,6,12,847,1017618,6,1017612
49516,7,17,227,1160015,7,1160008
49517,18,19,8,1240710,18,1240692
49518,14,-10,546,339138,14,339124
49519,17,11,379,993643,17,993626
49520,20,9,482,932583,20,932563
49521,13,19,221,1242492,13,1242479
49522,5,17,774,1171742,5,1171737
49523,6,0,242,630652,6,630646
49524,15,3,91,742484,15,742469
49525,17,-17,367,118200,17,118183
49526,19,-20,523,26745,19,26726
49527,10,11,281,974282,10,974272
49528,14,-10,947,342215,14,342201
49529,14,-4,811,528065,14,528051
49530,12,-2,497,588901,12,588889
49531,9,-8,107,377611,9,377602
49532,9,-20,68,1478,9,1469
49533,13,16,631,1151607,13,1151594
49534,20,-1,268,618661,20,618641
49535,17,17,126,1178786,17,1178769
49536,7,-5,468,478129,7,478122
49537,16,10,222,961531,16,961515
49538,18,-17,236,117204,18,117186
49539,20,10,365,962605,20,962585
49540,5,-18,342,69873,5,69868
49541,5,18,580,1199068,5,1199063
49542,17,-15,11,177912,17,177895
49543,17,-4,163,523316,17,523299
49544,13,-17,13,115666,13,115653
49545,9,-8,811,392699,9,392690
49546,15,14,953,1092903,15,1092888
49547,7,-1,865,612469,7,612462
49548,15,-14,590,214172,15,214157
49549,6,-19,646,45769,6,45763
49550,6,15,82,1096206,6,1096200
49551,7,-14,585,199399,7,199392
49552,6,13,376,1038785,6,1038779
49553,15,-5,19,490918,15,490903
49554,17,-13,586,245368,17,245351
49555,15,6,615,840725,15,840710
49556,8,-16,355,131559,8,131551
49557,12,-4,913,528931,12,528919
49558,18,-19,39,54162,18,54144
49559,13,-16,599,151423,13,151410
49560,18,9,436,932213,18,932195
49561,9,-8,478,385215,9,385206
49562,6,-7,268,411508,6,411502
49563,11,19,841,1247582,11,1247571
49564,16,-8,973,404825,16,404809
49565,16,17,668,1182845,16,1182829
49566,13,5,347,806322,13,806309
49567,11,-18,958,92199,11,92188
49568,19,-15,99,178554,19,178535
49569,8,6,885,832245,8,832237
49570,5,-19,119,34193,5,34188
49571,17,-5,166,492257,17,492240
49572,14,-15,710,183058,14,183044
49573,7,15,547,1106104,7,1106097
49574,13,17,157,1179012,13,1178999
49575,13,-11,95,304437,13,304424
49576,7,5,163,784951,7,784944
49577,8,-8,266,381100,8,381092
49578,7,0,252,630854,7,630847
49579,5,8,215,879836,5,879831
49580,13,14,314,1087867,13,1087854
49581,10,8,1,875179,10,875169
49582,12,11,534,994706,12,994694
49583,11,18,232,1210824,11,1210813
49584,14,-5,485,494650,14,494636
49585,14,-9,84,367275,14,367261
49586,7,-4,996,520907,7,520900
49587,19,6,384,838784,19,838765
49588,7,5,151,784674,7,784667
49589,18,-20,188,24299,18,24281
49590,8,-3,770,547688,8,547680
49591,14,-10,647,339909,14,339895
49592,10,2,511,699542,10,699532
49593,7,-14,26,187066,7,187059
49594,12,4,517,777012,12,777000
49595,10,-12,247,254838,10,254828
49596,16,-11,185,305210,16,305194
49597,11,-8,707,402887,11,402876
49598,13,-16,85,147499,13,147486
49599,19,-3,757,559837,19,559818
49600,19,18,243,1210918,19,1210899
49601,19,-6,537,463332,19,463313
49602,12,2,33,710744,12,710732
49603,6,5,799,798316,6,798310
49604,16,-17,665,120522,16,120506
49605,7,15,707,1109451,7,1109444
49606,17,-2,739,590661,17,590644
49607,20,11,452,994139,20,994119
49608,15,-11,173,305112,15,305097
49609,11,1,179,681302,11,681291
49610,9,-6,570,449067,9,449058
49611,20,11,434,994047,20,994027
49612,5,-9,918,364285,5,364280
49613,7,-5,796,485082,7,485075
49614,9,-1,564,606229,9,606220
49615,7,0,136,628410,7,628403
49616,8,14,267,1067742,8,1067734
49617,6,-8,229,380384,6,380378
49618,20,8,45,898213,20,898193
49619,15,12,839,1028344,15,1028329
49620,20,-15,873,184390,20,184370
49621,20,-4,88,522717,20,522697
49622,6,-12,797,266708,6,266702
49623,19,-10,757,340813,19,340794
49624,12,9,36,929317,12,929305
49625,9,7,369,852720,9,852711
49626,13,-15,498,181452,13,181439
49627,11,-2,843,591543,11,591532
49628,5,9,44,907731,5,907726
49629,5,-16,463,134255,5,134250
49630,9,-12,651,263655,9,263646
49631,11,13,793,1059194,11,1059183
49632,20,10,500,963637,20,963617
49633,5,9,497,917175,5,917170
49634,18,-8,50,398283,18,398265
49635,20,9,481,932569,20,932549
49636,15,-5,195,492395,15,492380
49637,14,-16,309,149221,14,149207
49638,6,-17,897,112472,6,112466
49639,10,7,52,846002,10,845992
49640,12,1,982,687464,12,687452
49641,17,-19,275,56140,17,56123
49642,5,-3,858,549611,5,549606
49643,13,-4,152,523231,13,523218
49644,19,13,965,1060395,19,1060376
49645,11,4,510,776924,11,776913
49646,16,-12,546,276573,16,276557
49647,12,-13,231,242755,12,242743
49648,7,18,207,1191414,7,1191407
49649,13,3,467,745335,13,745322
49650,10,-5,180,472062,10,472052
49651,19,-14,663,214690,19,214671
49652,17,-12,725,277817,17,277800
49653,19,0,905,655162,19,655143
49654,16,3,888,748495,16,748479
49655,18,1,177,681272,18,681254
49656,16,-18,321,87733,16,87717
49657,20,19,116,1241740,20,1241720
49658,15,19,912,1248167,15,1248152
49659,11,1,286,682126,11,682115
49660,14,-8,134,398832,14,398818
49661,5,-16,121,126716,5,126711
49662,19,16,391,1149966,19,1149947
49663,15,6,715,841580,15,841565
49664,6,13,725,1046285,6,1046279
49665,12,17,789,1183782,12,1183770
49666,6,-19,356,39231,6,39225
49667,8,-8,666,389683,8,389675
49668,11,9,914,935874,11,935863
49669,11,-13,643,245721,11,245710
49670,17,-5,913,497720,17,497703
49671,9,15,88,1096342,9,1096333
49672,20,16,412,1150137,20,1150117
49673,14,1,66,680284,14,680270
49674,13,0,146,649307,13,649294
49675,13,1,411,683095,13,683082
49676,13,18,332,1211530,13,1211517
49677,19,-17,977,122649,19,122630
49678,13,16,162,1148200,13,1148187
49679,5,12,674,1013905,5,1013900
49680,6,-4,955,519924,6,519918
49681,8,3,712,734346,8,734338
49682,19,-7,300,430583,19,430564
49683,9,18,293,1193174,9,1193165
49684,10,-4,52,500422,10,500412
49685,10,-15,575,167877,10,167867
49686,14,5,739,809194,14,809180
49687,20,-20,773,28779,20,28759
49688,17,-12,327,274985,17,274968
49689,16,7,180,868319,16,868303
49690,11,11,698,995769,11,995758
49691,9,-15,70,156802,9,156793
49692,7,-10,318,319449,7,319442
49693,17,17,813,1184056,17,1184039
49694,18,-20,329,25430,18,25412
49695,11,9,675,934032,11,934021
49696,15,18,744,1214335,15,1214320
49697,6,-15,323,162394,6,162388
49698,17,-13,466,244400,17,244383
49699,14,8,143,899061,14,899047
49700,15,11,670,995596,15,995581
49701,14,-17,344,118059,14,118045
49702,14,2,958,717646,14,717632
49703,15,-7,182,429665,15,429650
49704,16,-7,327,430817,16,430801
49705,5,-14,548,198331,5,198326
49706,19,19,513,1245025,19,1245006
49707,11,10,660,965008,11,964997
49708,15,-5,736,496427,15,496412
49709,6,6,34,812953,6,812947
49710,6,12,699,1014457,6,1014451
49711,5,19,762,1234353,5,1234348
49712,6,13,85,1032588,6,1032582
49713,11,13,802,1059277,11,1059266
49714,15,-2,535,589137,15,589122
49715,8,4,687,765406,8,765398
49716,12,10,116,960796,12,960784
49717,14,5,803,809621,14,809607
49718,16,-12,151,273666,16,273650
49719,5,-14,36,187280,5,187275
49720,11,6,579,840466,11,840455
49721,13,7,520,870919,13,870906
49722,6,-14,117,189050,6,189044
49723,11,5,793,809555,11,809544
49724,10,2,796,705184,10,705174
49725,17,-20,806,29089,17,29072
49726,15,5,514,807529,15,807514
49727,8,17,370,1163260,8,1163252
49728,10,-20,1,44,10,34
49729,18,5,978,810972,18,810954
49730,6,12,907,1019091,6,1019085
49731,6,17,932,1175263,6,1175257
49732,16,-10,878,341696,16,341680
49733,7,4,990,772123,7,772116
49734,13,-16,662,151802,13,151789
49735,13,15,811,1122726,13,1122713
49736,10,2,563,700495,10,700485
49737,5,-8,789,392253,5,392248
49738,6,19,855,1236528,6,1236522
49739,8,0,218,630221,8,630213
49740,13,-19,465,57530,13,57517
49741,11,-19,335,56616,11,56605
49742,15,-15,71,178293,15,178278
49743,12,-16,102,147677,12,147665
49744,10,-9,340,351121,10,351111
49745,13,13,25,1053396,13,1053383
49746,19,-14,415,212814,19,212795
49747,12,4,575,777433,12,777421
49748,8,0,322,632067,8,632059
49749,12,-10,136,336142,12,336130
49750,9,-16,456,134033,9,134024
49751,6,13,219,1035429,6,1035423
49752,19,-12,453,275790,19,275771
49753,15,10,134,960927,15,960912
49754,12,2,671,715641,12,715629
49755,6,19,678,1232510,6,1232504
49756,13,-1,58,616982,13,616969
49757,17,11,875,997220,17,997203
49758,15,-4,220,523818,15,523803
49759,18,1,776,685923,18,685905
49760,19,15,811,1122735,19,1122716
49761,19,-17,929,122347,19,122328
49762,5,8,486,885809,5,885804
49763,10,12,626,1012653,10,1012643
49764,9,4,477,760849,9,760840
49765,18,-14,459,213046,18,213028
49766,11,-19,156,55315,11,55304
49767,20,16,703,1152096,20,1152076
49768,8,-20,594,12973,8,12965
49769,13,19,982,1248662,13,1248649
49770,9,0,287,631469,9,631460
49771,11,-4,8,522114,11,522103
49772,6,15,273,1100356,6,1100350
49773,11,-17,287,117619,11,117608
49774,19,-7,289,430502,19,430483
49775,8,-1,389,602511,8,602503
49776,14,-20,543,26943,14,26929
49777,10,-4,241,504913,10,504903
49778,13,2,579,714914,13,714901
49779,15,7,989,874046,15,874031
49780,12,7,111,867831,12,867819
49781,7,-13,867,237067,7,237060
49782,15,10,63,960304,15,960289
49783,13,6,994,843697,13,843684
49784,18,-16,530,150899,18,150881
49785,17,-1,441,620060,17,620043
49786,6,15,604,1107304,6,1107298
49787,12,-20,745,28517,12,28505
49788,18,-14,508,213434,18,213416
49789,7,-20,492,10545,7,10538
49790,18,-3,774,560037,18,560019
49791,7,-8,578,387551,7,387544
49792,15,2,349,713218,15,713203
49793,5,5,744,797166,5,797161
49794,5,6,86,814029,5,814024
49795,5,19,770,1234585,5,1234580
49796,11,-9,695,371932,11,371921
49797,7,11,342,975755,7,975748
49798,10,-9,930,364464,10,364454
49799,7,-15,51,156431,7,156424
49800,20,-11,353,306589,20,306569
49801,18,-1,472,620344,18,620326
49802,13,3,987,749421,13,749408
49803,13,2,880,717063,13,717050
49804,9,6,191,816355,9,816346
49805,20,-16,243,148767,20,148747
49806,7,16,820,1142203,7,1142196
49807,5,5,423,790286,5,790281
49808,12,14,683,1090840,12,1090828
49809,19,-13,488,244609,19,244590
49810,14,-19,470,57592,14,57578
49811,12,1,109,680672,12,680660
49812,5,-4,516,510668,5,510663
49813,11,11,630,995331,11,995320
49814,8,14,405,1070797,8,1070789
49815,7,9,102,908924,7,908917
49816,12,-1,500,620543,12,620531
49817,14,-12,117,273396,14,273382
49818,9,14,873,1081416,9,1081407
49819,17,-7,0,428261,17,428244
49820,18,3,791,747824,18,747806
49821,14,-14,445,212980,14,212966
49822,11,-7,831,434320,11,434309
49823,13,-3,912,561107,13,561094
49824,8,-10,81,314436,8,314428
49825,17,-2,277,587213,17,587196
49826,9,-2,71,564368,9,564359
49827,12,-13,11,241117,12,241105
49828,14,-1,799,622705,14,622691
49829,9,-19,513,42585,9,42576
49830,8,-5,49,468964,8,468956
49831,8,-16,516,135262,8,135254
49832,18,7,292,869122,18,869104
49833,13,-9,528,370883,13,370870
49834,16,9,663,933965,16,933949
49835,6,4,867,769699,6,769693
49836,8,15,240,1099632,8,1099624
49837,15,-5,471,494533,15,494518
49838,9,-17,12,93812,9,93803
49839,13,8,877,904750,13,904737
49840,17,8,473,901668,17,901651
49841,14,-11,386,306831,14,306817
49842,15,-10,372,337747,15,337732
49843,11,13,511,1057044,11,1057033
49844,10,-15,476,165777,10,165767
49845,10,13,598,1043676,10,1043666
49846,15,12,537,1025985,15,1025970
49847,14,-20,405,25906,14,25892
49848,5,-4,330,506676,5,506671
49849,5,-6,804,454101,5,454096
49850,14,4,588,777518,14,777504
49851,6,4,559,762623,6,762617
49852,11,-2,541,589189,11,589178
49853,11,-20,223,24487,11,24476
49854,13,5,475,807299,13,807286
49855,8,-15,845,173401,8,173393
49856,20,5,919,810476,20,810456
49857,13,14,252,1087400,13,1087387
49858,14,-5,849,497195,14,497181
49859,10,-5,764,484490,10,484480
49860,18,-13,931,248068,18,248050
49861,16,-9,980,374163,16,374147
49862,19,-2,371,587838,19,587819
49863,17,3,42,742121,17,742104
49864,7,-17,193,97522,7,97515
49865,15,6,54,836184,15,836169
49866,20,-3,517,557797,20,557777
49867,12,18,871,1215310,12,1215298
49868,19,5,14,803888,19,803869
49869,8,5,86,783413,8,783405
49870,16,4,938,780162,16,780146
49871,19,-19,110,54850,19,54831
49872,13,-20,565,27109,13,27096
49873,6,-2,135,565731,6,565725
49874,6,14,14,1062057,6,1062051
49875,6,-13,575,230631,6,230625
49876,17,-1,197,618028,17,618011
49877,14,-8,352,400377,14,400363
49878,18,14,455,1089024,18,1089006
49879,12,14,130,1086502,12,1086490
49880,20,5,241,805620,20,805600
49881,6,-17,971,113931,6,113925
49882,11,-19,500,57831,11,57820
49883,11,-12,261,274419,11,274408
49884,15,-3,109,554568,15,554553
49885,15,-16,105,147698,15,147683
49886,13,10,355,962492,13,962479
49887,17,-16,941,153849,17,153832
49888,20,6,564,840330,20,840310
49889,14,13,308,1055463,14,1055449
49890,10,-6,544,448584,10,448574
49891,15,-16,257,148853,15,148838
49892,19,11,230,992441,19,992422
49893,13,-11,264,305814,13,305801
49894,11,9,139,930080,11,930069
49895,6,-10,388,320926,6,320920
49896,6,-8,790,392298,6,392292
49897,6,4,358,758303,6,758297
49898,13,11,626,995313,13,995300
49899,7,-19,441,41015,7,41008
49900,5,-12,169,253143,5,253138
49901,12,-4,716,527450,12,527438
49902,19,13,377,1055999,19,1055980
49903,19,-2,564,589369,19,589350
49904,9,-8,173,379217,9,379208
49905,11,17,236,1179626,11,1179615
49906,5,8,491,885943,5,885938
49907,12,2,360,713327,12,713315
49908,12,-20,215,24457,12,24445
49909,17,-9,878,373518,17,373501
49910,9,-11,296,287536,9,287527
49911,18,-8,533,401600,18,401582
49912,5,6,410,821660,5,821655
49913,16,-5,241,492796,16,492780
49914,17,-13,524,244908,17,244891
49915,15,-1,388,619675,15,619660
49916,10,-5,892,487448,10,487438
49917,14,-10,661,340069,14,340055
49918,5,6,793,830170,5,830165
49919,20,-11,768,309708,20,309688
49920,19,-3,228,555362,19,555343
49921,15,-4,69,522573,15,522558
49922,7,-17,314,100276,7,100269
49923,19,-9,798,372861,19,372842
49924,5,-20,472,10129,5,10124
49925,20,19,510,1244996,20,1244976
49926,15,17,667,1182836,15,1182821
49927,11,-12,740,277932,11,277921
49928,9,-14,845,204872,9,204863
49929,5,-6,193,441134,5,441129
49930,16,11,420,993931,16,993915
49931,12,13,498,1056927,12,1056915
49932,18,-16,0,146709,18,146691
49933,9,-10,175,316449,9,316440
49934,5,7,396,853360,5,853355
49935,9,19,236,1222724,9,1222715
49936,20,-10,502,338814,20,338794
49937,16,17,618,1182436,16,1182420
49938,19,-14,348,212112,19,212093
49939,18,8,279,900163,18,900145
49940,6,-9,700,359020,6,359014
49941,5,6,156,815551,5,815546
49942,19,-20,909,29782,19,29763
49943,6,-5,14,468055,6,468049
49944,8,7,540,856273,8,856265
49945,15,-18,342,87886,15,87871
49946,19,1,544,684198,19,684179
49947,12,-10,374,337769,12,337757
49948,10,-10,49,313679,10,313669
49949,12,4,386,776006,12,775994
49950,15,16,336,1149539,15,1149524
49951,5,-7,629,419203,5,419198
49952,10,5,651,795025,10,795015
49953,6,-9,908,364043,6,364037
49954,8,13,746,1046746,8,1046738
49955,17,-11,51,304046,17,304029
49956,17,13,67,1053736,17,1053719
49957,5,2,836,706049,5,706044
49958,13,16,753,1152422,13,1152409
49959,19,17,348,1180584,19,1180565
49960,12,11,804,996677,12,996665
49961,9,-3,844,549258,9,549249
49962,17,13,258,1055093,17,1055076
49963,14,-10,189,336479,14,336465
49964,10,6,133,815074,10,815064
49965,20,14,43,1085754,20,1085734
49966,12,-18,346,87932,12,87920
49967,19,-9,533,370949,19,370930
49968,7,-3,687,545965,7,545958
49969,19,-20,501,26575,19,26556
49970,12,-7,935,435240,12,435228
49971,19,17,907,1184760,19,1184741
49972,5,-7,271,411567,5,411562
49973,6,-4,694,514397,6,514391
49974,11,17,77,1178448,11,1178437
49975,9,5,7,781747,9,781738
49976,7,4,419,759685,7,759678
49977,6,18,573,1198959,6,1198953
49978,13,13,627,1058009,13,1057996
49979,11,4,641,777918,11,777907
49980,10,-11,668,295872,10,295862
49981,19,-9,673,371750,19,371731
49982,18,-6,178,460570,18,460552
49983,18,-2,379,587913,18,587895
49984,10,3,89,720727,10,720717
49985,11,9,625,933715,11,933704
49986,19,17,986,1185360,19,1185341
49987,5,14,984,1083861,5,1083856
49988,14,-3,638,558892,14,558878
49989,8,14,244,1067250,8,1067242
49990,13,-5,220,492578,13,492565
49991,20,-2,275,587201,20,587181
49992,11,-6,72,459611,11,459600
49993,16,3,603,746335,16,746319
49994,20,-11,747,309546,20,309526
49995,10,-11,393,289833,10,289823
49996,7,9,168,910352,7,910345
49997,11,15,276,1118828,11,1118817
49998,15,-10,962,342298,15,342283
49999,15,-11,963,311267,15,311252
50000,19,-8,389,400643,19,400624
50001,18,-17,52,115929,18,115911
50002,9,2,406,697492,9,697483
50003,16,13,151,1054309,16,1054293
50004,16,-9,954,374084,16,374068
50005,9,-3,797,548258,9,548249
50006,20,8,153,899150,20,899130
50007,10,-8,680,389981,10,389971
50008,19,12,828,1028226,19,1028207
50009,14,12,82,1022668,14,1022654
50010,18,14,866,1092200,18,1092182
50011,11,11,638,995388,11,995377
50012,13,-14,712,215086,13,215073
50013,6,1,315,664055,6,664049
50014,14,19,2,1240641,14,1240627
50015,7,-20,186,4355,7,4348
50016,19,-18,635,89864,19,89845
50017,16,-9,134,367546,16,367530
50018,11,1,100,680622,11,680611
50019,10,8,234,880386,10,880376
50020,11,6,233,837524,11,837513
50021,16,4,95,773986,16,773970
50022,6,-1,248,599277,6,599271
50023,15,0,914,655232,15,655217
50024,11,19,190,1242256,11,1242245
50025,13,-7,782,433982,13,433969
50026,7,18,14,1186883,7,1186876
50027,14,-10,132,336107,14,336093
50028,6,-11,221,285828,6,285822
50029,12,10,150,961031,12,961019
50030,14,15,615,1121289,14,1121275
50031,14,12,696,1027303,14,1027289
50032,16,6,178,837088,16,837072
50033,15,15,642,1121479,15,1121464
50034,15,4,351,775760,15,775745
50035,16,-11,175,305151,16,305135
50036,7,4,613,763932,7,763925
50037,8,13,805,1048131,8,1048123
50038,18,-15,252,179604,18,179586
50039,6,1,209,661778,6,661772
50040,17,-12,89,273192,17,273175
50041,6,8,235,880429,6,880423
50042,14,-11,897,310724,14,310710
50043,20,8,298,900312,20,900292
50044,19,-19,551,58340,19,58321
50045,18,-7,842,434438,18,434420
50046,19,-19,310,56395,19,56376
50047,8,-6,833,454621,8,454613
50048,16,-12,637,277183,16,277167
50049,7,-5,299,474707,7,474700
50050,11,4,172,774522,11,774511
50051,14,0,769,654168,14,654154
50052,8,-10,182,316590,8,316582
50053,5,12,394,1007586,5,1007581
50054,17,15,363,1119423,17,1119406
50055,9,-9,492,354791,9,354782
50056,10,-2,678,577214,10,577204
50057,6,-20,733,16096,6,16090
50058,9,-17,778,110149,9,110140
50059,13,-17,271,117488,13,117475
50060,9,11,791,985375,9,985366
50061,5,-11,410,290194,5,290189
50062,6,-5,720,483576,6,483570
50063,15,-11,48,304003,15,303988
50064,11,-2,189,586491,11,586480
50065,5,13,611,1043944,5,1043939
50066,9,-2,948,583167,9,583158
50067,9,-13,886,237524,9,237515
50068,7,4,16,750826,7,750819
50069,10,18,780,1203227,10,1203217
50070,13,-5,331,493594,13,493581
50071,14,19,508,1244970,14,1244956
50072,15,13,993,1060566,15,1060551
50073,10,-12,645,263484,10,263474
50074,7,-10,270,318353,7,318346
50075,12,10,183,961262,12,961250
50076,15,12,562,1026159,15,1026144
50077,12,-14,623,214403,12,214391
50078,19,19,426,1244367,19,1244348
50079,9,8,735,891460,9,891451
50080,9,15,656,1108359,9,1108350
50081,19,-15,84,178426,19,178407
50082,8,12,187,1003259,8,1003251
50083,17,-10,133,336115,17,336098
50084,13,-7,461,431792,13,431779
50085,17,0,402,651108,17,651091
50086,6,-4,237,504834,6,504828
50087,6,9,765,922772,6,922766
50088,15,5,753,809263,15,809248
50089,20,-7,802,434118,20,434098
50090,19,1,248,681847,19,681828
50091,8,2,245,693873,8,693865
50092,7,9,273,912373,7,912366
50093,9,10,548,949165,9,949156
50094,20,-6,865,465651,20,465631
50095,13,12,665,1027034,13,1027021
50096,16,-20,973,30196,16,30180
50097,6,18,712,1201555,6,1201549
50098,19,-19,812,60235,19,60216
50099,5,-15,651,169514,5,169509
50100,17,-14,916,216668,17,216651
50101,17,2,622,715210,17,715193
50102,14,-18,778,90919,14,90905
50103,18,4,134,774231,18,774213
50104,14,-4,351,524839,14,524825
50105,6,6,209,816768,6,816762
50106,17,13,147,1054287,17,1054270
50107,9,-14,518,197818,9,197809
50108,10,-1,745,609831,10,609821
50109,5,-20,330,7378,5,7373
50110,16,9,545,933036,16,933020
50111,7,11,527,979777,7,979770
50112,9,14,668,1076931,9,1076922
50113,8,10,495,947998,8,947990
50114,13,-11,191,305256,13,305243
50115,7,-2,394,571049,7,571042
50116,9,7,891,863677,9,863668
50117,6,-5,949,488686,6,488680
50118,17,14,394,1088474,17,1088457
50119,14,-8,123,398744,14,398730
50120,19,3,84,742454,19,742435
50121,18,9,973,936376,18,936358
50122,19,-8,218,399452,19,399433
50123,6,-20,662,14589,6,14583
50124,5,-13,439,227568,5,227563
50125,10,-9,569,356455,10,356445
50126,7,3,370,726831,7,726824
50127,8,14,707,1077891,8,1077883
50128,11,18,876,1215341,11,1215330
50129,12,17,623,1182483,12,1182471
50130,19,10,103,960695,19,960676
50131,11,-6,508,463087,11,463076
50132,8,-3,827,548831,8,548823
50133,18,15,588,1121074,18,1121056
50134,20,-20,29,16338,20,16318
50135,9,-3,875,549974,9,549965
50136,15,12,625,1026682,15,1026667
50137,13,12,848,1028454,13,1028441
50138,9,-8,805,392548,9,392539
50139,20,2,903,717217,20,717197
50140,19,-12,706,277713,19,277694
50141,17,3,721,747323,17,747306
50142,9,14,10,1061956,9,1061947
50143,6,6,206,816714,6,816708
50144,13,11,271,992809,13,992796
50145,12,19,536,1245192,12,1245180
50146,11,17,429,1181114,11,1181103
50147,16,14,632,1090357,16,1090341
50148,15,-17,205,116954,15,116939
50149,15,10,352,962445,15,962430
50150,11,-15,77,178315,11,178304
50151,17,-3,547,558120,17,558103
50152,8,0,989,646830,8,646822
50153,15,6,715,841585,15,841570
50154,12,15,860,1123045,12,1123033
50155,20,10,160,961126,20,961106
50156,15,-14,5,209392,15,209377
50157,9,6,181,816129,9,816120
50158,19,-14,370,212403,19,212384
50159,11,-19,770,60001,11,59990
50160,9,19,426,1227409,9,1227400
50161,11,9,182,930408,11,930397
50162,15,-20,899,29726,15,29711
50163,17,-2,712,590515,17,590498
50164,5,11,463,978349,5,978344
50165,12,0,641,653103,12,653091
50166,13,15,596,1121106,13,1121093
50167,19,-6,480,462853,19,462834
50168,15,-16,711,152121,15,152106
50169,13,5,819,809766,13,809753
50170,15,6,241,837568,15,837553
50171,8,-4,787,516232,8,516224
50172,10,-17,461,103315,10,103305
50173,19,-13,634,245726,19,245707
50174,10,-8,465,384922,10,384912
50175,10,12,581,1011552,10,1011542
50176,7,9,734,922160,7,922153
50177,17,-18,962,92218,17,92201
50178,8,3,431,728066,8,728058
50179,6,-19,776,48589,6,48583
50180,15,-8,18,398024,15,398009
50181,11,-1,376,619586,11,619575
50182,9,4,734,766586,9,766577
50183,8,10,336,944649,8,944641
50184,13,-3,311,556051,13,556038
50185,14,-7,429,431541,14,431527
50186,19,-15,309,180011,19,179992
50187,10,-4,23,499796,10,499786
50188,6,-9,593,356932,6,356926
50189,5,8,280,881325,5,881320
50190,5,-19,52,32577,5,32572
50191,10,3,81,720536,10,720526
50192,17,-2,231,586866,17,586849
50193,20,16,0,1147107,20,1147087
50194,9,-15,927,175169,9,175160
50195,12,10,748,965617,12,965605
50196,17,16,103,1147794,17,1147777
50197,14,-9,552,371107,14,371093
50198,17,6,967,843467,17,843450
50199,10,6,432,822115,10,822105
50200,13,15,895,1123313,13,1123300
50201,11,15,330,1119196,11,1119185
50202,18,-19,395,57100,18,57082
50203,10,18,370,1194712,10,1194702
50204,20,8,689,903440,20,903420
50205,10,10,593,950255,10,950245
50206,16,11,696,995755,16,995739
50207,7,-1,578,606527,7,606520
50208,5,17,618,1168464,5,1168459
50209,13,0,578,652635,13,652622
50210,9,3,492,729361,9,729352
50211,18,5,28,803938,18,803920
50212,8,-11,900,300482,8,300474
50213,9,-19,575,44170,9,44161
50214,7,12,824,1016988,7,1016981
50215,9,-8,467,384970,9,384961
50216,5,14,637,1076197,5,1076192
50217,11,-3,875,560782,11,560771
50218,19,-17,66,115982,19,115963
50219,10,7,42,845743,10,845733
50220,11,9,670,933980,11,933969
50221,5,14,153,1065260,5,1065255
50222,18,-14,44,209669,18,209651
50223,6,-15,90,157363,6,157357
50224,19,7,862,873248,19,873229
50225,6,17,724,1170725,6,1170719
50226,9,8,772,892177,9,892168
50227,17,-1,393,619703,17,619686
50228,5,14,697,1077724,5,1077719
50229,6,5,573,793453,6,793447
50230,11,2,880,717064,11,717053
50231,8,-9,228,348487,8,348479
50232,8,18,786,1203370,8,1203362
50233,10,5,930,801209,10,801199
50234,20,-17,586,119958,20,119938
50235,16,-13,519,244875,16,244859
50236,9,-15,821,172950,9,172941
50237,9,15,792,1111215,9,1111206
50238,11,10,253,961724,11,961713
50239,20,1,707,685304,20,685284
50240,18,5,178,805127,18,805109
50241,8,-4,228,504575,8,504567
50242,18,7,251,868850,18,868832
50243,12,-3,532,558039,12,558027
50244,7,-4,999,521021,7,521014
50245,9,5,728,796804,9,796795
50246,8,-20,817,18156,8,18148
50247,15,-15,374,180535,15,180520
50248,7,-16,382,132198,7,132191
50249,11,14,419,1088748,11,1088737
50250,17,7,839,873094,17,873077
50251,6,18,839,1204451,6,1204445
50252,20,-12,458,275822,20,275802
50253,17,18,183,1210458,17,1210441
50254,19,1,337,682589,19,682570
50255,10,-9,469,354098,10,354088
50256,15,-18,390,88228,15,88213
50257,12,-15,741,183308,12,183296
50258,12,16,14,1147189,12,1147177
50259,17,-13,425,244115,17,244098
50260,5,7,526,856039,5,856034
50261,20,-1,108,617387,20,617367
50262,7,-9,351,351310,7,351303
50263,14,6,736,841733,14,841719
50264,10,-3,441,540276,10,540266
50265,12,6,6,835777,12,835765
50266,10,9,828,924345,10,924335
50267,16,-10,832,341334,16,341318
50268,16,-5,134,491973,16,491957
50269,18,2,929,717373,18,717355
50270,9,-12,810,267039,9,267030
50271,15,8,201,899554,15,899539
50272,15,-17,148,116574,15,116559
50273,6,8,455,885131,6,885125
50274,10,-2,505,573539,10,573529
50275,7,18,886,1205524,7,1205517
50276,10,5,433,790525,10,790515
50277,14,-11,739,309453,14,309439
50278,19,-17,571,119816,19,119797
50279,7,12,699,1014464,7,1014457
50280,15,-19,43,54197,15,54182
50281,8,-3,676,545757,8,545749
50282,5,-15,274,161261,5,161256
50283,16,9,718,934364,16,934348
50284,7,-18,39,63213,7,63206
50285,13,0,277,650190,13,650177
50286,20,8,971,905505,20,905485
50287,18,9,396,931890,18,931872
50288,10,-5,70,469396,10,469386
50289,10,14,415,1071087,10,1071077
50290,12,-17,572,119837,12,119825
50291,6,9,67,908135,6,908129
50292,15,10,687,965220,15,965205
50293,18,-13,260,242996,18,242978
50294,19,18,60,1209403,19,1209384
50295,12,8,842,904489,12,904477
50296,17,19,973,1248607,17,1248590
50297,12,-1,297,618903,12,618891
50298,17,1,470,683561,17,683544
50299,19,-18,838,91291,19,91272
50300,5,-2,391,570968,5,570963
50301,13,10,12,959916,13,959903
50302,18,-20,10,5749,18,5731
50303,20,0,810,654472,20,654452
50304,8,7,28,845349,8,845341
50305,9,3,21,719283,9,719274
50306,5,11,163,971851,5,971846
50307,7,-15,871,173996,7,173989
50308,12,-20,165,24016,12,24004
50309,5,12,877,1018340,5,1018335
50310,11,-3,604,558538,11,558527
50311,10,12,738,1015209,10,1015199
50312,17,-14,851,216162,17,216145
50313,15,17,119,1178738,15,1178723
50314,18,12,255,1023973,18,1023955
50315,8,-13,297,224814,8,224806
50316,18,1,445,683324,18,683306
50317,16,-6,408,462268,16,462252
50318,7,4,371,758611,7,758604
50319,19,-8,784,403470,19,403451
50320,16,-15,881,184436,16,184420
50321,14,1,916,687009,14,686995
50322,13,-14,161,210549,13,210536
50323,6,15,607,1107356,6,1107350
50324,14,3,857,748292,14,748278
50325,18,19,541,1245236,18,1245218
50326,9,11,922,988426,9,988417
50327,8,4,776,767538,8,767530
50328,12,-1,982,624025,12,624013
50329,12,10,546,964020,12,964008
50330,17,11,216,992337,17,992320
50331,7,-3,632,544713,7,544706
50332,19,11,752,996250,19,996231
50333,5,-13,420,227069,5,227064
50334,13,-19,713,59553,13,59540
50335,8,-4,794,516346,8,516338
50336,8,10,394,945898,8,945890
50337,19,-8,704,402872,19,402853
50338,13,-5,864,497315,13,497302
50339,7,14,673,1077092,7,1077085
50340,17,16,497,1150645,17,1150628
50341,14,19,562,1245375,14,1245361
50342,17,-16,78,147448,17,147431
50343,16,18,757,1214447,16,1214431
50344,15,-14,435,212897,15,212882
50345,11,-17,250,117320,11,117309
50346,9,-7,540,417459,9,417450
50347,12,-15,102,178569,12,178557
50348,5,12,268,1005149,5,1005144
50349,16,7,696,872105,16,872089
50350,10,-10,527,323985,10,323975
50351,18,-12,353,275165,18,275147
50352,6,-2,878,581634,6,581628
50353,18,-11,821,310106,18,310088
50354,19,-6,718,464626,19,464607
50355,14,7,851,873150,14,873136
50356,5,6,810,830605,5,830600
50357,10,8,930,895368,10,895358
50358,7,14,670,1077003,7,1076996
50359,14,-13,606,245538,14,245524
50360,16,7,555,871109,16,871093
50361,11,15,943,1123687,11,1123676
50362,18,-15,476,181308,18,181290
50363,12,-17,181,116782,12,116770
50364,14,-11,162,305044,14,305030
50365,13,2,639,715352,13,715339
50366,18,5,133,804741,18,804723
50367,8,14,510,1073220,8,1073212
50368,14,-6,640,464076,14,464062
50369,14,-2,492,588856,14,588842
50370,17,3,342,744476,17,744459
50371,12,7,100,867738,12,867726
50372,11,5,487,807372,11,807361
50373,12,12,163,1023232,12,1023220
50374,15,4,112,774082,15,774067
50375,17,11,682,995704,17,995687
50376,5,8,238,880466,5,880461
50377,18,-19,638,59026,18,59008
50378,20,17,549,1181976,20,1181956
50379,20,9,418,932076,20,932056
50380,16,-5,929,497865,16,497849
50381,17,0,738,653962,17,653945
50382,18,-17,268,117460,18,117442
50383,18,2,691,715827,18,715809
50384,9,17,621,1168550,9,1168541
50385,19,-1,169,617822,19,617803
50386,20,-13,100,241808,20,241788
50387,8,-8,574,387521,8,387513
50388,5,-20,175,3946,5,3941
50389,14,8,410,901262,14,901248
50390,19,-3,535,558060,19,558041
50391,13,5,826,809800,13,809787
50392,12,-17,828,121696,12,121684
50393,10,-6,926,456537,10,456527
50394,20,-4,780,527884,20,527864
50395,6,3,380,727031,6,727025
50396,14,2,273,712603,14,712589
50397,12,19,395,1243994,12,1243982
50398,5,-1,334,601373,5,601368
50399,5,-12,179,253302,5,253297
50400,12,-4,404,525254,12,525242
50401,10,-15,896,174469,10,174459
50402,5,15,551,1106140,5,1106135
50403,11,3,791,747825,11,747814
50404,9,11,370,976380,9,976371
50405,18,6,35,836085,18,836067
50406,19,10,919,966926,19,966907
50407,5,7,171,848364,5,848359
50408,14,-15,144,178884,14,178870
50409,19,1,197,681427,19,681408
50410,6,-3,414,539554,6,539548
50411,20,-10,140,336181,20,336161
50412,12,0,981,655805,12,655793
50413,19,-9,329,369037,19,369018
50414,15,19,855,1247701,15,1247686
50415,13,13,592,1057752,13,1057739
50416,15,8,418,901310,15,901295
50417,13,-11,831,310187,13,310174
50418,17,6,146,836852,17,836835
50419,11,7,957,873788,11,873777
50420,8,-3,464,540864,8,540856
50421,9,-20,595,13011,9,13002
50422,18,6,314,838173,18,838155
50423,18,12,919,1029128,18,1029110
50424,18,-17,318,117853,18,117835
50425,19,-4,1000,529614,19,529595
50426,17,13,342,1055759,17,1055742
50427,5,-17,964,113777,5,113772
50428,11,14,938,1092803,11,1092792
50429,5,-10,140,315763,5,315758
50430,5,4,632,764347,5,764342
50431,17,13,623,1057973,17,1057956
50432,11,10,438,963151,11,963140
50433,20,-20,480,26396,20,26376
50434,9,12,721,1014889,9,1014880
50435,7,10,984,958540,7,958533
50436,8,0,605,638461,8,638453
50437,6,13,292,1037003,6,1036997
50438,6,15,24,1094997,6,1094991
50439,12,7,907,873496,12,873484
50440,20,13,490,1056831,20,1056811
50441,14,-9,610,371429,14,371415
50442,19,-15,57,178208,19,178189
50443,12,14,85,1086104,12,1086092
50444,7,-16,696,138939,7,138932
50445,12,-10,969,342365,12,342353
50446,9,6,257,818015,9,818006
50447,18,-17,945,122456,18,122438
50448,6,-11,246,286396,6,286390
50449,19,-6,857,465628,19,465609
50450,20,-14,836,216009,20,215989
50451,11,2,341,713177,11,713166
50452,17,10,273,961890,17,961873
50453,5,-17,237,98480,5,98475
50454,11,4,174,774547,11,774536
50455,11,-13,989,248495,11,248484
50456,9,-1,479,604530,9,604521
50457,13,-8,516,401458,13,401445
50458,13,-20,200,24405,13,24392
50459,17,-6,884,465803,17,465786
50460,10,7,620,857917,10,857907
50461,16,-11,132,304742,16,304726
50462,12,7,318,869327,12,869315
50463,14,11,309,993127,14,993113
50464,16,-20,66,23283,16,23267
50465,16,-16,620,151615,16,151599
50466,12,12,200,1023489,12,1023477
50467,15,-13,91,241697,15,241682
50468,17,7,910,873513,17,873496
50469,17,19,305,1243208,17,1243191
50470,6,-14,805,204196,6,204190
50471,16,-12,103,273275,16,273259
50472,10,-3,542,542731,10,542721
50473,6,4,601,763671,6,763665
50474,13,14,773,1091552,13,1091539
50475,14,1,237,681773,14,681759
50476,7,-18,49,63409,7,63402
50477,17,-4,401,525236,17,525219
50478,20,0,987,655823,20,655803
50479,10,13,711,1045951,10,1045941
50480,12,-14,20,209483,12,209471
50481,9,-11,381,289630,9,289621
50482,10,-4,249,505092,10,505082
50483,13,15,848,1122960,13,1122947
50484,9,5,864,799749,9,799740
50485,20,9,594,933492,20,933472
50486,8,16,301,1131550,8,1131542
50487,17,5,870,810118,17,810101
50488,6,-6,159,440186,6,440180
50489,11,-14,335,212024,11,212013
50490,16,-16,717,152168,16,152152
50491,17,-16,66,147294,17,147277
50492,14,10,823,966236,14,966222
50493,10,12,36,999858,10,999848
50494,18,-10,440,338289,18,338271
50495,13,-10,744,340694,13,340681
50496,16,15,434,1119857,16,1119841
50497,14,4,746,778754,14,778740
50498,17,-19,278,56182,17,56165
50499,14,18,999,1216305,14,1216291
50500,9,-2,316,569565,9,569556
50501,12,6,962,843391,12,843379
50502,14,-6,102,459851,14,459837
50503,11,-12,316,274859,11,274848
50504,8,11,398,977051,8,977043
50505,12,18,210,1210705,12,1210693
50506,15,12,954,1029434,15,1029419
50507,12,-18,308,87631,12,87619
50508,7,-16,671,138506,7,138499
50509,15,12,334,1024578,15,1024563
50510,13,16,92,1147722,13,1147709
50511,10,-13,961,239225,10,239215
50512,20,-1,764,622421,20,622401
50513,10,-3,44,531485,10,531475
50514,12,8,946,905319,12,905307
50515,14,-19,212,55770,14,55756
50516,9,-10,302,319089,9,319080
50517,13,-19,873,60718,13,60705
50518,20,-5,107,491755,20,491735
50519,18,-4,341,524737,18,524719
50520,19,11,377,993613,19,993594
50521,14,-8,970,404801,14,404787
50522,14,11,720,996005,14,995991
50523,14,-19,868,60683,14,60669
50524,6,-9,246,348971,6,348965
50525,5,0,617,638762,5,638757
50526,12,-13,175,242308,12,242296
50527,9,-13,762,234778,9,234769
50528,11,8,371,900861,11,900850
50529,19,1,340,682632,19,682613
50530,15,-10,243,336839,15,336824
50531,16,-20,582,27229,16,27213
50532,11,19,559,1245341,11,1245330
50533,16,-4,269,524169,16,524153
50534,14,1,223,681659,14,681645
50535,15,-10,548,339152,15,339137
50536,16,-7,191,429728,16,429712
50537,8,1,276,663189,8,663181
50538,13,-10,462,338477,13,338464
50539,9,8,50,876135,9,876126
50540,18,15,823,1122815,18,1122797
50541,6,4,672,765071,6,765065
50542,13,-19,670,59193,13,59180
50543,6,-19,515,42660,6,42654
50544,10,-6,871,455359,10,455349
50545,17,-13,879,247608,17,247591
50546,16,-2,415,588217,16,588201
50547,5,-7,165,409264,5,409259
50548,10,-17,111,95793,10,95783
50549,18,17,410,1180972,18,1180954
50550,15,-14,160,210540,15,210525
50551,12,-3,300,555987,12,555975
50552,10,4,375,758710,10,758700
50553,20,10,537,963966,20,963946
50554,10,11,314,975085,10,975075
50555,10,7,615,857813,10,857803
50556,10,7,485,855253,10,855243
50557,8,5,551,793056,8,793048
50558,13,-9,955,374086,13,374073
50559,19,19,861,1247765,19,1247746
50560,18,2,48,710878,18,710860
50561,8,-14,985,207989,8,207981
50562,6,2,313,695358,6,695352
50563,11,-13,363,243689,11,243678
50564,14,15,529,1120610,14,1120596
50565,18,-10,469,338587,18,338569
50566,11,15,196,1118275,11,1118264
50567,13,-11,12,303785,13,303772
50568,6,-4,263,505325,6,505319
50569,11,-1,548,620905,11,620894
50570,10,10,567,949681,10,949671
50571,19,0,556,652429,19,652410
50572,20,-1,932,623708,20,623688
50573,5,-11,226,285964,5,285959
50574,11,-17,240,117238,11,117227
50575,19,6,617,840733,19,840714
50576,8,8,905,894886,8,894878
50577,10,-14,377,195021,10,195011
50578,11,-17,978,122655,11,122644
50579,19,16,371,1149821,19,1149802
50580,5,-12,345,257136,5,257131
50581,6,-6,18,437221,6,437215
50582,14,-20,175,24109,14,24095
50583,12,-12,840,278713,12,278701
50584,17,8,480,901719,17,901702
50585,15,-12,182,273815,15,273800
50586,7,18,986,1207638,7,1207631
50587,14,-7,895,434938,14,434924
50588,16,14,491,1089281,16,1089265
50589,20,-18,949,92109,20,92089
50590,5,-6,398,445290,5,445285
50591,16,18,332,1211536,16,1211520
50592,18,-17,338,118025,18,118007
50593,18,-3,507,557716,18,557698
50594,15,-6,0,459142,15,459127
50595,19,-14,920,216688,19,216669
50596,8,-5,365,476139,8,476131
50597,12,-16,183,148249,12,148237
50598,15,-15,462,181166,15,181151
50599,11,7,64,867482,11,867471
50600,12,-6,846,465545,12,465533
50601,7,14,294,1068333,7,1068326
50602,6,19,194,1221824,6,1221818
50603,11,11,252,992660,11,992649
50604,14,-13,572,245266,14,245252
50605,16,-17,75,116065,16,116049
50606,11,1,498,683803,11,683792
50607,18,-7,533,432374,18,432356
50608,18,-13,227,242716,18,242698
50609,12,18,530,1212867,12,1212855
50610,10,-12,372,257691,10,257681
50611,19,13,571,1057553,19,1057534
50612,16,-19,564,58463,16,58447
50613,6,10,431,946768,6,946762
50614,6,-7,265,411455,6,411449
50615,14,-15,989,185251,14,185237
50616,13,-2,605,589680,13,589667
50617,7,16,221,1129917,7,1129910
50618,7,7,80,846561,7,846554
50619,8,-7,320,412851,8,412843
50620,12,0,144,649297,12,649285
50621,15,6,577,840458,15,840443
50622,11,4,466,776599,11,776588
50623,5,16,35,1125929,5,1125924
50624,14,-11,771,309767,14,309753
50625,16,1,891,686762,16,686746
50626,7,-10,513,323786,7,323779
50627,14,-12,60,272950,14,272936
50628,12,3,909,748675,12,748663
50629,20,13,438,1056528,20,1056508
50630,20,19,131,1241822,20,1241802
50631,19,-2,474,588741,19,588722
50632,15,2,769,716293,15,716278
50633,6,-20,948,20851,6,20845
50634,10,-16,553,136039,10,136029
50635,19,-4,220,523827,19,523808
50636,15,-3,145,554804,15,554789
50637,16,9,573,933293,16,933277
50638,7,-2,392,570994,7,570987
50639,19,-14,142,210419,19,210400
50640,11,1,982,687465,11,687454
50641,13,-16,176,148195,13,148182
50642,6,-19,142,34752,6,34746
50643,7,12,747,1015377,7,1015370
50644,5,-18,354,70133,5,70128
50645,6,-18,982,83801,6,83795
50646,20,-3,757,559847,20,559827
50647,12,-4,656,527055,12,527043
50648,19,-3,496,557615,19,557596
50649,19,-16,956,153949,19,153930
50650,5,11,100,970640,5,970635
50651,12,-19,922,60961,12,60949
50652,14,-6,39,459433,14,459419
50653,8,2,48,689659,8,689651
50654,7,-14,873,205445,7,205438
50655,6,-3,486,541410,6,541404
50656,17,-14,297,211709,17,211692
50657,13,-7,395,431343,13,431330
50658,5,2,308,695231,5,695226
50659,8,-14,172,190234,8,190226
50660,15,5,747,809233,15,809218
50661,13,-17,853,121852,13,121839
50662,17,-12,418,275579,17,275562
50663,8,15,924,1114096,8,1114088
50664,15,-14,781,215648,15,215633
50665,6,-10,970,333309,6,333303
50666,15,-2,789,591061,15,591046
50667,12,-17,827,121687,12,121675
50668,9,-14,272,192722,9,192713
50669,17,-5,669,495859,17,495842
50670,19,8,344,900706,19,900687
50671,19,-4,980,529467,19,529448
50672,19,9,203,930558,19,930539
50673,9,6,203,816635,9,816626
50674,6,4,503,761425,6,761419
50675,9,3,984,740418,9,740409
50676,6,17,114,1157673,6,1157667
50677,5,19,150,1220774,5,1220769
50678,20,0,33,648516,20,648496
50679,9,0,431,634686,9,634677
50680,7,-3,488,541519,7,541512
50681,13,5,617,808356,13,808343
50682,7,4,255,756158,7,756151
50683,10,14,617,1075631,10,1075621
50684,9,0,169,629149,9,629140
50685,9,8,551,887311,9,887302
50686,11,3,735,747395,11,747384
50687,9,3,539,730124,9,730115
50688,16,15,330,1119202,16,1119186
50689,8,8,651,889448,8,889440
50690,18,-6,600,463735,18,463717
50691,6,5,114,783933,6,783927
50692,14,10,2,959841,14,959827
50693,15,-16,565,151148,15,151133
50694,10,-9,362,351557,10,351547
50695,8,-6,344,444216,8,444208
50696,13,9,330,931419,13,931406
50697,5,-17,627,107011,5,107006
50698,18,-2,83,585758,18,585740
50699,18,-5,16,490891,18,490873
50700,20,-16,37,147008,20,146988
50701,6,7,292,851064,6,851058
50702,7,13,468,1040786,7,1040779
50703,14,-16,878,153435,14,153421
50704,14,12,603,1026476,14,1026462
50705,13,-2,937,592284,13,592271
50706,13,-4,316,524556,13,524543
50707,7,15,291,1100804,7,1100797
50708,12,12,191,1023406,12,1023394
50709,16,7,648,871759,16,871743
50710,12,-2,258,587069,12,587057
50711,11,-3,672,559155,11,559144
50712,15,13,757,1058890,15,1058875
50713,14,-8,180,399192,14,399178
50714,19,4,824,779341,19,779322
50715,20,10,37,960134,20,960114
50716,20,-9,546,371045,20,371025
50717,15,12,434,1025247,15,1025232
50718,6,-17,803,110611,6,110605
50719,9,17,893,1174552,9,1174543
50720,5,-16,705,139148,5,139143
50721,17,0,917,655241,17,655224
50722,7,8,314,882136,7,882129
50723,8,-7,625,419112,8,419104
50724,6,-16,481,134570,6,134564
50725,12,-8,36,398182,12,398170
50726,20,17,686,1182960,20,1182940
50727,12,2,297,712835,12,712823
50728,10,-3,914,550946,10,550936
50729,10,-11,731,296949,10,296939
50730,17,12,542,1026039,17,1026022
50731,15,8,675,903315,15,903300
50732,15,16,130,1147990,15,1147975
50733,10,12,847,1017628,10,1017618
50734,5,3,756,735192,5,735187
50735,13,16,968,1154054,13,1154041
50736,14,5,500,807436,14,807422
50737,14,-18,949,92113,14,92099
50738,14,13,363,1055902,14,1055888
50739,5,-8,728,391001,5,390996
50740,8,17,521,1166519,8,1166511
50741,13,0,127,649222,13,649209
50742,9,-15,773,171966,9,171957
50743,12,-17,992,122726,12,122714
50744,5,-5,339,475601,5,475596
50745,15,-19,950,61167,15,61152
50746,12,19,694,1246407,12,1246395
50747,18,2,336,713116,18,713098
50748,9,-19,754,48137,9,48128
50749,8,14,146,1065127,8,1065119
50750,6,-20,111,2424,6,2418
50751,16,13,781,1059077,16,1059061
50752,18,-17,529,119440,18,119422
50753,8,13,617,1044103,8,1044095
50754,20,10,357,962518,20,962498
50755,12,4,298,775343,12,775331
50756,14,13,735,1058712,14,1058698
50757,8,3,173,722536,8,722528
50758,9,-12,188,253477,9,253468
50759,17,-10,338,337511,17,337494
50760,10,12,539,1010713,10,1010703
50761,6,-10,325,319582,6,319576
50762,9,15,0,1094363,9,1094354
50763,8,-8,374,383232,8,383224
50764,19,1,734,685577,19,685558
50765,14,-1,971,623929,14,623915
50766,9,18,391,1195085,9,1195076
50767,6,15,938,1114409,6,1114403
50768,10,-16,796,141106,10,141096
50769,18,15,590,1121080,18,1121062
50770,9,9,248,911934,9,911925
50771,13,18,692,1213974,13,1213961
50772,12,1,659,685057,12,685045
50773,14,12,664,1027032,14,1027018
50774,19,-14,529,213585,19,213566
50775,5,19,145,1220685,5,1220680
50776,18,0,453,651554,18,651536
50777,9,5,307,787947,9,787938
50778,18,-19,966,61253,18,61235
50779,20,8,304,900362,20,900342
50780,5,15,397,1102856,5,1102851
50781,18,-13,227,242724,18,242706
50782,20,12,206,1023538,20,1023518
50783,12,-10,550,339157,12,339145
50784,5,10,799,954892,5,954887
50785,17,-7,493,432025,17,432008
50786,12,18,61,1209430,12,1209418
50787,15,16,711,1152183,15,1152168
50788,16,6,241,837574,16,837558
50789,5,-13,190,222491,5,222486
50790,12,-8,621,402239,12,402227
50791,7,-12,748,265712,7,265705
50792,12,-18,614,89667,12,89655
50793,9,3,140,721854,9,721845
50794,6,10,864,956112,6,956106
50795,16,9,836,935275,16,935259
50796,15,9,319,931341,15,931326
50797,8,2,11,688751,8,688743
50798,15,1,53,680207,15,680192
50799,11,18,510,1212701,11,1212690
50800,14,2,304,712864,14,712850
50801,15,10,765,965736,15,965721
50802,6,12,662,1013534,6,1013528
50803,12,-18,875,91572,12,91560
50804,12,3,532,745724,12,745712
50805,19,13,89,1053892,19,1053873
50806,9,-3,323,537439,9,537430
50807,10,2,12,688771,10,688761
50808,6,8,958,895975,6,895969
50809,18,-1,154,617712,18,617694
50810,12,-5,980,498232,12,498220
50811,19,-8,781,403455,19,403436
50812,10,-11,30,281726,10,281716
50813,17,-20,599,27360,17,27343
50814,9,9,349,914086,9,914077
50815,12,-4,714,527439,12,527427
50816,12,6,70,836272,12,836260
50817,16,-8,208,399362,16,399346
50818,5,-20,139,3056,5,3051
50819,14,-4,332,524668,14,524654
50820,14,5,659,808596,14,808582
50821,13,9,869,935497,13,935484
50822,14,4,900,779916,14,779902
50823,11,-8,399,400751,11,400740
50824,19,-11,195,305282,19,305263
50825,20,1,511,683895,20,683875
50826,18,-17,346,118081,18,118063
50827,14,-4,361,524943,14,524929
50828,14,-7,106,429056,14,429042
50829,15,-19,151,55259,15,55244
50830,9,4,142,753642,9,753633
50831,20,3,201,743440,20,743420
50832,12,-9,173,367778,12,367766
50833,10,-10,363,320444,10,320434
50834,16,-6,426,462419,16,462403
50835,5,-6,439,446098,5,446093
50836,17,17,664,1182789,17,1182772
50837,8,19,135,1220371,8,1220363
50838,19,-6,975,466532,19,466513
50839,14,17,145,1178934,14,1178920
50840,11,4,707,778428,11,778417
50841,14,-14,615,214349,14,214335
50842,9,-13,376,226237,9,226228
50843,7,-9,211,348045,7,348038
50844,7,14,582,1074766,7,1074759
50845,16,-3,608,558597,16,558581
50846,16,5,766,809367,16,809351
50847,12,8,984,905601,12,905589
50848,7,8,128,877795,7,877788
50849,13,-4,653,527034,13,527021
50850,5,-2,541,574203,5,574198
50851,10,13,301,1037161,10,1037151
50852,17,-2,135,586116,17,586099
50853,16,1,350,682673,16,682657
50854,7,-16,692,138849,7,138842
50855,18,-6,290,461443,18,461425
50856,14,-19,357,56781,14,56767
50857,8,-11,868,299712,8,299704
50858,12,-18,70,85741,12,85729
50859,15,-12,908,279403,15,279388
50860,11,-7,306,430628,11,430617
50861,17,-19,64,54343,17,54326
50862,13,-12,898,279256,13,279243
50863,20,-14,653,214610,20,214590
50864,18,5,588,808077,18,808059
50865,7,8,599,888282,7,888275
50866,6,-9,255,349183,6,349177
50867,10,-4,130,502232,10,502222
50868,9,-7,645,419533,9,419524
50869,7,16,282,1131173,7,1131166
50870,20,8,621,902855,20,902835
50871,6,5,573,793459,6,793453
50872,14,-11,145,304881,14,304867
50873,15,16,216,1148687,15,1148672
50874,13,6,342,838444,13,838431
50875,6,-20,905,20076,6,20070
50876,5,12,86,1001047,5,1001042
50877,6,7,730,860218,6,860212
50878,7,4,261,756233,7,756226
50879,16,-17,521,119415,16,119399
50880,18,2,497,714380,18,714362
50881,15,8,680,903355,15,903340
50882,8,-11,569,293745,8,293737
50883,10,8,12,875405,10,875395
50884,18,-4,910,528931,18,528913
50885,10,-18,569,74633,10,74623
50886,17,9,910,935843,17,935826
50887,6,10,893,956697,6,956691
50888,9,-6,579,449223,9,449214
50889,17,-20,477,26346,17,26329
50890,12,14,37,1085703,12,1085691
50891,9,9,457,916298,9,916289
50892,9,14,469,1072258,9,1072249
50893,14,1,744,685666,14,685652
50894,9,-6,644,450670,9,450661
50895,8,0,484,635876,8,635868
50896,7,-3,134,533329,7,533322
50897,5,3,625,732182,5,732177
50898,10,10,360,945161,10,945151
50899,18,19,366,1243756,18,1243738
50900,20,11,292,993018,20,992998
50901,9,7,946,864759,9,864750
50902,5,13,371,1038686,5,1038681
50903,12,-2,720,590572,12,590560
50904,13,16,793,1152763,13,1152750
50905,8,-15,745,171400,8,171392
50906,6,13,669,1045173,6,1045167
50907,9,-4,104,501647,9,501638
50908,9,-7,702,420740,9,420731
50909,8,18,172,1190559,8,1190551
50910,5,13,774,1047380,5,1047375
50911,5,2,70,690142,5,690137
50912,11,4,537,777134,11,777123
50913,11,-15,540,181731,11,181720
50914,10,-4,57,500530,10,500520
50915,8,-10,452,322453,8,322445
50916,19,2,307,712893,19,712874
50917,17,-8,200,399329,17,399312
50918,15,9,290,931040,15,931025
50919,19,-1,777,622572,19,622553
50920,13,-16,484,150581,13,150568
50921,18,7,187,868358,18,868340
50922,16,6,754,841837,16,841821
50923,17,6,497,839773,17,839756
50924,20,17,851,1184401,20,1184381
50925,10,-14,188,190516,10,190506
50926,5,-17,702,108532,5,108527
50927,20,-7,13,428389,20,428369
50928,12,10,765,965738,12,965726
50929,6,-17,548,105311,6,105305
50930,9,-2,312,569482,9,569473
50931,8,9,261,912104,8,912096
50932,13,13,283,1055272,13,1055259
50933,10,5,965,802084,10,802074
50934,12,19,606,1245694,12,1245682
50935,19,-17,874,121976,19,121957
50936,15,14,726,1091160,15,1091145
50937,20,13,544,1057325,20,1057305
50938,11,7,909,873507,11,873496
50939,5,2,610,701516,5,701511
50940,9,6,791,830099,9,830090
50941,20,-11,510,307821,20,307801
50942,7,-6,539,448437,7,448430
50943,11,-18,851,91381,11,91370
50944,13,-2,233,586885,13,586872
50945,18,19,723,1246644,18,1246626
50946,19,-14,752,215342,19,215323
50947,6,-2,694,577640,6,577634
50948,12,5,314,806061,12,806049
50949,15,-4,602,526602,15,526587
50950,15,-4,141,523126,15,523111
50951,8,9,592,919362,8,919354
50952,7,-17,378,101591,7,101584
50953,8,6,627,826462,8,826454
50954,14,13,861,1059681,14,1059667
50955,19,-6,24,459348,19,459329
50956,15,18,915,1215625,15,1215610
50957,18,16,97,1147744,18,1147726
50958,8,-9,690,358770,8,358762
50959,16,-4,896,528795,16,528779
50960,14,13,419,1056372,14,1056358
50961,12,-3,908,561068,12,561056
50962,17,8,975,905520,17,905503
50963,7,7,337,852126,7,852119
50964,13,3,159,743012,13,742999
50965,13,-20,291,25071,13,25058
50966,15,-15,913,184731,15,184716
50967,20,-18,348,87957,20,87937
50968,18,-5,517,494869,18,494851
50969,13,-15,333,180178,13,180165
50970,6,-10,173,316408,6,316402
50971,6,-19,0,31473,6,31467
50972,18,6,148,836890,18,836872
50973,12,-5,515,494844,12,494832
50974,15,5,991,811071,15,811056
50975,5,-10,892,331701,5,331696
50976,15,-7,27,428528,15,428513
50977,12,18,682,1213874,12,1213862
50978,7,11,415,977364,7,977357
50979,8,8,827,893169,8,893161
50980,16,14,446,1088933,16,1088917
50981,18,12,768,1027755,18,1027737
50982,19,8,844,904520,19,904501
50983,13,12,129,1022986,13,1022973
50984,18,0,969,655697,18,655679
50985,13,-17,453,118844,13,118831
50986,19,6,207,837262,19,837243
50987,7,10,788,954493,7,954486
50988,17,-19,359,56798,17,56781
50989,17,-2,275,587208,17,587191
50990,15,0,630,653011,15,652996
50991,18,-18,999,92483,18,92465
50992,17,-20,543,26950,17,26933
50993,20,2,336,713126,20,713106
50994,9,-15,612,168583,9,168574
50995,13,-4,980,529470,13,529457
50996,16,8,583,902524,16,902508
50997,7,1,838,675141,7,675134
50998,11,-20,95,23470,11,23459
50999,8,10,387,945764,8,945756
51000,18,17,530,1181824,18,1181806
51001,12,13,308,1055465,12,1055453
51002,15,6,671,841153,15,841138
51003,15,1,306,682267,15,682252
51004,9,3,965,739917,9,739908
51005,6,-6,523,448114,6,448108
51006,20,16,666,1151918,20,1151898
51007,15,11,528,994685,15,994670
51008,13,17,832,1184204,13,1184191
51009,12,7,516,870854,12,870842
51010,5,-9,255,349188,5,349183
51011,8,-4,152,502687,8,502679
51012,8,-3,631,544662,8,544654
51013,18,-10,899,341845,18,341827
51014,8,4,508,761491,8,761483
51015,6,-16,821,141660,6,141654
51016,16,-6,829,465446,16,465430
51017,20,11,364,993531,20,993511
51018,15,-18,412,88367,15,88352
51019,11,-8,46,398248,11,398237
51020,8,15,491,1104844,8,1104836
51021,12,10,97,960657,12,960645
51022,19,12,954,1029443,19,1029424
51023,9,6,436,822292,9,822283
51024,12,6,296,838051,12,838039
51025,5,17,249,1160572,5,1160567
51026,6,-2,428,571897,6,571891
51027,8,-7,273,411633,8,411625
51028,18,10,886,966593,18,966575
51029,13,9,393,931875,13,931862
51030,14,11,3,990880,14,990866
51031,8,6,201,816582,8,816574
51032,19,6,367,838604,19,838585
51033,19,-12,952,279713,19,279694
51034,6,-1,81,595574,6,595568
51035,17,-6,209,460779,17,460762
51036,13,7,240,868718,13,868705
51037,12,17,89,1178504,12,1178492
51038,10,12,339,1006600,10,1006590
51039,20,8,182,899357,20,899337
51040,6,-4,791,516307,6,516301
51041,17,17,649,1182697,17,1182680
51042,15,-2,52,585559,15,585544
51043,9,18,506,1197556,9,1197547
51044,8,-10,414,321633,8,321625
51045,8,13,183,1034622,8,1034614
51046,6,-3,747,547169,6,547163
51047,11,-5,809,496889,11,496878
51048,15,1,587,684521,15,684506
51049,20,-20,757,28639,20,28619
51050,13,17,800,1183914,13,1183901
51051,8,15,423,1103350,8,1103342
51052,18,-14,7,209398,18,209380
51053,9,-15,586,168072,9,168063
51054,11,-13,265,243035,11,243024
51055,10,18,836,1204401,10,1204391
51056,14,-17,372,118237,14,118223
51057,19,-8,575,401897,19,401878
51058,7,-8,313,382027,7,382020
51059,16,7,725,872279,16,872263
51060,9,-13,584,230829,9,230820
51061,16,16,647,1151774,16,1151758
51062,13,-3,312,556058,13,556045
51063,6,6,544,824591,6,824585
51064,12,-12,843,278750,12,278738
51065,10,-6,825,454522,10,454512
51066,18,9,863,935462,18,935444
51067,16,-17,627,120182,16,120166
51068,11,4,161,774424,11,774413
51069,9,-16,396,132487,9,132478
51070,5,3,164,722313,5,722308
51071,6,-19,309,38208,6,38202
51072,9,17,291,1161627,9,1161618
51073,18,19,484,1244766,18,1244748
51074,11,10,518,963828,11,963817
51075,12,-1,461,620243,12,620231
51076,18,2,985,717779,18,717761
51077,6,-4,969,520280,6,520274
51078,11,9,753,934544,11,934533
51079,17,-17,628,120192,17,120175
51080,7,-8,32,376042,7,376035
51081,16,-5,759,496560,16,496544
51082,14,-5,279,493085,14,493071
51083,5,17,536,1166743,5,1166738
51084,18,-11,130,304716,18,304698
51085,10,6,647,826845,10,826835
51086,15,7,246,868778,15,868763
51087,7,-19,384,39777,7,39770
51088,18,-15,564,181941,18,181923
51089,19,12,720,1027446,19,1027427
51090,16,-19,651,59103,16,59087
51091,5,7,563,856764,5,856759
51092,7,19,154,1220916,7,1220909
51093,7,-7,66,407369,7,407362
51094,6,17,654,1169336,6,1169330
51095,18,-12,521,276398,18,276380
51096,6,-17,253,98828,6,98822
51097,18,0,355,650718,18,650700
51098,16,-8,531,401570,16,401554
51099,13,4,613,777751,13,777738
51100,11,19,987,1248703,11,1248692
51101,15,12,910,1029024,15,1029009
51102,9,17,761,1171492,9,1171483
51103,12,5,258,805730,12,805718
51104,11,-14,326,211946,11,211935
51105,11,-6,943,466287,11,466276
51106,9,-14,326,193827,9,193818
51107,11,12,398,1024987,11,1024976
51108,8,8,891,894480,8,894472
51109,11,13,509,1057045,11,1057034
51110,15,1,498,683808,15,683793
51111,15,-3,279,555741,15,555726
51112,11,-19,422,57238,11,57227
51113,11,-15,34,178044,11,178033
51114,10,18,165,1190410,10,1190400
51115,20,-6,536,463290,20,463270
51116,12,-16,931,153787,12,153775
51117,14,-9,10,366725,14,366711
51118,10,-15,603,168352,10,168342
51119,16,-18,702,90321,16,90305
51120,12,19,387,1243933,12,1243921
51121,17,3,631,746605,17,746588
51122,12,-6,857,465630,12,465618
51123,10,-19,965,52219,10,52209
51124,14,1,796,686063,14,686049
51125,17,18,870,1215309,17,1215292
51126,14,6,688,841294,14,841280
51127,16,-18,287,87468,16,87452
51128,20,12,903,1028960,20,1028940
51129,15,-6,522,463204,15,463189
51130,7,-5,453,477730,7,477723
51131,14,17,833,1184220,14,1184206
51132,8,16,874,1143266,8,1143258
51133,15,4,509,776914,15,776899
51134,19,-4,131,523051,19,523032
51135,7,7,823,862294,7,862287
51136,8,-11,299,287627,8,287619
51137,9,-17,326,100495,9,100486
51138,12,-11,436,307265,12,307253
51139,15,-16,420,150025,15,150010
51140,13,-18,839,91293,13,91280
51141,5,-11,718,296628,5,296623
51142,6,7,976,865416,6,865410
51143,9,0,999,647183,9,647174
51144,7,-16,520,135368,7,135361
51145,15,6,160,836962,15,836947
51146,17,-10,984,342508,17,342491
51147,12,3,248,743735,12,743723
51148,17,-4,677,527206,17,527189
51149,20,3,428,745069,20,745049
51150,5,-5,451,477685,5,477680
51151,11,9,26,929246,11,929235
51152,6,18,217,1191539,6,1191533
51153,19,-8,21,398052,19,398033
51154,14,-15,570,181964,14,181950
51155,20,17,721,1183289,20,1183269
51156,19,-14,909,216606,19,216587
51157,12,15,668,1121690,12,1121678
51158,5,-2,928,582691,5,582686
51159,8,4,236,755802,8,755794
51160,16,-7,400,431390,16,431374
51161,5,-13,395,226623,5,226618
51162,20,-6,911,466055,20,466035
51163,14,-10,595,339502,14,339488
51164,20,-16,729,152244,20,152224
51165,19,-9,758,372520,19,372501
51166,7,-6,476,447000,7,446993
51167,6,8,4,875248,6,875242
51168,13,-14,961,216932,13,216919
51169,18,15,117,1117667,18,1117649
51170,20,4,611,777737,20,777717
51171,18,-14,553,213740,18,213722
51172,19,6,348,838493,19,838474
51173,6,12,752,1015460,6,1015454
51174,10,-14,207,191099,10,191089
51175,12,11,210,992307,12,992295
51176,12,-2,549,589260,12,589248
51177,20,-15,630,182420,20,182400
51178,15,12,962,1029544,15,1029529
51179,16,16,496,1150629,16,1150613
51180,9,-12,440,259111,9,259102
51181,12,13,733,1058688,12,1058676
51182,19,13,755,1058853,19,1058834
51183,16,-19,319,56459,16,56443
51184,20,-11,945,311083,20,311063
51185,14,-6,371,462008,14,461994
51186,6,5,804,798433,6,798427
51187,17,-2,610,589717,17,589700
51188,20,3,447,745202,20,745182
51189,16,-2,403,588126,16,588110
51190,9,11,315,975113,9,975104
51191,5,19,623,1231459,5,1231454
51192,14,-6,498,463005,14,462991
51193,10,3,932,739063,10,739053
51194,18,-15,288,179873,18,179855
51195,6,5,383,789515,6,789509
51196,18,9,370,931767,18,931749
51197,16,-17,88,116227,16,116211
51198,14,3,567,746053,14,746039
51199,18,12,157,1023180,18,1023162
51200,15,18,943,1215869,15,1215854
51201,8,-3,66,531919,8,531911
51202,9,0,931,645581,9,645572
51203,15,18,949,1215935,15,1215920
51204,7,2,616,701647,7,701640
51205,6,9,883,925449,6,925443
51206,6,17,335,1162566,6,1162560
51207,5,5,117,783991,5,783986
51208,17,12,919,1029135,17,1029118
51209,18,-10,51,335527,18,335509
51210,15,-6,510,463111,15,463096
51211,17,-2,332,587597,17,587580
51212,12,3,847,748215,12,748203
51213,10,-12,769,266148,10,266138
51214,12,17,871,1184530,12,1184518
51215,11,-20,10,5887,11,5876
51216,10,10,578,949917,10,949907
51217,16,12,994,1029771,16,1029755
51218,5,16,330,1132160,5,1132155
51219,18,19,939,1248319,18,1248301
51220,19,-7,198,429773,19,429754
51221,6,-16,736,139823,6,139817
51222,16,-4,215,523762,16,523746
51223,16,-10,541,339113,16,339097
51224,8,-3,163,533890,8,533882
51225,17,19,384,1243885,17,1243868
51226,17,19,42,1241034,17,1241017
51227,15,-12,748,278006,15,277991
51228,17,18,926,1215738,17,1215721
51229,18,1,336,682569,18,682551
51230,20,-15,195,179147,20,179127
51231,10,5,23,782091,10,782081
51232,9,-20,79,1798,9,1789
51233,8,-8,163,378984,8,378976
51234,15,3,228,743608,15,743593
51235,8,-7,692,420516,8,420508
51236,14,3,600,746312,14,746298
51237,15,-20,897,29716,15,29701
51238,15,9,811,935038,15,935023
51239,15,12,718,1027435,15,1027420
51240,16,11,308,993120,16,993104
51241,10,2,509,699473,10,699463
51242,17,-1,596,621227,17,621210
51243,9,2,559,700447,9,700438
51244,11,-18,821,91239,11,91228
51245,9,18,285,1193028,9,1193019
51246,10,0,477,635723,10,635713
51247,16,10,943,967069,16,967053
51248,6,12,436,1008473,6,1008467
51249,18,13,418,1056353,18,1056335
51250,13,1,993,687521,13,687508
51251,20,-11,152,304942,20,304922
51252,19,7,131,867971,19,867952
51253,12,13,703,1058518,12,1058506
51254,20,4,467,776613,20,776593
51255,8,16,471,1135277,8,1135269
51256,14,18,6,1208966,14,1208952
51257,7,8,378,883402,7,883395
51258,17,6,990,843686,17,843669
51259,10,16,737,1140379,10,1140369
51260,13,-17,410,118471,13,118458
51261,19,-18,778,90928,19,90909
51262,5,-8,83,377236,5,377231
51263,6,-16,435,133521,6,133515
51264,19,-7,265,430282,19,430263
51265,9,-5,780,484708,9,484699
51266,7,-5,239,473309,7,473302
51267,5,-3,555,543002,5,542997
51268,10,15,830,1112067,10,1112057
51269,12,10,515,963821,12,963809
51270,14,-14,822,215930,14,215916
51271,13,7,873,873323,13,873310
51272,12,8,457,901572,12,901560
51273,18,-19,339,56664,18,56646
51274,14,-20,858,29406,14,29392
51275,5,-18,49,63414,5,63409
51276,20,6,925,843133,20,843113
51277,14,-1,212,618198,14,618184
51278,20,14,992,1093251,20,1093231
51279,13,-13,685,245986,13,245973
51280,11,5,572,807944,11,807933
51281,10,-20,471,10095,10,10085
51282,6,12,490,1009653,6,1009647
51283,9,-20,371,8127,9,8118
51284,20,2,583,714949,20,714929
51285,13,-8,475,401130,13,401117
51286,17,-5,433,494202,17,494185
51287,17,1,349,682661,17,682644
51288,5,-20,804,17852,5,17847
51289,12,16,811,1152937,12,1152925
51290,14,12,448,1025328,14,1025314
51291,12,11,265,992755,12,992743
51292,15,8,365,900822,15,900807
51293,5,13,412,1039698,5,1039693
51294,9,-10,620,326054,9,326045
51295,7,-4,80,501112,7,501105
51296,19,16,390,1149937,19,1149918
51297,11,2,842,716798,11,716787
51298,5,-9,889,363572,5,363567
51299,8,-1,676,608416,8,608408
51300,19,-13,714,246279,19,246260
51301,6,-10,979,333563,6,333557
51302,6,19,220,1222416,6,1222410
51303,5,15,202,1098790,5,1098785
51304,15,1,415,683127,15,683112
51305,14,5,634,808440,14,808426
51306,12,-20,504,26629,12,26617
51307,8,-20,51,1092,8,1084
51308,11,16,121,1147903,11,1147892
51309,17,-20,972,30176,17,30159
51310,11,10,519,963850,11,963839
51311,9,-12,426,258805,9,258796
51312,15,3,36,742097,15,742082
51313,6,-10,800,329785,6,329779
51314,19,-20,953,30015,19,29996
51315,6,7,989,865752,6,865746
51316,19,-8,925,404417,19,404398
51317,9,10,823,955320,9,955311
51318,8,-14,253,192297,8,192289
51319,9,-3,967,552177,9,552168
51320,13,3,286,744077,13,744064
51321,15,-13,3,241073,15,241058
51322,10,-8,929,395185,10,395175
51323,5,0,932,645599,5,645594
51324,19,-16,137,147947,19,147928
51325,6,-3,750,547226,6,547220
51326,17,1,57,680228,17,680211
51327,20,-3,752,559788,20,559768
51328,18,-13,796,246946,18,246928
51329,6,-10,216,317351,6,317345
51330,5,-11,662,295738,5,295733
51331,9,-12,708,264842,9,264833
51332,13,18,161,1210265,13,1210252
51333,12,1,698,685269,12,685257
51334,9,7,880,863505,9,863496
51335,20,0,80,648800,20,648780
51336,16,-13,256,242939,16,242923
51337,6,18,25,1187100,6,1187094
51338,17,8,904,905023,17,905006
51339,15,9,0,929068,15,929053
51340,14,-4,30,522257,14,522243
51341,15,-20,617,27486,15,27471
51342,8,-6,991,457965,8,457957
51343,5,-16,131,126909,5,126904
51344,15,-2,561,589351,15,589336
51345,11,13,420,1056372,11,1056361
51346,8,19,622,1231435,8,1231427
51347,7,-16,933,144098,7,144091
51348,10,2,655,702438,10,702428
51349,10,12,882,1018461,10,1018451
51350,13,0,549,652391,13,652378
51351,16,9,247,930814,16,930798
51352,10,-7,821,423188,10,423178
51353,11,-20,688,28118,11,28107
51354,6,19,184,1221608,6,1221602
51355,18,-3,34,554060,18,554042
51356,8,8,1000,896901,8,896893
51357,20,12,554,1026108,20,1026088
51358,12,-4,834,528165,12,528153
51359,17,-17,693,120700,17,120683
51360,11,-1,707,622017,11,622006
51361,11,2,129,711586,11,711575
51362,17,7,659,871855,17,871838
51363,10,0,547,637178,10,637168
51364,14,-14,300,211734,14,211720
51365,11,17,481,1181526,11,1181515
51366,18,15,470,1120100,18,1120082
51367,10,-17,315,100300,10,100290
51368,16,-15,460,181153,16,181137
51369,14,14,14,1085489,14,1085475
51370,20,-15,404,180741,20,180721
51371,14,7,106,867795,14,867781
51372,7,19,180,1221497,7,1221490
51373,15,18,104,1209783,15,1209768
51374,9,-17,92,95432,9,95423
51375,9,4,703,765713,9,765704
51376,18,8,37,898149,18,898131
51377,13,-12,411,275543,13,275530
51378,19,-18,702,90330,19,90311
51379,8,-5,977,489287,8,489279
51380,5,-3,474,541102,5,541097
51381,6,-4,119,501895,6,501889
51382,8,14,176,1065691,8,1065683
51383,13,-11,565,308221,13,308208
51384,20,-14,687,214932,20,214912
51385,8,17,629,1168731,8,1168723
51386,8,5,129,784227,8,784219
51387,13,-7,289,430505,13,430492
51388,11,-17,358,118138,11,118127
51389,6,-6,805,454120,6,454114
51390,17,3,691,747120,17,747103
51391,11,0,446,651487,11,651476
51392,16,-20,242,24632,16,24616
51393,9,-5,216,472759,9,472750
51394,18,-12,278,274587,18,274569
51395,14,15,671,1121715,14,1121701
51396,14,-2,847,591578,14,591564
51397,12,-7,332,430855,12,430843
51398,13,18,411,1212073,13,1212060
51399,16,-12,472,275990,16,275974
51400,20,19,108,1241632,20,1241612
51401,20,9,766,934650,20,934630
51402,18,0,371,650875,18,650857
51403,14,-3,197,555159,14,555145
51404,13,10,752,965628,13,965615
51405,13,3,770,747650,13,747637
51406,19,5,356,806363,19,806344
51407,20,-17,806,121597,20,121577
51408,7,12,102,1001320,7,1001313
51409,9,-6,634,450423,9,450414
51410,11,7,47,867391,11,867380
51411,14,-18,441,88546,14,88532
51412,9,3,301,725474,9,725465
51413,17,0,917,655248,17,655231
51414,18,-19,261,56051,18,56033
51415,16,5,889,810233,16,810217
51416,14,4,725,778590,14,778576
51417,10,-19,115,34076,10,34066
51418,5,-18,326,69581,5,69576
51419,10,4,271,756448,10,756438
51420,14,8,692,903441,14,903427
51421,20,6,516,839957,20,839937
51422,20,11,643,995420,20,995400
51423,8,4,612,763913,8,763905
51424,18,-4,586,526511,18,526493
51425,8,-4,900,518764,8,518756
51426,11,-18,475,88824,11,88813
51427,5,-12,728,265188,5,265183
51428,8,7,270,850574,8,850566
51429,12,-10,241,336831,12,336819
51430,16,18,44,1209232,16,1209216
51431,15,-4,649,526981,15,526966
51432,13,6,223,837428,13,837415
51433,7,5,364,789079,7,789072
51434,5,-13,807,235872,5,235867
51435,5,-11,758,297444,5,297439
51436,7,-15,947,175676,7,175669
51437,7,12,469,1009166,7,1009159
51438,18,11,572,994991,18,994973
51439,18,-11,81,304291,18,304273
51440,20,0,874,654861,20,654841
51441,8,-7,648,419573,8,419565
51442,14,-13,711,246257,14,246243
51443,20,-13,952,248248,20,248228
51444,7,-9,10,343979,7,343972
51445,14,19,317,1243326,14,1243312
51446,10,-12,528,261074,10,261064
51447,19,-3,666,559083,19,559064
51448,17,16,131,1148002,17,1147985
51449,8,-5,736,483932,8,483924
51450,10,1,868,675894,10,675884
51451,7,7,324,851764,7,851757
51452,9,12,307,1005972,9,1005963
51453,8,15,174,1098211,8,1098203
51454,11,-5,7,490817,11,490806
51455,5,-20,567,12397,5,12392
51456,6,17,393,1163716,6,1163710
51457,5,-14,697,201940,5,201935
51458,5,5,425,790318,5,790313
51459,9,12,507,1009927,9,1009918
51460,18,3,102,742595,18,742577
51461,18,2,112,711429,18,711411
51462,5,-4,43,500222,5,500217
51463,13,15,367,1119450,13,1119437
51464,13,4,149,774360,13,774347
51465,13,-16,491,150627,13,150614
51466,9,17,771,1171644,9,1171635
51467,6,9,606,919624,6,919618
51468,15,14,621,1090253,15,1090238
51469,16,10,286,961980,16,961964
51470,20,-3,423,556994,20,556974
51471,9,10,832,955466,9,955457
51472,15,6,916,843087,15,843072
51473,16,-15,36,178063,16,178047
51474,16,-3,899,561007,16,560991
51475,6,-19,222,36450,6,36444
51476,12,11,367,993552,12,993540
51477,11,-19,247,55985,11,55974
51478,12,15,4,1116760,12,1116748
51479,5,-3,158,533783,5,533778
51480,14,9,100,929819,14,929805
51481,20,-8,14,397984,20,397964
51482,8,13,687,1045517,8,1045509
51483,10,-7,666,419858,10,419848
51484,18,15,640,1121461,18,1121443
51485,7,-15,731,171120,7,171113
51486,18,-17,238,117228,18,117210
51487,7,19,357,1225532,7,1225525
51488,19,-12,656,277364,19,277345
51489,16,14,422,1088785,16,1088769
51490,15,-7,836,434389,15,434374
51491,12,18,398,1211984,12,1211972
51492,5,-19,878,50658,5,50653
51493,16,-19,690,59375,16,59359
51494,11,-1,551,620922,11,620911
51495,20,6,645,840964,20,840944
51496,18,-11,500,307757,18,307739
51497,16,16,790,1152746,16,1152730
51498,6,-1,903,613447,6,613441
51499,18,-18,191,86764,18,86746
51500,17,6,77,836306,17,836289
51501,9,-3,517,542044,9,542035
51502,16,-14,222,211096,16,211080
51503,15,-12,455,275793,15,275778
51504,6,-8,668,389727,6,389721
51505,6,0,386,633742,6,633736
51506,11,-19,237,55902,11,55891
51507,9,3,547,730317,9,730308
51508,20,19,201,1242364,20,1242344
51509,16,-3,299,555957,16,555941
51510,14,10,584,964404,14,964390
51511,11,18,579,1213151,11,1213140
51512,5,-3,749,547184,5,547179
51513,19,-11,587,308417,19,308398
51514,18,12,498,1025707,18,1025689
51515,18,11,425,993973,18,993955
51516,15,-10,579,339368,15,339353
51517,8,-17,234,98391,8,98383
51518,8,11,67,969913,8,969905
51519,10,4,667,764940,10,764930
51520,18,-6,888,465838,18,465820
51521,18,-6,997,466703,18,466685
51522,19,9,41,929360,19,929341
51523,17,-19,680,59299,17,59282
51524,7,-3,282,536488,7,536481
51525,10,0,677,640165,10,640155
51526,13,11,9,990931,13,990918
51527,5,3,462,728718,5,728713
51528,20,17,505,1181694,20,1181674
51529,20,-9,747,372354,20,372334
51530,20,-16,85,147509,20,147489
51531,5,-3,179,534242,5,534237
51532,20,19,626,1245893,20,1245873
51533,6,-20,185,4299,6,4293
51534,8,-20,493,10572,8,10564
51535,11,-16,740,152308,11,152297
51536,8,16,100,1127218,8,1127210
51537,8,-8,832,393133,8,393125
51538,20,2,950,717570,20,717550
51539,9,15,559,1106379,9,1106370
51540,6,-13,761,234737,6,234731
51541,16,6,560,840271,16,840255
51542,6,12,828,1017069,6,1017063
51543,17,14,147,1086612,17,1086595
51544,11,-2,335,587600,11,587589
51545,14,-9,277,368608,14,368594
51546,10,-10,54,313787,10,313777
51547,8,-16,303,130559,8,130551
51548,17,11,55,991281,17,991264
51549,13,5,313,806060,13,806047
51550,9,-11,372,289406,9,289397
51551,16,8,597,902636,16,902620
51552,16,-10,420,338148,16,338132
51553,9,-2,510,573641,9,573632
51554,16,19,709,1246524,16,1246508
51555,17,-19,76,54480,17,54463
51556,12,15,853,1122991,12,1122979
51557,13,1,406,683080,13,683067
51558,20,15,948,1123761,20,1123741
51559,15,14,799,1091696,15,1091681
51560,13,-3,130,554721,13,554708
51561,10,-4,539,511137,10,511127
51562,14,-10,820,341249,14,341235
51563,14,3,914,748733,14,748719
51564,8,-9,832,362131,8,362123
51565,13,-6,560,463491,13,463478
51566,5,-19,694,46790,5,46785
51567,18,-6,166,460416,18,460398
51568,16,15,594,1121095,16,1121079
51569,11,2,568,714854,11,714843
51570,11,-12,668,277446,11,277435
51571,8,15,695,1109259,8,1109251
51572,11,-8,452,401016,11,401005
51573,12,11,546,994773,12,994761
51574,18,7,578,871297,18,871279
51575,20,-12,499,276235,20,276215
51576,12,1,257,681936,12,681924
51577,16,-3,616,558674,16,558658
51578,11,-5,471,494534,11,494523
51579,6,-16,803,141229,6,141223
51580,13,-18,240,87203,13,87190
51581,6,0,642,639319,6,639313
51582,6,-4,715,514787,6,514781
51583,19,-20,671,27961,19,27942
51584,11,-3,102,554510,11,554499
51585,13,7,189,868373,13,868360
51586,11,2,696,715868,11,715857
51587,17,-19,631,58994,17,58977
51588,15,-10,514,338899,15,338884
51589,15,8,133,898975,15,898960
51590,17,-10,166,336335,17,336318
51591,19,-5,375,493810,19,493791
51592,6,-11,460,291417,6,291411
51593,7,8,827,893176,7,893169
51594,19,-3,845,560539,19,560520
51595,15,4,708,778452,15,778437
51596,20,8,853,904608,20,904588
51597,16,13,192,1054618,16,1054602
51598,17,-2,876,591810,17,591793
51599,15,-6,429,462435,15,462420
51600,10,16,978,1145655,10,1145645
51601,19,-14,464,213097,19,213078
51602,15,19,97,1241539,15,1241524
51603,19,-11,427,307172,19,307153
51604,10,8,737,891506,10,891496
51605,11,1,627,684774,11,684763
51606,12,-9,456,370188,12,370176
51607,5,-11,829,298874,5,298869
51608,19,-3,820,560357,19,560338
51609,16,15,637,1121448,16,1121432
51610,7,-5,500,478821,7,478814
51611,17,19,948,1248392,17,1248375
51612,7,13,303,1037203,7,1037196
51613,20,17,986,1185370,20,1185350
51614,8,5,210,786062,8,786054
51615,15,-14,444,212977,15,212962
51616,10,1,403,665977,10,665967
51617,9,13,550,1042550,9,1042541
51618,5,-20,150,3333,5,3328
51619,19,14,33,1085649,19,1085630
51620,14,-18,352,87979,14,87965
51621,18,4,192,774633,18,774615
51622,15,0,55,648656,15,648641
51623,5,-3,869,549827,5,549822
51624,8,-17,528,104820,8,104812
51625,8,-16,47,124830,8,124822
51626,19,9,733,934435,19,934416
51627,10,19,172,1221357,10,1221347
51628,5,11,188,972254,5,972249
51629,20,15,788,1122565,20,1122545
51630,12,-10,93,335834,12,335822
51631,9,-8,64,376830,9,376821
51632,16,18,433,1212248,16,1212232
51633,10,-7,731,421342,10,421332
51634,19,16,590,1151262,19,1151243
51635,12,17,451,1181320,12,1181308
51636,8,19,724,1233583,8,1233575
51637,15,-8,207,399348,15,399333
51638,17,-4,662,527104,17,527087
51639,7,7,718,859958,7,859951
51640,16,18,177,1210386,16,1210370
51641,16,1,766,685846,16,685830
51642,13,-1,543,620879,13,620866
51643,10,-13,189,222477,10,222467
51644,8,-17,216,98067,8,98059
51645,14,13,940,1060196,14,1060182
51646,13,7,692,872086,13,872073
51647,18,-17,339,118037,18,118019
51648,16,8,932,905208,16,905192
51649,15,-19,614,58813,15,58798
51650,6,1,476,667602,6,667596
51651,5,8,452,885051,5,885046
51652,9,11,567,980590,9,980581
51653,17,-5,202,492433,17,492416
51654,8,9,362,914357,8,914349
51655,20,18,682,1213884,20,1213864
51656,15,3,940,748996,15,748981
51657,10,-20,572,12494,10,12484
51658,16,18,597,1213213,16,1213197
51659,13,17,796,1183880,13,1183867
51660,5,-15,163,158929,5,158924
51661,20,-18,580,89461,20,89441
51662,7,11,543,980089,7,980082
51663,12,-4,37,522324,12,522312
51664,19,-19,45,54212,19,54193
51665,18,15,773,1122491,18,1122473
51666,13,-10,873,341635,13,341622
51667,6,13,793,1047798,6,1047792
51668,18,-4,716,527458,18,527440
51669,12,14,317,1087887,12,1087875
51670,20,-13,52,241465,20,241445
51671,9,-19,266,37391,9,37382
51672,10,11,838,986376,10,986366
51673,13,6,249,837656,13,837643
51674,6,15,384,1102626,6,1102620
51675,6,3,553,730472,6,730466
51676,9,-15,327,162471,9,162462
51677,16,-16,129,147921,16,147905
51678,7,14,208,1066293,7,1066286
51679,7,-11,932,301110,7,301103
51680,9,9,395,915001,9,914992
51681,5,7,462,854696,5,854691
51682,7,7,955,864919,7,864912
51683,20,-17,196,116909,20,116889
51684,12,7,998,874111,12,874099
51685,19,6,499,839788,19,839769
51686,20,-12,971,279881,20,279861
51687,14,-13,957,248281,14,248267
51688,6,13,192,1034782,6,1034776
51689,11,8,908,905059,11,905048
51690,5,6,741,829051,5,829046
51691,9,-8,155,378826,9,378817
51692,7,5,400,789835,7,789828
51693,11,-5,923,497802,11,497791
51694,19,10,856,966385,19,966366
51695,19,3,903,748609,19,748590
51696,19,-19,450,57453,19,57434
51697,6,18,919,1206155,6,1206149
51698,7,-18,273,68464,7,68457
51699,18,18,507,1212668,18,1212650
51700,14,3,69,742342,14,742328
51701,7,-6,962,457264,7,457257
51702,10,0,225,630364,10,630354
51703,17,-16,729,152251,17,152234
51704,12,-18,816,91218,12,91206
51705,17,-6,837,465483,17,465466
51706,16,-6,68,459581,16,459565
51707,17,-15,544,181775,17,181758
51708,17,-18,621,89715,17,89698
51709,20,-4,408,525286,20,525266
51710,7,14,825,1080419,7,1080412
51711,11,-6,225,460886,11,460875
51712,7,11,628,981854,7,981847
51713,8,-18,115,64993,8,64985
51714,9,3,654,732940,9,732931
51715,19,10,100,960681,19,960662
51716,17,-14,16,209466,17,209449
51717,17,-16,774,152582,17,152565
51718,7,-1,314,600895,7,600888
51719,12,-16,798,152748,12,152736
51720,18,-1,930,623678,18,623660
51721,9,-3,34,531293,9,531284
51722,11,-3,309,556033,11,556022
51723,13,-4,477,525656,13,525643
51724,16,-17,803,121576,16,121560
51725,14,-2,235,586910,14,586896
51726,5,7,905,863963,5,863958
51727,7,-1,214,598399,7,598392
51728,13,17,316,1180339,13,1180326
51729,10,12,675,1013941,10,1013931
51730,18,-2,435,588420,18,588402
51731,14,-15,847,184147,14,184133
51732,12,6,759,841864,12,841852
51733,18,6,708,841516,18,841498
51734,13,1,362,682756,13,682743
51735,7,-20,562,12290,7,12283
51736,15,-5,902,497632,15,497617
51737,17,-2,679,590238,17,590221
51738,5,12,971,1020449,5,1020444
51739,6,-2,591,575308,6,575302
51740,5,16,997,1146043,5,1146038
51741,13,12,459,1025405,13,1025392
51742,9,11,813,985896,9,985887
51743,20,4,227,774932,20,774912
51744,6,-15,939,175432,6,175426
51745,16,10,278,961921,16,961905
51746,6,13,879,1049637,6,1049631
51747,15,-7,85,428880,15,428865
51748,7,9,460,916352,7,916345
51749,5,-5,781,484752,5,484747
51750,20,7,10,867097,20,867077
51751,14,11,173,992066,14,992052
51752,10,-6,403,445398,10,445388
51753,18,10,501,963655,18,963637
51754,10,18,9,1186781,10,1186771
51755,12,-3,10,553935,12,553923
51756,19,2,342,713190,19,713171
51757,12,-18,428,88497,12,88485
51758,14,3,335,744429,14,744415
51759,11,-12,219,274111,11,274100
51760,9,12,65,1000513,9,1000504
51761,7,15,732,1110096,7,1110089
51762,6,-2,897,581977,6,581971
51763,13,-2,386,587951,13,587938
51764,15,-9,590,371318,15,371303
51765,17,10,363,962561,17,962544
51766,7,1,349,664835,7,664828
51767,12,3,34,742063,12,742051
51768,20,19,761,1246935,20,1246915
51769,14,14,126,1086485,14,1086471
51770,11,-3,288,555853,11,555842
51771,19,-12,979,279940,19,279921
51772,16,4,724,778587,16,778571
51773,5,8,281,881359,5,881354
51774,7,12,857,1017871,7,1017864
51775,10,-11,603,294519,10,294509
51776,8,-6,653,450790,8,450782
51777,17,6,400,838990,17,838973
51778,19,-7,292,430539,19,430520
51779,17,-3,703,559392,17,559375
51780,17,-2,138,586131,17,586114
51781,16,13,383,1056050,16,1056034
51782,13,-9,68,367140,13,367127
51783,16,2,772,716320,16,716304
51784,5,-12,299,256110,5,256105
51785,17,14,432,1088859,17,1088842
51786,10,2,168,692276,10,692266
51787,14,-13,568,245247,14,245233
51788,17,-16,416,149985,17,149968
51789,8,-9,547,356011,8,356003
51790,15,-15,578,182044,15,182029
51791,11,7,556,871113,11,871102
51792,20,-15,182,179079,20,179059
51793,19,14,755,1091364,19,1091345
51794,9,3,296,725346,9,725337
51795,11,4,88,773906,11,773895
51796,11,-17,714,120845,11,120834
51797,14,-9,397,369672,14,369658
51798,5,11,169,971941,5,971936
51799,13,5,587,808060,13,808047
51800,17,7,834,873034,17,873017
51801,18,7,693,872096,18,872078
51802,14,-18,365,88027,14,88013
51803,5,-17,218,98126,5,98121
51804,15,-13,774,246819,15,246804
51805,11,-18,457,88719,11,88708
51806,12,-17,551,119629,12,119617
51807,7,6,431,822086,7,822079
51808,18,-1,385,619645,18,619627
51809,17,12,939,1029303,17,1029286
51810,7,-8,687,390182,7,390175
51811,13,2,464,714145,13,714132
51812,15,-8,994,404977,15,404962
51813,11,2,306,712885,11,712874
51814,12,-4,605,526640,12,526628
51815,6,-2,737,578457,6,578451
51816,18,-15,910,184685,18,184667
51817,6,-14,29,187126,6,187120
51818,12,17,202,1179395,12,1179383
51819,17,-4,9,522120,17,522103
51820,12,-20,466,26297,12,26285
51821,12,14,31,1085621,12,1085609
51822,19,-3,735,559623,19,559604
51823,14,-8,836,403830,14,403816
51824,11,10,856,966386,11,966375
51825,13,-2,704,590438,13,590425
51826,5,13,120,1033321,5,1033316
51827,8,-17,508,104469,8,104461
51828,11,4,588,777519,11,777508
51829,16,19,898,1248054,16,1248038
51830,16,-10,932,342081,16,342065
51831,17,-14,858,216205,17,216188
51832,17,13,879,1059820,17,1059803
51833,7,8,485,885775,7,885768
51834,19,-6,698,464502,19,464483
51835,18,10,313,962187,18,962169
51836,9,19,174,1221380,9,1221371
51837,20,-4,618,526743,20,526723
51838,20,-17,821,121644,20,121624
51839,9,-3,486,541419,9,541410
51840,20,6,96,836467,20,836447
51841,11,8,400,901142,11,901131
51842,16,-15,699,182941,16,182925
51843,12,1,723,685490,12,685478
51844,17,-2,686,590316,17,590299
51845,16,-4,929,529019,16,529003
51846,11,-15,302,179976,11,179965
51847,20,4,988,780502,20,780482
51848,16,19,820,1247386,16,1247370
51849,8,-4,872,518102,8,518094
51850,20,-6,228,460948,20,460928
51851,15,-15,860,184306,15,184291
51852,18,9,738,934464,18,934446
51853,17,-17,725,121018,17,121001
51854,20,7,369,869677,20,869657
51855,6,2,370,696689,6,696683
51856,17,17,944,1184956,17,1184939
51857,8,-19,94,33466,8,33458
51858,19,11,874,997214,19,997195
51859,7,-15,697,170264,7,170257
51860,16,-5,722,496305,16,496289
51861,8,10,96,939712,8,939704
51862,7,-11,178,285026,7,285019
51863,12,11,921,997598,12,997586
51864,15,15,380,1119576,15,1119561
51865,15,-14,571,214018,15,214003
51866,6,12,633,1012846,6,1012840
51867,8,-17,549,105328,8,105320
51868,10,-10,193,316835,10,316825
51869,8,-17,33,94252,8,94244
51870,20,-18,609,89650,20,89630
51871,11,3,104,742630,11,742619
51872,5,-4,631,513056,5,513051
51873,15,14,149,1086626,15,1086611
51874,12,13,36,1053488,12,1053476
51875,9,-9,459,353797,9,353788
51876,6,0,91,627322,6,627316
51877,15,9,305,931202,15,931187
51878,5,-8,573,387486,5,387481
51879,6,-9,750,360226,6,360220
51880,15,-3,640,558911,15,558896
51881,17,19,522,1245126,17,1245109
51882,20,-2,293,587371,20,587351
51883,5,-11,901,300514,5,300509
51884,16,-9,366,369403,16,369387
51885,16,-7,726,433582,16,433566
51886,10,9,248,911944,10,911934
51887,18,-15,425,180946,18,180928
51888,7,16,361,1132830,7,1132823
51889,9,-11,91,283013,9,283004
51890,19,10,425,963090,19,963071
51891,13,-15,625,182360,13,182347
51892,8,-11,608,294661,8,294653
51893,16,-10,535,339052,16,339036
51894,17,-6,25,459360,17,459343
51895,18,8,315,900442,18,900424
51896,9,9,843,924745,9,924736
51897,12,0,85,648851,12,648839
51898,15,8,775,904118,15,904103
51899,15,6,989,843671,15,843656
51900,9,-19,620,45111,9,45102
51901,10,4,848,769383,10,769373
51902,12,-12,392,275390,12,275378
51903,11,5,504,807475,11,807464
51904,15,19,809,1247343,15,1247328
51905,13,-2,531,589125,13,589112
51906,5,-5,52,468996,5,468991
51907,10,-7,669,419943,10,419933
51908,10,2,564,700551,10,700541
51909,18,-14,121,210229,18,210211
51910,8,-2,8,562908,8,562900
51911,15,9,378,931805,15,931790
51912,15,-17,377,118278,15,118263
51913,8,4,303,757056,8,757048
51914,5,-18,366,70303,5,70298
51915,15,-1,882,623356,15,623341
51916,12,11,412,993876,12,993864
51917,13,9,955,936203,13,936190
51918,6,-7,565,418023,6,418017
51919,18,-17,242,117262,18,117244
51920,14,-11,450,307375,14,307361
51921,14,-2,829,591447,14,591433
51922,18,-15,571,181987,18,181969
51923,12,-3,387,556671,12,556659
51924,9,-16,436,133558,9,133549
51925,15,-20,821,29175,15,29160
51926,7,2,430,697853,7,697846
51927,14,-2,665,590140,14,590126
51928,11,16,963,1153994,11,1153983
51929,18,-20,167,24027,18,24009
51930,5,18,232,1191849,5,1191844
51931,12,16,152,1148158,12,1148146
51932,14,-4,151,523221,14,523207
51933,10,0,669,639996,10,639986
51934,19,-11,845,310302,19,310283
51935,15,6,762,841890,15,841875
51936,16,13,290,1055348,16,1055332
51937,15,-14,470,213157,15,213142
51938,14,16,147,1148137,14,1148123
51939,12,-1,222,618296,12,618284
51940,16,11,563,994905,16,994889
51941,11,7,121,867872,11,867861
51942,16,11,986,997947,16,997931
51943,20,-11,92,304394,20,304374
51944,16,-3,807,560260,16,560244
51945,14,-10,472,338614,14,338600
51946,6,-4,504,510390,6,510384
51947,14,16,996,1154273,14,1154259
51948,11,16,506,1150695,11,1150684
51949,12,-6,637,464041,12,464029
51950,6,9,989,927822,6,927816
51951,7,-11,707,296468,7,296461
51952,6,16,824,1142306,6,1142300
51953,6,6,493,823544,6,823538
51954,8,15,232,1099505,8,1099497
51955,14,12,201,1023502,14,1023488
51956,5,-8,185,379507,5,379502
51957,8,2,697,703374,8,703366
51958,11,7,755,872473,11,872462
51959,8,1,855,675597,8,675589
51960,5,0,944,645855,5,645850
51961,7,7,101,846992,7,846985
51962,20,1,432,683225,20,683205
51963,13,0,388,651026,13,651013
51964,20,-11,681,309134,20,309114
51965,18,0,362,650790,18,650772
51966,7,0,262,631050,7,631043
51967,10,3,911,738528,10,738518
51968,20,10,678,965158,20,965138
51969,12,3,488,745480,12,745468
51970,13,-2,887,591927,13,591914
51971,19,-7,609,432803,19,432784
51972,19,-17,214,117052,19,117033
51973,18,-8,151,398993,18,398975
51974,10,-1,43,594768,10,594758
51975,16,1,35,680079,16,680063
51976,8,16,346,1132516,8,1132508
51977,11,-14,301,211734,11,211723
51978,10,15,316,1101266,10,1101256
51979,17,15,400,1119660,17,1119643
51980,12,-8,898,404292,12,404280
51981,17,14,62,1085924,17,1085907
51982,7,-12,597,262445,7,262438
51983,5,7,327,851867,5,851862
51984,16,11,459,994198,16,994182
51985,7,-14,386,195226,7,195219
51986,18,2,126,711564,18,711546
51987,18,3,438,745131,18,745113
51988,16,2,645,715388,16,715372
51989,5,8,904,894829,5,894824
51990,19,-16,846,153117,19,153098
51991,5,12,473,1009250,5,1009245
51992,12,-16,431,150160,12,150148
51993,19,-7,949,435337,19,435318
51994,7,15,976,1115276,7,1115269
51995,20,-2,342,587657,20,587637
51996,16,-1,736,622260,16,622244
51997,15,-9,732,372163,15,372148
51998,17,-3,309,556040,17,556023
51999,17,6,953,843334,17,843317
52000,15,10,519,963855,15,963840
52001,16,-4,296,524373,16,524357
52002,8,14,615,1075556,8,1075548
52003,15,5,520,807603,15,807588
52004,11,13,850,1059597,11,1059586
52005,15,-5,266,493002,15,492987
52006,9,4,765,767293,9,767284
52007,8,-16,180,127901,8,127893
52008,7,-14,52,187673,7,187666
52009,10,11,196,972473,10,972463
52010,13,15,9,1116813,13,1116800
52011,19,19,262,1242829,19,1242810
52012,13,10,189,961278,13,961265
52013,5,0,744,641700,5,641695
52014,18,-15,800,183690,18,183672
52015,6,18,116,1189352,6,1189346
52016,6,15,594,1107008,6,1107002
52017,11,-12,655,277343,11,277332
52018,16,-15,560,181896,16,181880
52019,7,7,928,864408,7,864401
52020,12,19,141,1241906,12,1241894
52021,13,-8,274,399813,13,399800
52022,5,-1,381,602310,5,602305
52023,12,12,680,1027186,12,1027174
52024,14,0,443,651450,14,651436
52025,16,2,131,711606,16,711590
52026,12,-13,968,248348,12,248336
52027,18,-13,762,246679,18,246661
52028,8,-13,792,235550,8,235542
52029,7,8,543,887080,7,887073
52030,9,4,575,762966,9,762957
52031,15,-9,50,367028,15,367013
52032,5,2,625,701839,5,701834
52033,7,12,28,999685,7,999678
52034,6,-8,811,392705,6,392699
52035,5,2,30,689227,5,689222
52036,11,-6,792,465184,11,465173
52037,14,-11,490,307654,14,307640
52038,12,3,562,745961,12,745949
52039,6,8,209,879782,6,879776
52040,18,18,815,1214857,18,1214839
52041,14,3,305,744214,14,744200
52042,17,6,369,838632,17,838615
52043,8,4,314,757297,8,757289
52044,15,11,340,993350,15,993335
52045,11,15,143,1117875,11,1117864
52046,16,-6,448,462547,16,462531
52047,17,14,316,1087875,17,1087858
52048,14,-20,744,28495,14,28481
52049,8,-10,928,332347,8,332339
52050,5,-13,692,232937,5,232932
52051,20,10,65,960336,20,960316
52052,17,11,431,994007,17,993990
52053,9,-8,105,377589,9,377580
52054,6,-8,854,393547,6,393541
52055,7,8,351,882875,7,882868
52056,13,-17,793,121492,13,121479
52057,12,-12,886,279134,12,279122
52058,16,-15,698,182936,16,182920
52059,14,11,165,992016,14,992002
52060,9,10,676,952156,9,952147
52061,15,5,131,804711,15,804696
52062,19,-20,889,29637,19,29618
52063,17,-7,511,432174,17,432157
52064,17,-12,463,275898,17,275881
52065,13,-19,575,58575,13,58562
52066,14,-2,865,591733,14,591719
52067,14,15,818,1122774,14,1122760
52068,7,5,657,795157,7,795150
52069,13,1,489,683713,13,683700
52070,5,-18,403,71060,5,71055
52071,7,-4,408,508498,7,508491
52072,10,9,66,908122,10,908112
52073,11,-19,516,57965,11,57954
52074,18,-5,829,497017,18,496999
52075,12,8,567,902407,12,902395
52076,6,-6,541,448468,6,448462
52077,10,-19,470,41689,10,41679
52078,11,-8,154,399003,11,398992
52079,19,2,982,717757,19,717738
52080,12,-19,344,56692,12,56680
52081,14,-19,858,60605,14,60591
52082,18,11,522,994627,18,994609
52083,14,13,821,1059389,14,1059375
52084,15,12,269,1024122,15,1024107
52085,8,-9,705,359116,8,359108
52086,18,9,304,931197,18,931179
52087,18,-5,674,495918,18,495900
52088,16,5,833,809869,16,809853
52089,6,-10,802,329819,6,329813
52090,5,-17,668,107878,5,107873
52091,14,0,775,654196,14,654182
52092,5,1,217,661955,5,661950
52093,8,-15,284,161473,8,161465
52094,11,-1,427,619948,11,619937
52095,10,10,515,948500,10,948490
52096,20,16,394,1149995,20,1149975
52097,13,-8,591,401974,13,401961
52098,9,-5,692,482974,9,482965
52099,19,13,259,1055102,19,1055083
52100,13,3,937,748948,13,748935
52101,17,-6,630,463970,17,463953
52102,12,-7,546,432448,12,432436
52103,8,-9,947,364842,8,364834
52104,10,-6,392,445195,10,445185
52105,12,5,358,806390,12,806378
52106,6,-15,632,169046,6,169040
52107,5,-9,837,362228,5,362223
52108,20,9,917,935898,20,935878
52109,7,-11,975,302134,7,302127
52110,20,-16,216,148568,20,148548
52111,18,-9,617,371475,18,371457
52112,11,11,362,993513,11,993502
52113,6,3,716,734394,6,734388
52114,8,13,645,1044640,8,1044632
52115,18,-19,83,54569,18,54551
52116,5,-4,641,513245,5,513240
52117,13,10,768,965758,13,965745
52118,20,3,308,744265,20,744245
52119,16,-16,754,152464,16,152448
52120,15,-16,558,151097,15,151082
52121,10,-10,691,327595,10,327585
52122,11,-18,218,86974,11,86963
52123,20,3,269,743926,20,743906
52124,9,-13,914,238108,9,238099
52125,20,2,797,716444,20,716424
52126,7,12,943,1019869,7,1019862
52127,16,15,288,1118934,16,1118918
52128,18,7,19,867160,18,867142
52129,17,-13,427,244145,17,244128
52130,15,9,295,931086,15,931071
52131,7,-17,136,96302,7,96295
52132,13,-9,801,372894,13,372881
52133,18,-3,246,555499,18,555481
52134,5,9,383,914754,5,914749
52135,10,-2,17,563119,10,563109
52136,11,6,626,840807,11,840796
52137,13,-6,32,459412,13,459399
52138,14,9,95,929768,14,929754
52139,7,6,843,831291,7,831284
52140,5,16,498,1135777,5,1135772
52141,10,10,923,957393,10,957383
52142,11,1,446,683348,11,683337
52143,12,7,48,867397,12,867385
52144,14,9,169,930314,14,930300
52145,14,18,452,1212335,14,1212321
52146,6,-6,710,452070,6,452064
52147,5,2,211,693184,5,693179
52148,18,5,523,807614,18,807596
52149,13,4,701,778367,13,778354
52150,7,-4,762,515651,7,515644
52151,11,14,934,1092731,11,1092720
52152,14,-20,527,26796,14,26782
52153,16,-9,475,370408,16,370392
52154,7,-13,113,220862,7,220855
52155,17,8,308,900393,17,900376
52156,17,-15,894,184531,17,184514
52157,5,-13,848,236734,5,236729
52158,9,13,278,1036645,9,1036636
52159,10,-20,456,9741,10,9731
52160,8,10,449,947119,8,947111
52161,5,17,365,1163133,5,1163128
52162,18,6,437,839281,18,839263
52163,20,-3,321,556124,20,556104
52164,9,-16,587,136757,9,136748
52165,12,-18,67,85729,12,85717
52166,17,-14,198,210837,17,210820
52167,20,1,376,682867,20,682847
52168,18,-11,535,308047,18,308029
52169,8,11,132,971259,8,971251
52170,16,18,897,1215542,16,1215526
52171,8,16,64,1126545,8,1126537
52172,6,19,436,1227636,6,1227630
52173,8,3,311,725742,8,725734
52174,11,-20,836,29280,11,29269
52175,12,-10,234,336786,12,336774
52176,17,9,874,935540,17,935523
52177,12,-8,84,398597,12,398585
52178,13,-9,760,372544,13,372531
52179,6,-13,930,238514,6,238508
52180,14,19,231,1242556,14,1242542
52181,10,15,266,1100230,10,1100220
52182,13,-20,181,24194,13,24181
52183,7,-7,476,416019,7,416012
52184,20,11,935,997655,20,997635
52185,6,-4,785,516197,6,516191
52186,7,18,605,1199445,7,1199438
52187,17,-2,767,590866,17,590849
52188,7,16,955,1145024,7,1145017
52189,10,2,284,694756,10,694746
52190,16,-2,758,590813,16,590797
52191,15,-4,469,525616,15,525601
52192,13,-9,418,369834,13,369821
52193,12,1,760,685782,12,685770
52194,18,6,92,836446,18,836428
52195,12,-10,833,341343,12,341331
52196,19,16,281,1149169,19,1149150
52197,16,6,264,837767,16,837751
52198,10,7,197,848946,10,848936
52199,16,5,799,809587,16,809571
52200,13,-14,337,212038,13,212025
52201,16,-20,78,23386,16,23370
52202,6,-14,193,190644,6,190638
52203,11,-12,544,276553,11,276542
52204,11,2,331,713083,11,713072
52205,7,-5,101,470316,7,470309
52206,6,-14,708,202213,6,202207
52207,10,-8,161,378921,10,378911
52208,7,15,646,1108148,7,1108141
52209,11,-12,1000,280122,11,280111
52210,17,1,713,685351,17,685334
52211,8,-9,729,359659,8,359651
52212,5,-2,769,579142,5,579137
52213,19,15,567,1120901,19,1120882
52214,11,-19,838,60447,11,60436
52215,11,-18,831,91265,11,91254
52216,10,-7,425,414975,10,414965
52217,15,-19,962,61222,15,61207
52218,20,1,805,686117,20,686097
52219,15,2,984,717772,15,717757
52220,18,8,355,900766,18,900748
52221,20,-15,833,184050,20,184030
52222,17,-16,756,152498,17,152481
52223,6,4,201,754999,6,754993
52224,12,9,534,932963,12,932951
52225,9,-13,630,231837,9,231828
52226,16,-7,413,431451,16,431435
52227,15,-7,938,435263,15,435248
52228,9,5,313,788096,9,788087
52229,8,-1,94,595868,8,595860
52230,15,8,46,898231,15,898216
52231,13,-2,859,591668,13,591655
52232,14,-14,716,215106,14,215092
52233,18,-17,421,118537,18,118519
52234,8,-9,173,347249,8,347241
52235,16,16,769,1152534,16,1152518
52236,11,10,773,965794,11,965783
52237,15,19,523,1245135,15,1245120
52238,16,12,631,1026712,16,1026696
52239,17,-20,303,25167,17,25150
52240,17,-9,107,367372,17,367355
52241,15,-19,909,60874,15,60859
52242,10,4,494,761149,10,761139
52243,5,8,234,880391,5,880386
52244,19,10,221,961526,19,961507
52245,13,7,891,873405,13,873392
52246,14,13,845,1059573,14,1059559
52247,16,18,283,1211198,16,1211182
52248,9,10,310,944092,9,944083
52249,6,1,206,661703,6,661697
52250,9,4,237,755859,9,755850
52251,19,8,227,899775,19,899756
52252,13,-14,989,217189,13,217176
52253,13,19,223,1242508,13,1242495
52254,8,1,520,668679,8,668671
52255,11,1,738,685600,11,685589
52256,16,15,982,1124011,16,1123995
52257,9,2,446,698164,9,698155
52258,11,18,456,1212359,11,1212348
52259,11,17,969,1185198,11,1185187
52260,12,10,317,962233,12,962221
52261,12,12,108,1022828,12,1022816
52262,7,-8,349,382779,7,382772
52263,19,-18,629,89810,19,89791
52264,18,-17,750,121210,18,121192
52265,19,-10,289,337132,19,337113
52266,11,-12,871,279020,11,279009
52267,7,-1,120,596427,7,596420
52268,18,17,10,1177915,18,1177897
52269,20,4,998,780563,20,780543
52270,16,-10,748,340724,16,340708
52271,18,-19,922,60969,18,60951
52272,12,5,895,810275,12,810263
52273,9,-16,179,127874,9,127865
52274,11,-12,595,276844,11,276833
52275,5,-5,325,475355,5,475350
52276,6,-16,108,126408,6,126402
52277,18,10,610,964619,18,964601
52278,17,7,344,869531,17,869514
52279,12,-6,85,459689,12,459677
52280,12,3,191,743330,12,743318
52281,8,6,180,816084,8,816076
52282,11,6,522,840054,11,840043
52283,17,-16,432,150178,17,150161
52284,11,8,860,904647,11,904636
52285,10,4,363,758408,10,758398
52286,8,0,161,628896,8,628888
52287,19,18,497,1212593,19,1212574
52288,18,4,476,776685,18,776667
52289,16,0,325,650453,16,650437
52290,6,-4,372,507737,6,507731
52291,17,-14,4,209382,17,209365
52292,20,16,630,1151595,20,1151575
52293,18,1,22,679969,18,679951
52294,15,7,135,868028,15,868013
52295,16,7,65,867499,16,867483
52296,9,-12,969,270749,9,270740
52297,20,-13,342,243587,20,243567
52298,15,-7,498,432055,15,432040
52299,6,-8,620,388565,6,388559
52300,14,-10,315,337357,14,337343
52301,17,3,956,749151,17,749134
52302,18,11,31,991115,18,991097
52303,18,-2,88,585801,18,585783
52304,18,-9,272,368568,18,368550
52305,13,-5,692,496082,13,496069
52306,14,7,850,873140,14,873126
52307,6,-9,550,356094,6,356088
52308,11,12,485,1025658,11,1025647
52309,11,8,715,903670,11,903659
52310,14,6,721,841618,14,841604
52311,19,9,189,930453,19,930434
52312,17,5,995,811106,17,811089
52313,9,3,456,728603,9,728594
52314,9,4,132,753447,9,753438
52315,8,12,10,999217,8,999209
52316,13,7,595,871416,13,871403
52317,19,1,350,682682,19,682663
52318,10,-1,828,611665,10,611655
52319,13,-16,934,153810,13,153797
52320,19,-14,25,209521,19,209502
52321,17,4,576,777443,17,777426
52322,14,1,416,683138,14,683124
52323,8,12,50,1000181,8,1000173
52324,8,6,317,819411,8,819403
52325,15,16,918,1153704,15,1153689
52326,5,-4,642,513249,5,513244
52327,6,11,142,971442,6,971436
52328,18,-9,861,373390,18,373372
52329,20,-19,329,56525,20,56505
52330,20,-14,422,212841,20,212821
52331,16,-20,790,28915,16,28899
52332,15,-6,273,461319,15,461304
52333,8,12,258,1004896,8,1004888
52334,14,-16,987,154188,14,154174
52335,17,-4,215,523769,17,523752
52336,10,1,845,675338,10,675328
52337,12,-13,97,241743,12,241731
52338,20,1,73,680325,20,680305
52339,6,0,895,644790,6,644784
52340,16,-7,574,432620,16,432604
52341,20,2,316,712941,20,712921
52342,17,4,297,775342,17,775325
52343,11,17,32,1178112,11,1178101
52344,17,-7,542,432437,17,432420
52345,18,6,804,842209,18,842191
52346,9,-16,86,125766,9,125757
52347,7,5,62,782992,7,782985
52348,6,14,243,1067198,6,1067192
52349,11,-16,553,151048,11,151037
52350,19,-1,450,620134,19,620115
52351,15,18,542,1212940,15,1212925
52352,13,4,476,776688,13,776675
52353,16,-2,224,586830,16,586814
52354,15,1,850,686430,15,686415
52355,6,12,570,1011273,6,1011267
52356,10,-20,180,4148,10,4138
52357,15,4,884,779826,15,779811
52358,16,-9,906,373770,16,373754
52359,6,17,227,1160021,6,1160015
52360,5,-8,633,388919,5,388914
52361,14,14,426,1088810,14,1088796
52362,17,4,565,777366,17,777349
52363,10,-14,638,200777,10,200767
52364,9,-4,426,508908,9,508899
52365,19,2,83,711168,19,711149
52366,11,-4,337,524692,11,524681
52367,6,-6,219,441657,6,441651
52368,16,-16,811,152855,16,152839
52369,14,-12,819,278519,14,278505
52370,15,-13,575,245309,15,245294
52371,6,3,231,723878,6,723872
52372,12,-11,929,310950,12,310938
52373,16,9,77,929626,16,929610
52374,17,-1,769,622455,17,622438
52375,16,19,246,1242677,16,1242661
52376,13,8,817,904357,13,904344
52377,19,-19,143,55145,19,55126
52378,13,-6,68,459584,13,459571
52379,20,-9,335,369105,20,369085
52380,10,14,587,1074846,10,1074836
52381,11,12,963,1029544,11,1029533
52382,5,-6,518,448019,5,448014
52383,11,0,779,654213,11,654202
52384,12,12,575,1026247,12,1026235
52385,20,-6,776,465087,20,465067
52386,12,16,204,1148567,12,1148555
52387,7,-2,93,564797,7,564790
52388,12,18,164,1210282,12,1210270
52389,5,-2,980,583802,5,583797
52390,8,6,838,831215,8,831207
52391,11,-15,583,182077,11,182066
52392,6,2,438,697967,6,697961
52393,8,-13,662,232369,8,232361
52394,11,9,968,936335,11,936324
52395,8,-2,187,566734,8,566726
52396,19,-14,619,214379,19,214360
52397,19,10,983,967336,19,967317
52398,13,10,829,966244,13,966231
52399,8,-5,161,471622,8,471614
52400,14,5,72,804348,14,804334
52401,16,-12,740,277938,16,277922
52402,12,11,359,993472,12,993460
52403,13,-2,981,592617,13,592604
52404,11,-9,666,371722,11,371711
52405,12,8,663,903199,12,903187
52406,20,10,506,963746,20,963726
52407,5,-3,508,541881,5,541876
52408,9,14,226,1066792,9,1066783
52409,7,-11,66,282573,7,282566
52410,18,12,878,1028672,18,1028654
52411,16,-19,920,60936,16,60920
52412,16,7,153,868131,16,868115
52413,19,-1,441,620069,19,620050
52414,18,-15,910,184693,18,184675
52415,14,9,726,934379,14,934365
52416,17,3,1000,749563,17,749546
52417,15,-7,691,433307,15,433292
52418,11,-12,355,275174,11,275163
52419,16,-8,949,404621,16,404605
52420,16,3,661,746836,16,746820
52421,8,-6,672,451175,8,451167
52422,12,-11,362,306638,12,306626
52423,18,17,812,1184042,18,1184024
52424,11,11,828,996823,11,996812
52425,12,13,278,1055239,12,1055227
52426,12,-17,421,118539,12,118527
52427,9,-14,53,187681,9,187672
52428,8,19,698,1233006,8,1232998
52429,15,18,197,1210610,15,1210595
52430,6,19,943,1238432,6,1238426
52431,14,11,799,996665,14,996651
52432,19,-12,405,275491,19,275472
52433,7,-5,741,484029,7,484022
52434,5,5,370,789265,5,789260
52435,19,0,538,652297,19,652278
52436,5,-6,676,451237,5,451232
52437,16,-18,825,91263,16,91247
52438,10,-7,79,407559,10,407549
52439,20,-20,863,29438,20,29418
52440,10,-18,570,74672,10,74662
52441,17,-2,678,590221,17,590204
52442,7,14,713,1078078,7,1078071
52443,7,-10,615,325948,7,325941
52444,19,-13,709,246243,19,246224
52445,18,-4,590,526536,18,526518
52446,19,18,365,1211773,19,1211754
52447,18,-1,38,616871,18,616853
52448,16,17,222,1179502,16,1179486
52449,5,11,562,980509,5,980504
52450,18,12,501,1025742,18,1025724
52451,5,-7,559,417906,5,417901
52452,10,16,624,1138308,10,1138298
52453,13,12,905,1028979,13,1028966
52454,19,-13,553,245113,19,245094
52455,13,13,247,1055025,13,1055012
52456,19,-19,570,58514,19,58495
52457,14,8,353,900748,14,900734
52458,8,8,810,892899,8,892891
52459,20,19,746,1246854,20,1246834
52460,19,8,479,901707,19,901688
52461,8,-11,238,286205,8,286197
52462,19,4,490,776762,19,776743
52463,5,3,386,727157,5,727152
52464,7,8,767,892078,7,892071
52465,12,6,248,837634,12,837622
52466,13,19,584,1245550,13,1245537
52467,15,0,873,654845,15,654830
52468,20,19,329,1243435,20,1243415
52469,13,15,243,1118588,13,1118575
52470,6,5,563,793220,6,793214
52471,5,6,765,829504,5,829499
52472,9,-10,891,331677,9,331668
52473,18,12,239,1023824,18,1023806
52474,7,14,809,1080136,7,1080129
52475,20,-2,389,587978,20,587958
52476,19,11,569,994964,19,994945
52477,15,10,547,964024,15,964009
52478,11,-17,741,121131,11,121120
52479,6,19,558,1230102,6,1230096
52480,9,-9,833,362159,9,362150
52481,6,12,856,1017825,6,1017819
52482,11,-3,65,554223,11,554212
52483,10,18,363,1194556,10,1194546
52484,13,-6,574,463530,13,463517
52485,11,17,951,1185018,11,1185007
52486,15,3,328,744376,15,744361
52487,5,-9,248,349029,5,349024
52488,12,0,238,650020,12,650008
52489,13,11,738,996114,13,996101
52490,7,-7,395,414507,7,414500
52491,9,-18,868,81141,9,81132
52492,7,0,622,638864,7,638857
52493,8,6,17,812598,8,812590
52494,5,-17,749,109541,5,109536
52495,10,3,101,721002,10,720992
52496,11,-2,586,589532,11,589521
52497,6,-18,955,83212,6,83206
52498,19,0,295,650294,19,650275
52499,10,0,268,631162,10,631152
52500,16,-12,944,279623,16,279607
52501,9,1,758,673462,9,673453
52502,11,15,333,1119229,11,1119218
52503,19,-10,798,341127,19,341108
52504,17,-4,489,525731,17,525714
52505,19,4,546,777210,19,777191
52506,6,-7,316,412738,6,412732
52507,14,10,444,963197,14,963183
52508,6,19,652,1231988,6,1231982
52509,8,16,844,1142638,8,1142630
52510,20,10,208,961411,20,961391
52511,20,-13,1000,248615,20,248595
52512,16,-19,727,59673,16,59657
52513,6,-16,53,124970,6,124964
52514,5,-8,900,394658,5,394653
52515,20,3,977,749339,20,749319
52516,6,-16,171,127629,6,127623
52517,12,-6,219,460846,12,460834
52518,14,-11,14,303793,14,303779
52519,19,18,955,1215986,19,1215967
52520,8,-4,802,516540,8,516532
52521,6,-4,896,518633,6,518627
52522,16,-1,660,621670,16,621654
52523,16,-13,461,244337,16,244321
52524,7,-8,989,396539,7,396532
52525,12,-12,877,279045,12,279033
52526,12,-10,794,341048,12,341036
52527,6,-10,638,326453,6,326447
52528,13,8,907,905057,13,905044
52529,14,12,214,1023655,14,1023641
52530,17,-20,790,28922,17,28905
52531,7,14,892,1081833,7,1081826
52532,14,-9,233,368259,14,368245
52533,6,10,538,948979,6,948973
52534,17,-13,261,243004,17,242987
52535,13,-3,468,557373,13,557360
52536,19,-19,507,57907,19,57888
52537,8,5,19,782012,8,782004
52538,11,19,232,1242560,11,1242549
52539,13,12,63,1022512,13,1022499
52540,14,12,927,1029180,14,1029166
52541,16,18,624,1213419,16,1213403
52542,15,19,52,1241142,15,1241127
52543,9,12,295,1005698,9,1005689
52544,12,-13,471,244459,12,244447
52545,17,-14,830,215984,17,215967
52546,16,14,746,1091288,16,1091272
52547,19,0,688,653548,19,653529
52548,10,-9,457,353739,10,353729
52549,8,11,285,974430,8,974422
52550,16,4,18,773377,16,773361
52551,8,-18,214,67047,8,67039
52552,13,-13,890,247685,13,247672
52553,5,-3,553,542935,5,542930
52554,6,-12,513,260759,6,260753
52555,11,-11,974,311340,11,311329
52556,9,2,353,696308,9,696299
52557,12,-14,461,213075,12,213063
52558,14,-14,77,209915,14,209901
52559,14,-20,489,26458,14,26444
52560,15,19,496,1244854,15,1244839
52561,8,-13,458,227905,8,227897
52562,15,7,310,869269,15,869254
52563,13,-20,528,26799,13,26786
52564,15,13,452,1056604,15,1056589
52565,18,9,802,934987,18,934969
52566,17,-16,15,146878,17,146861
52567,11,-11,537,308058,11,308047
52568,16,-19,839,60466,16,60450
52569,20,-4,604,526626,20,526606
52570,14,7,746,872424,14,872410
52571,18,-5,894,497602,18,497584
52572,11,13,852,1059602,11,1059591
52573,8,-2,926,582654,8,582646
52574,15,12,20,1022244,15,1022229
52575,7,5,403,789839,7,789832
52576,11,-14,162,210549,11,210538
52577,6,10,361,945176,6,945170
52578,10,13,136,1033589,10,1033579
52579,14,-14,136,210384,14,210370
52580,14,4,723,778580,14,778566
52581,11,16,248,1148883,11,1148872
52582,5,16,65,1126559,5,1126554
52583,12,11,30,991092,12,991080
52584,13,-12,388,275355,13,275342
52585,13,-17,882,122052,13,122039
52586,18,-11,62,304163,18,304145
52587,18,19,264,1242863,18,1242845
52588,16,16,150,1148151,16,1148135
52589,16,8,571,902451,16,902435
52590,18,1,740,685626,18,685608
52591,6,-18,927,82606,6,82600
52592,18,8,83,898541,18,898523
52593,14,0,221,649903,14,649889
52594,8,4,440,760106,8,760098
52595,5,-13,216,222940,5,222935
52596,11,-11,263,305812,11,305801
52597,6,3,848,737132,6,737126
52598,13,-14,729,215180,13,215167
52599,14,-14,938,216795,14,216781
52600,10,18,857,1204867,10,1204857
52601,15,1,809,686155,15,686140
52602,9,8,956,895925,9,895916
52603,6,17,276,1161228,6,1161222
52604,16,4,146,774309,16,774293
52605,8,13,658,1044977,8,1044969
52606,19,5,36,804030,19,804011
52607,10,6,925,833017,10,833007
52608,11,6,589,840522,11,840511
52609,19,-20,910,29790,19,29771
52610,18,-13,589,245385,18,245367
52611,20,-3,829,560418,20,560398
52612,6,3,909,738453,6,738447
52613,20,2,62,710996,20,710976
52614,8,-10,48,313655,8,313647
52615,17,5,150,804878,17,804861
52616,6,-1,999,615469,6,615463
52617,20,-12,636,277168,20,277148
52618,18,-12,446,275725,18,275707
52619,18,3,187,743297,18,743279
52620,7,-11,362,289145,7,289138
52621,17,5,85,804425,17,804408
52622,10,5,367,789198,10,789188
52623,9,15,189,1098510,9,1098501
52624,12,-15,589,182105,12,182093
52625,17,7,241,868745,17,868728
52626,13,9,576,933303,13,933290
52627,8,5,628,794699,8,794691
52628,8,15,679,1108875,8,1108867
52629,17,9,177,930384,17,930367
52630,17,1,825,686240,17,686223
52631,7,-12,384,257917,7,257910
52632,6,-15,46,156291,6,156285
52633,20,9,922,935967,20,935947
52634,13,4,162,774441,13,774428
52635,5,-8,943,395515,5,395510
52636,20,-7,818,434252,20,434232
52637,20,19,735,1246764,20,1246744
52638,12,6,22,835994,12,835982
52639,11,18,165,1210286,11,1210275
52640,5,-17,526,104763,5,104758
52641,7,-6,815,454351,7,454344
52642,7,-7,705,420811,7,420804
52643,19,-9,432,369987,19,369968
52644,15,-4,598,526575,15,526560
52645,10,3,546,730296,10,730286
52646,13,-13,612,245596,13,245583
52647,12,8,993,905675,12,905663
52648,20,13,159,1054380,20,1054360
52649,5,14,618,1075642,5,1075637
52650,9,4,8,750717,9,750708
52651,15,1,150,681063,15,681048
52652,17,-11,820,310094,17,310077
52653,9,-16,338,131188,9,131179
52654,11,0,326,650465,11,650454
52655,19,4,789,779051,19,779032
52656,13,18,382,1211873,13,1211860
52657,15,4,3,773337,15,773322
52658,5,16,861,1142984,5,1142979
52659,8,4,14,750791,8,750783
52660,10,-12,539,261316,10,261306
52661,11,6,833,842474,11,842463
52662,6,7,21,845200,6,845194
52663,20,16,902,1153531,20,1153511
52664,16,-5,835,497084,16,497068
52665,14,-19,322,56492,14,56478
52666,12,-16,399,149798,12,149786
52667,11,-12,915,279442,11,279431
52668,8,5,304,787891,8,787883
52669,14,-9,514,370718,14,370704
52670,6,-9,262,349357,6,349351
52671,18,-15,714,183094,18,183076
52672,18,18,73,1209525,18,1209507
52673,9,0,107,627795,9,627786
52674,16,7,345,869541,16,869525
52675,7,11,631,981914,7,981907
52676,6,-5,993,489590,6,489584
52677,15,11,369,993566,15,993551
52678,18,14,447,1088940,18,1088922
52679,19,-11,45,303964,19,303945
52680,19,-7,264,430268,19,430249
52681,14,-16,487,150596,14,150582
52682,11,1,402,683052,11,683041
52683,14,-12,301,274760,14,274746
52684,16,-4,558,526314,16,526298
52685,6,-8,632,388909,6,388903
52686,19,-4,898,528819,19,528800
52687,18,-10,740,340655,18,340637
52688,13,4,600,777665,13,777652
52689,17,-15,520,181581,17,181564
52690,20,12,723,1027489,20,1027469
52691,9,-4,765,515769,9,515760
52692,17,6,119,836684,17,836667
52693,11,2,545,714711,11,714700
52694,5,-8,40,376211,5,376206
52695,12,-9,966,374131,12,374119
52696,12,4,841,779525,12,779513
52697,6,13,359,1038488,6,1038482
52698,17,-12,874,279033,17,279016
52699,6,-5,109,470528,6,470522
52700,20,-18,234,87166,20,87146
52701,8,-4,734,515172,8,515164
52702,14,10,58,960278,14,960264
52703,9,13,565,1042927,9,1042918
52704,14,-20,998,30436,14,30422
52705,18,19,52,1241150,18,1241132
52706,8,0,509,636346,8,636338
52707,17,6,723,841636,17,841619
52708,11,-1,534,620813,11,620802
52709,8,-7,512,416820,8,416812
52710,8,-13,664,232405,8,232397
52711,12,-16,919,153685,12,153673
52712,14,-15,218,179295,14,179281
52713,13,-12,404,275466,13,275453
52714,18,8,279,900171,18,900153
52715,8,-9,498,354962,8,354954
52716,12,2,533,714632,12,714620
52717,20,-18,736,90646,20,90626
52718,17,3,123,742782,17,742765
52719,19,-6,153,460306,19,460287
52720,5,2,655,702443,5,702438
52721,6,2,80,690282,6,690276
52722,19,-20,303,25176,19,25157
52723,19,4,147,774340,19,774321
52724,6,10,716,952957,6,952951
52725,5,17,792,1172254,5,1172249
52726,15,12,365,1024776,15,1024761
52727,12,-1,265,618627,12,618615
52728,6,-5,537,479686,6,479680
52729,18,-10,675,340203,18,340185
52730,19,-10,227,336751,19,336732
52731,13,13,333,1055694,13,1055681
52732,11,-13,892,247701,11,247690
52733,12,13,394,1056141,12,1056129
52734,19,-6,888,465847,19,465828
52735,10,5,942,801516,10,801506
52736,11,-9,55,367063,11,367052
52737,16,17,408,1180934,16,1180918
52738,16,14,71,1086007,16,1085991
52739,10,3,48,719850,10,719840
52740,10,-6,441,446145,10,446135
52741,13,-2,260,587089,13,587076
52742,10,11,325,975375,10,975365
52743,6,-8,804,392520,6,392514
52744,5,11,304,974891,5,974886
52745,15,2,521,714579,15,714564
52746,5,8,518,886620,5,886615
52747,17,-5,452,494331,17,494314
52748,9,-16,522,135395,9,135386
52749,6,-1,939,614235,6,614229
52750,19,13,883,1059846,19,1059827
52751,9,-14,552,198439,9,198430
52752,14,7,447,870376,14,870362
52753,20,18,60,1209413,20,1209393
52754,17,-20,562,27089,17,27072
52755,8,17,700,1170259,8,1170251
52756,7,0,715,641042,7,641035
52757,6,13,670,1045228,6,1045222
52758,20,-3,859,560653,20,560633
52759,19,10,265,961826,19,961807
52760,12,-10,788,340981,12,340969
52761,20,8,415,901293,20,901273
52762,5,-11,60,282407,5,282402
52763,6,12,149,1002350,6,1002344
52764,18,0,652,653260,18,653242
52765,13,6,83,836356,13,836343
52766,7,10,845,955662,7,955655
52767,16,-1,902,623462,16,623446
52768,14,19,891,1248009,14,1247995
52769,11,12,335,1024589,11,1024578
52770,18,-20,289,25050,18,25032
52771,18,7,947,873750,18,873732
52772,9,6,169,815847,9,815838
52773,17,18,596,1213202,17,1213185
52774,12,-1,114,617421,12,617409
52775,18,12,144,1023071,18,1023053
52776,8,-19,597,44617,8,44609
52777,12,-20,127,23723,12,23711
52778,9,8,427,884543,9,884534
52779,12,-5,585,495365,12,495353
52780,13,-8,174,399155,13,399142
52781,15,16,889,1153408,15,1153393
52782,19,-12,990,280032,19,280013
52783,10,0,123,628120,10,628110
52784,18,7,282,869039,18,869021
52785,18,17,635,1182574,18,1182556
52786,9,6,405,821559,9,821550
52787,12,6,461,839457,12,839445
52788,13,-20,770,28740,13,28727
52789,7,2,55,689789,7,689782
52790,10,14,668,1076941,10,1076931
52791,11,-7,574,432621,11,432610
52792,14,-17,453,118848,14,118834
52793,14,-11,585,308401,14,308387
52794,9,6,656,827098,9,827089
52795,20,3,147,742945,20,742925
52796,16,19,969,1248537,16,1248521
52797,18,11,189,992156,18,992138
52798,10,0,710,640887,10,640877
52799,18,18,999,1216313,18,1216295
52800,5,15,163,1097910,5,1097905
52801,17,17,779,1183681,17,1183664
52802,7,17,259,1160757,7,1160750
52803,8,-5,124,470793,8,470785
52804,10,10,373,945424,10,945414
52805,19,-15,6,177868,19,177849
52806,18,4,93,773956,18,773938
52807,8,2,540,700081,8,700073
52808,13,19,408,1244147,13,1244134
52809,7,5,191,785672,7,785665
52810,8,16,587,1137509,8,1137501
52811,6,6,401,821410,6,821404
52812,14,-14,448,212988,14,212974
52813,9,-6,342,444160,9,444151
52814,9,0,284,631418,9,631409
52815,12,5,512,807514,12,807502
52816,5,-8,34,376086,5,376081
52817,17,13,739,1058736,17,1058719
52818,18,9,499,932690,18,932672
52819,18,-12,391,275386,18,275368
52820,14,15,470,1120104,14,1120090
52821,19,0,229,649954,19,649935
52822,12,4,620,777791,12,777779
52823,14,-10,57,335593,14,335579
52824,17,-12,346,275109,17,275092
52825,20,2,30,710699,20,710679
52826,9,19,911,1237774,9,1237765
52827,16,0,174,649555,16,649539
52828,16,11,451,994119,16,994103
52829,19,13,568,1057524,19,1057505
52830,10,-2,113,565298,10,565288
52831,11,4,431,776368,11,776357
52832,13,-5,631,495666,13,495653
52833,8,-1,693,608811,8,608803
52834,9,-18,268,68342,9,68333
52835,7,18,576,1199012,7,1199005
52836,10,1,614,670641,10,670631
52837,9,0,307,631852,9,631843
52838,17,-7,18,428430,17,428413
52839,15,-11,474,307533,15,307518
52840,17,-8,129,398786,17,398769
52841,8,3,513,729716,8,729708
52842,7,11,91,970387,7,970380
52843,13,-18,563,89336,13,89323
52844,6,-20,189,4450,6,4444
52845,13,-2,222,586813,13,586800
52846,16,17,426,1181091,16,1181075
52847,17,4,424,776314,17,776297
52848,19,19,918,1248184,19,1248165
52849,8,13,798,1047897,8,1047889
52850,7,-4,744,515335,7,515328
52851,7,-8,125,378008,7,378001
52852,17,-18,701,90316,17,90299
52853,11,-1,635,621455,11,621444
52854,14,-11,311,306270,14,306256
52855,13,4,614,777753,13,777740
52856,14,13,128,1054153,14,1054139
52857,15,19,660,1246128,15,1246113
52858,18,14,763,1091449,18,1091431
52859,5,-4,172,503150,5,503145
52860,9,7,924,864356,9,864347
52861,9,-3,192,534497,9,534488
52862,9,10,464,947479,9,947470
52863,11,-11,519,307868,11,307857
52864,10,-16,107,126376,10,126366
52865,14,-3,445,557182,14,557168
52866,19,-17,97,116309,19,116290
52867,12,0,211,649839,12,649827
52868,20,-2,45,585495,20,585475
52869,13,6,835,842492,13,842479
52870,9,-19,842,49990,9,49981
52871,18,-11,103,304503,18,304485
52872,5,-10,874,331310,5,331305
52873,9,14,547,1074051,9,1074042
52874,13,5,636,808449,13,808436
52875,14,8,281,900205,14,900191
52876,12,-3,976,561589,12,561577
52877,18,-4,767,527781,18,527763
52878,16,-19,609,58790,16,58774
52879,5,-3,280,536426,5,536421
52880,7,-7,856,424016,7,424009
52881,13,7,288,869088,13,869075
52882,11,-14,128,210270,11,210259
52883,9,15,213,1099015,9,1099006
52884,16,3,180,743228,16,743212
52885,6,-4,786,516212,6,516206
52886,20,11,786,996527,20,996507
52887,20,10,382,962691,20,962671
52888,5,12,944,1019938,5,1019933
52889,20,10,511,963795,20,963775
52890,8,-13,767,234948,8,234940
52891,5,5,59,782924,5,782919
52892,6,-3,941,551576,6,551570
52893,10,-3,603,543937,10,543927
52894,17,-12,173,273782,17,273765
52895,16,4,46,773582,16,773566
52896,5,2,330,695751,5,695746
52897,5,17,135,1158101,5,1158096
52898,7,-8,662,389624,7,389617
52899,5,-5,911,487882,5,487877
52900,14,15,988,1124046,14,1124032
52901,9,-12,217,254199,9,254190
52902,13,18,10,1208987,13,1208974
52903,12,-11,769,309727,12,309715
52904,7,14,438,1071615,7,1071608
52905,19,-18,448,88630,19,88611
52906,15,-1,893,623401,15,623386
52907,13,10,149,961009,13,960996
52908,12,-9,193,367920,12,367908
52909,10,-13,474,228321,10,228311
52910,18,17,458,1181373,18,1181355
52911,12,9,944,936123,12,936111
52912,12,7,158,868183,12,868171
52913,16,3,667,746873,16,746857
52914,15,-6,901,465963,15,465948
52915,17,5,445,807018,17,807001
52916,20,5,653,808536,20,808516
52917,15,17,37,1178147,15,1178132
52918,17,-11,173,305119,17,305102
52919,7,4,528,762031,7,762024
52920,15,16,419,1150159,15,1150144
52921,11,-2,609,589711,11,589700
52922,12,-17,754,121236,12,121224
52923,16,-19,107,54799,16,54783
52924,8,-11,545,293322,8,293314
52925,17,18,105,1209810,17,1209793
52926,10,-2,162,566194,10,566184
52927,20,-11,370,306733,20,306713
52928,10,-16,200,128381,10,128371
52929,6,13,630,1044363,6,1044357
52930,14,-6,877,465728,14,465714
52931,18,-9,909,373798,18,373780
52932,17,17,446,1181259,17,1181242
52933,19,14,894,1092473,19,1092454
52934,5,2,500,699276,5,699271
52935,14,-11,458,307428,14,307414
52936,13,0,93,648951,13,648938
52937,12,11,761,996352,12,996340
52938,16,-15,750,183357,16,183341
52939,9,-20,822,18277,9,18268
52940,11,15,148,1117912,11,1117901
52941,9,-9,611,357254,9,357245
52942,15,-3,300,555992,15,555977
52943,15,16,164,1148252,15,1148237
52944,18,-8,807,403660,18,403642
52945,5,17,2,1155324,5,1155319
52946,19,-3,173,555000,19,554981
52947,5,8,197,879415,5,879410
52948,19,1,81,680394,19,680375
52949,16,8,240,899930,16,899914
52950,6,3,655,732945,6,732939
52951,19,17,56,1178325,19,1178306
52952,6,-19,754,48143,6,48137
52953,8,0,768,642215,8,642207
52954,7,-3,468,540935,7,540928
52955,10,3,1000,740809,10,740799
52956,14,11,642,995409,14,995395
52957,15,19,911,1248162,15,1248147
52958,10,-16,510,135147,10,135137
52959,8,19,935,1238161,8,1238153
52960,8,1,1,657002,8,656994
52961,15,3,566,746036,15,746021
52962,18,-1,165,617795,18,617777
52963,16,3,386,744787,16,744771
52964,8,-3,87,532271,8,532263
52965,15,6,663,841095,15,841080
52966,12,-11,829,310179,12,310167
52967,17,-6,412,462290,17,462273
52968,16,-15,707,183027,16,183011
52969,15,-9,640,371604,15,371589
52970,18,-16,248,148782,18,148764
52971,10,13,621,1044148,10,1044138
52972,18,-5,9,490825,18,490807
52973,17,-16,608,151494,17,151477
52974,15,-20,5,3195,15,3180
52975,19,10,69,960355,19,960336
52976,15,-11,320,306314,15,306299
52977,6,-9,231,348539,6,348533
52978,15,-5,285,493153,15,493138
52979,5,9,108,909056,5,909051
52980,8,-2,993,583993,8,583985
52981,12,-4,348,524833,12,524821
52982,10,-3,989,552585,10,552575
52983,9,-13,149,221537,9,221528
52984,16,-2,429,588362,16,588346
52985,18,-8,562,401808,18,401790
52986,20,12,362,1024747,20,1024727
52987,18,6,184,837139,18,837121
52988,9,14,107,1064256,9,1064247
52989,7,17,714,1170511,7,1170504
52990,10,-14,535,198093,10,198083
52991,15,9,576,933308,15,933293
52992,13,19,825,1247436,13,1247423
52993,7,1,138,660231,7,660224
52994,10,-15,47,156340,10,156330
52995,18,5,53,804218,18,804200
52996,13,-18,486,88896,13,88883
52997,17,13,941,1060229,17,1060212
52998,18,-20,839,29316,18,29298
52999,13,6,943,843272,13,843259
53000,12,-3,453,557271,12,557259
53001,7,-3,818,548705,7,548698
53002,13,-8,591,401977,13,401964
53003,17,11,795,996648,17,996631
53004,9,-17,873,111943,9,111934
53005,17,10,567,964254,17,964237
53006,16,-4,979,529454,16,529438
53007,9,7,946,864768,9,864759
53008,9,-3,913,550904,9,550895
53009,17,14,275,1087559,17,1087542
53010,7,2,590,701013,7,701006
53011,5,-18,945,82923,5,82918
53012,15,-14,758,215413,15,215398
53013,7,-13,508,229105,7,229098
53014,11,7,751,872445,11,872434
53015,19,13,678,1058329,19,1058310
53016,18,-14,220,211070,18,211052
53017,8,-5,107,470489,8,470481
53018,9,-19,775,48574,9,48565
53019,19,9,665,933972,19,933953
53020,19,6,566,840362,19,840343
53021,15,1,933,687167,15,687152
53022,11,-6,168,460426,11,460415
53023,13,-12,764,278137,13,278124
53024,10,6,241,817592,10,817582
53025,17,-5,804,496832,17,496815
53026,16,-8,662,402589,16,402573
53027,9,-13,748,234369,9,234360
53028,8,9,422,915541,8,915533
53029,12,18,122,1209911,12,1209899
53030,9,13,346,1038233,9,1038224
53031,19,6,753,841815,19,841796
53032,5,-4,50,500374,5,500369
53033,17,3,76,742402,17,742385
53034,10,12,491,1009677,10,1009667
53035,19,19,341,1243507,19,1243488
53036,11,-2,490,588849,11,588838
53037,8,14,416,1071134,8,1071126
53038,7,-4,348,507196,7,507189
53039,12,18,430,1212204,12,1212192
53040,18,-5,379,493831,18,493813
53041,11,-3,586,558420,11,558409
53042,8,-4,132,502287,8,502279
53043,15,-4,982,529482,15,529467
53044,7,-7,527,417130,7,417123
53045,11,-13,652,245790,11,245779
53046,20,-3,38,554088,20,554068
53047,5,-2,189,566812,5,566807
53048,19,9,524,932896,19,932877
53049,15,-9,662,371713,15,371698
53050,9,6,757,829346,9,829337
53051,10,14,347,1069454,10,1069444
53052,6,-4,203,503928,6,503922
53053,5,4,194,754794,5,754789
53054,10,-20,346,7625,10,7615
53055,7,-13,270,224197,7,224190
53056,18,-1,997,624136,18,624118
53057,6,1,471,667486,6,667480
53058,6,-5,40,468743,6,468737
53059,6,19,607,1231092,6,1231086
53060,16,1,952,687302,16,687286
53061,18,14,686,1090868,18,1090850
53062,18,-5,687,496039,18,496021
53063,20,1,837,686314,20,686294
53064,19,-1,72,617137,19,617118
53065,10,11,78,970139,10,970129
53066,16,7,620,871565,16,871549
53067,14,18,680,1213860,14,1213846
53068,13,-15,29,178026,13,178013
53069,18,-12,135,273558,18,273540
53070,12,10,43,960172,12,960160
53071,14,-15,930,184863,14,184849
53072,15,-20,400,25844,15,25829
53073,8,-1,323,601042,8,601034
53074,7,-4,862,517838,7,517831
53075,14,0,997,655921,14,655907
53076,6,1,959,677890,6,677884
53077,20,2,703,715925,20,715905
53078,6,-10,935,332537,6,332531
53079,11,-1,289,618864,11,618853
53080,12,-14,752,215344,12,215332
53081,17,-14,74,209888,17,209871
53082,13,10,889,966606,13,966593
53083,11,2,174,711910,11,711899
53084,13,11,833,996856,13,996843
53085,12,18,606,1213263,12,1213251
53086,9,2,104,690877,9,690868
53087,9,-10,708,327885,9,327876
53088,17,13,93,1053914,17,1053897
53089,9,-16,622,137536,9,137527
53090,8,-5,875,487095,8,487087
53091,20,-1,839,622988,20,622968
53092,10,-9,693,358838,10,358828
53093,20,10,617,964693,20,964673
53094,12,-3,287,555831,12,555819
53095,5,7,484,855219,5,855214
53096,12,11,959,997711,12,997699
53097,10,2,572,700675,10,700665
53098,15,15,880,1123195,15,1123180
53099,18,15,853,1122999,18,1122981
53100,13,16,335,1149535,13,1149522
53101,14,13,103,1053988,14,1053974
53102,20,-3,935,561284,20,561264
53103,11,-10,611,339647,11,339636
53104,9,-5,799,485138,9,485129
53105,9,-17,326,100504,9,100495
53106,9,-3,369,538477,9,538468
53107,12,17,263,1179871,12,1179859
53108,12,-7,921,435133,12,435121
53109,13,-8,975,404843,13,404830
53110,17,-17,702,120771,17,120754
53111,12,7,622,871572,12,871560
53112,12,-5,830,497039,12,497027
53113,18,-17,384,118338,18,118320
53114,10,4,442,760152,10,760142
53115,11,16,633,1151627,11,1151616
53116,12,14,44,1085755,12,1085743
53117,7,6,711,828457,7,828450
53118,18,9,891,935656,18,935638
53119,9,-19,493,42092,9,42083
53120,20,2,213,712203,20,712183
53121,14,7,113,867840,14,867826
53122,14,6,161,836965,14,836951
53123,20,-1,356,619480,20,619460
53124,14,-19,94,54647,14,54633
53125,18,6,746,841773,18,841755
53126,12,4,973,780375,12,780363
53127,15,-12,827,278593,15,278578
53128,18,-15,884,184460,18,184442
53129,7,15,85,1096280,7,1096273
53130,9,0,449,635133,9,635124
53131,9,-8,821,392939,9,392930
53132,6,-16,690,138804,6,138798
53133,19,-13,841,247307,19,247288
53134,5,-20,292,6520,5,6515
53135,17,2,388,713528,17,713511
53136,5,-2,545,574287,5,574282
53137,13,6,837,842512,13,842499
53138,16,-7,668,433109,16,433093
53139,9,-1,434,603451,9,603442
53140,11,13,805,1059305,11,1059294
53141,20,-7,842,434448,20,434428
53142,13,-9,889,373635,13,373622
53143,7,12,838,1017340,7,1017333
53144,20,19,419,1244303,20,1244283
53145,20,-5,115,491815,20,491795
53146,8,8,930,895376,8,895368
53147,7,2,54,689757,7,689750
53148,17,4,246,775046,17,775029
53149,9,-7,475,415999,9,415990
53150,15,0,847,654678,15,654663
53151,19,-13,742,246515,19,246496
53152,5,1,348,664803,5,664798
53153,12,7,3,867050,12,867038
53154,6,10,85,939357,6,939351
53155,16,12,235,1023776,16,1023760
53156,16,0,749,654048,16,654032
53157,11,-16,754,152465,11,152454
53158,8,-8,530,386512,8,386504
53159,18,-18,418,88413,18,88395
53160,18,19,595,1245633,18,1245615
53161,18,-1,738,622277,18,622259
53162,15,12,715,1027417,15,1027402
53163,19,-17,257,117374,19,117355
53164,11,19,153,1241982,11,1241971
53165,10,4,417,759652,10,759642
53166,10,12,402,1007760,10,1007750
53167,15,-20,247,24654,15,24639
53168,14,7,798,872768,14,872754
53169,16,-14,663,214696,16,214680
53170,14,18,630,1213465,14,1213451
53171,6,-20,708,15639,6,15633
53172,17,16,234,1148776,17,1148759
53173,6,-7,433,415191,6,415185
53174,18,-15,281,179805,18,179787
53175,10,0,191,629657,10,629647
53176,11,16,319,1149428,11,1149417
53177,9,-3,912,550878,9,550869
53178,15,-8,147,398966,15,398951
53179,20,-2,125,586055,20,586035
53180,12,-12,373,275292,12,275280
53181,17,12,253,1023924,17,1023907
53182,5,11,326,975393,5,975388
53183,5,15,716,1109744,5,1109739
53184,16,-8,93,398612,16,398596
53185,11,-3,29,554013,11,554002
53186,14,5,969,810937,14,810923
53187,5,-8,887,394291,5,394286
53188,13,-13,255,242916,13,242903
53189,18,5,199,805342,18,805324
53190,8,19,850,1236380,8,1236372
53191,18,4,921,780062,18,780044
53192,17,-4,675,527173,17,527156
53193,9,10,896,956750,9,956741
53194,19,5,268,805825,19,805806
53195,7,8,580,887916,7,887909
53196,6,8,116,877536,6,877530
53197,14,12,979,1029661,14,1029647
53198,12,6,457,839424,12,839412
53199,9,-13,685,232789,9,232780
53200,5,-5,995,489620,5,489615
53201,11,-3,384,556643,11,556632
53202,8,14,824,1080403,8,1080395
53203,6,-17,976,114036,6,114030
53204,11,0,253,650074,11,650063
53205,18,12,37,1022375,18,1022357
53206,13,6,566,840365,13,840352
53207,6,1,991,678530,6,678524
53208,5,-14,63,187889,5,187884
53209,5,8,766,892057,5,892052
53210,13,-12,39,272769,13,272756
53211,17,1,218,681616,17,681599
53212,8,14,343,1069393,8,1069385
53213,14,13,147,1054291,14,1054277
53214,20,-19,257,56016,20,55996
53215,7,-12,509,260688,7,260681
53216,17,5,786,809496,17,809479
53217,6,13,185,1034631,6,1034625
53218,16,-12,24,272678,16,272662
53219,8,-14,639,200814,8,200806
53220,20,-3,523,557897,20,557877
53221,6,-7,776,422327,6,422321
53222,17,3,53,742240,17,742223
53223,8,-18,502,73277,8,73269
53224,6,14,134,1064863,6,1064857
53225,10,13,224,1035543,10,1035533
53226,20,8,832,904425,20,904405
53227,10,-10,600,325603,10,325593
53228,6,-3,483,541306,6,541300
53229,16,14,894,1092479,16,1092463
53230,12,2,57,710960,12,710948
53231,9,2,924,707828,9,707819
53232,6,-4,481,509786,6,509780
53233,7,4,776,767545,7,767538
53234,11,-10,394,337902,11,337891
53235,6,2,354,696351,6,696345
53236,6,-2,308,569407,6,569401
53237,15,-13,615,245617,15,245602
53238,6,-4,488,509935,6,509929
53239,9,9,385,914803,9,914794
53240,7,-14,95,188632,7,188625
53241,19,-5,130,491955,19,491936
53242,15,5,711,808973,15,808958
53243,12,-13,471,244461,12,244449
53244,6,15,456,1104086,6,1104080
53245,5,17,466,1165297,5,1165292
53246,8,-14,407,195703,8,195695
53247,11,-10,835,341368,11,341357
53248,5,17,512,1166312,5,1166307
53249,12,-6,959,466393,12,466381
53250,8,-5,160,471572,8,471564
53251,15,-6,626,463944,15,463929
53252,15,-10,524,338919,15,338904
53253,16,1,210,681557,16,681541
53254,6,-8,631,388818,6,388812
53255,6,-17,643,107312,6,107306
53256,19,-16,840,153044,19,153025
53257,9,6,63,813513,9,813504
53258,11,-9,146,367619,11,367608
53259,18,-16,623,151629,18,151611
53260,5,16,115,1127494,5,1127489
53261,9,-17,863,111711,9,111702
53262,10,-5,382,476394,10,476384
53263,18,18,638,1213581,18,1213563
53264,20,-2,277,587223,20,587203
53265,17,19,763,1246941,17,1246924
53266,10,-11,247,286435,10,286425
53267,7,5,944,801574,7,801567
53268,19,-15,790,183629,19,183610
53269,16,-5,683,495982,16,495966
53270,8,8,614,888583,8,888575
53271,6,-9,693,358844,6,358838
53272,20,-7,508,432145,20,432125
53273,15,9,121,929944,15,929929
53274,9,-14,760,203270,9,203261
53275,15,-4,719,527466,15,527451
53276,12,-10,199,336540,12,336528
53277,12,13,98,1053947,12,1053935
53278,5,-20,918,20307,5,20302
53279,10,18,505,1197528,10,1197518
53280,19,-3,27,554013,19,553994
53281,17,10,354,962479,17,962462
53282,12,-15,842,184076,12,184064
53283,20,5,347,806332,20,806312
53284,13,12,473,1025523,13,1025510
53285,20,15,439,1119893,20,1119873
53286,7,-3,817,548699,7,548692
53287,11,-20,437,26120,11,26109
53288,14,-7,92,428936,14,428922
53289,19,14,488,1089245,19,1089226
53290,5,-11,471,291644,5,291639
53291,8,-12,116,252070,8,252062
53292,19,-1,705,621995,19,621976
53293,8,14,886,1081729,8,1081721
53294,18,-3,911,561095,18,561077
53295,12,16,419,1150161,12,1150149
53296,16,14,42,1085745,16,1085729
53297,10,-2,807,580033,10,580023
53298,5,-9,178,347353,5,347348
53299,8,13,517,1041831,8,1041823
53300,10,14,198,1066106,10,1066096
53301,20,15,882,1123210,20,1123190
53302,8,5,919,800913,8,800905
53303,9,-1,316,600952,9,600943
53304,5,-16,270,129892,5,129887
53305,15,11,353,993444,15,993429
53306,12,-9,981,374164,12,374152
53307,7,8,18,875546,7,875539
53308,7,17,784,1172011,7,1172004
53309,19,15,723,1122143,19,1122124
53310,18,6,596,840608,18,840590
53311,8,7,800,861731,8,861723
53312,9,-13,28,218992,9,218983
53313,10,17,732,1170915,10,1170905
53314,20,-12,978,279932,20,279912
53315,15,-4,205,523707,15,523692
53316,12,-20,624,27508,12,27496
53317,17,5,797,809570,17,809553
53318,19,11,142,991867,19,991848
53319,11,18,995,1216269,11,1216258
53320,19,-18,869,91526,19,91507
53321,5,17,977,1176328,5,1176323
53322,14,3,703,747181,14,747167
53323,7,-4,516,510675,7,510668
53324,6,-8,522,386325,6,386319
53325,5,7,28,845354,5,845349
53326,6,-6,794,453826,6,453820
53327,5,-7,547,417633,5,417628
53328,18,-17,769,121350,18,121332
53329,10,-3,581,543540,10,543530
53330,9,-4,923,519165,9,519156
53331,10,3,540,730171,10,730161
53332,17,14,65,1085987,17,1085970
53333,11,-18,590,89522,11,89511
53334,6,-17,517,104656,6,104650
53335,5,19,143,1220630,5,1220625
53336,15,7,134,868001,15,867986
53337,20,-12,53,272902,20,272882
53338,5,-16,90,125946,5,125941
53339,18,-2,83,585766,18,585748
53340,17,-15,360,180397,17,180380
53341,9,19,135,1220380,9,1220371
53342,16,-3,340,556303,16,556287
53343,19,19,959,1248487,19,1248468
53344,8,6,297,818938,8,818930
53345,20,17,291,1180138,20,1180118
53346,6,-7,344,413340,6,413334
53347,15,2,711,715953,15,715938
53348,11,-11,882,310643,11,310632
53349,7,-17,743,109466,7,109459
53350,20,-8,772,403360,20,403340
53351,19,17,409,1180955,19,1180936
53352,6,7,401,853482,6,853476
53353,10,9,894,925709,10,925699
53354,5,-20,931,20519,5,20514
53355,9,10,773,954144,9,954135
53356,19,16,963,1154003,19,1153984
53357,20,-7,782,433992,20,433972
53358,8,-18,214,67055,8,67047
53359,18,-7,553,432485,18,432467
53360,19,16,85,1147677,19,1147658
53361,19,-15,865,184334,19,184315
53362,18,-4,740,527613,18,527595
53363,16,-7,564,432569,16,432553
53364,17,13,997,1060616,17,1060599
53365,18,-12,545,276560,18,276542
53366,17,-17,511,119343,17,119326
53367,15,-6,200,460699,15,460684
53368,5,3,9,719014,5,719009
53369,5,4,557,762609,5,762604
53370,5,17,461,1165198,5,1165193
53371,20,13,534,1057189,20,1057169
53372,17,-9,218,368094,17,368077
53373,6,-7,460,415673,6,415667
53374,17,15,324,1119159,17,1119142
53375,8,16,412,1134094,8,1134086
53376,10,11,777,985104,10,985094
53377,10,-19,560,43677,10,43667
53378,11,9,160,930251,11,930240
53379,14,-17,480,119046,14,119032
53380,11,13,884,1059856,11,1059845
53381,17,-18,228,87093,17,87076
53382,6,-1,777,610599,6,610593
53383,15,-19,604,58757,15,58742
53384,15,-17,78,116103,15,116088
53385,13,-9,435,370017,13,370004
53386,8,8,889,894422,8,894414
53387,20,-13,677,245914,20,245894
53388,19,17,934,1184891,19,1184872
53389,11,17,792,1183828,11,1183817
53390,9,-6,329,443904,9,443895
53391,19,-4,345,524787,19,524768
53392,18,-3,373,556555,18,556537
53393,7,-5,165,471725,7,471718
53394,11,0,140,649286,11,649275
53395,8,17,377,1163398,8,1163390
53396,11,2,942,717472,11,717461
53397,14,13,422,1056382,14,1056368
53398,15,0,342,650647,15,650632
53399,14,15,297,1119006,14,1118992
53400,14,-13,913,247900,14,247886
53401,13,-14,666,214729,13,214716
53402,8,-12,38,250339,8,250331
53403,16,-8,472,401121,16,401105
53404,19,18,826,1214946,19,1214927
53405,5,-16,957,144583,5,144578
53406,18,-4,906,528880,18,528862
53407,9,-15,245,160622,9,160613
53408,16,-12,410,275523,16,275507
53409,20,-10,335,337481,20,337461
53410,14,-10,229,336761,14,336747
53411,20,-3,924,561194,20,561174
53412,13,19,957,1248474,13,1248461
53413,10,-6,495,447506,10,447496
53414,20,8,35,898136,20,898116
53415,17,0,361,650773,17,650756
53416,6,-17,450,103018,6,103012
53417,17,-15,547,181810,17,181793
53418,14,-12,691,277588,14,277574
53419,16,-4,902,528858,16,528842
53420,19,-4,89,522737,19,522718
53421,19,-18,768,90842,19,90823
53422,15,-1,887,623368,15,623353
53423,19,9,126,930009,19,929990
53424,8,-17,364,101289,8,101281
53425,15,3,75,742396,15,742381
53426,8,18,935,1206502,8,1206494
53427,11,-10,263,337025,11,337014
53428,8,-17,377,101580,8,101572
53429,9,7,211,849232,9,849223
53430,12,-9,194,367921,12,367909
53431,19,11,793,996604,19,996585
53432,9,6,703,828276,9,828267
53433,6,-13,327,225301,6,225295
53434,16,-17,98,116341,16,116325
53435,14,19,70,1241317,14,1241303
53436,13,16,155,1148181,13,1148168
53437,18,2,653,715478,18,715460
53438,6,5,750,797287,6,797281
53439,5,9,872,925210,5,925205
53440,7,13,396,1039286,7,1039279
53441,9,-6,351,444337,9,444328
53442,12,15,164,1118006,12,1117994
53443,12,12,221,1023688,12,1023676
53444,20,14,868,1092218,20,1092198
53445,5,10,297,943804,5,943799
53446,5,-7,301,412340,5,412335
53447,11,-18,623,89741,11,89730
53448,6,12,940,1019816,6,1019810
53449,9,2,605,701365,9,701356
53450,18,6,445,839319,18,839301
53451,18,-10,446,338342,18,338324
53452,17,16,894,1153452,17,1153435
53453,10,12,138,1002117,10,1002107
53454,17,-16,603,151452,17,151435
53455,15,15,909,1123403,15,1123388
53456,16,-13,781,246875,16,246859
53457,16,18,313,1211353,16,1211337
53458,8,-4,779,516082,8,516074
53459,10,-18,389,70774,10,70764
53460,9,-16,425,133186,9,133177
53461,18,-16,811,152863,18,152845
53462,15,17,413,1180999,15,1180984
53463,20,-16,710,152117,20,152097
53464,10,8,293,881603,10,881593
53465,15,14,259,1087448,15,1087433
53466,16,7,699,872136,16,872120
53467,6,-6,977,457628,6,457622
53468,10,3,905,738323,10,738313
53469,17,-14,655,214627,17,214610
53470,10,6,769,829579,10,829569
53471,7,-1,788,610803,7,610796
53472,8,-14,12,186709,8,186701
53473,10,-4,934,519423,10,519413
53474,11,7,145,868082,11,868071
53475,20,2,20,710617,20,710597
53476,14,-20,704,28210,14,28196
53477,19,19,344,1243529,19,1243510
53478,8,8,5,875265,8,875257
53479,8,-17,782,110173,8,110165
53480,16,18,612,1213341,16,1213325
53481,6,-18,880,81423,6,81417
53482,15,6,9,835804,15,835789
53483,5,-19,111,33963,5,33958
53484,19,-1,233,618420,19,618401
53485,16,1,26,679998,16,679982
53486,16,-15,477,181319,16,181303
53487,11,-11,461,307435,11,307424
53488,16,-11,548,308148,16,308132
53489,12,18,618,1213368,12,1213356
53490,16,16,643,1151735,16,1151719
53491,10,-15,247,160717,10,160707
53492,19,-13,251,242901,19,242882
53493,8,7,350,852355,8,852347
53494,8,6,987,834461,8,834453
53495,9,-18,946,82950,9,82941
53496,10,11,175,972057,10,972047
53497,5,-7,303,412385,5,412380
53498,9,17,336,1162592,9,1162583
53499,15,11,778,996482,15,996467
53500,14,6,407,839045,14,839031
53501,11,-14,123,210249,11,210238
53502,10,-1,917,613750,10,613740
53503,6,-9,385,352065,6,352059
53504,5,-19,822,49398,5,49393
53505,16,8,478,901694,16,901678
53506,11,5,477,807313,11,807302
53507,12,-14,936,216761,12,216749
53508,14,19,786,1247171,14,1247157
53509,20,-1,38,616881,20,616861
53510,13,-10,158,336251,13,336238
53511,19,-10,973,342433,19,342414
53512,11,-15,288,179874,11,179863
53513,11,11,68,991392,11,991381
53514,10,4,845,769255,10,769245
53515,5,-2,854,581075,5,581070
53516,17,-1,762,622401,17,622384
53517,10,-5,439,477480,10,477470
53518,16,-18,735,90620,16,90604
53519,15,18,769,1214537,15,1214522
53520,11,1,695,685253,11,685242
53521,12,0,125,649198,12,649186
53522,12,-8,49,398263,12,398251
53523,10,-15,529,166874,10,166864
53524,5,-1,335,601403,5,601398
53525,15,-10,700,340382,15,340367
53526,18,12,6,1022165,18,1022147
53527,19,8,118,898861,19,898842
53528,17,18,915,1215632,17,1215615
53529,9,-16,555,136086,9,136077
53530,14,-14,43,209651,14,209637
53531,7,-3,208,534843,7,534836
53532,20,-5,738,496453,20,496433
53533,5,3,506,729648,5,729643
53534,17,-16,887,153489,17,153472
53535,13,-20,255,24742,13,24729
53536,12,-18,469,88798,12,88786
53537,6,-18,458,72320,6,72314
53538,12,11,267,992762,12,992750
53539,9,19,553,1230005,9,1229996
53540,15,-3,421,556937,15,556922
53541,5,-9,329,350816,5,350811
53542,5,10,404,946171,5,946166
53543,20,-17,764,121294,20,121274
53544,11,0,914,655233,11,655222
53545,9,7,535,856171,9,856162
53546,19,-5,570,495243,19,495224
53547,14,-13,462,244352,14,244338
53548,14,19,323,1243360,14,1243346
53549,18,-9,905,373765,18,373747
53550,19,-4,847,528294,19,528275
53551,18,-11,446,307341,18,307323
53552,18,-14,795,215740,18,215722
53553,17,-1,646,621546,17,621529
53554,14,8,128,898937,14,898923
53555,20,3,343,744485,20,744465
53556,14,9,378,931809,14,931795
53557,8,18,66,1188229,8,1188221
53558,6,0,122,628091,6,628085
53559,17,11,855,997060,17,997043
53560,11,15,456,1120010,11,1119999
53561,11,11,773,996443,11,996432
53562,9,-8,486,385430,9,385421
53563,12,7,641,871709,12,871697
53564,14,6,860,842622,14,842608
53565,16,1,529,684048,16,684032
53566,19,-19,262,56066,19,56047
53567,8,-16,940,144220,8,144212
53568,18,-18,852,91390,18,91372
53569,9,17,750,1171265,9,1171256
53570,13,8,617,902815,13,902802
53571,6,-4,883,518385,6,518379
53572,15,8,229,899822,15,899807
53573,17,-20,224,24508,17,24491
53574,13,-9,325,368978,13,368965
53575,20,4,416,776237,20,776217
53576,12,-20,57,23209,12,23197
53577,6,-14,657,201063,6,201057
53578,11,-13,184,242411,11,242400
53579,15,-2,783,591025,15,591010
53580,12,13,21,1053375,12,1053363
53581,19,7,730,872336,19,872317
53582,11,8,583,902525,11,902514
53583,11,3,565,746023,11,746012
53584,15,7,640,871701,15,871686
53585,17,7,360,869634,17,869617
53586,19,-2,544,589221,19,589202
53587,19,-11,641,308849,19,308830
53588,18,19,800,1247256,18,1247238
53589,5,8,558,887432,5,887427
53590,19,2,90,711232,19,711213
53591,14,-20,702,28198,14,28184
53592,7,3,568,730882,7,730875
53593,11,0,624,652942,11,652931
53594,7,12,262,1005007,7,1005000
53595,12,10,822,966233,12,966221
53596,12,-19,99,54721,12,54709
53597,12,13,691,1058404,12,1058392
53598,19,10,911,966843,19,966824
53599,8,13,968,1051443,8,1051435
53600,5,18,749,1202514,5,1202509
53601,17,-17,646,120305,17,120288
53602,15,0,966,655681,15,655666
53603,8,-14,316,193555,8,193547
53604,6,13,165,1034161,6,1034155
53605,12,-5,893,497580,12,497568
53606,10,13,669,1045183,10,1045173
53607,11,8,671,903291,11,903280
53608,18,4,323,775516,18,775498
53609,7,-15,63,156651,7,156644
53610,11,18,509,1212695,11,1212684
53611,14,-10,997,342700,14,342686
53612,14,-6,732,464752,14,464738
53613,20,-11,524,307917,20,307897
53614,20,5,48,804145,20,804125
53615,15,-6,885,465821,15,465806
53616,6,-14,709,202238,6,202232
53617,19,14,890,1092420,19,1092401
53618,11,3,710,747261,11,747250
53619,15,17,694,1183065,15,1183050
53620,10,7,787,861465,10,861455
53621,19,-1,380,619605,19,619586
53622,6,-6,582,449309,6,449303
53623,14,-4,969,529404,14,529390
53624,7,-12,614,262720,7,262713
53625,10,-5,688,482913,10,482903
53626,19,19,927,1248235,19,1248216
53627,10,-18,221,67210,10,67200
53628,7,2,618,701697,7,701690
53629,14,2,423,713827,14,713813
53630,12,-2,483,588801,12,588789
53631,12,-6,752,464913,12,464901
53632,14,19,559,1245345,14,1245331
53633,7,12,676,1013977,7,1013970
53634,20,6,997,843728,20,843708
53635,8,7,701,859671,8,859663
53636,6,-19,821,49384,6,49378
53637,14,-19,892,60809,14,60795
53638,17,-13,811,247077,17,247060
53639,6,-12,140,252572,6,252566
53640,6,-16,313,130741,6,130735
53641,6,5,234,786558,6,786552
53642,6,-1,542,605793,6,605787
53643,17,19,69,1241304,17,1241287
53644,12,-20,639,27638,12,27626
53645,11,10,220,961502,11,961491
53646,19,7,845,873122,19,873103
53647,19,-19,550,58309,19,58290
53648,8,-19,245,36968,8,36960
53649,12,5,39,804053,12,804041
53650,12,-5,46,491194,12,491182
53651,7,10,258,942909,7,942902
53652,6,-20,730,16053,6,16047
53653,16,10,497,963625,16,963609
53654,14,19,807,1247311,14,1247297
53655,11,-11,620,308673,11,308662
53656,12,-5,561,495183,12,495171
53657,14,-16,299,149149,14,149135
53658,10,17,607,1168194,10,1168184
53659,6,9,823,924206,6,924200
53660,15,-11,597,308484,15,308469
53661,7,14,498,1072966,7,1072959
53662,6,-16,112,126512,6,126506
53663,20,18,323,1211457,20,1211437
53664,16,-9,423,369904,16,369888
53665,5,-2,110,565204,5,565199
53666,13,-15,530,181684,13,181671
53667,6,-4,249,505098,6,505092
53668,20,-12,495,276189,20,276169
53669,9,13,229,1035598,9,1035589
53670,7,-10,855,330914,7,330907
53671,19,-15,796,183662,19,183643
53672,9,19,701,1233050,9,1233041
53673,12,9,48,929436,12,929424
53674,15,9,774,934758,15,934743
53675,14,-7,701,433410,14,433396
53676,15,-14,363,212253,15,212238
53677,16,-1,341,619324,16,619308
53678,7,-19,437,40930,7,40923
53679,8,14,719,1078220,8,1078212
53680,19,6,860,842631,19,842612
53681,20,14,556,1089797,20,1089777
53682,16,-12,885,279120,16,279104
53683,12,7,177,868287,12,868275
53684,19,13,931,1060143,19,1060124
53685,7,12,259,1004902,7,1004895
53686,17,-4,110,522859,17,522842
53687,17,18,243,1210925,17,1210908
53688,16,15,734,1122234,16,1122218
53689,12,12,111,1022880,12,1022868
53690,7,1,25,657605,7,657598
53691,14,-20,672,27964,14,27950
53692,6,10,561,949501,6,949495
53693,10,3,295,725298,10,725288
53694,17,-19,272,56120,17,56103
53695,14,7,771,872580,14,872566
53696,15,14,507,1089424,15,1089409
53697,7,17,511,1166278,7,1166271
53698,14,18,27,1209093,14,1209079
53699,18,0,270,650161,18,650143
53700,17,-15,31,178031,17,178014
53701,8,2,65,690020,8,690012
53702,18,17,1000,1185498,18,1185480
53703,6,-14,805,204202,6,204196
53704,10,5,594,793927,10,793917
53705,15,-6,418,462353,15,462338
53706,17,1,199,681449,17,681432
53707,5,-14,649,200935,5,200930
53708,15,7,300,869186,15,869171
53709,13,-17,658,120458,13,120445
53710,5,-2,262,568442,5,568437
53711,16,0,911,655194,16,655178
53712,20,11,413,993885,20,993865
53713,18,-3,509,557730,18,557712
53714,7,-11,197,285437,7,285430
53715,8,-13,260,223918,8,223910
53716,20,-2,647,589980,20,589960
53717,13,-4,706,527394,13,527381
53718,18,16,341,1149603,18,1149585
53719,12,-12,101,273256,12,273244
53720,13,1,430,683205,13,683192
53721,8,11,246,973518,8,973510
53722,15,-9,673,371755,15,371740
53723,8,-2,171,566329,8,566321
53724,9,-18,245,67849,9,67840
53725,20,17,197,1179372,20,1179352
53726,13,16,787,1152715,13,1152702
53727,20,14,614,1090203,20,1090183
53728,9,11,689,983101,9,983092
53729,9,2,87,690416,9,690407
53730,9,-5,488,478567,9,478558
53731,18,3,995,749497,18,749479
53732,10,-13,181,222228,10,222218
53733,7,-10,104,314793,7,314786
53734,6,-2,189,566818,6,566812
53735,14,12,927,1029184,14,1029170
53736,16,-15,434,181010,16,180994
53737,18,1,174,681252,18,681234
53738,11,10,583,964401,11,964390
53739,17,-1,469,620326,17,620309
53740,8,4,415,759624,8,759616
53741,12,-10,877,341687,12,341675
53742,7,14,440,1071669,7,1071662
53743,14,6,759,841868,14,841854
53744,10,19,877,1237041,10,1237031
53745,12,-15,376,180561,12,180549
53746,13,17,840,1184267,13,1184254
53747,14,18,200,1210620,14,1210606
53748,16,2,344,713200,16,713184
53749,16,-4,27,522247,16,522231
53750,10,16,806,1141960,10,1141950
53751,13,-13,798,246969,13,246956
53752,6,-4,847,517445,6,517439
53753,7,-7,362,413787,7,413780
53754,20,-13,340,243557,20,243537
53755,17,-20,462,26276,17,26259
53756,9,-11,192,285322,9,285313
53757,6,-7,961,426354,6,426348
53758,11,-7,185,429684,11,429673
53759,17,-10,139,336172,17,336155
53760,6,14,429,1071429,6,1071423
53761,19,17,195,1179359,19,1179340
53762,20,16,925,1153744,20,1153724
53763,12,-18,880,91586,12,91574
53764,5,-14,462,196664,5,196659
53765,12,-6,852,465569,12,465557
53766,19,-20,48,23160,19,23141
53767,12,1,803,686099,12,686087
53768,17,18,51,1209300,17,1209283
53769,10,-7,577,418307,10,418297
53770,5,5,756,797383,5,797378
53771,12,-3,428,557010,12,556998
53772,7,-19,940,51712,7,51705
53773,15,9,788,934874,15,934859
53774,18,-7,23,428482,18,428464
53775,5,11,155,971643,5,971638
53776,6,8,890,894463,6,894457
53777,5,-17,915,112860,5,112855
53778,11,10,266,961843,11,961832
53779,15,9,749,934536,15,934521
53780,7,7,756,860734,7,860727
53781,8,-17,918,112935,8,112927
53782,12,13,36,1053490,12,1053478
53783,6,-12,890,268938,6,268932
53784,18,-11,533,308018,18,308000
53785,11,-8,943,404553,11,404542
53786,12,-8,631,402294,12,402282
53787,8,10,948,957879,8,957871
53788,11,-11,191,305257,11,305246
53789,19,-10,248,336889,19,336870
53790,7,-13,761,234744,7,234737
53791,16,19,269,1242912,16,1242896
53792,8,-17,594,106353,8,106345
53793,7,-19,190,35781,7,35774
53794,8,11,262,973828,8,973820
53795,5,-16,394,132450,5,132445
53796,10,18,621,1199859,10,1199849
53797,11,-3,393,556680,11,556669
53798,16,1,938,687181,16,687165
53799,13,-4,836,528184,13,528171
53800,15,-2,287,587283,15,587268
53801,20,-4,855,528369,20,528349
53802,20,-20,740,28471,20,28451
53803,16,2,235,712335,16,712319
53804,5,1,456,667159,5,667154
53805,19,-3,603,558537,19,558518
53806,9,-5,2,467775,9,467766
53807,9,14,104,1064174,9,1064165
53808,5,13,841,1048857,5,1048852
53809,5,-11,684,296161,5,296156
53810,13,18,20,1209033,13,1209020
53811,13,-16,954,153922,13,153909
53812,18,1,647,684945,18,684927
53813,14,-15,843,184103,14,184089
53814,11,-11,796,309910,11,309899
53815,17,-16,474,150533,17,150516
53816,7,2,402,697329,7,697322
53817,18,-15,829,184003,18,183985
53818,12,2,825,716646,12,716634
53819,6,-9,791,361332,6,361326
53820,7,-19,145,34826,7,34819
53821,14,-4,793,527954,14,527940
53822,13,-20,638,27637,13,27624
53823,16,7,798,872774,16,872758
53824,7,1,599,670271,7,670264
53825,7,11,72,970028,7,970021
53826,12,6,256,837704,12,837692
53827,8,15,30,1095111,8,1095103
53828,15,-15,564,181946,15,181931
53829,12,0,503,651989,12,651977
53830,9,-12,661,263913,9,263904
53831,11,-6,971,466454,11,466443
53832,20,-5,510,494790,20,494770
53833,20,7,780,872651,20,872631
53834,11,5,894,810270,11,810259
53835,11,-9,506,370644,11,370633
53836,11,17,539,1181876,11,1181865
53837,9,1,588,670123,9,670114
53838,5,-3,167,533961,5,533956
53839,5,-9,610,357236,5,357231
53840,11,-17,332,117943,11,117932
53841,13,5,925,810571,13,810558
53842,17,-17,960,122553,17,122536
53843,12,14,423,1088796,12,1088784
53844,20,-16,795,152740,20,152720
53845,9,-1,755,610026,9,610017
53846,8,-11,939,301278,8,301270
53847,13,-13,851,247351,13,247338
53848,20,-8,33,398157,20,398137
53849,11,18,382,1211874,11,1211863
53850,7,-4,954,519919,7,519912
53851,6,16,224,1130002,6,1129996
53852,6,3,65,720180,6,720174
53853,8,1,99,659235,8,659227
53854,19,-10,51,335536,19,335517
53855,8,0,165,629048,8,629040
53856,5,19,784,1234841,5,1234836
53857,12,-15,217,179292,12,179280
53858,15,4,24,773422,15,773407
53859,18,6,37,836109,18,836091
53860,10,-1,115,596275,10,596265
53861,5,0,721,641245,5,641240
53862,7,-9,184,347504,7,347497
53863,10,-1,86,595658,10,595648
53864,8,2,433,697871,8,697863
53865,5,-14,730,202624,5,202619
53866,7,18,248,1192212,7,1192205
53867,16,5,372,806521,16,806505
53868,5,15,724,1109917,5,1109912
53869,20,0,373,650897,20,650877
53870,9,16,687,1139531,9,1139522
53871,19,14,248,1087382,19,1087363
53872,13,5,672,808678,13,808665
53873,17,4,944,780214,17,780197
53874,5,9,3,906770,5,906765
53875,19,8,480,901728,19,901709
53876,14,6,996,843711,14,843697
53877,14,-9,873,373496,14,373482
53878,11,-17,439,118718,11,118707
53879,13,-1,222,618299,13,618286
53880,11,-20,648,27728,11,27717
53881,12,8,312,900403,12,900391
53882,13,1,870,686581,13,686568
53883,10,-5,134,470988,10,470978
53884,8,4,628,764227,8,764219
53885,14,3,645,746701,14,746687
53886,10,-20,892,19791,10,19781
53887,9,14,411,1070962,9,1070953
53888,11,2,715,715999,11,715988
53889,5,16,727,1140209,5,1140204
53890,6,-14,731,202639,6,202633
53891,7,15,843,1112394,7,1112387
53892,16,14,627,1090297,16,1090281
53893,13,-19,461,57504,13,57491
53894,18,18,203,1210641,18,1210623
53895,7,-11,790,298088,7,298081
53896,10,10,244,942618,10,942608
53897,5,7,304,851338,5,851333
53898,20,-6,627,463953,20,463933
53899,9,10,189,941578,9,941569
53900,9,-15,442,164984,9,164975
53901,17,5,818,809760,17,809743
53902,18,-17,35,115818,18,115800
53903,20,-3,294,555927,20,555907
53904,8,4,782,767693,8,767685
53905,9,-16,768,140560,9,140551
53906,19,0,671,653375,19,653356
53907,6,-20,779,17162,6,17156
53908,14,14,682,1090822,14,1090808
53909,17,14,356,1088191,17,1088174
53910,7,-1,731,609574,7,609567
53911,14,-7,114,429114,14,429100
53912,20,6,517,839994,20,839974
53913,9,-3,148,533609,9,533600
53914,20,2,627,715268,20,715248
53915,5,17,45,1156340,5,1156335
53916,12,-12,813,278472,12,278460
53917,14,-13,330,243483,14,243469
53918,9,-15,179,159244,9,159235
53919,9,7,187,848739,9,848730
53920,12,18,993,1216262,12,1216250
53921,20,-17,956,122521,20,122501
53922,16,-5,97,491667,16,491651
53923,19,16,519,1150807,19,1150788
53924,8,-17,70,94882,8,94874
53925,14,-5,513,494814,14,494800
53926,11,17,702,1183136,11,1183125
53927,11,2,761,716269,11,716258
53928,16,-4,972,529433,16,529417
53929,17,-1,464,620286,17,620269
53930,8,-19,538,43197,8,43189
53931,14,13,230,1054920,14,1054906
53932,5,-8,489,385480,5,385475
53933,8,-10,201,316977,8,316969
53934,12,-4,890,528752,12,528740
53935,7,13,854,1049136,7,1049129
53936,15,-4,795,527969,15,527954
53937,12,-14,448,212990,12,212978
53938,18,-3,432,557039,18,557021
53939,13,7,473,870542,13,870529
53940,11,-15,275,179771,11,179760
53941,19,10,438,963160,19,963141
53942,10,1,651,671420,10,671410
53943,12,1,906,686902,12,686890
53944,7,-16,714,139323,7,139316
53945,13,0,248,650062,13,650049
53946,12,3,720,747312,12,747300
53947,5,12,793,1016289,5,1016284
53948,17,-14,803,215836,17,215819
53949,12,13,638,1058072,12,1058060
53950,18,4,605,777707,18,777689
53951,10,-12,383,257906,10,257896
53952,18,6,278,837921,18,837903
53953,15,4,652,778021,15,778006
53954,20,13,452,1056614,20,1056594
53955,11,-17,212,117033,11,117022
53956,14,-16,120,147811,14,147797
53957,8,-16,171,127637,8,127629
53958,6,-20,142,3111,6,3105
53959,20,18,513,1212750,20,1212730
53960,9,1,493,668054,9,668045
53961,16,16,872,1153305,16,1153289
53962,14,-19,533,58139,14,58125
53963,17,12,67,1022550,17,1022533
53964,9,10,270,943276,9,943267
53965,5,-16,934,144126,5,144121
53966,17,-1,659,621665,17,621648
53967,11,1,522,683986,11,683975
53968,6,6,103,814436,6,814430
53969,17,8,792,904235,17,904218
53970,20,14,704,1090997,20,1090977
53971,19,19,970,1248561,19,1248542
53972,16,8,888,904825,16,904809
53973,6,14,947,1083071,6,1083065
53974,15,12,425,1025147,15,1025132
53975,17,1,6,679790,17,679773
53976,15,-14,906,216563,15,216548
53977,20,12,781,1027877,20,1027857
53978,9,1,294,663597,9,663588
53979,8,-14,560,198664,8,198656
53980,13,-7,931,435178,13,435165
53981,12,-7,369,431154,12,431142
53982,5,1,125,659890,5,659885
53983,11,17,620,1182454,11,1182443
53984,8,13,943,1050902,8,1050894
53985,12,12,533,1025948,12,1025936
53986,11,-3,388,556671,11,556660
53987,14,-5,915,497748,14,497734
53988,11,-4,888,528741,11,528730
53989,10,-10,132,315556,10,315546
53990,7,19,432,1227542,7,1227535
53991,17,11,388,993739,17,993722
53992,7,8,968,896231,7,896224
53993,17,8,896,904947,17,904930
53994,11,-1,612,621321,11,621310
53995,5,-19,261,37269,5,37264
53996,13,17,105,1178592,13,1178579
53997,14,19,178,1242173,14,1242159
53998,11,-14,157,210512,11,210501
53999,10,6,984,834389,10,834379
54000,13,18,237,1210885,13,1210872
54001,12,14,60,1085891,12,1085879
54002,9,-11,29,281691,9,281682
54003,9,12,585,1011669,9,1011660
54004,5,16,612,1138010,5,1138005
54005,15,-7,686,433280,15,433265
54006,15,10,64,960315,15,960300
54007,11,-2,365,587810,11,587799
54008,11,5,696,808861,11,808850
54009,9,-13,644,232061,9,232052
54010,8,9,618,919916,8,919908
54011,8,-14,564,198813,8,198805
54012,12,12,302,1024362,12,1024350
54013,7,2,144,691676,7,691669
54014,7,-6,411,445564,7,445557
54015,17,8,683,903397,17,903380
54016,10,18,212,1191475,10,1191465
54017,8,2,15,688867,8,688859
54018,9,13,602,1043765,9,1043756
54019,16,-4,415,525341,16,525325
54020,13,9,122,929954,13,929941
54021,17,-9,87,367287,17,367270
54022,7,12,650,1013296,7,1013289
54023,20,-20,534,26827,20,26807
54024,11,18,905,1215545,11,1215534
54025,19,-5,162,492213,19,492194
54026,19,6,890,842875,19,842856
54027,5,-15,562,167501,5,167496
54028,5,-5,647,482044,5,482039
54029,17,-3,250,555550,17,555533
54030,17,-4,147,523180,17,523163
54031,8,7,827,862382,8,862374
54032,12,10,916,966905,12,966893
54033,10,-2,931,582752,10,582742
54034,16,10,327,962306,16,962290
54035,11,-16,71,147319,11,147308
54036,13,7,805,872827,13,872814
54037,15,-9,514,370723,15,370708
54038,14,-10,313,337344,14,337330
54039,10,17,144,1158327,10,1158317
54040,20,0,724,653884,20,653864
54041,6,-8,369,383104,6,383098
54042,19,-3,303,556000,19,555981
54043,5,7,400,853447,5,853442
54044,9,-20,30,688,9,679
54045,8,-5,749,484184,8,484176
54046,18,2,74,711128,18,711110
54047,8,3,847,737117,8,737109
54048,11,-9,748,372365,11,372354
54049,5,6,442,822425,5,822420
54050,12,19,707,1246511,12,1246499
54051,11,10,555,964097,11,964086
54052,5,10,151,940845,5,940840
54053,10,15,427,1103453,10,1103443
54054,19,-19,496,57807,19,57788
54055,5,2,385,696952,5,696947
54056,12,-4,277,524244,12,524232
54057,7,-2,196,566930,7,566923
54058,16,3,685,747061,16,747045
54059,5,9,475,916647,5,916642
54060,18,18,983,1216196,18,1216178
54061,7,7,74,846403,7,846396
54062,8,-7,933,425787,8,425779
54063,6,-5,357,475932,6,475926
54064,18,-5,852,497223,18,497205
54065,12,19,621,1245863,12,1245851
54066,18,19,10,1240732,18,1240714
54067,8,-13,30,219047,8,219039
54068,9,-14,820,204462,9,204453
54069,8,13,428,1039961,8,1039953
54070,10,-13,768,235001,10,234991
54071,8,-9,785,361134,8,361126
54072,9,4,334,757735,9,757726
54073,13,-14,782,215656,13,215643
54074,9,-2,22,563257,9,563248
54075,17,-16,83,147472,17,147455
54076,15,9,707,934277,15,934262
54077,12,-7,333,430857,12,430845
54078,19,-7,670,433133,19,433114
54079,16,-1,372,619576,16,619560
54080,17,17,255,1179820,17,1179803
54081,11,-7,662,433078,11,433067
54082,10,-15,487,166027,10,166017
54083,13,7,439,870310,13,870297
54084,16,9,435,932190,16,932174
54085,16,7,888,873375,16,873359
54086,17,-18,305,87608,17,87591
54087,8,-14,325,193789,8,193781
54088,5,7,623,858012,5,858007
54089,17,7,628,871608,17,871591
54090,6,-6,672,451181,6,451175
54091,6,10,119,940309,6,940303
54092,6,12,627,1012703,6,1012697
54093,10,-13,29,219011,10,219001
54094,19,18,257,1211055,19,1211036
54095,11,-8,685,402765,11,402754
54096,14,-5,34,491064,14,491050
54097,12,4,727,778619,12,778607
54098,9,3,905,738332,9,738323
54099,9,-10,308,319217,9,319208
54100,12,17,37,1178149,12,1178137
54101,20,-7,653,433053,20,433033
54102,12,-1,186,617932,12,617920
54103,8,1,332,664499,8,664491
54104,13,-3,931,561227,13,561214
54105,7,14,604,1075269,7,1075262
54106,18,-10,100,335874,18,335856
54107,10,-4,18,499693,10,499683
54108,9,-10,537,324202,9,324193
54109,11,-6,383,462091,11,462080
54110,15,0,90,648896,15,648881
54111,20,-4,763,527747,20,527727
54112,18,-14,750,215295,18,215277
54113,13,2,393,713583,13,713570
54114,16,-18,143,86297,16,86281
54115,11,3,671,746910,11,746899
54116,17,18,432,1212225,17,1212208
54117,10,15,55,1095657,10,1095647
54118,17,-6,588,463640,17,463623
54119,7,-14,74,188198,7,188191
54120,11,7,153,868132,11,868121
54121,16,-10,539,339085,16,339069
54122,18,15,618,1121310,18,1121292
54123,8,13,245,1035890,8,1035882
54124,11,-9,922,373871,11,373860
54125,6,-3,247,535818,6,535812
54126,15,-3,678,559223,15,559208
54127,11,17,993,1185424,11,1185413
54128,14,-17,445,118782,14,118768
54129,11,-14,400,212688,11,212677
54130,6,-2,388,570914,6,570908
54131,12,5,270,805827,12,805815
54132,6,19,247,1222944,6,1222938
54133,7,5,925,801117,7,801110
54134,17,10,729,965497,17,965480
54135,19,8,400,901151,19,901132
54136,13,12,232,1023747,13,1023734
54137,20,-17,385,118347,20,118327
54138,16,19,306,1243227,16,1243211
54139,14,-11,132,304746,14,304732
54140,18,17,163,1179097,18,1179079
54141,17,-18,801,91095,17,91078
54142,5,11,618,981694,5,981689
54143,18,19,898,1248062,18,1248044
54144,15,13,988,1060516,15,1060501
54145,9,19,137,1220444,9,1220435
54146,8,17,383,1163508,8,1163500
54147,20,2,896,717151,20,717131
54148,16,2,46,710851,16,710835
54149,5,0,135,628387,5,628382
54150,5,-14,587,199492,5,199487
54151,13,-20,42,23112,13,23099
54152,14,3,689,747076,14,747062
54153,5,-5,539,479717,5,479712
54154,19,6,798,842149,19,842130
54155,15,1,493,683759,15,683744
54156,12,-1,873,623236,12,623224
54157,20,-20,318,25326,20,25306
54158,15,-5,317,493450,15,493435
54159,17,11,752,996257,17,996240
54160,9,9,449,916121,9,916112
54161,5,9,770,922932,5,922927
54162,18,9,774,934766,18,934748
54163,12,17,261,1179835,12,1179823
54164,12,-2,626,589831,12,589819
54165,14,14,98,1086253,14,1086239
54166,8,1,134,660140,8,660132
54167,6,-7,290,412138,6,412132
54168,17,-4,674,527161,17,527144
54169,8,-7,477,416044,8,416036
54170,6,13,576,1043184,6,1043178
54171,17,-3,415,556865,17,556848
54172,5,-9,641,357798,5,357793
54173,8,2,220,693330,8,693322
54174,19,-19,19,54035,19,54016
54175,17,-7,901,434995,17,434978
54176,18,-6,972,466475,18,466457
54177,20,6,71,836284,20,836264
54178,8,-5,676,482626,8,482618
54179,15,7,239,868703,15,868688
54180,18,16,355,1149708,18,1149690
54181,7,-13,785,235457,7,235450
54182,15,-7,403,431403,15,431388
54183,16,-14,463,213089,16,213073
54184,15,-9,433,369991,15,369976
54185,11,-2,860,591678,11,591667
54186,6,18,264,1192638,6,1192632
54187,10,-15,117,158057,10,158047
54188,11,4,588,777520,11,777509
54189,18,18,853,1215200,18,1215182
54190,14,2,616,715179,14,715165
54191,6,-6,493,447435,6,447429
54192,9,12,752,1015469,9,1015460
54193,8,-1,117,596309,8,596301
54194,13,-6,226,460888,13,460875
54195,17,5,702,808914,17,808897
54196,13,-2,273,587178,13,587165
54197,10,-20,773,17025,10,17015
54198,15,-1,838,622973,15,622958
54199,20,-4,293,524360,20,524340
54200,16,19,815,1247375,16,1247359
54201,17,-5,495,494688,17,494671
54202,10,16,927,1144524,10,1144514
54203,13,-3,366,556504,13,556491
54204,15,-5,560,495179,15,495164
54205,16,-4,765,527768,16,527752
54206,7,-9,174,347274,7,347267
54207,6,4,503,761431,6,761425
54208,7,-19,289,37831,7,37824
54209,10,-5,3,467831,10,467821
54210,13,3,564,746018,13,746005
54211,6,4,399,759235,6,759229
54212,14,3,910,748693,14,748679
54213,19,-3,524,557940,19,557921
54214,13,4,909,779966,13,779953
54215,7,17,132,1158039,7,1158032
54216,6,-16,76,125529,6,125523
54217,16,-17,81,116159,16,116143
54218,16,19,281,1242998,16,1242982
54219,5,13,848,1048980,5,1048975
54220,8,-17,979,114152,8,114144
54221,20,5,897,810302,20,810282
54222,18,-9,520,370798,18,370780
54223,9,-13,357,225836,9,225827
54224,20,-11,28,303870,20,303850
54225,16,-9,668,371733,16,371717
54226,16,1,689,685239,16,685223
54227,10,-7,403,414687,10,414677
54228,13,6,707,841501,13,841488
54229,17,-18,201,86860,17,86843
54230,12,12,669,1027093,12,1027081
54231,11,12,655,1026909,11,1026898
54232,17,6,93,836455,17,836438
54233,19,-9,518,370764,19,370745
54234,16,-16,72,147340,16,147324
54235,12,-1,797,622693,12,622681
54236,13,-13,748,246561,13,246548
54237,20,1,505,683846,20,683826
54238,8,-9,259,349294,8,349286
54239,17,-16,966,154045,17,154028
54240,5,13,486,1041121,5,1041116
54241,16,-7,454,431754,16,431738
54242,9,-5,853,486480,9,486471
54243,8,2,170,692309,8,692301
54244,8,-16,860,142507,8,142499
54245,12,-2,754,590758,12,590746
54246,7,13,898,1050011,7,1050004
54247,18,-4,151,523229,18,523211
54248,10,7,728,860164,10,860154
54249,12,8,727,903738,12,903726
54250,10,5,704,796278,10,796268
54251,19,-11,886,310655,19,310636
54252,17,-9,209,368021,17,368004
54253,8,-4,19,499720,8,499712
54254,8,18,121,1189463,8,1189455
54255,14,-7,380,431244,14,431230
54256,10,-14,716,202393,10,202383
54257,8,-5,179,472036,8,472028
54258,18,10,925,966973,18,966955
54259,14,1,987,687485,14,687471
54260,10,2,974,709016,10,709006
54261,15,-5,411,494047,15,494032
54262,12,-4,184,523497,12,523485
54263,10,-5,746,484127,10,484117
54264,8,2,21,689029,8,689021
54265,11,2,166,711852,11,711841
54266,7,15,318,1101287,7,1101280
54267,10,-20,860,19038,10,19028
54268,17,-12,4,272545,17,272528
54269,9,-5,229,473024,9,473015
54270,6,-3,49,531609,6,531603
54271,15,17,823,1184121,15,1184106
54272,6,-16,230,129142,6,129136
54273,7,-6,189,441023,7,441016
54274,19,-19,581,58625,19,58606
54275,16,-12,299,274746,16,274730
54276,8,8,484,885769,8,885761
54277,17,-2,154,586226,17,586209
54278,6,-16,928,143940,6,143934
54279,15,-9,850,373280,15,373265
54280,14,12,508,1025771,14,1025757
54281,20,-18,68,85741,20,85721
54282,18,10,735,965533,18,965515
54283,10,2,39,689489,10,689479
54284,16,-7,448,431712,16,431696
54285,7,10,232,942433,7,942426
54286,6,8,867,894007,6,894001
54287,16,19,54,1241165,16,1241149
54288,14,-11,455,307417,14,307403
54289,5,-3,79,532156,5,532151
54290,5,4,16,750831,5,750826
54291,8,-3,71,532049,8,532041
54292,7,-18,222,67266,7,67259
54293,18,4,719,778554,18,778536
54294,17,1,259,681951,17,681934
54295,12,-14,971,217054,12,217042
54296,10,2,905,707411,10,707401
54297,13,-4,952,529220,13,529207
54298,11,-7,30,428568,11,428557
54299,19,-1,146,617641,19,617622
54300,13,8,984,905604,13,905591
54301,14,-4,805,528029,14,528015
54302,5,-10,305,319140,5,319135
54303,7,16,799,1141751,7,1141744
54304,15,15,854,1123022,15,1123007
54305,10,-7,375,414052,10,414042
54306,7,17,315,1162080,7,1162073
54307,20,-4,573,526427,20,526407
54308,13,5,738,809175,13,809162
54309,16,2,744,716164,16,716148
54310,8,11,262,973836,8,973828
54311,17,-8,279,399851,17,399834
54312,12,-3,296,555934,12,555922
54313,7,16,708,1139854,7,1139847
54314,14,1,861,686524,14,686510
54315,20,0,643,653133,20,653113
54316,11,9,555,933131,11,933120
54317,14,1,47,680155,14,680141
54318,18,4,873,779774,18,779756
54319,17,0,957,655568,17,655551
54320,5,18,119,1189425,5,1189420
54321,16,4,620,777797,16,777781
54322,15,-4,609,526671,15,526656
54323,19,0,272,650173,19,650154
54324,7,6,203,816642,7,816635
54325,8,-13,847,236697,8,236689
54326,15,11,20,991005,15,990990
54327,13,-1,719,622145,13,622132
54328,19,11,446,994098,19,994079
54329,15,-6,756,464921,15,464906
54330,16,-5,539,495029,16,495013
54331,20,-8,894,404238,20,404218
54332,13,-9,889,373638,13,373625
54333,13,-9,233,368262,13,368249
54334,8,-4,237,504842,8,504834
54335,16,-11,109,304550,16,304534
54336,16,4,722,778573,16,778557
54337,16,5,656,808555,16,808539
54338,11,-20,164,24015,11,24004
54339,7,14,181,1065768,7,1065761
54340,13,-7,338,430914,13,430901
54341,9,8,467,885410,9,885401
54342,20,-14,592,214208,20,214188
54343,11,16,843,1153161,11,1153150
54344,5,18,635,1200193,5,1200188
54345,11,-20,367,25622,11,25611
54346,15,-9,319,368943,15,368928
54347,7,-20,632,13804,7,13797
54348,14,6,180,837100,14,837086
54349,5,-20,762,16749,5,16744
54350,12,7,489,870672,12,870660
54351,12,4,599,777628,12,777616
54352,5,16,188,1129188,5,1129183
54353,7,-12,703,264680,7,264673
54354,6,7,956,864953,6,864947
54355,20,4,910,779984,20,779964
54356,7,19,725,1233609,7,1233602
54357,6,-7,204,410186,6,410180
54358,5,13,883,1049711,5,1049706
54359,13,-11,781,309845,13,309832
54360,8,-20,17,431,8,423
54361,14,-14,533,213611,14,213597
54362,19,-9,433,370000,19,369981
54363,5,-12,43,250465,5,250460
54364,17,-8,52,398315,17,398298
54365,9,7,601,857606,9,857597
54366,20,15,946,1123729,20,1123709
54367,15,-1,46,616920,15,616905
54368,8,-9,707,359160,8,359152
54369,7,0,400,634004,7,633997
54370,14,-9,716,372054,14,372040
54371,9,6,929,833106,9,833097
54372,20,8,185,899380,20,899360
54373,13,-11,457,307418,13,307405
54374,19,7,415,870099,19,870080
54375,15,14,108,1086347,15,1086332
54376,17,10,164,961138,17,961121
54377,10,-15,162,158908,10,158898
54378,10,-17,974,113977,10,113967
54379,8,-15,231,160303,8,160295
54380,9,0,436,634759,9,634750
54381,17,-13,216,242625,17,242608
54382,20,19,30,1240957,20,1240937
54383,16,13,570,1057538,16,1057522
54384,13,-1,267,618645,13,618632
54385,8,0,370,633284,8,633276
54386,8,-3,793,548182,8,548174
54387,11,-5,338,493647,11,493636
54388,11,-2,471,588698,11,588687
54389,20,-4,678,527230,20,527210
54390,6,8,705,890726,6,890720
54391,12,-1,972,623930,12,623918
54392,18,17,852,1184414,18,1184396
54393,18,-19,583,58640,18,58622
54394,6,3,403,727484,6,727478
54395,7,2,511,699549,7,699542
54396,18,17,757,1183516,18,1183498
54397,12,3,650,746761,12,746749
54398,16,-2,924,592170,16,592154
54399,8,-13,662,232377,8,232369
54400,14,-9,403,369690,14,369676
54401,6,0,216,630159,6,630153
54402,9,18,515,1197828,9,1197819
54403,14,15,90,1117460,14,1117446
54404,20,17,16,1177966,20,1177946
54405,6,-17,316,100320,6,100314
54406,10,4,720,766206,10,766196
54407,6,-6,538,448431,6,448425
54408,10,7,714,859871,10,859861
54409,17,-12,862,278963,17,278946
54410,18,-19,623,58915,18,58897
54411,18,-4,501,525886,18,525868
54412,12,17,574,1182081,12,1182069
54413,20,17,990,1185421,20,1185401
54414,14,-19,416,57205,14,57191
54415,6,11,819,985971,6,985965
54416,13,-19,153,55288,13,55275
54417,9,-18,141,65502,9,65493
54418,6,7,89,846763,6,846757
54419,7,14,745,1078716,7,1078709
54420,13,-7,749,433702,13,433689
54421,5,-10,467,322835,5,322830
54422,19,-4,794,527962,19,527943
54423,5,-4,575,511874,5,511869
54424,19,-18,100,85987,19,85968
54425,8,14,210,1066344,8,1066336
54426,11,-12,769,278177,11,278166
54427,13,-5,595,495438,13,495425
54428,11,-20,991,30375,11,30364
54429,5,-3,209,534887,5,534882
54430,18,-17,364,118180,18,118162
54431,9,19,278,1223657,9,1223648
54432,12,8,500,901938,12,901926
54433,12,-3,592,558477,12,558465
54434,5,7,205,849146,5,849141
54435,19,-8,43,398237,19,398218
54436,6,-19,211,36266,6,36260
54437,11,15,927,1123537,11,1123526
54438,20,16,657,1151822,20,1151802
54439,12,-3,866,560722,12,560710
54440,8,-17,999,114502,8,114494
54441,11,13,24,1053392,11,1053381
54442,12,3,671,746912,12,746900
54443,14,15,243,1118592,14,1118578
54444,18,12,764,1027736,18,1027718
54445,13,9,613,933610,13,933597
54446,15,14,172,1086793,15,1086778
54447,18,-20,371,25664,18,25646
54448,16,-15,491,181399,16,181383
54449,7,-12,814,267196,7,267189
54450,18,-4,161,523289,18,523271
54451,6,5,457,791082,6,791076
54452,8,-10,974,333475,8,333467
54453,10,-5,599,481074,10,481064
54454,20,0,910,655184,20,655164
54455,6,-20,796,17610,6,17604
54456,8,1,11,657245,8,657237
54457,17,-5,671,495883,17,495866
54458,20,15,24,1116969,20,1116949
54459,13,2,199,712101,13,712088
54460,5,10,734,953296,5,953291
54461,15,-15,291,179902,15,179887
54462,17,8,696,903489,17,903472
54463,18,-15,331,180163,18,180145
54464,17,6,319,838243,17,838226
54465,7,-5,4,467857,7,467850
54466,16,-9,481,370472,16,370456
54467,16,-4,395,525199,16,525183
54468,11,5,780,809438,11,809427
54469,19,15,296,1118989,19,1118970
54470,5,-3,668,545505,5,545500
54471,18,19,13,1240763,18,1240745
54472,15,-2,599,589614,15,589599
54473,11,-20,546,26962,11,26951
54474,14,-19,89,54622,14,54608
54475,7,-19,930,51482,7,51475
54476,10,-6,136,439628,10,439618
54477,6,3,732,734724,6,734718
54478,14,6,339,838424,14,838410
54479,7,2,59,689915,7,689908
54480,15,1,854,686468,15,686453
54481,17,19,385,1243909,17,1243892
54482,7,1,883,676180,7,676173
54483,19,10,885,966582,19,966563
54484,15,0,680,653479,15,653464
54485,9,-5,196,472301,9,472292
54486,13,-15,52,178172,13,178159
54487,13,17,55,1178299,13,1178286
54488,16,14,266,1087480,16,1087464
54489,13,1,438,683272,13,683259
54490,17,2,194,712055,17,712038
54491,14,-8,708,402902,14,402888
54492,9,-16,86,125775,9,125766
54493,10,8,18,875556,10,875546
54494,12,8,275,900118,12,900106
54495,20,-9,922,373881,20,373861
54496,18,-1,570,621053,18,621035
54497,8,9,229,911601,8,911593
54498,9,5,162,784938,9,784929
54499,10,12,486,1009585,10,1009575
54500,5,-13,475,228343,5,228338
54501,5,-13,385,226410,5,226405
54502,7,-18,91,64519,7,64512
54503,13,13,801,1059270,13,1059257
54504,18,12,847,1028444,18,1028426
54505,6,4,684,765338,6,765332
54506,16,-20,798,29000,16,28984
54507,13,-9,164,367751,13,367738
54508,15,-15,493,181421,15,181406
54509,16,12,416,1025078,16,1025062
54510,19,15,978,1123988,19,1123969
54511,13,-2,148,586195,13,586182
54512,12,-14,748,215275,12,215263
54513,17,-13,800,246993,17,246976
54514,19,7,508,870786,19,870767
54515,10,-3,926,551228,10,551218
54516,20,19,345,1243539,20,1243519
54517,13,-10,993,342655,13,342642
54518,18,9,761,934577,18,934559
54519,18,19,700,1246467,18,1246449
54520,15,6,436,839274,15,839259
54521,8,12,646,1013275,8,1013267
54522,11,-15,878,184410,11,184399
54523,18,16,948,1153830,18,1153812
54524,12,-1,981,623991,12,623979
54525,16,9,848,935361,16,935345
54526,5,19,439,1227718,5,1227713
54527,13,17,753,1183480,13,1183467
54528,7,17,408,1163952,7,1163945
54529,20,2,654,715487,20,715467
54530,12,-17,434,118686,12,118674
54531,8,0,228,630385,8,630377
54532,8,-3,108,532762,8,532754
54533,5,-1,958,614551,5,614546
54534,13,2,942,717475,13,717462
54535,10,-2,795,579703,10,579693
54536,18,-12,966,279842,18,279824
54537,15,6,247,837619,15,837604
54538,20,-8,144,398920,20,398900
54539,8,-19,201,36064,8,36056
54540,8,-3,925,551204,8,551196
54541,11,9,802,934988,11,934977
54542,17,-12,738,277881,17,277864
54543,18,7,721,872249,18,872231
54544,10,14,342,1069376,10,1069366
54545,18,-9,734,372177,18,372159
54546,7,8,683,890251,7,890244
54547,15,-10,600,339542,15,339527
54548,6,-5,15,468080,6,468074
54549,7,7,202,849086,7,849079
54550,18,-1,213,618213,18,618195
54551,5,5,527,792571,5,792566
54552,6,16,5,1125287,6,1125281
54553,11,-14,765,215490,11,215479
54554,5,-20,7,180,5,175
54555,12,-17,422,118556,12,118544
54556,17,9,408,932008,17,931991
54557,11,1,114,680704,11,680693
54558,18,-11,36,303918,18,303900
54559,18,-6,227,460920,18,460902
54560,20,-13,927,248021,20,248001
54561,11,10,330,962333,11,962322
54562,13,13,210,1054787,13,1054774
54563,20,19,771,1247046,20,1247026
54564,19,15,72,1117297,19,1117278
54565,13,4,791,779056,13,779043
54566,10,5,15,781946,10,781936
54567,5,1,679,671929,5,671924
54568,8,-14,137,189507,8,189499
54569,16,-15,900,184571,16,184555
54570,13,-7,820,434264,13,434251
54571,11,0,354,650711,11,650700
54572,5,3,828,736654,5,736649
54573,7,12,46,1000132,7,1000125
54574,16,12,261,1024032,16,1024016
54575,5,15,24,1095012,5,1095007
54576,8,-14,743,202860,8,202852
54577,12,0,373,650899,12,650887
54578,16,7,929,873616,16,873600
54579,13,4,195,774654,13,774641
54580,17,-10,609,339642,17,339625
54581,12,13,32,1053441,12,1053429
54582,6,15,191,1098551,6,1098545
54583,9,-7,689,420387,9,420378
54584,11,-4,814,528079,11,528068
54585,15,-2,676,590213,15,590198
54586,16,-9,550,371089,16,371073
54587,19,-4,146,523156,19,523137
54588,12,17,485,1181546,12,1181534
54589,10,9,708,921670,10,921660
54590,19,9,884,935625,19,935606
54591,7,0,688,640435,7,640428
54592,10,3,142,721902,10,721892
54593,6,14,508,1073178,6,1073172
54594,17,5,563,807873,17,807856
54595,15,6,589,840527,15,840512
54596,6,17,202,1159568,6,1159562
54597,12,13,273,1055181,12,1055169
54598,13,19,98,1241552,13,1241539
54599,12,-10,539,339087,12,339075
54600,8,16,94,1127108,8,1127100
54601,13,0,803,654422,13,654409
54602,8,17,207,1159664,8,1159656
54603,5,13,261,1036217,5,1036212
54604,8,-20,934,20608,8,20600
54605,10,-3,795,548209,10,548199
54606,13,-10,686,340283,13,340270
54607,15,1,17,679870,15,679855
54608,15,8,923,905136,15,905121
54609,8,-11,308,287976,8,287968
54610,6,1,505,668324,6,668318
54611,13,13,147,1054294,13,1054281
54612,13,8,804,904292,13,904279
54613,11,4,173,774545,11,774534
54614,7,-15,318,162303,7,162296
54615,15,-8,313,400088,15,400073
54616,15,19,972,1248579,15,1248564
54617,10,0,86,627183,10,627173
54618,20,-6,115,459941,20,459921
54619,9,6,126,814870,9,814861
54620,14,-16,692,151998,14,151984
54621,8,17,942,1175468,8,1175460
54622,15,-13,92,241702,15,241687
54623,20,2,988,717798,20,717778
54624,20,14,8,1085430,20,1085410
54625,17,4,550,777250,17,777233
54626,9,19,586,1230721,9,1230712
54627,15,-6,233,460990,15,460975
54628,6,-12,861,268360,6,268354
54629,14,-9,882,373586,14,373572
54630,13,-8,294,399943,13,399930
54631,7,12,120,1001753,7,1001746
54632,16,0,357,650735,16,650719
54633,12,-5,752,496531,12,496519
54634,14,-1,902,623466,14,623452
54635,11,-3,607,558574,11,558563
54636,13,19,593,1245604,13,1245591
54637,19,6,170,837020,19,837001
54638,10,17,282,1161396,10,1161386
54639,7,12,837,1017284,7,1017277
54640,16,-17,711,120837,16,120821
54641,9,-18,669,76738,9,76729
54642,6,-15,2,155365,6,155359
54643,11,8,834,904441,11,904430
54644,12,2,88,711200,12,711188
54645,20,-15,829,184013,20,183993
54646,8,-1,149,596999,8,596991
54647,20,-16,311,149236,20,149216
54648,19,-4,768,527799,19,527780
54649,17,5,820,809772,17,809755
54650,10,-11,951,301663,10,301653
54651,7,-15,801,172490,7,172483
54652,16,-20,536,26866,16,26850
54653,15,3,588,746217,15,746202
54654,17,-9,711,372047,17,372030
54655,13,1,842,686361,13,686348
54656,12,-18,74,85793,12,85781
54657,18,19,550,1245285,18,1245267
54658,17,-2,891,591951,17,591934
54659,20,-17,689,120676,20,120656
54660,16,-9,355,369317,16,369301
54661,15,9,555,933136,15,933121
54662,10,-15,977,176282,10,176272
54663,18,-16,104,147692,18,147674
54664,5,17,775,1171756,5,1171751
54665,14,-9,634,371550,14,371536
54666,19,-19,595,58694,19,58675
54667,8,-8,794,392349,8,392341
54668,12,-14,369,212361,12,212349
54669,8,17,106,1157510,8,1157502
54670,9,-10,700,327793,9,327784
54671,9,10,464,947488,9,947479
54672,9,-10,424,321841,9,321832
54673,5,11,942,988712,5,988707
54674,9,-8,70,376998,9,376989
54675,17,-12,350,275153,17,275136
54676,6,1,968,678062,6,678056
54677,17,4,845,779579,17,779562
54678,12,10,998,967419,12,967407
54679,12,-16,248,148784,12,148772
54680,18,2,822,716612,18,716594
54681,12,-9,936,374015,12,374003
54682,13,-15,266,179686,13,179673
54683,17,15,391,1119628,17,1119611
54684,12,-19,245,55967,12,55955
54685,11,-5,964,498137,11,498126
54686,16,6,832,842470,16,842454
54687,9,-17,13,93876,9,93867
54688,20,-8,20,398032,20,398012
54689,15,-20,646,27708,15,27693
54690,11,-14,270,211536,11,211525
54691,8,-13,91,220368,8,220360
54692,9,4,248,756081,9,756072
54693,12,-7,624,432891,12,432879
54694,14,6,373,838684,14,838670
54695,10,0,820,643192,10,643182
54696,8,-16,514,135216,8,135208
54697,10,11,91,970397,10,970387
54698,7,16,72,1126692,7,1126685
54699,20,-3,480,557460,20,557440
54700,10,2,416,697638,10,697628
54701,17,14,579,1089918,17,1089901
54702,5,-11,688,296233,5,296228
54703,14,14,779,1091592,14,1091578
54704,17,8,299,900323,17,900306
54705,17,1,439,683278,17,683261
54706,9,6,971,834163,9,834154
54707,16,-14,649,214591,16,214575
54708,15,14,543,1089705,15,1089690
54709,14,0,727,653899,14,653885
54710,9,-19,9,31630,9,31621
54711,6,-16,622,137542,6,137536
54712,20,-18,970,92270,20,92250
54713,19,-19,521,58017,19,57998
54714,18,-16,495,150652,18,150634
54715,8,-5,888,487368,8,487360
54716,18,-14,254,211428,18,211410
54717,6,3,169,722414,6,722408
54718,17,-14,727,215164,17,215147
54719,13,-3,674,559163,13,559150
54720,17,-7,765,433863,17,433846
54721,12,11,263,992732,12,992720
54722,9,-17,404,102052,9,102043
54723,18,-14,204,210901,18,210883
54724,16,14,728,1091171,16,1091155
54725,14,-10,442,338318,14,338304
54726,20,18,593,1213185,20,1213165
54727,20,4,848,779631,20,779611
54728,9,18,46,1187646,9,1187637
54729,19,-7,304,430614,19,430595
54730,6,-11,941,301342,6,301336
54731,6,-4,443,509138,6,509132
54732,9,13,378,1038829,9,1038820
54733,17,-5,32,491059,17,491042
54734,18,-16,555,151073,18,151055
54735,7,-13,547,229970,7,229963
54736,16,-1,765,622431,16,622415
54737,11,-12,195,273877,11,273866
54738,8,2,857,706444,8,706436
54739,20,5,466,807243,20,807223
54740,10,16,267,1130881,10,1130871
54741,5,-2,966,583505,5,583500
54742,13,-1,615,621349,13,621336
54743,6,2,929,707930,6,707924
54744,13,-19,262,56069,13,56056
54745,6,-7,226,410645,6,410639
54746,18,-12,837,278693,18,278675
54747,15,8,837,904462,15,904447
54748,11,10,777,965842,11,965831
54749,11,15,460,1120041,11,1120030
54750,16,3,189,743312,16,743296
54751,11,19,163,1242064,11,1242053
54752,11,-12,704,277676,11,277665
54753,17,-16,848,153133,17,153116
54754,15,-9,73,367180,15,367165
54755,16,-14,274,211578,16,211562
54756,12,-5,658,495807,12,495795
54757,18,7,126,867917,18,867899
54758,20,5,107,804584,20,804564
54759,6,-17,731,109181,6,109175
54760,8,6,600,825849,8,825841
54761,11,19,295,1243106,11,1243095
54762,11,18,821,1214883,11,1214872
54763,9,-5,978,489320,9,489311
54764,9,0,26,625855,9,625846
54765,9,-11,282,287208,9,287199
54766,15,-18,692,90253,15,90238
54767,18,-8,290,399933,18,399915
54768,8,-2,762,579005,8,578997
54769,15,-1,276,618706,15,618691
54770,13,-9,108,367377,13,367364
54771,20,-14,766,215503,20,215483
54772,10,-5,742,484055,10,484045
54773,16,19,22,1240886,16,1240870
54774,5,-15,955,175848,5,175843
54775,9,17,441,1164724,9,1164715
54776,11,7,401,870024,11,870013
54777,20,-9,648,371653,20,371633
54778,10,-1,229,598895,10,598885
54779,16,-9,815,373003,16,372987
54780,16,-19,103,54738,16,54722
54781,18,5,452,807090,18,807072
54782,7,12,887,1018567,7,1018560
54783,14,10,638,964854,14,964840
54784,20,6,907,842993,20,842973
54785,19,5,959,810867,19,810848
54786,15,0,567,652517,15,652502
54787,17,-5,841,497123,17,497106
54788,5,1,842,675271,5,675266
54789,14,-7,714,433514,14,433500
54790,10,-8,775,391966,10,391956
54791,12,-6,309,461554,12,461542
54792,9,1,443,666826,9,666817
54793,19,12,257,1023990,19,1023971
54794,10,4,444,760186,10,760176
54795,9,-7,420,414915,9,414906
54796,5,0,607,638502,5,638497
54797,6,14,514,1073272,6,1073266
54798,20,6,995,843708,20,843688
54799,6,-19,725,47414,6,47408
54800,9,1,668,671724,9,671715
54801,20,16,900,1153510,20,1153490
54802,19,0,9,648264,19,648245
54803,19,18,737,1214242,19,1214223
54804,17,6,53,836173,17,836156
54805,16,-20,307,25238,16,25222
54806,7,-6,832,454614,7,454607
54807,18,-4,915,528940,18,528922
54808,11,10,698,965276,11,965265
54809,7,16,914,1144197,7,1144190
54810,20,5,119,804653,20,804633
54811,10,-3,570,543354,10,543344
54812,8,17,23,1155760,8,1155752
54813,16,8,434,901424,16,901408
54814,10,11,398,977061,10,977051
54815,17,2,643,715371,17,715354
54816,20,1,901,686855,20,686835
54817,13,-12,141,273590,13,273577
54818,16,17,553,1181994,16,1181978
54819,16,19,162,1242064,16,1242048
54820,5,3,883,737865,5,737860
54821,14,17,763,1183531,14,1183517
54822,13,-8,69,398488,13,398475
54823,12,3,464,745307,12,745295
54824,12,-15,884,184462,12,184450
54825,8,10,220,942228,8,942220
54826,9,17,658,1169415,9,1169406
54827,9,-6,183,440907,9,440898
54828,10,10,893,956707,10,956697
54829,5,-2,66,564317,5,564312
54830,19,-14,825,215943,19,215924
54831,8,-6,173,440569,8,440561
54832,13,-17,6,115596,13,115583
54833,13,-3,22,553969,13,553956
54834,10,-2,184,566668,10,566658
54835,7,17,278,1161303,7,1161296
54836,12,0,24,648401,12,648389
54837,8,18,318,1193622,8,1193614
54838,11,6,82,836336,11,836325
54839,18,11,774,996476,18,996458
54840,17,-13,37,241340,17,241323
54841,7,7,759,860830,7,860823
54842,20,7,148,868091,20,868071
54843,8,-3,912,550886,8,550878
54844,14,16,509,1150715,14,1150701
54845,19,8,844,904529,19,904510
54846,17,-13,369,243737,17,243720
54847,16,16,402,1150013,16,1149997
54848,15,-2,879,591858,15,591843
54849,16,-8,802,403620,16,403604
54850,11,14,246,1087346,11,1087335
54851,20,-17,448,118812,20,118792
54852,5,-2,857,581138,5,581133
54853,12,2,423,713829,12,713817
54854,12,1,502,683822,12,683810
54855,14,18,798,1214780,14,1214766
54856,19,8,456,901571,19,901552
54857,20,6,998,843737,20,843717
54858,20,13,479,1056780,20,1056760
54859,16,-18,31,85435,16,85419
54860,14,-7,860,434605,14,434591
54861,8,-12,551,261466,8,261458
54862,8,5,201,785914,8,785906
54863,10,8,511,886450,10,886440
54864,10,6,560,824886,10,824876
54865,18,15,343,1119323,18,1119305
54866,7,7,264,850429,7,850422
54867,16,17,139,1178912,16,1178896
54868,6,14,965,1083374,6,1083368
54869,20,10,848,966316,20,966296
54870,13,16,659,1151845,13,1151832
54871,11,3,165,743074,11,743063
54872,13,15,258,1118679,13,1118666
54873,8,6,786,829959,8,829951
54874,15,14,732,1091186,15,1091171
54875,19,15,627,1121381,19,1121362
54876,6,18,186,1191006,6,1191000
54877,16,-2,205,586646,16,586630
54878,15,-15,389,180611,15,180596
54879,5,6,100,814331,5,814326
54880,6,-12,688,264355,6,264349
54881,6,17,396,1163774,6,1163768
54882,16,-2,696,590400,16,590384
54883,9,-11,135,284087,9,284078
54884,18,10,138,960966,18,960948
54885,5,-10,683,327404,5,327399
54886,7,-14,980,207873,7,207866
54887,16,-13,887,247666,16,247650
54888,8,3,328,726047,8,726039
54889,10,-6,379,444963,10,444953
54890,15,13,778,1059065,15,1059050
54891,10,3,155,722129,10,722119
54892,10,-14,72,188138,10,188128
54893,13,14,135,1086539,13,1086526
54894,12,12,546,1026081,12,1026069
54895,18,-6,64,459574,18,459556
54896,17,11,460,994205,17,994188
54897,6,-9,810,361662,6,361656
54898,17,-20,130,23747,17,23730
54899,11,-19,384,56981,11,56970
54900,18,-13,808,247063,18,247045
54901,19,6,535,840102,19,840083
54902,19,-15,887,184480,19,184461
54903,13,19,986,1248686,13,1248673
54904,17,-12,26,272698,17,272681
54905,8,-18,779,79332,8,79324
54906,11,-16,991,154241,11,154230
54907,5,4,542,762278,5,762273
54908,7,8,489,885914,7,885907
54909,19,-8,340,400308,19,400289
54910,6,-19,582,44332,6,44326
54911,5,18,113,1189258,5,1189253
54912,17,-14,907,216570,17,216553
54913,20,9,314,931315,20,931295
54914,7,12,10,999224,7,999217
54915,18,15,710,1122048,18,1122030
54916,10,2,960,708750,10,708740
54917,13,3,962,749204,13,749191
54918,19,11,913,997514,19,997495
54919,12,-15,675,182794,12,182782
54920,5,18,521,1197968,5,1197963
54921,12,-9,315,368916,12,368904
54922,11,-8,561,401782,11,401771
54923,7,-14,892,205883,7,205876
54924,11,17,792,1183829,11,1183818
54925,14,-19,306,56359,14,56345
54926,18,-5,383,493846,18,493828
54927,16,11,34,991136,16,991120
54928,10,-12,233,254524,10,254514
54929,9,-14,260,192481,9,192472
54930,13,0,679,653460,13,653447
54931,6,-15,509,166424,6,166418
54932,17,-4,824,528118,17,528101
54933,8,10,861,956039,8,956031
54934,15,-12,735,277863,15,277848
54935,15,-6,684,464359,15,464344
54936,8,-20,791,17470,8,17462
54937,5,19,915,1237826,5,1237821
54938,16,-2,754,590764,16,590748
54939,14,-11,297,306063,14,306049
54940,10,-16,728,139651,10,139641
54941,18,15,751,1122401,18,1122383
54942,6,-3,149,533640,6,533634
54943,19,-7,649,433035,19,433016
54944,8,13,777,1047423,8,1047415
54945,20,-9,829,373106,20,373086
54946,13,-13,935,248098,13,248085
54947,19,8,567,902416,19,902397
54948,18,12,656,1026916,18,1026898
54949,16,15,208,1118370,16,1118354
54950,18,17,465,1181422,18,1181404
54951,8,-10,972,333399,8,333391
54952,12,1,241,681793,12,681781
54953,14,3,940,749000,14,748986
54954,13,-3,329,556197,13,556184
54955,17,-7,136,429277,17,429260
54956,14,12,621,1026657,14,1026643
54957,15,-20,162,23997,15,23982
54958,9,-20,161,3525,9,3516
54959,11,-11,926,310917,11,310906
54960,18,-2,587,589539,18,589521
54961,10,0,588,638121,10,638111
54962,15,-3,784,560106,15,560091
54963,6,-3,600,543900,6,543894
54964,9,-17,839,111273,9,111264
54965,8,16,671,1139266,8,1139258
54966,11,16,31,1147288,11,1147277
54967,9,-10,315,319409,9,319400
54968,11,7,433,870270,11,870259
54969,13,6,961,843388,13,843375
54970,8,-9,476,354308,8,354300
54971,19,-8,241,399615,19,399596
54972,10,12,520,1010228,10,1010218
54973,6,2,637,702097,6,702091
54974,13,16,904,1153551,13,1153538
54975,16,-16,387,149731,16,149715
54976,15,-7,884,434821,15,434806
54977,13,5,124,804693,13,804680
54978,10,13,552,1042624,10,1042614
54979,6,-1,292,600339,6,600333
54980,6,6,629,826496,6,826490
54981,8,-2,899,582044,8,582036
54982,10,8,50,876145,10,876135
54983,7,-19,150,35015,7,35008
54984,7,4,77,752235,7,752228
54985,7,1,340,664724,7,664717
54986,10,2,358,696447,10,696437
54987,12,-18,221,86983,12,86971
54988,10,19,568,1230329,10,1230319
54989,13,15,227,1118516,13,1118503
54990,18,12,997,1029798,18,1029780
54991,18,15,932,1123581,18,1123563
54992,20,-18,886,91648,20,91628
54993,13,6,245,837599,13,837586
54994,8,-14,549,198383,8,198375
54995,7,-16,86,125782,7,125775
54996,11,5,684,808796,11,808785
54997,12,19,410,1244164,12,1244152
54998,7,-7,935,425832,7,425825
54999,13,9,927,935989,13,935976
55000,20,-1,443,620077,20,620057
55001,11,10,968,967226,11,967215
55002,9,-18,747,78573,9,78564
55003,14,15,802,1122638,14,1122624
55004,15,-11,630,308734,15,308719
55005,11,-8,270,399758,11,399747
55006,6,-15,511,166481,6,166475
55007,19,9,45,929410,19,929391
55008,14,15,124,1117754,14,1117740
55009,11,-11,873,310552,11,310541
55010,10,-13,335,225435,10,225425
55011,19,0,262,650132,19,650113
55012,12,-14,901,216512,12,216500
55013,16,3,206,743460,16,743444
55014,8,3,683,733604,8,733596
55015,13,19,951,1248418,13,1248405
55016,5,-19,539,43226,5,43221
55017,11,4,120,774112,11,774101
55018,5,12,29,999721,5,999716
55019,12,-20,578,27193,12,27181
55020,8,-20,549,12031,8,12023
55021,12,3,398,744870,12,744858
55022,19,-13,597,245425,19,245406
55023,6,-19,757,48185,6,48179
55024,10,-15,974,176215,10,176205
55025,13,-11,905,310820,13,310807
55026,12,-20,48,23162,12,23150
55027,18,-13,870,247524,18,247506
55028,16,-5,535,495012,16,494996
55029,15,-18,481,88868,15,88853
55030,7,-4,851,517562,7,517555
55031,15,-2,7,585170,15,585155
55032,17,-17,614,120103,17,120086
55033,14,4,429,776359,14,776345
55034,19,-15,534,181703,19,181684
55035,16,-19,948,61158,16,61142
55036,8,-7,777,422344,8,422336
55037,8,-2,505,573547,8,573539
55038,20,12,821,1028171,20,1028151
55039,14,10,491,963561,14,963547
55040,10,-16,328,131055,10,131045
55041,16,-11,62,304169,16,304153
55042,6,4,179,754464,6,754458
55043,20,-7,68,428793,20,428773
55044,7,-7,871,424367,7,424360
55045,13,-14,951,216871,13,216858
55046,6,8,796,892685,6,892679
55047,11,3,238,743676,11,743665
55048,18,13,468,1056696,18,1056678
55049,7,-7,340,413287,7,413280
55050,8,-6,743,452793,8,452785
55051,7,4,209,755159,7,755152
55052,14,19,462,1244614,14,1244600
55053,12,11,315,993164,12,993152
55054,8,-5,832,485961,8,485953
55055,6,-5,231,473057,6,473051
55056,19,-4,669,527154,19,527135
55057,18,3,972,749302,18,749284
55058,20,19,96,1241535,20,1241515
55059,5,-4,833,517039,5,517034
55060,19,-13,529,244941,19,244922
55061,17,-15,56,178188,17,178171
55062,10,-20,680,15051,10,15041
55063,6,16,907,1143995,6,1143989
55064,11,9,612,933589,11,933578
55065,12,4,18,773379,12,773367
55066,13,-14,732,215210,13,215197
55067,7,6,175,815971,7,815964
55068,5,-1,224,598723,5,598718
55069,19,4,78,773803,19,773784
55070,10,-8,133,378240,10,378230
55071,13,2,597,715045,13,715032
55072,5,8,139,878090,5,878085
55073,9,-20,266,5874,9,5865
55074,15,18,348,1211630,15,1211615
55075,11,18,6,1208967,11,1208956
55076,16,12,30,1022314,16,1022298
55077,14,5,843,809924,14,809910
55078,20,3,26,741980,20,741960
55079,20,1,95,680551,20,680531
55080,10,3,788,735756,10,735746
55081,18,-12,171,273769,18,273751
55082,12,4,183,774563,12,774551
55083,16,-14,288,211655,16,211639
55084,7,-9,307,350296,7,350289
55085,6,-7,179,409674,6,409668
55086,15,7,854,873160,15,873145
55087,19,-20,61,23256,19,23237
55088,6,5,722,796704,6,796698
55089,16,15,561,1120835,16,1120819
55090,12,4,198,774660,12,774648
55091,9,-9,493,354853,9,354844
55092,15,19,148,1241967,15,1241952
55093,18,-20,534,26835,18,26817
55094,6,-4,750,515449,6,515443
55095,10,17,735,1170975,10,1170965
55096,9,-19,441,41024,9,41015
55097,12,13,123,1054141,12,1054129
55098,10,-20,436,9305,10,9295
55099,12,-17,73,116054,12,116042
55100,6,19,692,1232790,6,1232784
55101,10,-6,522,448085,10,448075
55102,10,11,505,979236,10,979226
55103,7,-11,595,294318,7,294311
55104,18,-3,134,554733,18,554715
55105,17,-2,241,586974,17,586957
55106,6,-5,667,482414,6,482408
55107,11,14,227,1087190,11,1087179
55108,18,-3,730,559587,18,559569
55109,15,12,4,1022148,15,1022133
55110,9,6,154,815501,9,815492
55111,7,-14,428,196088,7,196081
55112,19,15,267,1118777,19,1118758
55113,13,-1,212,618201,13,618188
55114,11,0,660,653301,11,653290
55115,7,10,125,940404,7,940397
55116,20,3,501,745562,20,745542
55117,14,-14,681,214867,14,214853
55118,10,15,687,1108995,10,1108985
55119,8,-5,342,475662,8,475654
55120,6,-4,111,501766,6,501760
55121,15,10,482,963508,15,963493
55122,16,8,163,899237,16,899221
55123,8,0,877,644336,8,644328
55124,20,-3,870,560769,20,560749
55125,11,5,734,809142,11,809131
55126,9,-18,235,67685,9,67676
55127,13,-6,368,461972,13,461959
55128,20,5,501,807445,20,807425
55129,7,-6,348,444246,7,444239
55130,14,10,874,966525,14,966511
55131,9,16,770,1141039,9,1141030
55132,17,-7,361,431112,17,431095
55133,12,2,806,716505,12,716493
55134,8,-19,364,39359,8,39351
55135,15,-11,47,303974,15,303959
55136,13,-8,256,399714,13,399701
55137,11,-9,815,373004,11,372993
55138,5,-15,307,162070,5,162065
55139,6,3,568,730888,6,730882
55140,18,1,483,683675,18,683657
55141,15,-3,416,556873,15,556858
55142,12,-14,555,213770,12,213758
55143,18,-13,197,242518,18,242500
55144,20,-13,562,245182,20,245162
55145,15,-16,916,153667,15,153652
55146,15,1,729,685539,15,685524
55147,17,-2,612,589739,17,589722
55148,9,1,24,657572,9,657563
55149,15,5,235,805568,15,805553
55150,12,-12,739,277926,12,277914
55151,16,-19,734,59787,16,59771
55152,13,13,542,1057277,13,1057264
55153,9,0,139,628484,9,628475
55154,19,11,592,995147,19,995128
55155,6,-1,927,613993,6,613987
55156,11,5,382,806600,11,806589
55157,14,-5,903,497642,14,497628
55158,20,16,31,1147298,20,1147278
55159,8,-9,464,353944,8,353936
55160,19,14,513,1089462,19,1089443
55161,7,2,745,704346,7,704339
55162,12,-2,143,586174,12,586162
55163,15,19,234,1242564,15,1242549
55164,16,16,286,1149206,16,1149190
55165,13,-16,638,151691,13,151678
55166,13,-17,700,120740,13,120727
55167,12,-1,694,621904,12,621892
55168,14,-19,536,58158,14,58144
55169,9,3,487,729254,9,729245
55170,7,-17,905,112670,7,112663
55171,18,15,390,1119616,18,1119598
55172,16,-1,214,618227,16,618211
55173,16,-5,803,496814,16,496798
55174,15,7,344,869536,15,869521
55175,19,-6,109,459890,19,459871
55176,7,-14,0,186422,7,186415
55177,15,5,832,809854,15,809839
55178,10,13,564,1042909,10,1042899
55179,14,-5,961,498082,14,498068
55180,11,-16,851,153155,11,153144
55181,20,-17,94,116280,20,116260
55182,11,18,290,1211226,11,1211215
55183,12,-4,908,528899,12,528887
55184,18,-2,776,590943,18,590925
55185,12,-13,135,241969,12,241957
55186,5,-5,67,469329,5,469324
55187,17,10,330,962340,17,962323
55188,18,3,32,742047,18,742029
55189,9,-5,235,473180,9,473171
55190,15,-4,311,524512,15,524497
55191,10,-14,622,200368,10,200358
55192,10,7,558,856647,10,856637
55193,16,7,295,869140,16,869124
55194,18,14,480,1089192,18,1089174
55195,5,0,809,643060,5,643055
55196,6,-10,218,317395,6,317389
55197,14,-10,550,339161,14,339147
55198,17,16,137,1148074,17,1148057
55199,12,-14,550,213724,12,213712
55200,18,-5,67,491353,18,491335
55201,5,13,782,1047523,5,1047518
55202,12,-18,763,90817,12,90805
55203,5,-4,393,508184,5,508179
55204,9,16,306,1131645,9,1131636
55205,17,-8,405,400785,17,400768
55206,17,-9,567,371187,17,371170
55207,15,2,740,716134,15,716119
55208,5,15,727,1109978,5,1109973
55209,8,15,479,1104568,8,1104560
55210,15,8,520,902133,15,902118
55211,11,-6,470,462750,11,462739
55212,13,-12,289,274637,13,274624
55213,13,3,431,745085,13,745072
55214,14,-3,519,557806,14,557792
55215,5,0,175,629330,5,629325
55216,16,18,592,1213175,16,1213159
55217,18,-1,674,621747,18,621729
55218,13,-5,910,497716,13,497703
55219,10,10,110,939998,10,939988
55220,16,-8,858,403960,16,403944
55221,10,-7,352,413532,10,413522
55222,15,-14,280,211626,15,211611
55223,6,7,696,859548,6,859542
55224,5,7,119,847362,5,847357
55225,20,5,574,807975,20,807955
55226,16,-2,228,586861,16,586845
55227,9,-9,438,353352,9,353343
55228,14,3,486,745454,14,745440
55229,12,14,606,1090131,12,1090119
55230,6,-13,560,230228,6,230222
55231,10,-7,844,423768,10,423758
55232,16,-8,353,400384,16,400368
55233,14,-14,970,217043,14,217029
55234,20,1,197,681437,20,681417
55235,13,3,742,747439,13,747426
55236,9,-20,866,19267,9,19258
55237,20,2,556,714787,20,714767
55238,8,-4,258,505245,8,505237
55239,13,-13,275,243127,13,243114
55240,20,-13,947,248189,20,248169
55241,11,6,198,837216,11,837205
55242,15,-15,175,179036,15,179021
55243,16,-5,128,491934,16,491918
55244,15,-5,844,497144,15,497129
55245,10,-18,60,63670,10,63660
55246,5,11,302,974852,5,974847
55247,19,-4,965,529352,19,529333
55248,13,4,589,777532,13,777519
55249,16,14,524,1089532,16,1089516
55250,8,-18,500,73224,8,73216
55251,14,12,79,1022616,14,1022602
55252,8,17,582,1167657,8,1167649
55253,17,-3,605,558560,17,558543
55254,7,-17,501,104289,7,104282
55255,17,-1,667,621696,17,621679
55256,17,17,726,1183330,17,1183313
55257,16,5,335,806248,16,806232
55258,10,-2,454,572469,10,572459
55259,18,-4,878,528651,18,528633
55260,12,12,790,1027936,12,1027924
55261,11,10,275,961902,11,961891
55262,17,19,323,1243367,17,1243350
55263,8,-9,564,356301,8,356293
55264,18,6,393,838883,18,838865
55265,5,-15,171,159029,5,159024
55266,20,-12,885,279130,20,279110
55267,16,17,696,1183069,16,1183053
55268,6,-12,172,253211,6,253205
55269,10,-18,315,69430,10,69420
55270,12,5,237,805578,12,805566
55271,18,18,760,1214457,18,1214439
55272,15,-4,881,528695,15,528680
55273,7,6,230,817404,7,817397
55274,8,-19,195,35893,8,35885
55275,6,4,626,764172,6,764166
55276,17,3,281,744026,17,744009
55277,9,17,451,1165000,9,1164991
55278,17,-3,553,558161,17,558144
55279,9,-3,525,542362,9,542353
55280,7,17,128,1157964,7,1157957
55281,10,-2,172,566354,10,566344
55282,13,3,134,742849,13,742836
55283,20,14,260,1087467,20,1087447
55284,16,11,156,991931,16,991915
55285,19,9,465,932394,19,932375
55286,15,2,829,716680,15,716665
55287,6,-14,375,194958,6,194952
55288,16,-15,699,182947,16,182931
55289,6,17,687,1169979,6,1169973
55290,18,9,55,929480,18,929462
55291,11,9,636,933798,11,933787
55292,18,-1,227,618364,18,618346
55293,14,-9,629,371516,14,371502
55294,7,-20,123,2732,7,2725
55295,8,19,851,1236408,8,1236400
55296,6,-15,414,164390,6,164384
55297,15,19,298,1243149,15,1243134
55298,5,-11,303,287790,5,287785
55299,18,10,832,966253,18,966235
55300,7,-10,795,329592,7,329585
55301,17,-14,101,210112,17,210095
55302,13,-10,681,340216,13,340203
55303,15,-3,849,560571,15,560556
55304,20,0,398,651101,20,651081
55305,20,8,542,902225,20,902205
55306,8,-18,441,71860,8,71852
55307,18,17,588,1182219,18,1182201
55308,8,17,451,1165008,8,1165000
55309,11,-1,242,618478,11,618467
55310,15,-18,571,89380,15,89365
55311,5,13,883,1049716,5,1049711
55312,9,10,615,950749,9,950740
55313,15,8,834,904446,15,904431
55314,13,6,463,839479,13,839466
55315,16,-10,61,335662,16,335646
55316,7,-4,623,512858,7,512851
55317,11,12,420,1025108,11,1025097
55318,16,12,887,1028755,16,1028739
55319,11,-1,13,616580,11,616569
55320,18,-7,863,434623,18,434605
55321,20,19,520,1245085,20,1245065
55322,7,-8,226,380301,7,380294
55323,14,-9,120,367482,14,367468
55324,18,-18,204,86893,18,86875
55325,7,-17,862,111683,7,111676
55326,12,-5,180,492318,12,492306
55327,10,14,49,1062902,10,1062892
55328,7,5,944,801581,7,801574
55329,13,10,877,966549,13,966536
55330,8,3,176,722587,8,722579
55331,7,7,907,864018,7,864011
55332,6,11,835,986271,6,986265
55333,8,4,852,769454,8,769446
55334,14,-13,75,241603,14,241589
55335,9,-2,464,572643,9,572634
55336,17,-19,728,59693,17,59676
55337,6,17,168,1158820,6,1158814
55338,10,4,764,767247,10,767237
55339,11,-4,803,528019,11,528008
55340,14,9,3,929072,14,929058
55341,12,19,474,1244697,12,1244685
55342,15,-13,551,245101,15,245086
55343,11,-1,263,618595,11,618584
55344,17,4,514,776982,17,776965
55345,13,17,511,1181743,13,1181730
55346,17,-3,212,555269,17,555252
55347,19,13,569,1057533,19,1057514
55348,19,19,560,1245363,19,1245344
55349,12,-11,583,308394,12,308382
55350,19,-15,414,180822,19,180803
55351,9,11,490,978919,9,978910
55352,18,-6,185,460596,18,460578
55353,6,8,629,888998,6,888992
55354,19,7,232,868661,19,868642
55355,13,13,657,1058204,13,1058191
55356,14,-8,83,398596,14,398582
55357,16,17,221,1179497,16,1179481
55358,5,-18,488,72928,5,72923
55359,18,11,432,994017,18,993999
55360,18,-2,61,585604,18,585586
55361,5,-19,470,41694,5,41689
55362,11,18,979,1216176,11,1216165
55363,10,-18,453,72151,10,72141
55364,11,-12,418,275580,11,275569
55365,6,-19,427,40729,6,40723
55366,11,-13,704,246174,11,246163
55367,13,13,544,1057328,13,1057315
55368,14,0,993,655884,14,655870
55369,17,-15,497,181427,17,181410
55370,7,2,268,694406,7,694399
55371,18,12,479,1025586,18,1025568
55372,6,-17,983,114220,6,114214
55373,10,-8,329,382430,10,382420
55374,16,-6,236,461014,16,460998
55375,9,2,257,694159,9,694150
55376,7,12,260,1004924,7,1004917
55377,12,-17,635,120256,12,120244
55378,20,-19,645,59087,20,59067
55379,20,3,33,742062,20,742042
55380,11,15,642,1121480,11,1121469
55381,16,6,501,839833,16,839817
55382,8,-5,292,474500,8,474492
55383,10,-6,811,454255,10,454245
55384,14,17,825,1184134,14,1184120
55385,6,-20,635,13883,6,13877
55386,13,-3,351,556353,13,556340
55387,20,7,333,869457,20,869437
55388,13,-13,804,247030,13,247017
55389,18,-2,400,588083,18,588065
55390,5,8,160,878569,5,878564
55391,11,-12,835,278678,11,278667
55392,15,-9,166,367761,15,367746
55393,5,1,108,659458,5,659453
55394,19,-3,766,559921,19,559902
55395,20,-10,742,340681,20,340661
55396,8,12,264,1005043,8,1005035
55397,5,-10,298,318981,5,318976
55398,6,15,668,1108615,6,1108609
55399,18,-1,953,623823,18,623805
55400,12,-16,571,151199,12,151187
55401,13,-12,736,277865,13,277852
55402,18,2,666,715582,18,715564
55403,6,-5,48,468939,6,468933
55404,14,-17,690,120679,14,120665
55405,20,-11,621,308682,20,308662
55406,11,19,565,1245389,11,1245378
55407,17,1,730,685545,17,685528
55408,13,-20,546,26965,13,26952
55409,8,18,447,1196332,8,1196324
55410,13,12,57,1022488,13,1022475
55411,14,6,754,841841,14,841827
55412,7,3,102,721038,7,721031
55413,12,11,381,993647,12,993635
55414,6,16,871,1143184,6,1143178
55415,6,10,573,949809,6,949803
55416,6,-17,454,103131,6,103125
55417,11,-8,708,402903,11,402892
55418,10,-18,79,64235,10,64225
55419,7,-4,474,509655,7,509648
55420,17,16,111,1147835,17,1147818
55421,18,-20,754,28616,18,28598
55422,17,2,668,715606,17,715589
55423,15,-12,887,279147,15,279132
55424,9,-13,682,232723,9,232714
55425,13,-18,519,89075,13,89062
55426,16,-20,989,30358,16,30342
55427,5,15,136,1097443,5,1097438
55428,15,2,69,711068,15,711053
55429,7,7,752,860625,7,860618
55430,16,18,217,1210747,16,1210731
55431,16,8,587,902573,16,902557
55432,11,0,555,652418,11,652407
55433,6,-14,135,189430,6,189424
55434,20,11,128,991751,20,991731
55435,20,8,958,905401,20,905381
55436,18,18,366,1211787,18,1211769
55437,14,3,135,742852,14,742838
55438,15,7,181,868323,15,868308
55439,13,1,258,681942,13,681929
55440,6,17,450,1164967,6,1164961
55441,8,1,146,660386,8,660378
55442,11,14,634,1090379,11,1090368
55443,11,-6,342,461823,11,461812
55444,18,3,742,747447,18,747429
55445,7,6,133,815081,7,815074
55446,7,0,536,636952,7,636945
55447,15,-18,578,89453,15,89438
55448,8,1,431,666531,8,666523
55449,7,11,556,980338,7,980331
55450,14,10,503,963683,14,963669
55451,9,-8,660,389552,9,389543
55452,20,-7,374,431215,20,431195
55453,14,9,797,934962,14,934948
55454,14,18,551,1213013,14,1212999
55455,10,-16,667,138355,10,138345
55456,12,4,863,779711,12,779699
55457,16,-5,761,496567,16,496551
55458,13,-15,611,182252,13,182239
55459,10,-11,797,298237,10,298227
55460,6,-4,435,509000,6,508994
55461,12,13,11,1053318,12,1053306
55462,20,0,459,651612,20,651592
55463,6,-10,217,317382,6,317376
55464,6,8,796,892691,6,892685
55465,20,2,587,714976,20,714956
55466,18,7,277,868986,18,868968
55467,9,-3,379,538762,9,538753
55468,8,-3,977,552344,8,552336
55469,12,-19,330,56540,12,56528
55470,7,-15,12,155571,7,155564
55471,12,-7,578,432683,12,432671
55472,18,8,644,903094,18,903076
55473,18,10,293,962018,18,962000
55474,19,0,273,650181,19,650162
55475,18,-8,681,402725,18,402707
55476,14,8,439,901496,14,901482
55477,15,-13,767,246725,15,246710
55478,18,-10,984,342516,18,342498
55479,18,-15,500,181465,18,181447
55480,19,-1,726,622192,19,622173
55481,18,-13,374,243779,18,243761
55482,15,-12,433,275633,15,275618
55483,17,-13,888,247676,17,247659
55484,7,11,124,971067,7,971060
55485,7,-5,422,477117,7,477110
55486,19,-10,392,337894,19,337875
55487,14,-8,968,404781,14,404767
55488,16,-5,853,497246,16,497230
55489,16,-11,249,305662,16,305646
55490,20,9,906,935823,20,935803
55491,20,4,210,774751,20,774731
55492,14,19,934,1248267,14,1248253
55493,6,13,337,1038074,6,1038068
55494,20,7,158,868193,20,868173
55495,6,-9,175,347289,6,347283
55496,17,13,532,1057168,17,1057151
55497,18,-19,43,54205,18,54187
55498,8,11,838,986384,8,986376
55499,20,9,532,932950,20,932930
55500,20,9,140,930089,20,930069
55501,17,-3,524,557947,17,557930
55502,10,6,424,821969,10,821959
55503,7,5,800,798351,7,798344
55504,19,7,122,867884,19,867865
55505,15,-7,971,435499,15,435484
55506,14,-1,342,619327,14,619313
55507,9,0,572,637718,9,637709
55508,18,-11,450,307383,18,307365
55509,6,-18,998,84170,6,84164
55510,18,14,447,1088948,18,1088930
55511,7,-1,863,612414,7,612407
55512,17,-3,328,556183,17,556166
55513,15,-20,827,29219,15,29204
55514,5,-14,53,187686,5,187681
55515,17,-1,812,622822,17,622805
55516,16,15,933,1123586,16,1123570
55517,11,-2,420,588266,11,588255
55518,17,2,94,711286,17,711269
55519,20,-18,954,92156,20,92136
55520,5,13,353,1038386,5,1038381
55521,10,-2,855,581125,10,581115
55522,18,9,421,932094,18,932076
55523,19,3,495,745526,19,745507
55524,10,-5,181,472091,10,472081
55525,15,-19,118,54940,15,54925
55526,8,15,635,1107933,8,1107925
55527,13,11,474,994323,13,994310
55528,5,-8,615,388439,5,388434
55529,8,-6,923,456493,8,456485
55530,15,14,469,1089089,15,1089074
55531,17,12,150,1023104,17,1023087
55532,8,-6,584,449362,8,449354
55533,16,-2,344,587688,16,587672
55534,9,-20,615,13429,9,13420
55535,12,14,927,1092665,12,1092653
55536,15,-12,56,272924,15,272909
55537,20,-4,312,524523,20,524503
55538,18,-3,749,559747,18,559729
55539,18,9,788,934882,18,934864
55540,19,-11,28,303879,19,303860
55541,14,6,315,838182,14,838168
55542,15,1,615,684681,15,684666
55543,14,0,789,654264,14,654250
55544,6,16,384,1133319,6,1133313
55545,18,-12,723,277806,18,277788
55546,12,16,897,1153470,12,1153458
55547,10,15,197,1098692,10,1098682
55548,8,5,943,801530,8,801522
55549,20,4,656,778049,20,778029
55550,5,-1,270,599780,5,599775
55551,19,13,718,1058593,19,1058574
55552,17,-3,838,560490,17,560473
55553,7,-8,638,389026,7,389019
55554,18,8,394,901088,18,901070
55555,18,-3,413,556857,18,556839
55556,18,16,193,1148521,18,1148503
55557,16,2,4,710519,16,710503
55558,8,-5,283,474291,8,474283
55559,8,19,270,1223490,8,1223482
55560,15,-9,385,369554,15,369539
55561,18,-12,582,276782,18,276764
55562,7,-20,996,22044,7,22037
55563,9,-10,143,315807,9,315798
55564,17,-17,486,119099,17,119082
55565,8,-17,532,104875,8,104867
55566,11,-1,616,621349,11,621338
55567,6,-14,400,195595,6,195589
55568,9,-20,15,367,9,358
55569,18,9,768,934672,18,934654
55570,14,-2,427,588343,14,588329
55571,18,12,19,1022231,18,1022213
55572,14,-11,624,308700,14,308686
55573,6,-11,417,290407,6,290401
55574,7,18,837,1204427,7,1204420
55575,20,7,968,873868,20,873848
55576,11,-4,225,523869,11,523858
55577,10,-17,192,97463,10,97453
55578,13,1,827,686260,13,686247
55579,15,-7,885,434832,15,434817
55580,18,-8,68,398486,18,398468
55581,8,-5,165,471733,8,471725
55582,13,-10,939,342170,13,342157
55583,9,-19,145,34835,9,34826
55584,20,-13,461,244347,20,244327
55585,11,-14,193,210796,11,210785
55586,15,-14,354,212155,15,212140
55587,8,5,980,802335,8,802327
55588,10,17,38,1156141,10,1156131
55589,13,-17,471,118977,13,118964
55590,9,15,447,1103924,9,1103915
55591,10,-6,711,452079,10,452069
55592,16,6,203,837244,16,837228
55593,20,0,459,651622,20,651602
55594,5,17,469,1165379,5,1165374
55595,11,-16,822,152950,11,152939
55596,18,19,784,1247148,18,1247130
55597,8,-5,490,478608,8,478600
55598,11,-18,25,85405,11,85394
55599,18,-17,77,116085,18,116067
55600,10,13,480,1041037,10,1041027
55601,16,-18,213,86924,16,86908
55602,8,-2,585,575171,8,575163
55603,20,7,797,872765,20,872745
55604,10,-8,207,379879,10,379869
55605,10,1,956,677787,10,677777
55606,16,13,889,1059874,16,1059858
55607,20,18,507,1212678,20,1212658
55608,9,-15,171,159038,9,159029
55609,10,-3,187,534371,10,534361
55610,5,7,508,855701,5,855696
55611,6,5,258,787041,6,787035
55612,9,-4,53,500440,9,500431
55613,13,12,507,1025768,13,1025755
55614,19,-1,338,619285,19,619266
55615,14,-11,440,307283,14,307269
55616,9,12,392,1007567,9,1007558
55617,6,-8,379,383328,6,383322
55618,19,-12,706,277722,19,277703
55619,19,13,857,1059636,19,1059617
55620,8,-1,232,598971,8,598963
55621,20,19,635,1245950,20,1245930
55622,20,14,528,1089565,20,1089545
55623,7,3,45,719790,7,719783
55624,10,8,288,881522,10,881512
55625,10,18,70,1188345,10,1188335
55626,20,10,929,967005,20,966985
55627,12,19,523,1245137,12,1245125
55628,20,10,913,966890,20,966870
55629,8,5,411,790021,8,790013
55630,18,-14,594,214225,18,214207
55631,20,2,128,711579,20,711559
55632,10,15,307,1101084,10,1101074
55633,12,14,40,1085722,12,1085710
55634,12,-3,333,556260,12,556248
55635,13,2,308,712899,13,712886
55636,13,16,412,1150140,13,1150127
55637,9,-8,607,388246,9,388237
55638,10,-12,852,268123,10,268113
55639,20,-15,270,179699,20,179679
55640,6,4,806,768190,6,768184
55641,8,-18,649,76299,8,76291
55642,11,-10,698,340370,11,340359
55643,13,-14,72,209875,13,209862
55644,10,18,669,1200846,10,1200836
55645,9,1,855,675606,9,675597
55646,17,18,735,1214214,17,1214197
55647,9,1,979,678257,9,678248
55648,14,-11,83,304302,14,304288
55649,6,9,489,917048,6,917042
55650,5,-5,255,473670,5,473665
55651,16,17,750,1183465,16,1183449
55652,14,5,779,809430,14,809416
55653,6,-11,74,282710,6,282704
55654,16,-9,496,370601,16,370585
55655,7,-19,506,42416,7,42409
55656,8,0,30,625929,8,625921
55657,18,4,87,773906,18,773888
55658,16,1,301,682232,16,682216
55659,9,-4,495,510141,9,510132
55660,20,2,254,712508,20,712488
55661,9,-3,980,552409,9,552400
55662,19,15,373,1119515,19,1119496
55663,16,-2,72,585666,16,585650
55664,11,-1,489,620475,11,620464
55665,17,2,988,717805,17,717788
55666,5,-19,83,33238,5,33233
55667,8,-9,19,344070,8,344062
55668,19,-11,773,309796,19,309777
55669,8,-16,116,126602,8,126594
55670,12,-20,988,30351,12,30339
55671,15,-8,270,399763,15,399748
55672,20,14,533,1089646,20,1089626
55673,10,19,364,1225714,10,1225704
55674,19,-12,592,276840,19,276821
55675,20,6,685,841275,20,841255
55676,16,6,828,842409,16,842393
55677,6,7,537,856214,6,856208
55678,13,-7,932,435207,13,435194
55679,17,14,48,1085793,17,1085776
55680,15,-8,11,397960,15,397945
55681,10,7,453,854533,10,854523
55682,10,-17,787,110311,10,110301
55683,20,15,585,1121041,20,1121021
55684,9,6,621,826335,9,826326
55685,13,-12,473,275994,13,275981
55686,16,-7,495,432036,16,432020
55687,13,18,183,1210461,13,1210448
55688,9,14,28,1062404,9,1062395
55689,20,-17,25,115746,20,115726
55690,14,-7,468,431854,14,431840
55691,10,12,807,1016576,10,1016566
55692,12,8,618,902831,12,902819
55693,6,13,664,1045100,6,1045094
55694,19,-18,321,87742,19,87723
55695,13,13,711,1058538,13,1058525
55696,11,-15,17,177952,11,177941
55697,15,-5,18,490909,15,490894
55698,13,-6,657,464148,13,464135
55699,17,19,168,1242097,17,1242080
55700,14,1,913,686977,14,686963
55701,9,-11,594,294302,9,294293
55702,15,-19,861,60627,15,60612
55703,11,18,564,1213050,11,1213039
55704,13,4,91,773925,13,773912
55705,6,17,340,1162700,6,1162694
55706,8,-4,849,517499,8,517491
55707,17,13,454,1056632,17,1056615
55708,14,-13,680,245957,14,245943
55709,9,-15,892,174388,9,174379
55710,13,-19,37,54140,13,54127
55711,9,8,300,881792,9,881783
55712,14,-17,563,119746,14,119732
55713,8,-5,599,481082,8,481074
55714,19,-13,393,243915,19,243896
55715,11,-13,424,244083,11,244072
55716,18,-13,831,247195,18,247177
55717,5,7,444,854347,5,854342
55718,8,15,17,1094847,8,1094839
55719,11,-13,221,242671,11,242660
55720,5,10,260,942981,5,942976
55721,12,0,753,654047,12,654035
55722,5,-15,270,161138,5,161133
55723,5,1,535,669099,5,669094
55724,10,3,828,736664,10,736654
55725,5,-13,670,232457,5,232452
55726,17,12,294,1024306,17,1024289
55727,20,11,135,991792,20,991772
55728,18,2,655,715494,18,715476
55729,9,-18,714,77789,9,77780
55730,10,8,139,878100,10,878090
55731,8,4,806,768198,8,768190
55732,10,-20,202,4742,10,4732
55733,14,12,995,1029774,14,1029760
55734,9,2,289,694879,9,694870
55735,15,0,20,648362,15,648347
55736,16,-1,685,621829,16,621813
55737,8,5,215,786162,8,786154
55738,14,19,725,1246688,14,1246674
55739,12,-9,39,366904,12,366892
55740,8,-2,314,569528,8,569520
55741,19,19,111,1241676,19,1241657
55742,14,0,228,649934,14,649920
55743,17,16,289,1149216,17,1149199
55744,16,17,265,1179893,16,1179877
55745,19,-9,406,369725,19,369706
55746,13,-2,192,586509,13,586496
55747,5,-5,280,474200,5,474195
55748,10,4,517,761728,10,761718
55749,16,16,237,1148795,16,1148779
55750,16,9,406,932003,16,931987
55751,10,3,437,728220,10,728210
55752,17,17,839,1184265,17,1184248
55753,10,9,967,927408,10,927398
55754,16,4,307,775401,16,775385
55755,9,-17,754,109673,9,109664
55756,11,16,28,1147285,11,1147274
55757,17,-7,735,433648,17,433631
55758,12,4,852,779648,12,779636
55759,5,2,745,704351,5,704346
55760,14,-17,152,116610,14,116596
55761,14,-11,822,310123,14,310109
55762,9,-9,662,358200,9,358191
55763,11,-18,609,89651,11,89640
55764,16,-12,767,278178,16,278162
55765,19,12,351,1024652,19,1024633
55766,6,12,282,1005443,6,1005437
55767,13,0,917,655251,13,655238
55768,17,-9,35,366874,17,366857
55769,9,-6,82,438456,9,438447
55770,12,14,480,1089194,12,1089182
55771,14,-17,412,118500,14,118486
55772,17,-2,692,590366,17,590349
55773,16,17,71,1178404,16,1178388
55774,6,17,4,1155348,6,1155342
55775,10,-8,846,393382,10,393372
55776,20,-13,477,244497,20,244477
55777,19,-9,800,372884,19,372865
55778,13,18,42,1209209,13,1209196
55779,13,-2,515,589023,13,589010
55780,17,-8,658,402549,17,402532
55781,7,-18,281,68624,7,68617
55782,12,5,52,804204,12,804192
55783,19,6,647,840971,19,840952
55784,10,11,489,978901,10,978891
55785,6,-6,59,438058,6,438052
55786,13,-13,247,242874,13,242861
55787,8,0,173,629241,8,629233
55788,13,3,259,743832,13,743819
55789,10,6,651,826992,10,826982
55790,5,-14,223,191533,5,191528
55791,20,-14,276,211601,20,211581
55792,10,14,66,1063359,10,1063349
55793,15,13,623,1057978,15,1057963
55794,8,-16,836,141926,8,141918
55795,11,-17,785,121456,11,121445
55796,14,16,578,1151169,14,1151155
55797,10,-11,56,282301,10,282291
55798,18,1,706,685295,18,685277
55799,19,0,724,653893,19,653874
55800,20,14,597,1090040,20,1090020
55801,18,5,287,805954,18,805936
55802,20,3,560,745939,20,745919
55803,13,-20,115,23638,13,23625
55804,15,-9,942,374036,15,374021
55805,5,-20,889,19711,5,19706
55806,17,-19,329,56532,17,56515
55807,11,1,566,684370,11,684359
55808,6,9,693,921346,6,921340
55809,9,-6,993,458008,9,457999
55810,10,-11,414,290322,10,290312
55811,9,9,908,926069,9,926060
55812,15,-1,312,619069,15,619054
55813,11,-6,211,460790,11,460779
55814,20,14,861,1092159,20,1092139
55815,20,-9,389,369610,20,369590
55816,14,7,117,867855,14,867841
55817,14,-14,763,215445,14,215431
55818,12,4,24,773424,12,773412
55819,8,3,968,740027,8,740019
55820,17,5,312,806050,17,806033
55821,16,11,561,994885,16,994869
55822,13,-7,848,434508,13,434495
55823,11,19,344,1243530,11,1243519
55824,9,8,661,889607,9,889598
55825,5,-11,828,298855,5,298850
55826,10,-4,658,513603,10,513593
55827,13,0,270,650164,13,650151
55828,5,-20,991,21934,5,21929
55829,14,-6,721,464661,14,464647
55830,5,9,719,921900,5,921895
55831,10,-2,726,578287,10,578277
55832,20,12,335,1024599,20,1024579
55833,14,7,825,872991,14,872977
55834,19,-7,148,429368,19,429349
55835,11,-13,45,241395,11,241384
55836,10,-10,362,320420,10,320410
55837,18,-16,721,152213,18,152195
55838,7,-6,891,455815,7,455808
55839,9,-19,723,47379,9,47370
55840,13,-11,96,304453,13,304440
55841,18,4,262,775105,18,775087
55842,5,16,533,1136514,5,1136509
55843,5,2,508,699435,5,699430
55844,18,-1,948,623798,18,623780
55845,18,19,351,1243613,18,1243595
55846,15,14,573,1089881,15,1089866
55847,8,-15,735,171224,8,171216
55848,10,4,111,753026,10,753016
55849,17,-12,555,276618,17,276601
55850,18,-19,711,59539,18,59521
55851,19,-2,580,589492,19,589473
55852,11,11,237,992511,11,992500
55853,18,-6,548,463417,18,463399
55854,20,-8,447,400969,20,400949
55855,10,10,926,957453,10,957443
55856,8,1,657,671571,8,671563
55857,12,-15,81,178368,12,178356
55858,9,0,782,642466,9,642457
55859,13,3,693,747156,13,747143
55860,6,-20,95,2095,6,2089
55861,7,-7,398,414586,7,414579
55862,10,-17,422,102387,10,102377
55863,9,10,596,950361,9,950352
55864,6,-5,968,489144,6,489138
55865,5,-9,18,344053,5,344048
55866,15,-2,100,585872,15,585857
55867,12,-18,902,91760,12,91748
55868,13,-6,325,461690,13,461677
55869,8,15,796,1111303,8,1111295
55870,10,-7,20,406517,10,406507
55871,20,-12,922,279482,20,279462
55872,8,12,665,1013605,8,1013597
55873,17,15,618,1121317,17,1121300
55874,10,7,634,858221,10,858211
55875,6,0,215,630132,6,630126
55876,19,12,849,1028470,19,1028451
55877,14,-2,407,588154,14,588140
55878,6,7,217,849365,6,849359
55879,20,1,64,680250,20,680230
55880,20,-20,553,27035,20,27015
55881,12,-13,345,243611,12,243599
55882,9,-5,366,476165,9,476156
55883,8,4,369,758559,8,758551
55884,20,-16,319,149320,20,149300
55885,18,18,801,1214792,18,1214774
55886,13,5,261,805758,13,805745
55887,8,-12,327,256790,8,256782
55888,6,-9,737,359926,6,359920
55889,7,-3,534,542560,7,542553
55890,6,-20,953,20972,6,20966
55891,11,4,427,776349,11,776338
55892,7,12,281,1005426,7,1005419
55893,9,-1,5,593827,9,593818
55894,17,-17,497,119227,17,119210
55895,16,6,247,837625,16,837609
55896,10,-7,359,413680,10,413670
55897,17,-13,229,242737,17,242720
55898,11,16,145,1148110,11,1148099
55899,19,14,148,1086620,19,1086601
55900,5,-13,517,229344,5,229339
55901,20,-4,409,525295,20,525275
55902,9,-19,794,48832,9,48823
55903,15,-3,416,556878,15,556863
55904,20,-5,761,496577,20,496557
55905,18,9,324,931369,18,931351
55906,19,11,319,993188,19,993169
55907,12,3,902,748597,12,748585
55908,5,-10,576,325103,5,325098
55909,13,-3,215,555276,13,555263
55910,10,11,387,976822,10,976812
55911,20,-6,684,464369,20,464349
55912,8,-15,12,155579,8,155571
55913,10,12,429,1008258,10,1008248
55914,10,4,171,754290,10,754280
55915,16,9,16,929148,16,929132
55916,15,-10,565,339301,15,339286
55917,13,-6,748,464890,13,464877
55918,18,16,327,1149482,18,1149464
55919,14,-9,545,371036,14,371022
55920,18,18,742,1214318,18,1214300
55921,10,7,677,859202,10,859192
55922,16,-1,480,620418,16,620402
55923,16,-10,791,341011,16,340995
55924,14,12,271,1024136,14,1024122
55925,9,5,282,787602,9,787593
55926,15,17,244,1179717,15,1179702
55927,18,-9,754,372427,18,372409
55928,10,0,901,644927,10,644917
55929,12,-12,840,278715,12,278703
55930,6,19,200,1221922,6,1221916
55931,6,15,61,1095798,6,1095792
55932,10,15,617,1107541,10,1107531
55933,6,10,999,958810,6,958804
55934,12,-16,928,153769,12,153757
55935,18,-16,264,148904,18,148886
55936,5,-15,538,167012,5,167007
55937,9,-11,436,290883,9,290874
55938,11,4,19,773379,11,773368
55939,16,0,815,654477,16,654461
55940,14,8,592,902608,14,902594
55941,13,16,754,1152427,13,1152414
55942,19,14,238,1087276,19,1087257
55943,6,-19,697,46863,6,46857
55944,5,18,736,1202083,5,1202078
55945,6,-16,300,130507,6,130501
55946,18,-4,179,523443,18,523425
55947,12,-17,308,117809,12,117797
55948,13,9,760,934570,13,934557
55949,15,-6,514,463152,15,463137
55950,11,-1,701,621958,11,621947
55951,7,8,184,879032,7,879025
55952,17,8,421,901349,17,901332
55953,18,-6,284,461397,18,461379
55954,13,-17,499,119233,13,119220
55955,15,-6,881,465745,15,465730
55956,11,15,100,1117518,11,1117507
55957,17,-10,448,338391,17,338374
55958,7,-9,605,357117,7,357110
55959,14,-13,185,242430,14,242416
55960,8,3,798,735979,8,735971
55961,5,-10,322,319516,5,319511
55962,19,-13,775,246827,19,246808
55963,17,-3,628,558790,17,558773
55964,6,6,106,814520,6,814514
55965,20,-19,599,58734,20,58714
55966,6,-10,99,314718,6,314712
55967,17,-20,489,26465,17,26448
55968,14,-17,553,119639,14,119625
55969,19,3,286,744086,19,744067
55970,5,17,187,1159277,5,1159272
55971,6,-1,988,615285,6,615279
55972,19,-7,305,430628,19,430609
55973,18,9,219,930691,18,930673
55974,18,9,217,930669,18,930651
55975,15,-14,895,216467,15,216452
55976,11,17,271,1179956,11,1179945
55977,16,18,938,1215827,16,1215811
55978,19,11,557,994850,19,994831
55979,9,-16,110,126435,9,126426
55980,20,-10,918,341983,20,341963
55981,16,-20,730,28410,16,28394
55982,13,-12,810,278438,13,278425
55983,16,16,721,1152241,16,1152225
55984,15,14,59,1085884,15,1085869
55985,12,19,629,1245906,12,1245894
55986,17,17,446,1181266,17,1181249
55987,7,13,377,1038811,7,1038804
55988,15,-13,732,246431,15,246416
55989,9,-6,361,444462,9,444453
55990,11,-17,367,118201,11,118190
55991,16,-6,69,459592,16,459576
55992,6,18,69,1188316,6,1188310
55993,13,8,497,901900,13,901887
55994,7,-10,210,317189,7,317182
55995,9,-4,72,500921,9,500912
55996,19,-2,181,586381,19,586362
55997,11,1,606,684622,11,684611
55998,17,-1,21,616678,17,616661
55999,20,-5,282,493117,20,493097
56000,13,17,862,1184489,13,1184476
56001,7,9,931,926557,7,926550
56002,14,-18,662,90119,14,90105
56003,6,11,802,985622,6,985616
56004,5,8,208,879737,5,879732
56005,10,-4,162,502875,10,502865
56006,6,12,261,1004982,6,1004976
56007,19,-12,682,277524,19,277505
56008,8,-6,401,445330,8,445322
56009,14,-14,346,212105,14,212091
56010,7,8,221,879995,7,879988
56011,13,0,315,650391,13,650378
56012,5,19,402,1226654,5,1226649
56013,10,-10,152,315979,10,315969
56014,18,1,186,681359,18,681341
56015,17,-20,562,27096,17,27079
56016,20,6,505,839878,20,839858
56017,20,-15,209,179251,20,179231
56018,19,5,25,803923,19,803904
56019,10,-6,653,450800,10,450790
56020,18,4,73,773775,18,773757
56021,14,18,606,1213267,14,1213253
56022,9,17,629,1168740,9,1168731
56023,9,18,114,1189316,9,1189307
56024,18,-9,509,370708,18,370690
56025,19,11,285,992951,19,992932
56026,6,-10,456,322525,6,322519
56027,17,-14,618,214370,17,214353
56028,19,2,837,716757,19,716738
56029,15,12,740,1027570,15,1027555
56030,16,14,540,1089676,16,1089660
56031,16,8,796,904260,16,904244
56032,18,2,735,716123,18,716105
56033,5,2,692,703253,5,703248
56034,7,-6,173,440576,7,440569
56035,14,-3,416,556882,14,556868
56036,15,-9,848,373262,15,373247
56037,14,-15,685,182832,14,182818
56038,10,4,441,760134,10,760124
56039,7,-14,305,193331,7,193324
56040,9,14,727,1078365,9,1078356
56041,19,14,348,1088139,19,1088120
56042,20,4,352,775779,20,775759
56043,13,-11,328,306375,13,306362
56044,17,3,195,743362,17,743345
56045,14,11,248,992619,14,992605
56046,6,7,811,862009,6,862003
56047,19,10,204,961379,19,961360
56048,18,-18,57,85642,18,85624
56049,18,-10,686,340291,18,340273
56050,17,-11,284,305950,17,305933
56051,5,19,646,1231936,5,1231931
56052,16,-4,544,526239,16,526223
56053,10,-3,558,543049,10,543039
56054,7,18,74,1188396,7,1188389
56055,10,1,826,674866,10,674856
56056,6,-6,179,440801,6,440795
56057,19,0,180,649616,19,649597
56058,12,-1,157,617730,12,617718
56059,19,13,789,1059173,19,1059154
56060,14,-17,424,118593,14,118579
56061,16,-10,23,335296,16,335280
56062,10,14,587,1074856,10,1074846
56063,6,13,878,1049622,6,1049616
56064,5,-17,652,107545,5,107540
56065,10,-11,975,302144,10,302134
56066,14,-10,137,336145,14,336131
56067,5,17,475,1165480,5,1165475
56068,11,-5,615,495556,11,495545
56069,20,1,363,682775,20,682755
56070,17,-19,107,54806,17,54789
56071,19,9,297,931112,19,931093
56072,5,17,952,1175693,5,1175688
56073,8,-16,230,129150,8,129142
56074,7,-3,592,543774,7,543767
56075,17,-6,39,459440,17,459423
56076,13,-7,682,433258,13,433245
56077,8,6,487,823397,8,823389
56078,16,-20,704,28216,16,28200
56079,11,18,563,1213050,11,1213039
56080,6,-18,375,70443,6,70437
56081,17,1,247,681830,17,681813
56082,5,-2,347,570126,5,570121
56083,14,-14,568,213996,14,213982
56084,15,-15,940,184934,15,184919
56085,8,-16,23,124375,8,124367
56086,6,10,361,945182,6,945176
56087,17,14,54,1085834,17,1085817
56088,16,0,642,653114,16,653098
56089,19,-11,834,310219,19,310200
56090,15,11,691,995742,15,995727
56091,8,-15,69,156794,8,156786
56092,13,15,684,1121803,13,1121790
56093,11,17,883,1184571,11,1184560
56094,14,4,258,775080,14,775066
56095,17,19,833,1247515,17,1247498
56096,13,17,15,1177949,13,1177936
56097,8,19,466,1228145,8,1228137
56098,7,19,883,1237201,7,1237194
56099,19,-20,293,25089,19,25070
56100,7,-14,867,205352,7,205345
56101,7,-11,301,287727,7,287720
56102,17,-14,66,209807,17,209790
56103,13,-16,901,153549,13,153536
56104,17,-7,877,434732,17,434715
56105,9,8,603,888363,9,888354
56106,18,9,919,935930,18,935912
56107,13,15,104,1117575,13,1117562
56108,6,13,596,1043588,6,1043582
56109,9,-6,219,441676,9,441667
56110,6,19,1000,1239588,6,1239582
56111,11,-18,934,92014,11,92003
56112,15,10,113,960756,15,960741
56113,13,19,291,1243069,13,1243056
56114,20,-2,449,588528,20,588508
56115,5,16,66,1126563,5,1126558
56116,16,-5,466,494493,16,494477
56117,15,5,637,808454,15,808439
56118,20,9,368,931751,20,931731
56119,19,-16,857,153199,19,153180
56120,14,14,430,1088841,14,1088827
56121,12,8,930,905195,12,905183
56122,5,15,993,1115616,5,1115611
56123,12,4,576,777445,12,777433
56124,7,-7,61,407294,7,407287
56125,6,-10,781,329259,6,329253
56126,10,19,475,1228367,10,1228357
56127,5,17,468,1165346,5,1165341
56128,8,-18,928,82648,8,82640
56129,9,-12,677,264168,9,264159
56130,19,-18,155,86452,19,86433
56131,10,14,76,1063529,10,1063519
56132,5,12,3,999110,5,999105
56133,14,-15,467,181239,14,181225
56134,7,-18,466,72469,7,72462
56135,8,16,504,1135924,8,1135916
56136,12,-6,663,464187,12,464175
56137,20,-2,813,591261,20,591241
56138,9,-4,282,505691,9,505682
56139,15,-14,223,211100,15,211085
56140,18,-4,190,523530,18,523512
56141,14,-17,132,116462,14,116448
56142,5,7,256,850306,5,850301
56143,17,2,689,715799,17,715782
56144,15,-9,864,373429,15,373414
56145,12,13,296,1055399,12,1055387
56146,10,-18,497,73153,10,73143
56147,12,14,524,1089534,12,1089522
56148,17,-16,290,149087,17,149070
56149,8,-10,25,313150,8,313142
56150,20,17,14,1177943,20,1177923
56151,9,11,62,969812,9,969803
56152,14,16,407,1150049,14,1150035
56153,7,-9,860,362802,7,362795
56154,18,11,139,991828,18,991810
56155,13,-1,276,618709,13,618696
56156,20,-9,469,370320,20,370300
56157,9,-19,618,45074,9,45065
56158,15,-14,665,214717,15,214702
56159,17,2,687,715774,17,715757
56160,17,-11,298,306073,17,306056
56161,20,-15,70,178274,20,178254
56162,13,18,99,1209722,13,1209709
56163,5,17,213,1159750,5,1159745
56164,7,12,304,1005872,7,1005865
56165,5,-13,295,224755,5,224750
56166,9,-15,276,161298,9,161289
56167,6,-6,623,450192,6,450186
56168,18,0,890,655053,18,655035
56169,9,-5,507,478974,9,478965
56170,7,15,310,1101118,7,1101111
56171,7,14,690,1077586,7,1077579
56172,6,4,787,767786,6,767780
56173,8,2,868,706673,8,706665
56174,10,1,926,677184,10,677174
56175,14,14,528,1089569,14,1089555
56176,13,17,269,1179942,13,1179929
56177,10,4,772,767429,10,767419
56178,17,-14,935,216748,17,216731
56179,7,3,587,731276,7,731269
56180,12,-3,607,558576,12,558564
56181,18,19,657,1246102,18,1246084
56182,6,-3,871,549876,6,549870
56183,12,13,795,1059208,12,1059196
56184,6,-9,717,359374,6,359368
56185,15,-2,817,591302,15,591287
56186,20,1,948,687275,20,687255
56187,10,11,383,976669,10,976659
56188,8,-9,757,360430,8,360422
56189,15,-16,743,152328,15,152313
56190,19,5,545,807770,19,807751
56191,14,13,120,1054122,14,1054108
56192,11,-18,135,86234,11,86223
56193,7,9,992,927925,7,927918
56194,16,10,47,960212,16,960196
56195,12,-2,949,592371,12,592359
56196,14,18,129,1209976,14,1209962
56197,18,-2,710,590482,18,590464
56198,18,-2,984,592627,18,592609
56199,20,-14,624,214426,20,214406
56200,10,5,894,800419,10,800409
56201,19,3,135,742861,19,742842
56202,15,11,196,992241,15,992226
56203,20,-14,85,209982,20,209962
56204,8,7,8,844946,8,844938
56205,18,-6,928,466160,18,466142
56206,19,-2,778,590979,19,590960
56207,6,-14,965,207579,6,207573
56208,6,-14,220,191468,6,191462
56209,13,0,957,655571,13,655558
56210,10,17,216,1159806,10,1159796
56211,11,-2,499,588919,11,588908
56212,12,3,300,744163,12,744151
56213,9,-14,491,197309,9,197300
56214,9,-3,449,540492,9,540483
56215,16,-12,695,277609,16,277593
56216,18,-5,469,494515,18,494497
56217,10,-3,167,533971,10,533961
56218,11,1,572,684422,11,684411
56219,7,-6,854,455039,7,455032
56220,12,19,504,1244933,12,1244921
56221,17,0,620,652929,17,652912
56222,13,-14,870,216280,13,216267
56223,16,18,747,1214372,16,1214356
56224,9,19,934,1238144,9,1238135
56225,11,19,704,1246473,11,1246462
56226,20,15,43,1117119,20,1117099
56227,16,2,54,710916,16,710900
56228,13,-12,43,272804,13,272791
56229,20,0,683,653498,20,653478
56230,11,-11,37,303924,11,303913
56231,13,-11,402,306933,13,306920
56232,20,19,684,1246316,20,1246296
56233,17,0,44,648598,17,648581
56234,15,1,127,680830,15,680815
56235,6,3,94,720866,6,720860
56236,20,11,51,991246,20,991226
56237,5,13,579,1043283,5,1043278
56238,18,-3,91,554423,18,554405
56239,16,3,692,747147,16,747131
56240,15,-3,655,559015,15,559000
56241,14,-12,571,276736,14,276722
56242,9,14,811,1080178,9,1080169
56243,6,-1,574,606415,6,606409
56244,13,3,845,748198,13,748185
56245,8,-7,470,415889,8,415881
56246,10,8,486,885819,10,885809
56247,8,-10,53,313767,8,313759
56248,12,-8,503,401343,12,401331
56249,11,13,840,1059524,11,1059513
56250,17,13,730,1058681,17,1058664
56251,18,-17,80,116137,18,116119
56252,6,-20,947,20840,6,20834
56253,13,-8,805,403636,13,403623
56254,16,11,797,996653,16,996637
56255,5,17,859,1173877,5,1173872
56256,11,18,41,1209200,11,1209189
56257,7,-15,100,157605,7,157598
56258,9,9,447,916079,9,916070
56259,18,-14,53,209720,18,209702
56260,17,13,852,1059609,17,1059592
56261,14,1,836,686305,14,686291
56262,13,9,170,930342,13,930329
56263,16,10,266,961849,16,961833
56264,17,-3,878,560805,17,560788
56265,18,9,20,929183,18,929165
56266,14,-17,328,117904,14,117890
56267,18,10,968,967234,18,967216
56268,8,4,409,759483,8,759475
56269,17,-3,180,555073,17,555056
56270,17,8,304,900369,17,900352
56271,14,11,465,994250,14,994236
56272,6,4,473,760781,6,760775
56273,19,13,857,1059645,19,1059626
56274,17,-15,959,185105,17,185088
56275,9,11,324,975351,9,975342
56276,20,-6,415,462335,20,462315
56277,8,-3,839,549166,8,549158
56278,10,4,873,769827,10,769817
56279,15,-9,32,366845,15,366830
56280,15,-8,655,402500,15,402485
56281,12,-14,996,217241,12,217229
56282,15,-7,876,434713,15,434698
56283,13,8,555,902319,13,902306
56284,11,-9,184,367862,11,367851
56285,11,-19,536,58159,11,58148
56286,19,-11,93,304413,19,304394
56287,17,12,960,1029507,17,1029490
56288,17,-14,811,215892,17,215875
56289,16,2,691,715833,16,715817
56290,16,-11,93,304419,16,304403
56291,12,4,647,777985,12,777973
56292,12,-11,257,305719,12,305707
56293,18,10,930,967012,18,966994
56294,8,-18,902,82027,8,82019
56295,6,-15,458,165304,6,165298
56296,8,-17,549,105336,8,105328
56297,13,18,956,1215988,13,1215975
56298,13,-6,87,459711,13,459698
56299,14,15,521,1120555,14,1120541
56300,16,-12,896,279227,16,279211
56301,20,0,744,654013,20,653993
56302,19,7,417,870147,19,870128
56303,8,11,8,968624,8,968616
56304,11,-14,797,215768,11,215757
56305,12,5,191,805256,12,805244
56306,16,11,949,997691,16,997675
56307,15,4,325,775565,15,775550
56308,11,18,817,1214860,11,1214849
56309,7,19,99,1219683,7,1219676
56310,13,-4,673,527153,13,527140
56311,20,-14,273,211556,20,211536
56312,7,5,606,794231,7,794224
56313,12,2,261,712534,12,712522
56314,17,-2,548,589243,17,589226
56315,19,16,535,1150898,19,1150879
56316,19,-3,596,558502,19,558483
56317,18,16,961,1153965,18,1153947
56318,17,7,153,868139,17,868122
56319,9,4,157,753986,9,753977
56320,18,-11,128,304697,18,304679
56321,15,-19,759,59934,15,59919
56322,8,-1,231,598947,8,598939
56323,17,-17,908,122236,17,122219
56324,10,-15,692,170172,10,170162
56325,5,14,941,1082927,5,1082922
56326,5,-1,63,595091,5,595086
56327,15,0,817,654486,15,654471
56328,5,-20,202,4747,5,4742
56329,8,-10,379,320766,8,320758
56330,17,-2,648,589987,17,589970
56331,12,-8,735,403083,12,403071
56332,13,-12,880,279083,13,279070
56333,20,-8,825,403780,20,403760
56334,5,7,911,864086,5,864081
56335,12,-6,242,461071,12,461059
56336,14,6,876,842761,14,842747
56337,13,-13,467,244416,13,244403
56338,16,-1,912,623534,16,623518
56339,17,-16,980,154137,17,154120
56340,5,3,171,722461,5,722456
56341,12,-7,875,434707,12,434695
56342,9,18,89,1188680,9,1188671
56343,6,16,400,1133750,6,1133744
56344,11,-7,185,429685,11,429674
56345,17,0,154,649376,17,649359
56346,12,-19,731,59732,12,59720
56347,14,4,917,780040,14,780026
56348,7,-5,905,487767,7,487760
56349,7,1,797,674376,7,674369
56350,16,-1,504,620574,16,620558
56351,20,3,375,744678,20,744658
56352,16,-18,727,90563,16,90547
56353,5,10,849,955807,5,955802
56354,19,-8,679,402714,19,402695
56355,10,-9,950,364912,10,364902
56356,11,5,623,808358,11,808347
56357,14,-19,480,57663,14,57649
56358,8,15,480,1104631,8,1104623
56359,9,19,635,1231652,9,1231643
56360,14,-11,807,310004,14,309990
56361,7,-12,271,255389,7,255382
56362,9,-3,917,550998,9,550989
56363,14,-16,217,148580,14,148566
56364,5,-19,657,45962,5,45957
56365,19,-6,511,463128,19,463109
56366,15,-5,846,497172,15,497157
56367,14,16,276,1149102,14,1149088
56368,12,-6,827,465435,12,465423
56369,19,-8,195,399290,19,399271
56370,5,-15,292,161689,5,161684
56371,11,-4,477,525657,11,525646
56372,10,-4,418,508722,10,508712
56373,8,19,298,1224165,8,1224157
56374,7,-13,307,224913,7,224906
56375,13,-4,533,526135,13,526122
56376,11,-17,941,122411,11,122400
56377,19,-5,965,498163,19,498144
56378,20,10,110,960734,20,960714
56379,10,-17,938,113248,10,113238
56380,11,10,520,963861,11,963850
56381,20,0,741,653984,20,653964
56382,16,10,857,966404,16,966388
56383,13,11,408,993866,13,993853
56384,5,-10,598,325567,5,325562
56385,14,19,413,1244212,14,1244198
56386,8,0,387,633780,8,633772
56387,11,-1,235,618424,11,618413
56388,14,0,991,655846,14,655832
56389,12,4,26,773452,12,773440
56390,16,12,333,1024563,16,1024547
56391,15,-11,38,303937,15,303922
56392,6,17,442,1164779,6,1164773
56393,15,15,707,1121996,15,1121981
56394,19,-14,255,211454,19,211435
56395,17,19,417,1244260,17,1244243
56396,12,-9,757,372494,12,372482
56397,19,9,362,931692,19,931673
56398,13,-5,284,493149,13,493136
56399,20,17,643,1182637,20,1182617
56400,20,0,188,649671,20,649651
56401,19,4,222,774870,19,774851
56402,12,-19,645,59089,12,59077
56403,16,-14,338,212063,16,212047
56404,5,-12,696,264567,5,264562
56405,17,15,941,1123666,17,1123649
56406,7,12,674,1013912,7,1013905
56407,19,4,413,776215,19,776196
56408,18,-16,902,153567,18,153549
56409,17,3,282,744039,17,744022
56410,18,7,587,871350,18,871332
56411,7,-3,191,534479,7,534472
56412,8,-8,788,392230,8,392222
56413,13,-4,84,522674,13,522661
56414,15,-4,397,525221,15,525206
56415,9,-10,360,320350,9,320341
56416,5,-14,229,191742,5,191737
56417,5,3,628,732295,5,732290
56418,17,-7,331,430847,17,430830
56419,7,11,928,988538,7,988531
56420,16,-20,105,23547,16,23531
56421,10,9,720,921919,10,921909
56422,13,-14,135,210372,13,210359
56423,10,13,922,1050432,10,1050422
56424,16,6,962,843397,16,843381
56425,19,-1,67,617065,19,617046
56426,7,11,605,981435,7,981428
56427,10,1,748,673311,10,673301
56428,6,16,320,1131970,6,1131964
56429,16,19,864,1247791,16,1247775
56430,12,9,285,931022,12,931010
56431,7,6,681,827659,7,827652
56432,10,4,374,758684,10,758674
56433,9,-5,625,481542,9,481533
56434,16,11,530,994690,16,994674
56435,6,-4,469,509585,6,509579
56436,11,0,147,649322,11,649311
56437,16,14,971,1093034,16,1093018
56438,12,16,229,1148740,12,1148728
56439,10,6,303,819084,10,819074
56440,5,-15,373,163488,5,163483
56441,16,12,897,1028865,16,1028849
56442,15,-10,887,341771,15,341756
56443,13,19,418,1244282,13,1244269
56444,10,-6,705,451987,10,451977
56445,19,-5,246,492823,19,492804
56446,9,15,936,1114386,9,1114377
56447,12,-13,725,246374,12,246362
56448,6,2,972,708959,6,708953
56449,10,-3,462,540802,10,540792
56450,12,0,947,655438,12,655426
56451,14,7,805,872831,14,872817
56452,7,7,917,864224,7,864217
56453,19,19,537,1245208,19,1245189
56454,7,11,63,969837,7,969830
56455,11,-6,576,463543,11,463532
56456,19,-5,726,496345,19,496326
56457,17,3,759,747581,17,747564
56458,20,12,641,1026846,20,1026826
56459,19,-20,334,25443,19,25424
56460,16,-3,493,557608,16,557592
56461,20,-10,504,338845,20,338825
56462,18,-13,818,247112,18,247094
56463,12,5,38,804043,12,804031
56464,13,3,142,742906,13,742893
56465,13,-16,616,151588,13,151575
56466,14,14,595,1090027,14,1090013
56467,14,-7,592,432766,14,432752
56468,11,-12,568,276710,11,276699
56469,5,-4,400,508322,5,508317
56470,15,-19,732,59753,15,59738
56471,11,8,433,901405,11,901394
56472,11,3,266,743897,11,743886
56473,20,2,896,717161,20,717141
56474,20,-15,598,182187,20,182167
56475,15,10,669,965074,15,965059
56476,6,-7,69,407422,6,407416
56477,8,-16,186,128079,8,128071
56478,12,12,183,1023380,12,1023368
56479,8,15,478,1104531,8,1104523
56480,12,12,209,1023580,12,1023568
56481,15,9,182,930413,15,930398
56482,11,14,832,1091959,11,1091948
56483,19,2,94,711295,19,711276
56484,13,-15,448,181084,13,181071
56485,6,3,59,720108,6,720102
56486,13,-16,300,149151,13,149138
56487,20,-7,766,433879,20,433859
56488,9,-9,566,356386,9,356377
56489,13,-10,23,335299,13,335286
56490,9,7,501,855513,9,855504
56491,14,2,307,712897,14,712883
56492,16,10,763,965722,16,965706
56493,13,-16,225,148638,13,148625
56494,11,11,88,991490,11,991479
56495,18,-17,230,117138,18,117120
56496,17,5,278,805874,17,805857
56497,9,-15,446,165062,9,165053
56498,17,-2,903,592019,17,592002
56499,15,3,494,745505,15,745490
56500,13,-3,156,554854,13,554841
56501,10,-5,401,476753,10,476743
56502,6,0,728,641367,6,641361
56503,13,-16,239,148724,13,148711
56504,11,-4,438,525442,11,525431
56505,18,-4,38,522331,18,522313
56506,10,4,704,765741,10,765731
56507,12,-13,736,246462,12,246450
56508,20,9,515,932851,20,932831
56509,15,10,960,967217,15,967202
56510,18,-12,647,277254,18,277236
56511,10,10,376,945496,10,945486
56512,14,-20,433,26074,14,26060
56513,8,-9,853,362633,8,362625
56514,19,-17,604,120058,19,120039
56515,17,-2,601,589653,17,589636
56516,10,18,901,1205831,10,1205821
56517,17,-4,687,527276,17,527259
56518,13,-3,64,554223,13,554210
56519,10,-16,878,142900,10,142890
56520,19,-16,574,151239,19,151220
56521,9,-17,652,107554,9,107545
56522,11,-6,699,464507,11,464496
56523,14,19,384,1243889,14,1243875
56524,7,5,671,795468,7,795461
56525,11,2,237,712345,11,712334
56526,6,6,63,813519,6,813513
56527,17,-12,829,278609,17,278592
56528,16,-1,235,618430,16,618414
56529,7,-16,373,132003,7,131996
56530,16,11,522,994633,16,994617
56531,13,-6,297,461492,13,461479
56532,11,3,339,744454,11,744443
56533,7,11,590,981146,7,981139
56534,19,-5,455,494374,19,494355
56535,8,2,165,692146,8,692138
56536,17,-4,232,523919,17,523902
56537,13,19,645,1246036,13,1246023
56538,19,-15,851,184201,19,184182
56539,18,-19,630,58976,18,58958
56540,6,19,879,1237096,6,1237090
56541,8,-9,15,344002,8,343994
56542,14,-6,175,460499,14,460485
56543,11,-10,252,336942,11,336931
56544,17,17,709,1183167,17,1183150
56545,18,-6,424,462405,18,462387
56546,13,12,987,1029730,13,1029717
56547,18,5,809,809686,18,809668
56548,18,-6,693,464479,18,464461
56549,7,17,312,1162039,7,1162032
56550,10,-13,789,235502,10,235492
56551,6,-3,684,545911,6,545905
56552,19,18,53,1209314,19,1209295
56553,18,8,184,899363,18,899345
56554,5,-16,604,137184,5,137179
56555,13,11,919,997588,13,997575
56556,15,-4,872,528584,15,528569
56557,12,5,288,805958,12,805946
56558,19,7,959,873804,19,873785
56559,11,0,620,652930,11,652919
56560,8,-14,357,194435,8,194427
56561,8,-5,641,481911,8,481903
56562,5,-6,235,442014,5,442009
56563,13,19,808,1247335,13,1247322
56564,5,-13,369,226079,5,226074
56565,17,-16,426,150065,17,150048
56566,11,11,601,995180,11,995169
56567,7,-9,529,355604,7,355597
56568,12,11,676,995635,12,995623
56569,14,16,593,1151296,14,1151282
56570,11,-1,786,622618,11,622607
56571,11,2,668,715607,11,715596
56572,5,6,73,813759,5,813754
56573,5,-10,920,332180,5,332175
56574,18,-10,338,337519,18,337501
56575,7,10,305,943935,7,943928
56576,16,11,729,996069,16,996053
56577,8,-17,954,113577,8,113569
56578,13,7,25,867178,13,867165
56579,9,9,778,923147,9,923138
56580,9,4,883,770037,9,770028
56581,10,11,383,976679,10,976669
56582,19,-1,32,616801,19,616782
56583,14,17,898,1184705,14,1184691
56584,14,-10,249,336897,14,336883
56585,18,3,220,743535,18,743517
56586,10,8,824,893120,10,893110
56587,6,-15,781,172083,6,172077
56588,7,-20,544,11873,7,11866
56589,5,2,578,700791,5,700786
56590,17,0,27,648437,17,648420
56591,20,6,293,838015,20,837995
56592,7,-12,503,260540,7,260533
56593,16,-15,401,180699,16,180683
56594,11,14,542,1089701,11,1089690
56595,5,19,485,1228595,5,1228590
56596,14,-17,306,117799,14,117785
56597,16,8,490,901842,16,901826
56598,19,-16,970,154082,19,154063
56599,15,1,640,684900,15,684885
56600,14,-18,849,91338,14,91324
56601,9,5,170,785049,9,785040
56602,7,13,723,1046225,7,1046218
56603,17,0,912,655219,17,655202
56604,14,-12,971,279885,14,279871
56605,8,14,230,1066900,8,1066892
56606,20,0,958,655598,20,655578
56607,10,-14,72,188158,10,188148
56608,20,3,193,743349,20,743329
56609,13,-3,13,553939,13,553926
56610,17,-15,901,184599,17,184582
56611,11,-10,31,335393,11,335382
56612,13,19,44,1241061,13,1241048
56613,5,15,453,1104048,5,1104043
56614,18,1,909,686934,18,686916
56615,20,-7,327,430827,20,430807
56616,5,6,933,833252,5,833247
56617,6,9,1,906760,6,906754
56618,10,17,664,1169548,10,1169538
56619,14,5,91,804476,14,804462
56620,12,-5,153,492133,12,492121
56621,8,-15,631,169031,8,169023
56622,14,-7,102,429010,14,428996
56623,20,-14,566,213957,20,213937
56624,11,-4,30,522258,11,522247
56625,6,13,646,1044645,6,1044639
56626,11,-15,890,184513,11,184502
56627,11,-3,429,557024,11,557013
56628,18,9,29,929276,18,929258
56629,12,5,922,810509,12,810497
56630,5,-19,126,34383,5,34378
56631,13,-19,111,54866,13,54853
56632,10,-6,895,455931,10,455921
56633,8,-16,591,136860,8,136852
56634,7,10,361,945189,7,945182
56635,11,19,957,1248475,11,1248464
56636,15,-14,441,212953,15,212938
56637,14,3,393,744838,14,744824
56638,11,2,257,712519,11,712508
56639,20,5,477,807323,20,807303
56640,15,3,691,747125,15,747110
56641,10,9,634,920254,10,920244
56642,8,-3,273,536314,8,536306
56643,9,-12,313,256434,9,256425
56644,9,15,794,1111248,9,1111239
56645,11,19,102,1241577,11,1241566
56646,20,-19,678,59284,20,59264
56647,8,-3,880,550090,8,550082
56648,14,6,507,839909,14,839895
56649,14,15,217,1118441,14,1118427
56650,7,-16,512,135185,7,135178
56651,10,-3,228,535302,10,535292
56652,17,-9,178,367811,17,367794
56653,18,4,295,775317,18,775299
56654,17,-7,943,435279,17,435262
56655,7,18,119,1189432,7,1189425
56656,17,12,697,1027316,17,1027299
56657,15,-17,683,120638,15,120623
56658,18,17,890,1184622,18,1184604
56659,19,-15,481,181338,19,181319
56660,5,-4,869,517988,5,517983
56661,5,-9,61,344948,5,344943
56662,8,0,443,634953,8,634945
56663,16,15,51,1117177,16,1117161
56664,18,16,97,1147752,18,1147734
56665,8,16,221,1129925,8,1129917
56666,13,10,495,963574,13,963561
56667,13,0,200,649777,13,649764
56668,15,-7,481,431953,15,431938
56669,9,-15,875,174077,9,174068
56670,16,-17,821,121650,16,121634
56671,11,3,178,743190,11,743179
56672,10,-8,361,382937,10,382927
56673,20,-5,991,498287,20,498267
56674,14,15,581,1120985,14,1120971
56675,13,-6,341,461817,13,461804
56676,10,-18,899,81936,10,81926
56677,17,-5,833,497064,17,497047
56678,14,7,508,870790,14,870776
56679,20,-9,916,373865,20,373845
56680,17,8,189,899407,17,899390
56681,5,13,348,1038292,5,1038287
56682,11,13,75,1053781,11,1053770
56683,11,7,112,867831,11,867820
56684,8,-1,436,603504,8,603496
56685,16,-1,701,621964,16,621948
56686,16,-9,542,371001,16,370985
56687,11,6,589,840528,11,840517
56688,12,-8,1,397835,12,397823
56689,6,-13,390,226528,6,226522
56690,16,4,199,774671,16,774655
56691,10,5,997,802667,10,802657
56692,6,12,410,1007855,6,1007849
56693,9,4,41,751462,9,751453
56694,18,-10,784,340968,18,340950
56695,12,16,60,1147521,12,1147509
56696,13,-9,284,368663,13,368650
56697,14,15,558,1120825,14,1120811
56698,15,10,6,959861,15,959846
56699,8,14,206,1066262,8,1066254
56700,7,10,304,943909,7,943902
56701,18,-16,362,149562,18,149544
56702,17,2,612,715143,17,715126
56703,7,-8,832,393140,7,393133
56704,15,-8,469,401087,15,401072
56705,7,13,300,1037136,7,1037129
56706,14,-2,25,585321,14,585307
56707,6,-2,181,566562,6,566556
56708,10,15,832,1112129,10,1112119
56709,14,-17,535,119481,14,119467
56710,10,-11,538,293173,10,293163
56711,13,-2,95,585828,13,585815
56712,14,-8,140,398882,14,398868
56713,5,-14,555,198535,5,198530
56714,16,-16,194,148369,16,148353
56715,5,7,394,853312,5,853307
56716,6,7,702,859685,6,859679
56717,5,-7,344,413345,5,413340
56718,17,-14,576,214072,17,214055
56719,16,-17,302,117770,16,117754
56720,14,13,231,1054927,14,1054913
56721,17,-2,707,590477,17,590460
56722,13,-3,531,558035,13,558022
56723,15,-13,488,244614,15,244599
56724,13,-7,96,428947,13,428934
56725,18,-16,989,154212,18,154194
56726,5,-19,739,47857,5,47852
56727,20,2,305,712880,20,712860
56728,10,17,955,1175760,10,1175750
56729,12,6,48,836150,12,836138
56730,20,-6,100,459842,20,459822
56731,13,-3,647,558946,13,558933
56732,8,-10,404,321382,8,321374
56733,18,17,804,1183959,18,1183941
56734,16,14,521,1089525,16,1089509
56735,17,9,936,936056,17,936039
56736,5,19,323,1224798,5,1224793
56737,14,-2,661,590098,14,590084
56738,9,12,418,1008003,9,1007994
56739,6,-15,256,160891,6,160885
56740,14,-19,565,58467,14,58453
56741,13,6,405,839037,13,839024
56742,17,14,695,1090940,17,1090923
56743,6,3,316,725852,6,725846
56744,9,-17,362,101213,9,101204
56745,6,-16,966,144819,6,144813
56746,17,-8,24,398069,17,398052
56747,9,-11,519,292721,9,292712
56748,20,13,372,1055966,20,1055946
56749,8,7,311,851506,8,851498
56750,7,18,561,1198718,7,1198711
56751,14,6,314,838177,14,838163
56752,9,-8,760,391651,9,391642
56753,11,-2,649,589993,11,589982
56754,15,-15,637,182478,15,182463
56755,17,13,275,1055210,17,1055193
56756,6,18,419,1195690,6,1195684
56757,16,-10,507,338854,16,338838
56758,8,3,596,731534,8,731526
56759,7,7,940,864627,7,864620
56760,11,-4,93,522758,11,522747
56761,8,-18,579,74909,8,74901
56762,8,3,601,731676,8,731668
56763,13,-19,526,58085,13,58072
56764,16,-7,390,431297,16,431281
56765,7,10,348,944868,7,944861
56766,9,-8,877,394090,9,394081
56767,9,-15,720,170898,9,170889
56768,6,12,404,1007784,6,1007778
56769,19,4,323,775525,19,775506
56770,16,-15,718,183138,16,183122
56771,7,15,137,1097489,7,1097482
56772,9,-10,67,314078,9,314069
56773,19,-14,382,212530,19,212511
56774,10,-14,79,188319,10,188309
56775,13,7,337,869489,13,869476
56776,20,7,220,868539,20,868519
56777,9,-19,18,31882,9,31873
56778,14,4,246,775050,14,775036
56779,14,-12,736,277869,14,277855
56780,8,17,11,1155465,8,1155457
56781,20,9,877,935585,20,935565
56782,17,17,946,1184989,17,1184972
56783,17,-9,329,369044,17,369027
56784,7,12,233,1004238,7,1004231
56785,7,1,477,667688,7,667681
56786,11,-14,69,209825,11,209814
56787,9,-8,609,388292,9,388283
56788,18,5,913,810440,18,810422
56789,5,-4,83,501153,5,501148
56790,17,-9,126,367537,17,367520
56791,13,3,424,745045,13,745032
56792,11,-6,871,465672,11,465661
56793,18,12,783,1027888,18,1027870
56794,8,-19,651,45839,8,45831
56795,6,12,816,1016801,6,1016795
56796,11,11,845,996991,11,996980
56797,5,-20,47,996,5,991
56798,19,10,715,965380,19,965361
56799,15,19,953,1248453,15,1248438
56800,9,-13,242,223510,9,223501
56801,6,6,102,814384,6,814378
56802,6,8,415,884330,6,884324
56803,13,-5,709,496206,13,496193
56804,12,-12,796,278328,12,278316
56805,15,15,576,1120972,15,1120957
56806,7,6,319,819453,7,819446
56807,16,2,623,715215,16,715199
56808,17,18,383,1211880,17,1211863
56809,12,16,849,1153178,12,1153166
56810,16,10,199,961359,16,961343
56811,6,4,22,750963,6,750957
56812,20,1,489,683723,20,683703
56813,9,13,660,1045017,9,1045008
56814,6,-9,415,352678,6,352672
56815,5,-14,210,191176,5,191171
56816,19,-15,998,185389,19,185370
56817,16,8,983,905589,16,905573
56818,14,16,405,1150047,14,1150033
56819,15,-20,70,23317,15,23302
56820,16,-2,445,588463,16,588447
56821,9,-19,188,35750,9,35741
56822,12,-10,665,340127,12,340115
56823,6,-12,148,252773,6,252767
56824,11,1,898,686798,11,686787
56825,18,-18,868,91515,18,91497
56826,10,-9,639,357744,10,357734
56827,20,-2,619,589808,20,589788
56828,16,-1,810,622808,16,622792
56829,14,14,29,1085601,14,1085587
56830,19,0,90,648905,19,648886
56831,18,-14,532,213602,18,213584
56832,13,-15,213,179274,13,179261
56833,14,-17,585,119949,14,119935
56834,11,-9,138,367581,11,367570
56835,8,-18,916,82378,8,82370
56836,5,5,65,783041,5,783036
56837,12,13,305,1055444,12,1055432
56838,19,-10,986,342533,19,342514
56839,11,-4,60,522499,11,522488
56840,7,15,203,1098806,7,1098799
56841,9,5,702,796233,9,796224
56842,17,-18,549,89289,17,89272
56843,14,-14,589,214164,14,214150
56844,19,14,359,1088226,19,1088207
56845,17,0,962,655624,17,655607
56846,20,-9,32,366855,20,366835
56847,8,-16,423,133143,8,133135
56848,15,14,778,1091586,15,1091571
56849,10,7,30,845391,10,845381
56850,6,18,745,1202383,6,1202377
56851,9,0,7,625354,9,625345
56852,16,-14,558,213805,16,213789
56853,19,-5,822,496963,19,496944
56854,17,15,510,1120468,17,1120451
56855,11,17,630,1182527,11,1182516
56856,20,5,610,808271,20,808251
56857,14,10,251,961700,14,961686
56858,14,-9,217,368088,14,368074
56859,8,14,225,1066750,8,1066742
56860,16,17,888,1184590,16,1184574
56861,13,-15,98,178537,13,178524
56862,15,-5,415,494082,15,494067
56863,18,-20,797,28993,18,28975
56864,9,14,355,1069599,9,1069590
56865,19,9,527,932927,19,932908
56866,8,-4,496,510166,8,510158
56867,20,-9,878,373528,20,373508
56868,9,-9,551,356122,9,356113
56869,10,19,583,1230670,10,1230660
56870,19,-7,589,432764,19,432745
56871,5,19,708,1233173,5,1233168
56872,19,-19,678,59293,19,59274
56873,11,-6,467,462737,11,462726
56874,7,0,691,640490,7,640483
56875,9,-17,984,114258,9,114249
56876,7,17,872,1174144,7,1174137
56877,13,19,326,1243397,13,1243384
56878,18,15,448,1119973,18,1119955
56879,5,-4,92,501331,5,501326
56880,10,3,821,736521,10,736511
56881,18,-10,788,340989,18,340971
56882,18,3,105,742644,18,742626
56883,19,6,511,839927,19,839908
56884,16,19,496,1244860,16,1244844
56885,16,16,167,1148279,16,1148263
56886,10,-7,794,422563,10,422553
56887,6,-6,70,438257,6,438251
56888,13,-9,729,372133,13,372120
56889,11,12,564,1026168,11,1026157
56890,17,1,127,680837,17,680820
56891,16,0,875,654876,16,654860
56892,15,-1,780,622599,15,622584
56893,18,-11,961,311258,18,311240
56894,11,-8,482,401195,11,401184
56895,13,4,131,774195,13,774182
56896,7,-20,394,8561,7,8554
56897,18,6,881,842785,18,842767
56898,18,-14,398,212684,18,212666
56899,5,-5,194,472264,5,472259
56900,20,17,796,1183890,20,1183870
56901,14,-2,251,587033,14,587019
56902,8,11,27,969045,8,969037
56903,12,-13,445,244261,12,244249
56904,12,-8,656,402512,12,402500
56905,20,-4,299,524394,20,524374
56906,16,7,300,869192,16,869176
56907,12,-3,317,556099,12,556087
56908,13,-9,448,370130,13,370117
56909,7,12,260,1004931,7,1004924
56910,18,-13,466,244408,18,244390
56911,15,1,440,683297,15,683282
56912,10,15,504,1105155,10,1105145
56913,7,17,77,1156969,7,1156962
56914,12,1,453,683440,12,683428
56915,11,4,356,775792,11,775781
56916,7,-1,941,614294,7,614287
56917,8,15,373,1102370,8,1102362
56918,11,-17,502,119242,11,119231
56919,10,-18,108,64896,10,64886
56920,14,-12,88,273186,14,273172
56921,10,8,764,891980,10,891970
56922,11,-18,718,90475,11,90464
56923,15,-7,969,435487,15,435472
56924,11,1,245,681810,11,681799
56925,7,7,181,848628,7,848621
56926,17,18,609,1213304,17,1213287
56927,17,16,473,1150491,17,1150474
56928,20,-2,889,591945,20,591925
56929,17,9,169,930321,17,930304
56930,7,-4,610,512560,7,512553
56931,18,-8,714,402934,18,402916
56932,8,-2,53,564059,8,564051
56933,6,8,957,895950,6,895944
56934,18,7,778,872626,18,872608
56935,16,-14,47,209697,16,209681
56936,10,14,707,1077901,10,1077891
56937,5,18,766,1202882,5,1202877
56938,6,-18,296,68950,6,68944
56939,8,-16,287,130217,8,130209
56940,12,16,973,1154105,12,1154093
56941,15,-14,389,212611,15,212596
56942,10,7,948,864812,10,864802
56943,19,-15,334,180190,19,180171
56944,15,5,660,808602,15,808587
56945,19,15,510,1120477,19,1120458
56946,11,-1,117,617443,11,617432
56947,11,-12,617,277013,11,277002
56948,15,-11,147,304891,15,304876
56949,7,-1,235,599079,7,599072
56950,6,-9,658,358067,6,358061
56951,16,-15,330,180153,16,180137
56952,16,3,716,747281,16,747265
56953,14,-3,77,554327,14,554313
56954,11,-11,151,304917,11,304906
56955,5,-18,802,79747,5,79742
56956,6,1,253,662738,6,662732
56957,8,-9,225,348432,8,348424
56958,13,4,640,777914,13,777901
56959,5,5,110,783855,5,783850
56960,16,12,293,1024294,16,1024278
56961,6,-20,598,13089,6,13083
56962,13,-3,242,555462,13,555449
56963,20,13,21,1053385,20,1053365
56964,16,-13,170,242285,16,242269
56965,12,-14,84,209966,12,209954
56966,8,-9,114,345994,8,345986
56967,7,8,468,885421,7,885414
56968,15,-9,240,368322,15,368307
56969,15,-15,910,184698,15,184683
56970,20,1,166,681185,20,681165
56971,19,8,947,905333,19,905314
56972,18,10,454,963263,18,963245
56973,8,9,71,908256,8,908248
56974,7,-9,736,359891,7,359884
56975,9,-19,462,41440,9,41431
56976,7,-20,186,4362,7,4355
56977,19,-8,505,401378,19,401359
56978,14,18,66,1209488,14,1209474
56979,10,-18,743,78468,10,78458
56980,13,7,214,868519,13,868506
56981,8,-20,705,15550,8,15542
56982,14,7,160,868200,14,868186
56983,7,12,220,1003930,7,1003923
56984,9,6,226,817285,9,817276
56985,14,12,607,1026521,14,1026507
56986,7,-16,742,139940,7,139933
56987,11,2,323,713032,11,713021
56988,6,17,669,1169698,6,1169692
56989,6,-1,768,610305,6,610299
56990,8,0,90,627307,8,627299
56991,13,7,471,870520,13,870507
56992,18,7,945,873728,18,873710
56993,6,-13,927,238441,6,238435
56994,13,-20,361,25593,13,25580
56995,9,19,363,1225690,9,1225681
56996,18,0,992,655868,18,655850
56997,6,4,490,761087,6,761081
56998,13,-20,705,28218,13,28205
56999,12,10,686,965216,12,965204
57000,17,-13,69,241534,17,241517
57001,11,-18,121,86124,11,86113
57002,16,16,516,1150783,16,1150767
57003,7,14,348,1069480,7,1069473
57004,8,-7,473,415955,8,415947
57005,14,11,753,996293,14,996279
57006,18,6,431,839217,18,839199
57007,9,15,625,1107729,9,1107720
57008,17,16,878,1153337,17,1153320
57009,5,19,829,1235840,5,1235835
57010,9,-13,135,221246,9,221237
57011,9,3,446,728419,9,728410
57012,14,-4,476,525646,14,525632
57013,6,15,250,1099901,6,1099895
57014,9,8,630,889023,9,889014
57015,10,-19,802,49007,10,48997
57016,20,10,255,961744,20,961724
57017,8,11,721,983876,8,983868
57018,5,3,148,722020,5,722015
57019,11,-3,129,554719,11,554708
57020,13,4,104,774045,13,774032
57021,6,8,824,893126,6,893120
57022,8,13,966,1051399,8,1051391
57023,5,-12,878,268644,5,268639
57024,11,10,816,966194,11,966183
57025,20,7,41,867334,20,867314
57026,20,18,749,1214408,20,1214388
57027,6,-17,399,101917,6,101911
57028,11,12,206,1023539,11,1023528
57029,14,-9,376,369478,14,369464
57030,6,7,783,861342,6,861336
57031,17,16,162,1148207,17,1148190
57032,13,-2,559,589338,13,589325
57033,16,-6,479,462841,16,462825
57034,15,4,528,777088,15,777073
57035,15,-3,396,556699,15,556684
57036,8,-14,993,208143,8,208135
57037,13,-4,591,526546,13,526533
57038,12,0,360,650753,12,650741
57039,17,-8,310,400076,17,400059
57040,5,6,219,817024,5,817019
57041,20,16,194,1148536,20,1148516
57042,11,4,15,773368,11,773357
57043,6,7,149,847942,6,847936
57044,12,-1,66,617039,12,617027
57045,18,14,75,1086032,18,1086014
57046,11,19,489,1244795,11,1244784
57047,17,-11,724,309394,17,309377
57048,12,11,570,994972,12,994960
57049,18,-16,701,152072,18,152054
57050,19,-4,353,524856,19,524837
57051,5,4,621,764080,5,764075
57052,9,0,572,637727,9,637718
57053,9,10,791,954599,9,954590
57054,12,6,372,838681,12,838669
57055,20,-1,50,616956,20,616936
57056,17,-18,823,91250,17,91233
57057,10,-8,708,390608,10,390598
57058,7,-9,970,365146,7,365139
57059,11,15,469,1120093,11,1120082
57060,14,4,448,776462,14,776448
57061,16,-1,623,621397,16,621381
57062,6,15,772,1110845,6,1110839
57063,5,-9,798,361448,5,361443
57064,19,12,454,1025366,19,1025347
57065,5,15,699,1109319,5,1109314
57066,18,6,630,840863,18,840845
57067,11,18,310,1211337,11,1211326
57068,9,-17,342,100824,9,100815
57069,14,18,188,1210526,14,1210512
57070,17,-18,682,90216,17,90199
57071,5,15,194,1098642,5,1098637
57072,19,6,989,843680,19,843661
57073,11,11,125,991719,11,991708
57074,15,-8,572,401885,15,401870
57075,17,-2,153,586218,17,586201
57076,16,-2,804,591172,16,591156
57077,10,14,900,1081986,10,1081976
57078,7,13,892,1049932,7,1049925
57079,13,-10,246,336854,13,336841
57080,9,-14,745,202885,9,202876
57081,16,4,648,777990,16,777974
57082,13,-18,767,90834,13,90821
57083,7,-13,545,229930,7,229923
57084,14,-16,906,153597,14,153583
57085,7,-13,914,238115,7,238108
57086,18,-5,513,494822,18,494804
57087,17,-13,0,241050,17,241033
57088,10,4,585,763195,10,763185
57089,8,17,315,1162088,8,1162080
57090,17,-6,466,462727,17,462710
57091,10,-15,206,159667,10,159657
57092,18,0,402,651116,18,651098
57093,6,12,881,1018416,6,1018410
57094,10,-17,529,104845,10,104835
57095,19,-5,550,495084,19,495065
57096,14,-9,609,371426,14,371412
57097,11,7,63,867478,11,867467
57098,16,14,858,1092131,16,1092115
57099,10,15,480,1104641,10,1104631
57100,9,-7,762,421990,9,421981
57101,11,-8,113,398670,11,398659
57102,13,11,235,992500,13,992487
57103,13,11,174,992071,13,992058
57104,8,-12,37,250332,8,250324
57105,10,9,283,912592,10,912582
57106,7,11,162,971832,7,971825
57107,5,1,71,658564,5,658559
57108,18,-20,685,28076,18,28058
57109,5,-11,972,302075,5,302070
57110,20,12,225,1023717,20,1023697
57111,20,0,715,653770,20,653750
57112,6,14,506,1073102,6,1073096
57113,16,-19,386,57006,16,56990
57114,15,-4,16,522165,15,522150
57115,20,-15,625,182370,20,182350
57116,18,-10,581,339392,18,339374
57117,17,3,529,745702,17,745685
57118,20,12,55,1022487,20,1022467
57119,17,-10,887,341778,17,341761
57120,11,5,79,804388,11,804377
57121,18,19,334,1243481,18,1243463
57122,17,7,838,873084,17,873067
57123,18,-8,886,404153,18,404135
57124,6,14,386,1070310,6,1070304
57125,11,-18,939,92039,11,92028
57126,10,-4,25,499852,10,499842
57127,20,10,819,966203,20,966183
57128,16,3,307,744251,16,744235
57129,13,-17,175,116745,13,116732
57130,7,17,480,1165593,7,1165586
57131,16,2,39,710827,16,710811
57132,6,18,461,1196644,6,1196638
57133,19,19,388,1243950,19,1243931
57134,12,18,852,1215193,12,1215181
57135,15,-11,882,310648,15,310633
57136,16,7,354,869593,16,869577
57137,12,-2,646,589966,12,589954
57138,17,-3,445,557189,17,557172
57139,14,16,124,1147923,14,1147909
57140,9,-7,554,417778,9,417769
57141,13,-18,6,85266,13,85253
57142,17,15,368,1119470,17,1119453
57143,5,12,575,1011389,5,1011384
57144,7,-7,252,411116,7,411109
57145,10,-2,560,574679,10,574669
57146,15,17,29,1178079,15,1178064
57147,5,-14,227,191662,5,191657
57148,16,-18,887,91661,16,91645
57149,5,-18,991,84014,5,84009
57150,11,-20,753,28606,11,28595
57151,7,-9,374,351803,7,351796
57152,15,-7,534,432387,15,432372
57153,19,-16,381,149691,19,149672
57154,16,-13,839,247287,16,247271
57155,12,11,2,990865,12,990853
57156,13,19,424,1244345,13,1244332
57157,13,2,879,717058,13,717045
57158,13,16,251,1148908,13,1148895
57159,12,-11,436,307267,12,307255
57160,9,-7,127,408508,9,408499
57161,14,8,322,900501,14,900487
57162,15,3,813,747965,15,747950
57163,12,17,236,1179628,12,1179616
57164,19,8,345,900729,19,900710
57165,19,-16,127,147906,19,147887
57166,18,16,961,1153973,18,1153955
57167,8,8,821,893055,8,893047
57168,13,8,403,901188,13,901175
57169,7,16,128,1127774,7,1127767
57170,16,3,917,748757,16,748741
57171,12,5,645,808487,12,808475
57172,10,12,927,1019531,10,1019521
57173,16,11,678,995671,16,995655
57174,10,15,724,1109927,10,1109917
57175,16,8,856,904641,16,904625
57176,7,19,412,1226944,7,1226937
57177,11,-7,515,432217,11,432206
57178,6,9,494,917147,6,917141
57179,10,4,174,754413,10,754403
57180,14,17,488,1181560,14,1181546
57181,16,-1,831,622927,16,622911
57182,13,19,801,1247279,13,1247266
57183,19,-9,946,374063,19,374044
57184,6,-2,134,565706,6,565700
57185,16,-7,720,433553,16,433537
57186,10,6,6,812272,10,812262
57187,8,19,494,1228721,8,1228713
57188,20,-19,148,55197,20,55177
57189,14,9,577,933323,14,933309
57190,18,15,708,1122016,18,1121998
57191,19,-17,272,117496,19,117477
57192,20,-4,871,528560,20,528540
57193,14,19,113,1241706,14,1241692
57194,11,-14,366,212297,11,212286
57195,14,6,602,840610,14,840596
57196,14,12,195,1023416,14,1023402
57197,11,12,923,1029160,11,1029149
57198,13,-9,888,373623,13,373610
57199,8,-6,325,443811,8,443803
57200,20,-19,150,55246,20,55226
57201,18,18,10,1208995,18,1208977
57202,6,-12,155,252877,6,252871
57203,19,-16,514,150790,19,150771
57204,12,-18,531,89159,12,89147
57205,8,-17,479,103681,8,103673
57206,7,2,876,706816,7,706809
57207,8,-12,339,256982,8,256974
57208,8,5,863,799698,8,799690
57209,7,14,779,1079419,7,1079412
57210,9,5,876,800038,9,800029
57211,20,1,201,681487,20,681467
57212,20,17,100,1178552,20,1178532
57213,18,19,168,1242105,18,1242087
57214,17,-18,36,85492,17,85475
57215,11,-17,106,116358,11,116347
57216,15,-16,402,149844,15,149829
57217,18,8,233,899893,18,899875
57218,13,-13,900,247723,13,247710
57219,16,-12,308,274817,16,274801
57220,13,-7,652,433042,13,433029
57221,20,11,924,997632,20,997612
57222,16,3,277,744000,16,743984
57223,17,13,196,1054672,17,1054655
57224,20,-11,241,305573,20,305553
57225,15,14,593,1090001,15,1089986
57226,11,-8,956,404673,11,404662
57227,11,1,62,680231,11,680220
57228,10,18,891,1205655,10,1205645
57229,10,-7,662,419781,10,419771
57230,10,-8,997,396758,10,396748
57231,19,-19,705,59489,19,59470
57232,13,14,972,1093046,13,1093033
57233,16,-2,138,586137,16,586121
57234,13,9,579,933330,13,933317
57235,20,-18,144,86323,20,86303
57236,10,5,47,782623,10,782613
57237,20,14,97,1086234,20,1086214
57238,15,-5,559,495175,15,495160
57239,6,-12,596,262409,6,262403
57240,9,-20,109,2386,9,2377
57241,14,15,807,1122671,14,1122657
57242,18,-14,809,215872,18,215854
57243,11,11,470,994280,11,994269
57244,17,-18,908,91816,17,91799
57245,8,6,365,820431,8,820423
57246,17,-18,869,91533,17,91516
57247,12,2,274,712608,12,712596
57248,13,6,938,843208,13,843195
57249,9,-13,443,227647,9,227638
57250,9,15,467,1104358,9,1104349
57251,11,-2,434,588408,11,588397
57252,18,13,6,1053302,18,1053284
57253,10,-1,40,594677,10,594667
57254,15,-1,300,618951,15,618936
57255,10,-2,959,583376,10,583366
57256,16,-17,372,118243,16,118227
57257,16,5,657,808574,16,808558
57258,8,-4,394,508211,8,508203
57259,5,-12,726,265138,5,265133
57260,14,12,274,1024163,14,1024149
57261,19,0,181,649643,19,649624
57262,13,-10,127,336054,13,336041
57263,8,4,145,753702,8,753694
57264,13,12,627,1026702,13,1026689
57265,13,-14,432,212870,13,212857
57266,5,7,777,861208,5,861203
57267,13,1,286,682129,13,682116
57268,12,-1,160,617729,12,617717
57269,11,-17,348,118087,11,118076
57270,9,12,597,1011898,9,1011889
57271,13,-10,11,335201,13,335188
57272,9,12,844,1017545,9,1017536
57273,13,-14,357,212176,13,212163
57274,5,-14,908,206271,5,206266
57275,18,-11,299,306080,18,306062
57276,17,5,657,808581,17,808564
57277,14,-14,903,216528,14,216514
57278,20,15,551,1120757,20,1120737
57279,9,-19,693,46771,9,46762
57280,6,2,11,688757,6,688751
57281,17,-16,908,153618,17,153601
57282,11,4,401,776086,11,776075
57283,13,-7,890,434876,13,434863
57284,18,-2,472,588711,18,588693
57285,5,14,477,1072422,5,1072417
57286,16,-12,755,278062,16,278046
57287,14,-15,761,183418,14,183404
57288,8,4,800,768020,8,768012
57289,7,-15,87,157274,7,157267
57290,14,-5,863,497309,14,497295
57291,8,-3,22,531034,8,531026
57292,7,10,364,945297,7,945290
57293,20,13,799,1059251,20,1059231
57294,7,-4,607,512462,7,512455
57295,7,4,375,758717,7,758710
57296,18,-16,143,147986,18,147968
57297,14,-18,652,90019,14,90005
57298,5,19,875,1237025,5,1237020
57299,18,-12,758,278091,18,278073
57300,11,-18,709,90401,11,90390
57301,18,-6,726,464698,18,464680
57302,8,-6,363,444546,8,444538
57303,18,-19,504,57865,18,57847
57304,12,-1,355,619459,12,619447
57305,17,5,181,805154,17,805137
57306,12,16,191,1148497,12,1148485
57307,10,-2,218,567460,10,567450
57308,20,15,316,1119112,20,1119092
57309,14,17,285,1180062,14,1180048
57310,13,-1,334,619251,13,619238
57311,20,-14,607,214309,20,214289
57312,6,12,429,1008264,6,1008258
57313,12,9,631,933757,12,933745
57314,15,12,146,1023094,15,1023079
57315,9,7,883,863550,9,863541
57316,20,-11,2,303681,20,303661
57317,13,-20,820,29158,13,29145
57318,15,5,160,804952,15,804937
57319,16,-13,867,247481,16,247465
57320,20,-20,538,26914,20,26894
57321,9,2,362,696538,9,696529
57322,8,8,850,893654,8,893646
57323,12,-6,768,464982,12,464970
57324,11,19,506,1244949,11,1244938
57325,10,-15,527,166795,10,166785
57326,18,17,358,1180646,18,1180628
57327,18,-2,938,592291,18,592273
57328,11,8,545,902231,11,902220
57329,12,-14,10,209420,12,209408
57330,19,18,943,1215878,19,1215859
57331,16,-11,193,305263,16,305247
57332,14,-15,751,183367,14,183353
57333,15,-9,467,370304,15,370289
57334,12,-14,702,215013,12,215001
57335,14,-2,963,592474,14,592460
57336,20,4,510,776934,20,776914
57337,15,-14,753,215357,15,215342
57338,17,3,198,743381,17,743364
57339,12,-2,325,587551,12,587539
57340,13,3,898,748579,13,748566
57341,5,16,86,1127006,5,1127001
57342,17,-15,211,179267,17,179250
57343,15,-6,361,461924,15,461909
57344,12,-13,642,245721,12,245709
57345,8,-15,612,168591,8,168583
57346,16,-6,939,466259,16,466243
57347,18,-10,4,335153,18,335135
57348,8,-10,478,323108,8,323100
57349,9,-19,599,44669,9,44660
57350,12,17,726,1183332,12,1183320
57351,8,-6,86,438553,8,438545
57352,8,13,648,1044701,8,1044693
57353,9,-11,235,286134,9,286125
57354,17,-17,771,121368,17,121351
57355,13,-17,728,121029,13,121016
57356,5,-17,173,97047,5,97042
57357,17,-11,429,307206,17,307189
57358,16,16,640,1151709,16,1151693
57359,12,-18,766,90832,12,90820
57360,17,14,759,1091406,17,1091389
57361,19,4,318,775460,19,775441
57362,16,19,931,1248253,16,1248237
57363,20,-3,365,556471,20,556451
57364,20,-16,734,152282,20,152262
57365,15,16,271,1149082,15,1149067
57366,19,4,548,777239,19,777220
57367,6,3,773,735504,6,735498
57368,11,-6,179,460578,11,460567
57369,18,-10,828,341321,18,341303
57370,12,-5,199,492410,12,492398
57371,11,0,172,649527,11,649516
57372,14,-2,636,589892,14,589878
57373,18,9,14,929141,18,929123
57374,6,-12,332,256870,6,256864
57375,13,6,321,838267,13,838254
57376,14,-4,213,523753,14,523739
57377,14,-19,494,57776,14,57762
57378,12,-7,77,428829,12,428817
57379,15,17,9,1177908,15,1177893
57380,5,10,605,950572,5,950567
57381,18,16,740,1152371,18,1152353
57382,17,-15,842,184083,17,184066
57383,18,-16,999,154304,18,154286
57384,16,12,322,1024478,16,1024462
57385,9,-20,25,620,9,611
57386,19,11,719,996002,19,995983
57387,7,-6,995,458029,7,458022
57388,10,-18,586,75039,10,75029
57389,19,6,327,838333,19,838314
57390,8,-15,77,156954,8,156946
57391,5,2,555,700355,5,700350
57392,8,-19,534,43096,8,43088
57393,5,-13,914,238120,5,238115
57394,9,-15,937,175377,9,175368
57395,9,-20,467,9989,9,9980
57396,16,11,740,996149,16,996133
57397,7,5,600,794135,7,794128
57398,10,-9,59,344904,10,344894
57399,8,-7,896,425142,8,425134
57400,18,10,506,963754,18,963736
57401,15,12,763,1027718,15,1027703
57402,18,-6,265,461232,18,461214
57403,7,4,223,755494,7,755487
57404,10,-18,820,80204,10,80194
57405,13,-16,581,151288,13,151275
57406,20,-6,48,459481,20,459461
57407,14,12,8,1022167,14,1022153
57408,17,-20,438,26133,17,26116
57409,10,-20,516,11092,10,11082
57410,11,5,491,807393,11,807382
57411,9,-18,970,83580,9,83571
57412,5,-14,156,189894,5,189889
57413,18,-5,747,496511,18,496493
57414,10,-7,977,426759,10,426749
57415,17,3,497,745543,17,745526
57416,16,-10,39,335463,16,335447
57417,5,-1,353,601825,5,601820
57418,5,-1,464,604219,5,604214
57419,9,5,444,790820,9,790811
57420,5,17,539,1166827,5,1166822
57421,14,19,607,1245697,14,1245683
57422,5,13,807,1048192,5,1048187
57423,18,-4,542,526216,18,526198
57424,10,-17,311,100239,10,100229
57425,12,1,131,680873,12,680861
57426,14,19,339,1243499,14,1243485
57427,6,-10,615,325954,6,325948
57428,5,2,484,698934,5,698929
57429,6,-4,716,514822,6,514816
57430,8,14,701,1077756,8,1077748
57431,9,11,575,980816,9,980807
57432,6,-9,885,363455,6,363449
57433,5,-1,188,597726,5,597721
57434,14,19,1,1240625,14,1240611
57435,6,-1,125,596526,6,596520
57436,7,-16,175,127725,7,127718
57437,5,16,167,1128652,5,1128647
57438,15,-17,366,118191,15,118176
57439,5,-2,461,572572,5,572567
57440,10,5,700,796196,10,796186
57441,15,-7,209,429885,15,429870
57442,11,15,992,1124083,11,1124072
57443,8,-18,105,64827,8,64819
57444,13,9,395,931883,13,931870
57445,14,12,986,1029728,14,1029714
57446,20,-14,328,211980,20,211960
57447,20,-5,639,495710,20,495690
57448,18,-9,819,373029,18,373011
57449,10,0,366,633182,10,633172
57450,8,5,990,802567,8,802559
57451,13,17,224,1179517,13,1179504
57452,11,11,85,991492,11,991481
57453,5,11,796,985508,5,985503
57454,7,-13,854,236860,7,236853
57455,12,3,493,745491,12,745479
57456,5,19,287,1223868,5,1223863
57457,15,8,329,900580,15,900565
57458,7,2,689,703146,7,703139
57459,5,-6,551,448771,5,448766
57460,10,-6,273,442788,10,442778
57461,6,-5,92,470145,6,470139
57462,20,-6,847,465554,20,465534
57463,5,-14,495,197401,5,197396
57464,13,-5,373,493799,13,493786
57465,14,7,843,873114,14,873100
57466,15,-8,393,400691,15,400676
57467,8,-1,126,596533,8,596525
57468,8,-6,368,444615,8,444607
57469,9,6,831,831059,9,831050
57470,10,-5,984,489430,10,489420
57471,10,10,146,940759,10,940749
57472,12,-1,454,620178,12,620166
57473,10,10,780,954358,10,954348
57474,14,-17,214,117056,14,117042
57475,9,14,867,1081247,9,1081238
57476,5,6,386,820993,5,820988
57477,18,-17,561,119717,18,119699
57478,19,-3,763,559910,19,559891
57479,9,4,209,755168,9,755159
57480,9,0,808,643041,9,643032
57481,9,-11,464,291535,9,291526
57482,19,11,549,994787,19,994768
57483,10,-5,499,478785,10,478775
57484,11,4,648,777991,11,777980
57485,8,0,409,634205,8,634197
57486,10,14,973,1083571,10,1083561
57487,8,-18,575,74807,8,74799
57488,13,-11,241,305576,13,305563
57489,20,-11,8,303760,20,303740
57490,16,2,402,713691,16,713675
57491,13,-11,862,310486,13,310473
57492,14,16,2,1147123,14,1147109
57493,12,16,436,1150264,12,1150252
57494,7,10,45,938518,7,938511
57495,17,19,887,1247968,17,1247951
57496,12,-8,447,400971,12,400959
57497,16,4,885,779837,16,779821
57498,15,-20,786,28872,15,28857
57499,11,-8,318,400128,11,400117
57500,14,15,4,1116764,14,1116750
57501,13,6,322,838269,13,838256
57502,6,-8,556,387082,6,387076
57503,13,19,413,1244215,13,1244202
57504,17,7,226,868593,17,868576
57505,20,-11,71,304251,20,304231
57506,18,16,643,1151743,18,1151725
57507,16,12,330,1024546,16,1024530
57508,16,-16,337,149389,16,149373
57509,6,3,554,730497,6,730491
57510,11,5,624,808360,11,808349
57511,9,17,509,1166253,9,1166244
57512,10,11,879,987429,10,987419
57513,19,-15,659,182719,19,182700
57514,11,13,884,1059857,11,1059846
57515,19,-14,143,210427,19,210408
57516,14,16,49,1147445,14,1147431
57517,10,19,906,1237716,10,1237706
57518,14,-19,530,58110,14,58096
57519,11,-20,688,28119,11,28108
57520,14,-19,536,58163,14,58149
57521,6,-4,795,516381,6,516375
57522,19,9,400,931959,19,931940
57523,5,14,790,1079641,5,1079636
57524,6,1,566,669710,6,669704
57525,9,-6,667,451100,9,451091
57526,17,6,800,842163,17,842146
57527,10,1,764,673635,10,673625
57528,19,-10,15,335244,19,335225
57529,19,-13,99,241780,19,241761
57530,20,-4,971,529417,20,529397
57531,14,0,897,655099,14,655085
57532,13,9,803,935009,13,934996
57533,19,17,352,1180598,19,1180579
57534,5,19,913,1237817,5,1237812
57535,18,-3,452,557259,18,557241
57536,10,-5,266,473909,10,473899
57537,10,-15,718,170835,10,170825
57538,15,-13,931,248073,15,248058
57539,15,-17,765,121323,15,121308
57540,20,14,673,1090732,20,1090712
57541,13,3,972,749305,13,749292
57542,6,-2,482,573057,6,573051
57543,11,10,166,961160,11,961149
57544,9,-15,343,162879,9,162870
57545,9,-12,979,270972,9,270963
57546,12,-11,395,306896,12,306884
57547,16,-19,434,57357,16,57341
57548,16,18,690,1213939,16,1213923
57549,16,7,831,873023,16,873007
57550,14,1,116,680730,14,680716
57551,10,-8,23,375848,10,375838
57552,14,-20,238,24596,14,24582
57553,16,-4,666,527132,16,527116
57554,14,-9,5,366665,14,366651
57555,5,17,595,1167956,5,1167951
57556,20,-12,243,274303,20,274283
57557,20,5,579,808019,20,807999
57558,6,-20,138,3026,6,3020
57559,18,-20,253,24714,18,24696
57560,8,5,723,796711,8,796703
57561,18,15,9,1116821,18,1116803
57562,7,12,271,1005226,7,1005219
57563,20,12,939,1029313,20,1029293
57564,8,-3,720,546613,8,546605
57565,7,2,487,699032,7,699025
57566,9,-7,669,419952,9,419943
57567,19,-15,82,178402,19,178383
57568,18,-4,938,529095,18,529077
57569,16,-5,843,497136,16,497120
57570,8,16,423,1134293,8,1134285
57571,20,-2,816,591286,20,591266
57572,9,18,894,1205701,9,1205692
57573,13,14,691,1090918,13,1090905
57574,16,-9,801,372900,16,372884
57575,10,14,434,1071557,10,1071547
57576,13,-11,36,303921,13,303908
57577,5,1,884,676203,5,676198
57578,11,0,719,653808,11,653797
57579,5,4,338,757811,5,757806
57580,13,-6,365,461954,13,461941
57581,11,8,153,899151,11,899140
57582,5,3,468,728868,5,728863
57583,14,-9,765,372577,14,372563
57584,14,6,987,843637,14,843623
57585,19,13,290,1055357,19,1055338
57586,15,-12,878,279056,15,279041
57587,7,0,228,630402,7,630395
57588,20,-9,395,369667,20,369647
57589,12,-11,62,304171,12,304159
57590,17,-9,804,372908,17,372891
57591,7,17,226,1159989,7,1159982
57592,20,-15,271,179730,20,179710
57593,15,-14,32,209577,15,209562
57594,11,-13,643,245722,11,245711
57595,12,15,785,1122532,12,1122520
57596,18,-7,776,433962,18,433944
57597,17,1,920,687044,17,687027
57598,17,15,386,1119601,17,1119584
57599,12,-5,461,494461,12,494449
57600,17,-13,360,243667,17,243650
57601,19,11,918,997571,19,997552
57602,16,11,193,992203,16,992187
57603,7,4,999,772296,7,772289
57604,7,-2,265,568517,7,568510
57605,15,-4,233,523941,15,523926
57606,9,14,606,1075358,9,1075349
57607,9,-7,316,412747,9,412738
57608,17,-1,927,623668,17,623651
57609,15,3,330,744395,15,744380
57610,14,-10,265,337027,14,337013
57611,8,13,414,1039737,8,1039729
57612,16,-14,632,214476,16,214460
57613,11,-10,503,338826,11,338815
57614,14,15,344,1119326,14,1119312
57615,8,-12,131,252421,8,252413
57616,10,-13,305,224878,10,224868
57617,11,13,87,1053877,11,1053866
57618,15,-12,58,272940,15,272925
57619,7,-18,409,71183,7,71176
57620,8,6,205,816689,8,816681
57621,19,19,476,1244706,19,1244687
57622,7,3,282,725019,7,725012
57623,13,7,23,867166,13,867153
57624,15,-2,29,585355,15,585340
57625,18,4,407,776143,18,776125
57626,11,-6,318,461638,11,461627
57627,16,-5,687,496045,16,496029
57628,16,-1,572,621062,16,621046
57629,13,-9,473,370380,13,370367
57630,19,15,168,1118028,19,1118009
57631,16,6,806,842254,16,842238
57632,17,-1,300,618958,17,618941
57633,16,14,62,1085930,16,1085914
57634,7,3,535,730020,7,730013
57635,10,6,430,822070,10,822060
57636,16,0,382,650994,16,650978
57637,13,-20,805,29068,13,29055
57638,7,-14,745,202892,7,202885
57639,11,-13,915,247920,11,247909
57640,17,-1,487,620466,17,620449
57641,17,-13,757,246641,17,246624
57642,5,-16,104,126277,5,126272
57643,6,7,80,846567,6,846561
57644,12,-9,385,369556,12,369544
57645,5,3,808,736250,5,736245
57646,14,-15,431,180993,14,180979
57647,20,-6,191,460649,20,460629
57648,20,-3,403,556783,20,556763
57649,13,0,447,651489,13,651476
57650,18,10,698,965284,18,965266
57651,20,-2,430,588371,20,588351
57652,8,-14,877,205565,8,205557
57653,5,1,778,673928,5,673923
57654,13,18,425,1212188,13,1212175
57655,11,9,946,936141,11,936130
57656,9,9,207,911170,9,911161
57657,10,6,273,818391,10,818381
57658,11,-1,794,622674,11,622663
57659,15,6,447,839332,15,839317
57660,10,9,891,925594,10,925584
57661,5,-19,573,44082,5,44077
57662,6,-4,811,516679,6,516673
57663,20,-3,114,554606,20,554586
57664,14,3,588,746221,14,746207
57665,9,7,930,864460,9,864451
57666,12,14,72,1086008,12,1085996
57667,13,2,266,712555,13,712542
57668,18,1,92,680506,18,680488
57669,13,-15,951,185020,13,185007
57670,8,-7,17,406437,8,406429
57671,8,-18,717,77853,8,77845
57672,15,19,723,1246649,15,1246634
57673,18,-7,644,433015,18,432997
57674,8,-7,2,406100,8,406092
57675,5,11,711,983613,5,983608
57676,6,12,961,1020335,6,1020329
57677,7,-15,246,160688,7,160681
57678,20,2,566,714855,20,714835
57679,17,-8,597,402032,17,402015
57680,7,-12,396,258229,7,258222
57681,13,13,211,1054806,13,1054793
57682,17,-20,961,30065,17,30048
57683,5,-5,356,475911,5,475906
57684,5,-17,405,102056,5,102051
57685,12,-18,126,86186,12,86174
57686,12,-14,148,210430,12,210418
57687,9,-5,402,476779,9,476770
57688,15,13,571,1057558,15,1057543
57689,8,9,476,916664,8,916656
57690,14,5,924,810560,14,810546
57691,13,4,755,778819,13,778806
57692,6,0,957,646164,6,646158
57693,7,-18,540,73981,7,73974
57694,20,-17,893,122148,20,122128
57695,9,-19,333,38736,9,38727
57696,18,0,196,649747,18,649729
57697,8,-10,323,319538,8,319530
57698,11,19,70,1241318,11,1241307
57699,12,14,681,1090815,12,1090803
57700,14,-5,354,493715,14,493701
57701,5,-3,889,550319,5,550314
57702,17,-13,728,246389,17,246372
57703,20,-8,226,399511,20,399491
57704,14,1,370,682842,14,682828
57705,16,-3,718,559489,16,559473
57706,11,-4,642,526915,11,526904
57707,11,19,884,1247934,11,1247923
57708,12,17,956,1185048,12,1185036
57709,7,-16,401,132607,7,132600
57710,11,-7,641,432994,11,432983
57711,6,16,15,1125536,6,1125530
57712,14,11,744,996175,14,996161
57713,20,-9,340,369200,20,369180
57714,19,-13,649,245787,19,245768
57715,9,16,752,1140696,9,1140687
57716,10,11,102,970696,10,970686
57717,16,-14,122,210240,16,210224
57718,6,-18,495,73094,6,73088
57719,9,-16,588,136781,9,136772
57720,6,18,777,1203165,6,1203159
57721,20,-10,988,342575,20,342555
57722,17,-9,492,370568,17,370551
57723,13,-19,571,58526,13,58513
57724,7,13,188,1034697,7,1034690
57725,7,-13,428,227321,7,227314
57726,6,-20,974,21500,6,21494
57727,11,4,162,774442,11,774431
57728,14,-1,391,619678,14,619664
57729,13,7,635,871662,13,871649
57730,12,17,230,1179567,12,1179555
57731,14,7,918,873570,14,873556
57732,16,-5,63,491305,16,491289
57733,6,10,307,943988,6,943982
57734,14,14,625,1090273,14,1090259
57735,5,-6,400,445303,5,445298
57736,14,3,799,747866,14,747852
57737,9,-3,769,547681,9,547672
57738,19,15,4,1116773,19,1116754
57739,7,-18,889,81691,7,81684
57740,19,11,458,994185,19,994166
57741,20,14,195,1086952,20,1086932
57742,11,8,747,903847,11,903836
57743,12,3,438,745133,12,745121
57744,8,-16,82,125649,8,125641
57745,6,19,820,1235635,6,1235629
57746,11,4,454,776511,11,776500
57747,14,-1,221,618274,14,618260
57748,5,-3,549,542833,5,542828
57749,20,-2,494,588882,20,588862
57750,9,12,873,1018253,9,1018244
57751,14,5,848,809932,14,809918
57752,12,13,481,1056788,12,1056776
57753,11,-7,917,435097,11,435086
57754,18,2,17,710577,18,710559
57755,14,0,204,649788,14,649774
57756,14,4,941,780173,14,780159
57757,9,8,294,881631,9,881622
57758,20,-3,628,558800,20,558780
57759,20,-19,976,61313,20,61293
57760,7,-20,700,15441,7,15434
57761,14,7,48,867401,14,867387
57762,7,7,155,848098,7,848091
57763,8,15,171,1098118,8,1098110
57764,12,18,813,1214849,12,1214837
57765,6,11,944,988726,6,988720
57766,6,17,959,1175908,6,1175902
57767,17,-8,995,404998,17,404981
57768,18,-18,199,86836,18,86818
57769,19,-12,415,275552,19,275533
57770,6,16,989,1145836,6,1145830
57771,14,-13,127,241926,14,241912
57772,6,13,977,1051658,6,1051652
57773,11,-11,186,305218,11,305207
57774,20,0,649,653215,20,653195
57775,14,18,459,1212372,14,1212358
57776,12,5,309,806026,12,806014
57777,11,5,683,808791,11,808780
57778,6,0,497,636193,6,636187
57779,7,14,553,1074165,7,1074158
57780,15,6,254,837679,15,837664
57781,12,1,675,685147,12,685135
57782,18,8,370,900861,18,900843
57783,18,-12,500,276246,18,276228
57784,12,2,979,717737,12,717725
57785,8,2,20,688992,8,688984
57786,6,-2,864,581280,6,581274
57787,5,-8,873,393989,5,393984
57788,7,8,430,884605,7,884598
57789,18,-7,388,431278,18,431260
57790,19,-9,709,372029,19,372010
57791,13,17,259,1179835,13,1179822
57792,18,13,940,1060204,18,1060186
57793,11,5,692,808843,11,808832
57794,12,-12,299,274748,12,274736
57795,9,17,886,1174333,9,1174324
57796,19,15,464,1120062,19,1120043
57797,13,19,198,1242315,13,1242302
57798,5,9,8,906904,5,906899
57799,14,-17,197,116915,14,116901
57800,20,2,34,710753,20,710733
57801,15,-10,124,336017,15,336002
57802,6,18,191,1191144,6,1191138
57803,18,-4,160,523271,18,523253
57804,8,-5,505,478944,8,478936
57805,15,-8,811,403684,15,403669
57806,18,-16,67,147306,18,147288
57807,12,2,52,710912,12,710900
57808,15,-10,733,340595,15,340580
57809,8,-3,904,550655,8,550647
57810,12,18,384,1211892,12,1211880
57811,6,3,472,728941,6,728935
57812,16,-19,95,54669,16,54653
57813,13,-5,970,498200,13,498187
57814,19,-2,352,587747,19,587728
57815,19,13,21,1053394,19,1053375
57816,17,9,162,930279,17,930262
57817,18,-1,306,619008,18,618990
57818,10,14,335,1069221,10,1069211
57819,14,10,739,965552,14,965538
57820,15,-20,679,28022,15,28007
57821,13,-10,833,341346,13,341333
57822,10,-5,868,486861,10,486851
57823,10,-17,942,113329,10,113319
57824,7,-2,683,577347,7,577340
57825,6,-3,310,537154,6,537148
57826,13,-13,514,244836,13,244823
57827,16,-11,261,305787,16,305771
57828,9,0,568,637575,9,637566
57829,6,19,910,1237738,6,1237732
57830,18,-13,431,244181,18,244163
57831,7,0,671,640028,7,640021
57832,15,11,615,995272,15,995257
57833,5,3,230,723853,5,723848
57834,6,10,971,958280,6,958274
57835,15,3,524,745686,15,745671
57836,20,-1,708,622037,20,622017
57837,11,15,19,1116922,11,1116911
57838,10,-15,915,174938,10,174928
57839,19,-16,73,147369,19,147350
57840,12,-1,416,619859,12,619847
57841,14,-13,509,244795,14,244781
57842,20,-12,906,279366,20,279346
57843,8,3,75,720426,8,720418
57844,13,0,30,648463,13,648450
57845,20,-5,680,495972,20,495952
57846,11,1,714,685373,11,685362
57847,5,-20,542,11814,5,11809
57848,11,-17,119,116424,11,116413
57849,16,-11,668,309050,16,309034
57850,13,-8,116,398714,13,398701
57851,11,18,54,1209334,11,1209323
57852,7,19,489,1228654,7,1228647
57853,10,-17,630,107111,10,107101
57854,11,-14,748,215276,11,215265
57855,19,4,643,777941,19,777922
57856,14,-18,225,87029,14,87015
57857,9,5,243,786744,9,786735
57858,14,2,680,715727,14,715713
57859,13,-7,224,429980,13,429967
57860,18,2,690,715810,18,715792
57861,8,-2,172,566362,8,566354
57862,13,-16,77,147442,13,147429
57863,12,-19,255,56008,12,55996
57864,13,-17,925,122327,13,122314
57865,19,-15,845,184132,19,184113
57866,5,-9,720,359453,5,359448
57867,10,4,45,751535,10,751525
57868,13,3,108,742671,13,742658
57869,20,-12,219,274121,20,274101
57870,8,2,505,699341,8,699333
57871,7,-12,354,257337,7,257330
57872,8,-14,580,199254,8,199246
57873,7,-20,433,9249,7,9242
57874,19,-4,789,527948,19,527929
57875,13,7,268,868942,13,868929
57876,18,16,638,1151669,18,1151651
57877,12,-3,563,558255,12,558243
57878,14,12,625,1026686,14,1026672
57879,13,-14,193,210799,13,210786
57880,12,-16,53,147174,12,147162
57881,7,-4,838,517185,7,517178
57882,9,9,566,918684,9,918675
57883,8,10,848,955736,8,955728
57884,20,13,685,1058397,20,1058377
57885,15,2,171,711894,15,711879
57886,6,10,288,943621,6,943615
57887,5,-7,96,407898,5,407893
57888,10,10,989,958646,10,958636
57889,18,2,714,715997,18,715979
57890,13,12,12,1022169,13,1022156
57891,13,10,634,964813,13,964800
57892,14,-5,40,491158,14,491144
57893,19,-6,453,462610,19,462591
57894,8,9,955,927048,8,927040
57895,17,15,301,1119037,17,1119020
57896,6,-15,887,174291,6,174285
57897,10,-10,319,319465,10,319455
57898,9,-15,527,166804,9,166795
57899,17,-16,220,148608,17,148591
57900,11,-10,613,339666,11,339655
57901,14,-2,962,592463,14,592449
57902,16,-15,811,183828,16,183812
57903,12,13,730,1058683,12,1058671
57904,5,5,835,799105,5,799100
57905,6,-10,583,325214,6,325208
57906,10,0,557,637376,10,637366
57907,9,0,755,641922,9,641913
57908,10,-7,213,410406,10,410396
57909,9,5,159,784845,9,784836
57910,7,16,915,1144238,7,1144231
57911,19,-11,640,308828,19,308809
57912,13,6,863,842654,13,842641
57913,14,5,990,811066,14,811052
57914,16,-20,308,25252,16,25236
57915,10,10,781,954377,10,954367
57916,14,-16,975,154100,14,154086
57917,13,-17,558,119682,13,119669
57918,9,0,194,629746,9,629737
57919,13,-19,648,59091,13,59078
57920,7,-8,235,380497,7,380490
57921,17,17,772,1183595,17,1183578
57922,11,-13,91,241698,11,241687
57923,17,4,667,778114,17,778097
57924,6,-7,965,426446,6,426440
57925,20,-6,730,464750,20,464730
57926,14,-5,644,495729,14,495715
57927,12,-15,749,183352,12,183340
57928,9,-18,765,79010,9,79001
57929,6,16,40,1126007,6,1126001
57930,6,8,836,893349,6,893343
57931,11,-5,499,494712,11,494701
57932,18,-1,710,622076,18,622058
57933,8,2,87,690424,8,690416
57934,8,-1,432,603407,8,603399
57935,7,-16,213,128692,7,128685
57936,10,-18,256,68039,10,68029
57937,6,-15,866,173891,6,173885
57938,19,-7,941,435269,19,435250
57939,10,13,601,1043727,10,1043717
57940,12,19,964,1248511,12,1248499
57941,11,2,954,717604,11,717593
57942,8,-8,518,386230,8,386222
57943,12,-18,264,87344,12,87332
57944,9,11,843,986508,9,986499
57945,19,6,577,840467,19,840448
57946,14,19,414,1244238,14,1244224
57947,6,-6,111,439101,6,439095
57948,10,11,736,984151,10,984141
57949,11,14,689,1090896,11,1090885
57950,11,-2,378,587905,11,587894
57951,20,17,939,1184940,20,1184920
57952,9,6,561,824914,9,824905
57953,7,-18,299,69010,7,69003
57954,16,-15,851,184207,16,184191
57955,9,-3,249,535878,9,535869
57956,16,-14,645,214572,16,214556
57957,6,7,87,846707,6,846701
57958,19,-8,601,402057,19,402038
57959,16,-18,212,86913,16,86897
57960,17,-14,567,213983,17,213966
57961,9,3,476,729016,9,729007
57962,13,4,378,775973,13,775960
57963,7,11,267,973951,7,973944
57964,6,-17,92,95438,6,95432
57965,10,13,153,1033936,10,1033926
57966,12,-3,219,555316,12,555304
57967,6,2,492,699113,6,699107
57968,18,-18,183,86718,18,86700
57969,5,13,412,1039703,5,1039698
57970,14,-11,551,308165,14,308151
57971,5,-3,174,534134,5,534129
57972,14,-15,323,180111,14,180097
57973,16,18,110,1209869,16,1209853
57974,8,1,165,660774,8,660766
57975,15,-16,927,153739,15,153724
57976,16,-18,944,92079,16,92063
57977,17,-16,213,148535,17,148518
57978,13,15,926,1123532,13,1123519
57979,16,16,773,1152570,16,1152554
57980,13,-17,537,119517,13,119504
57981,18,-17,195,116899,18,116881
57982,17,-3,910,561088,17,561071
57983,17,-14,456,213027,17,213010
57984,13,0,864,654792,13,654779
57985,10,-20,276,6166,10,6156
57986,7,17,515,1166363,7,1166356
57987,19,17,87,1178487,19,1178468
57988,11,9,435,932191,11,932180
57989,9,-17,886,112237,9,112228
57990,12,15,9,1116823,12,1116811
57991,13,6,505,839881,13,839868
57992,5,2,844,706214,5,706209
57993,10,7,275,850679,10,850669
57994,15,-14,971,217059,15,217044
57995,20,-4,299,524404,20,524384
57996,20,2,624,715236,20,715216
57997,16,3,213,743482,16,743466
57998,14,-4,72,522593,14,522579
57999,20,-12,919,279461,20,279441
58000,12,6,593,840574,12,840562
58001,10,7,487,855302,10,855292
58002,6,-15,651,169520,6,169514
58003,11,-20,910,29791,11,29780
58004,20,8,643,903087,20,903067
58005,19,11,579,995019,19,995000
58006,5,-16,897,143208,5,143203
58007,18,-14,54,209731,18,209713
58008,6,19,771,1234606,6,1234600
58009,16,6,5,835764,16,835748
58010,8,18,168,1190488,8,1190480
58011,5,10,527,948794,5,948789
58012,14,-19,912,60885,14,60871
58013,9,-11,330,288404,9,288395
58014,13,-1,631,621450,13,621437
58015,10,-11,948,301512,10,301502
58016,12,19,172,1242139,12,1242127
58017,10,10,757,953741,10,953731
58018,10,-2,62,564221,10,564211
58019,10,8,340,882679,10,882669
58020,14,4,166,774480,14,774466
58021,20,-16,191,148331,20,148311
58022,6,17,895,1174605,6,1174599
58023,16,-2,110,585962,16,585946
58024,20,4,923,780078,20,780058
58025,20,6,344,838467,20,838447
58026,5,-19,827,49504,5,49499
58027,9,6,267,818249,9,818240
58028,12,-14,671,214769,12,214757
58029,5,-14,662,201185,5,201180
58030,20,1,999,687566,20,687546
58031,16,-5,941,497947,16,497931
58032,14,6,275,837872,14,837858
58033,16,11,328,993244,16,993228
58034,10,-1,385,602423,10,602413
58035,6,-15,738,171307,6,171301
58036,19,18,562,1213050,19,1213031
58037,19,15,297,1119015,19,1118996
58038,15,17,802,1183938,15,1183923
58039,14,11,880,997253,14,997239
58040,18,12,597,1026429,18,1026411
58041,13,-2,506,588958,13,588945
58042,8,-8,240,380615,8,380607
58043,15,-7,671,433151,15,433136
58044,11,-10,390,337852,11,337841
58045,8,-1,708,609160,8,609152
58046,20,-10,916,341950,20,341930
58047,16,-19,61,54308,16,54292
58048,5,14,688,1077522,5,1077517
58049,6,-2,535,574079,6,574073
58050,18,-15,707,183035,18,183017
58051,10,-1,488,604708,10,604698
58052,6,-16,89,125881,6,125875
58053,10,-1,425,603271,10,603261
58054,16,8,271,900066,16,900050
58055,10,1,808,674569,10,674559
58056,8,-14,768,203509,8,203501
58057,7,-20,491,10513,7,10506
58058,15,12,696,1027308,15,1027293
58059,9,5,353,788824,9,788815
58060,17,1,106,680649,17,680632
58061,8,1,716,672573,8,672565
58062,19,7,475,870590,19,870571
58063,6,-14,602,199884,6,199878
58064,8,15,163,1097918,8,1097910
58065,19,-13,486,244583,19,244564
58066,14,17,782,1183725,14,1183711
58067,14,0,233,649992,14,649978
58068,17,-16,430,150157,17,150140
58069,18,-3,892,560927,18,560909
58070,20,8,846,904554,20,904534
58071,10,-18,401,71028,10,71018
58072,19,-16,716,152151,19,152132
58073,10,-7,227,410664,10,410654
58074,9,18,270,1192791,9,1192782
58075,11,-7,877,434733,11,434722
58076,6,-2,660,576797,6,576791
58077,20,12,888,1028766,20,1028746
58078,14,-5,621,495568,14,495554
58079,16,3,819,748006,16,747990
58080,13,5,858,809995,13,809982
58081,10,-19,230,36644,10,36634
58082,16,-6,407,462256,16,462240
58083,9,-19,670,46197,9,46188
58084,6,19,85,1219417,6,1219411
58085,5,15,311,1101142,5,1101137
58086,7,7,309,851463,7,851456
58087,12,-10,906,341901,12,341889
58088,20,0,180,649626,20,649606
58089,8,9,949,926898,8,926890
58090,13,18,362,1211720,13,1211707
58091,19,-5,584,495362,19,495343
58092,17,-17,782,121430,17,121413
58093,10,0,829,643358,10,643348
58094,7,-11,936,301198,7,301191
58095,14,16,325,1149474,14,1149460
58096,16,1,745,685677,16,685661
58097,17,-19,545,58236,17,58219
58098,12,4,290,775301,12,775289
58099,5,-1,827,611600,5,611595
58100,14,-10,779,340915,14,340901
58101,16,-11,261,305793,16,305777
58102,5,4,61,751919,5,751914
58103,12,5,945,810750,12,810738
58104,12,14,418,1088733,12,1088721
58105,7,9,795,923634,7,923627
58106,5,11,677,982837,5,982832
58107,14,15,913,1123463,14,1123449
58108,9,-14,3,186483,9,186474
58109,17,3,732,747370,17,747353
58110,16,8,201,899560,16,899544
58111,10,1,255,662796,10,662786
58112,8,-8,514,386142,8,386134
58113,12,-2,122,586037,12,586025
58114,7,16,463,1135147,7,1135140
58115,14,11,538,994737,14,994723
58116,17,10,46,960207,17,960190
58117,10,-9,453,353637,10,353627
58118,16,8,614,902786,16,902770
58119,12,15,555,1120802,12,1120790
58120,20,9,765,934628,20,934608
58121,5,7,806,861898,5,861893
58122,17,-6,386,462103,17,462086
58123,9,-8,725,390932,9,390923
58124,12,11,971,997831,12,997819
58125,19,-9,730,372145,19,372126
58126,7,-1,153,597088,7,597081
58127,7,-2,83,564619,7,564612
58128,16,-16,904,153586,16,153570
58129,18,-14,154,210499,18,210481
58130,20,-18,745,90678,20,90658
58131,14,-2,94,585826,14,585812
58132,19,-12,80,273132,19,273113
58133,12,-12,268,274510,12,274498
58134,18,14,267,1087495,18,1087477
58135,12,-18,477,88836,12,88824
58136,7,2,554,700325,7,700318
58137,11,5,947,810764,11,810753
58138,17,-2,283,587242,17,587225
58139,5,-12,806,266956,5,266951
58140,19,11,179,992079,19,992060
58141,17,12,836,1028297,17,1028280
58142,19,-6,235,461004,19,460985
58143,8,19,833,1235971,8,1235963
58144,18,1,0,679734,18,679716
58145,7,-12,13,249876,7,249869
58146,19,-11,804,309967,19,309948
58147,13,15,275,1118815,13,1118802
58148,8,17,760,1171464,8,1171456
58149,5,-20,915,20242,5,20237
58150,12,3,164,743058,12,743046
58151,13,2,435,713869,13,713856
58152,9,-17,884,112179,9,112170
58153,19,-15,826,183980,19,183961
58154,6,-16,44,124745,6,124739
58155,5,-7,766,422113,5,422108
58156,18,11,843,996981,18,996963
58157,20,-20,77,23381,20,23361
58158,19,-8,972,404813,19,404794
58159,11,13,558,1057447,11,1057436
58160,17,4,603,777680,17,777663
58161,12,-1,587,621156,12,621144
58162,10,-20,541,11800,10,11790
58163,5,-14,291,193061,5,193056
58164,5,16,669,1139235,5,1139230
58165,7,-6,598,449696,7,449689
58166,14,13,696,1058453,14,1058439
58167,20,-5,122,491891,20,491871
58168,5,-20,700,15446,5,15441
58169,6,-11,638,295235,6,295229
58170,16,-5,3,490792,16,490776
58171,8,-16,585,136733,8,136725
58172,19,10,27,960048,19,960029
58173,13,-2,580,589495,13,589482
58174,20,4,589,777542,20,777522
58175,14,3,600,746316,14,746302
58176,5,15,941,1114481,5,1114476
58177,11,-11,847,310323,11,310312
58178,8,17,359,1163015,8,1163007
58179,18,-19,313,56410,18,56392
58180,13,0,531,652230,13,652217
58181,14,-8,477,401142,14,401128
58182,6,0,66,626720,6,626714
58183,7,15,800,1111372,7,1111365
58184,15,11,441,994079,15,994064
58185,14,17,40,1178178,14,1178164
58186,12,15,977,1123980,12,1123968
58187,18,16,413,1150147,18,1150129
58188,10,12,86,1001057,10,1001047
58189,16,-18,719,90496,16,90480
58190,13,-9,407,369746,13,369733
58191,10,-12,790,266604,10,266594
58192,15,4,546,777215,15,777200
58193,10,-14,548,198341,10,198331
58194,7,-14,538,198144,7,198137
58195,15,16,887,1153378,15,1153363
58196,6,2,10,688724,6,688718
58197,14,16,851,1153190,14,1153176
58198,19,-14,117,210225,19,210206
58199,8,-16,942,144274,8,144266
58200,9,-15,10,155495,9,155486
58201,11,-2,404,588139,11,588128
58202,12,-20,916,29802,12,29790
58203,15,-18,56,85633,15,85618
58204,15,11,964,997772,15,997757
58205,11,9,65,929534,11,929523
58206,19,6,390,838848,19,838829
58207,18,-1,616,621357,18,621339
58208,12,6,225,837452,12,837440
58209,19,11,524,994659,19,994640
58210,10,19,505,1229010,10,1229000
58211,14,-4,252,524081,14,524067
58212,7,-7,868,424279,7,424272
58213,18,19,405,1244115,18,1244097
58214,17,-16,977,154109,17,154092
58215,17,-3,462,557336,17,557319
58216,10,-18,671,76816,10,76806
58217,10,-2,114,565346,10,565336
58218,5,-12,451,259304,5,259299
58219,12,0,492,651897,12,651885
58220,19,-9,631,371533,19,371514
58221,10,4,286,756723,10,756713
58222,5,-9,538,355834,5,355829
58223,5,6,126,814875,5,814870
58224,15,18,28,1209110,15,1209095
58225,15,19,867,1247824,15,1247809
58226,19,-4,424,525396,19,525377
58227,14,-16,258,148856,14,148842
58228,6,-20,76,1740,6,1734
58229,19,-3,570,558319,19,558300
58230,20,-18,33,85445,20,85425
58231,14,-11,419,307091,14,307077
58232,9,7,680,859238,9,859229
58233,19,14,429,1088831,19,1088812
58234,14,-14,768,215542,14,215528
58235,20,-11,119,304671,20,304651
58236,8,4,923,770895,8,770887
58237,16,7,654,871810,16,871794
58238,15,-4,880,528668,15,528653
58239,18,-16,128,147916,18,147898
58240,8,-4,587,512093,8,512085
58241,16,-7,500,432079,16,432063
58242,14,7,666,871926,14,871912
58243,5,-4,688,514285,5,514280
58244,17,-5,200,492416,17,492399
58245,13,4,599,777631,13,777618
58246,20,-12,193,273872,20,273852
58247,18,-1,202,618093,18,618075
58248,19,-13,872,247554,19,247535
58249,11,13,371,1055955,11,1055944
58250,7,-10,918,332157,7,332150
58251,20,-15,513,181547,20,181527
58252,19,-6,92,459766,19,459747
58253,10,-10,544,324407,10,324397
58254,7,18,354,1194328,7,1194321
58255,15,-20,817,29146,15,29131
58256,18,-14,25,209529,18,209511
58257,8,11,286,974457,8,974449
58258,19,5,491,807402,19,807383
58259,20,5,806,809656,20,809636
58260,9,-19,827,49513,9,49504
58261,10,14,855,1080953,10,1080943
58262,6,-7,32,406829,6,406823
58263,6,-17,811,110749,6,110743
58264,20,-11,521,307885,20,307865
58265,19,3,589,746244,19,746225
58266,17,-13,20,241205,17,241188
58267,17,-4,182,523494,17,523477
58268,9,19,466,1228154,9,1228145
58269,13,6,23,836001,13,835988
58270,10,6,37,813050,10,813040
58271,15,-11,478,307546,15,307531
58272,20,18,943,1215888,20,1215868
58273,13,-2,693,590369,13,590356
58274,9,12,370,1007202,9,1007193
58275,9,-10,691,327604,9,327595
58276,8,-5,472,478208,8,478200
58277,14,11,401,993847,14,993833
58278,16,6,367,838610,16,838594
58279,12,-17,461,118939,12,118927
58280,8,-15,78,156971,8,156963
58281,12,-5,207,492477,12,492465
58282,12,-18,546,89269,12,89257
58283,7,-10,937,332613,7,332606
58284,20,-14,507,213406,20,213386
58285,15,-19,201,55656,15,55641
58286,12,19,574,1245489,12,1245477
58287,20,-5,539,495039,20,495019
58288,19,12,532,1025947,19,1025928
58289,14,19,775,1247066,14,1247052
58290,13,-19,573,58544,13,58531
58291,6,13,766,1047238,6,1047232
58292,15,0,414,651250,15,651235
58293,20,16,295,1149251,20,1149231
58294,20,6,54,836194,20,836174
58295,18,-5,434,494219,18,494201
58296,13,-13,171,242291,13,242278
58297,18,-4,681,527252,18,527234
58298,15,-8,31,398147,15,398132
58299,5,-9,536,355831,5,355826
58300,18,3,35,742084,18,742066
58301,18,4,615,777762,18,777744
58302,19,12,274,1024172,19,1024153
58303,15,-18,245,87230,15,87215
58304,12,17,50,1178277,12,1178265
58305,8,6,42,813154,8,813146
58306,14,10,514,963815,14,963801
58307,6,17,47,1156364,6,1156358
58308,5,-19,812,49164,5,49159
58309,7,-13,985,239690,7,239683
58310,13,19,988,1248715,13,1248702
58311,7,-13,40,219205,7,219198
58312,17,-6,188,460624,17,460607
58313,14,3,922,748816,14,748802
58314,8,-3,930,551322,8,551314
58315,9,-11,5,281230,9,281221
58316,16,2,809,716530,16,716514
58317,6,2,275,694512,6,694506
58318,12,-3,359,556448,12,556436
58319,7,10,578,949924,7,949917
58320,5,18,450,1196397,5,1196392
58321,6,-11,372,289412,6,289406
58322,13,16,753,1152425,13,1152412
58323,20,8,189,899417,20,899397
58324,8,-17,302,100050,8,100042
58325,16,13,864,1059711,16,1059695
58326,19,9,649,933849,19,933830
58327,18,10,406,962920,18,962902
58328,12,4,995,780519,12,780507
58329,18,-19,562,58422,18,58404
58330,12,-10,775,340902,12,340890
58331,20,14,929,1092683,20,1092663
58332,8,-13,488,228656,8,228648
58333,7,-5,361,476041,7,476034
58334,5,16,656,1138949,5,1138944
58335,14,15,894,1123311,14,1123297
58336,19,17,429,1181123,19,1181104
58337,12,1,872,686596,12,686584
58338,18,4,868,779729,18,779711
58339,16,-12,455,275799,16,275783
58340,20,-20,7,4849,20,4829
58341,12,6,574,840433,12,840421
58342,14,11,49,991212,14,991198
58343,12,-15,395,180654,12,180642
58344,14,3,431,745089,14,745075
58345,10,-17,382,101667,10,101657
58346,10,-6,731,452554,10,452544
58347,9,14,997,1084249,9,1084240
58348,18,0,450,651507,18,651489
58349,5,-15,887,174296,5,174291
58350,16,-10,55,335575,16,335559
58351,11,9,498,932666,11,932655
58352,16,-20,160,23957,16,23941
58353,17,-12,525,276440,17,276423
58354,8,-14,503,197491,8,197483
58355,18,0,68,648750,18,648732
58356,18,3,580,746194,18,746176
58357,20,15,543,1120722,20,1120702
58358,14,-19,192,55564,14,55550
58359,8,15,39,1095360,8,1095352
58360,5,-13,284,224541,5,224536
58361,16,7,51,867438,16,867422
58362,8,-12,83,251369,8,251361
58363,11,9,863,935463,11,935452
58364,8,7,135,847747,8,847739
58365,9,-8,262,381024,9,381015
58366,16,-15,528,181652,16,181636
58367,6,-3,220,535118,6,535112
58368,17,16,425,1150194,17,1150177
58369,14,-12,296,274713,14,274699
58370,8,-1,167,597337,8,597329
58371,6,-12,844,267903,6,267897
58372,15,-5,879,497497,15,497482
58373,6,-11,848,299278,6,299272
58374,13,18,39,1209183,13,1209170
58375,6,-9,574,356594,6,356588
58376,10,16,902,1143867,10,1143857
58377,16,-14,368,212327,16,212311
58378,10,16,328,1132137,10,1132127
58379,14,-14,895,216471,14,216457
58380,10,17,409,1163997,10,1163987
58381,15,-18,779,90932,15,90917
58382,13,-7,676,433204,13,433191
58383,5,-16,305,130602,5,130597
58384,17,8,614,902793,17,902776
58385,12,10,354,962481,12,962469
58386,15,15,960,1123845,15,1123830
58387,18,2,476,714229,18,714211
58388,6,11,927,988532,6,988526
58389,17,10,505,963717,17,963700
58390,14,16,78,1147629,14,1147615
58391,12,-10,922,342015,12,342003
58392,12,-9,89,367296,12,367284
58393,19,-5,453,494349,19,494330
58394,13,-18,368,88064,13,88051
58395,20,12,980,1029680,20,1029660
58396,7,1,115,659608,7,659601
58397,10,-1,974,614875,10,614865
58398,6,7,91,846821,6,846815
58399,14,-18,589,89519,14,89505
58400,20,-20,274,24890,20,24870
58401,15,-6,389,462123,15,462108
58402,6,3,848,737138,6,737132
58403,14,17,562,1182026,14,1182012
58404,14,6,517,839998,14,839984
58405,5,-2,8,562913,5,562908
58406,18,-1,695,621920,18,621902
58407,5,-4,591,512170,5,512165
58408,7,-11,593,294284,7,294277
58409,8,-6,40,437711,8,437703
58410,19,-15,525,181598,19,181579
58411,15,3,647,746730,15,746715
58412,6,0,969,646414,6,646408
58413,17,-8,73,398536,17,398519
58414,15,-20,533,26818,15,26803
58415,20,-10,215,336668,20,336648
58416,16,-10,849,341468,16,341452
58417,6,-14,225,191587,6,191581
58418,14,-14,312,211822,14,211808
58419,14,-1,363,619510,14,619496
58420,18,14,794,1091675,18,1091657
58421,6,19,817,1235575,6,1235569
58422,16,-1,146,617647,16,617631
58423,10,9,89,908578,10,908568
58424,16,7,115,867853,16,867837
58425,20,6,317,838228,20,838208
58426,6,-3,913,550910,6,550904
58427,6,-11,793,298145,6,298139
58428,5,2,268,694411,5,694406
58429,15,18,376,1211827,15,1211812
58430,14,8,163,899241,14,899227
58431,6,-9,141,346617,6,346611
58432,12,-10,555,339213,12,339201
58433,6,7,289,851015,6,851009
58434,7,-12,978,270946,7,270939
58435,7,-8,852,393487,7,393480
58436,11,-16,926,153725,11,153714
58437,15,3,703,747186,15,747171
58438,12,-1,301,618969,12,618957
58439,9,-12,119,252146,9,252137
58440,15,-10,461,338456,15,338441
58441,8,9,604,919568,8,919560
58442,19,-4,625,526821,19,526802
58443,18,-1,558,620970,18,620952
58444,8,2,307,695222,8,695214
58445,8,-19,592,44496,8,44488
58446,13,-4,378,525045,13,525032
58447,18,-12,825,278574,18,278556
58448,6,-17,523,104725,6,104719
58449,20,-8,771,403348,20,403328
58450,9,7,467,854795,9,854786
58451,9,4,232,755716,9,755707
58452,8,17,19,1155645,8,1155637
58453,8,10,541,949044,8,949036
58454,13,15,315,1119101,13,1119088
58455,20,-4,184,523507,20,523487
58456,20,-18,650,89984,20,89964
58457,8,-15,171,159046,8,159038
58458,14,0,448,651501,14,651487
58459,9,15,924,1114105,9,1114096
58460,5,18,173,1190617,5,1190612
58461,6,-12,32,250266,6,250260
58462,10,-17,506,104413,10,104403
58463,6,-9,661,358148,6,358142
58464,9,9,434,915793,9,915784
58465,11,9,342,931513,11,931502
58466,15,19,553,1245324,15,1245309
58467,19,10,500,963646,19,963627
58468,20,1,621,684721,20,684701
58469,12,6,511,839929,12,839917
58470,7,10,230,942422,7,942415
58471,6,-12,304,256255,6,256249
58472,8,0,629,639046,8,639038
58473,15,1,126,680826,15,680811
58474,19,15,141,1117873,19,1117854
58475,20,14,323,1087969,20,1087949
58476,20,-7,106,429066,20,429046
58477,7,-18,512,73452,7,73445
58478,12,9,217,930671,12,930659
58479,11,5,767,809367,11,809356
58480,15,3,57,742274,15,742259
58481,9,7,684,859300,9,859291
58482,20,-17,563,119756,20,119736
58483,16,3,784,747741,16,747725
58484,15,-1,704,621984,15,621969
58485,13,0,188,649674,13,649661
58486,11,17,447,1181274,11,1181263
58487,14,-9,191,367897,14,367883
58488,13,3,626,746544,13,746531
58489,7,-6,782,453621,7,453614
58490,19,2,195,712064,19,712045
58491,10,19,268,1223440,10,1223430
58492,19,-2,13,585217,19,585198
58493,18,1,323,682466,18,682448
58494,16,-17,443,118764,16,118748
58495,5,-9,344,351215,5,351210
58496,11,-19,155,55303,11,55292
58497,20,-18,90,85910,20,85890
58498,14,-5,809,496893,14,496879
58499,12,-11,225,305467,12,305455
58500,14,-8,318,400132,14,400118
58501,20,-11,410,307003,20,306983
58502,5,-17,960,113716,5,113711
58503,18,17,228,1179556,18,1179538
58504,9,0,776,642365,9,642356
58505,7,-11,393,289840,7,289833
58506,5,-15,37,156116,5,156111
58507,8,-12,907,269405,8,269397
58508,6,-16,837,141940,6,141934
58509,6,-7,993,427037,6,427031
58510,5,15,862,1112813,5,1112808
58511,6,-4,464,509484,6,509478
58512,6,10,362,945204,6,945198
58513,7,7,934,864549,7,864542
58514,6,16,298,1131498,6,1131492
58515,15,3,103,742621,15,742606
58516,11,-15,279,179791,11,179780
58517,13,13,56,1053645,13,1053632
58518,13,-19,964,61233,13,61220
58519,20,-8,546,401713,20,401693
58520,11,-14,913,216648,11,216637
58521,11,-9,716,372055,11,372044
58522,11,10,184,961267,11,961256
58523,12,-15,825,183970,12,183958
58524,19,17,624,1182491,19,1182472
58525,10,19,393,1226402,10,1226392
58526,17,-12,446,275732,17,275715
58527,6,0,352,632840,6,632834
58528,17,16,717,1152230,17,1152213
58529,14,-10,68,335688,14,335674
58530,17,-11,574,308280,17,308263
58531,18,-12,961,279766,18,279748
58532,16,18,54,1209340,16,1209324
58533,9,-14,420,196002,9,195993
58534,16,-20,227,24525,16,24509
58535,8,2,698,703391,8,703383
58536,18,3,798,747854,18,747836
58537,9,1,23,657544,9,657535
58538,5,-16,747,140040,5,140035
58539,9,10,5,937603,9,937594
58540,19,16,792,1152759,19,1152740
58541,14,-9,20,366747,14,366733
58542,11,-5,27,491024,11,491013
58543,14,-17,14,115689,14,115675
58544,19,-9,745,372336,19,372317
58545,19,17,862,1184498,19,1184479
58546,17,-14,408,212723,17,212706
58547,9,-15,985,176448,9,176439
58548,5,-10,668,327203,5,327198
58549,15,-8,419,400813,15,400798
58550,6,18,550,1198576,6,1198570
58551,9,-12,337,256936,9,256927
58552,16,3,554,745901,16,745885
58553,10,3,640,732570,10,732560
58554,16,-1,110,617414,16,617398
58555,5,-15,705,170479,5,170474
58556,18,-5,59,491271,18,491253
58557,5,1,608,670512,5,670507
58558,15,-12,629,277077,15,277062
58559,10,1,507,668349,10,668339
58560,13,-5,934,497915,13,497902
58561,13,18,136,1210054,13,1210041
58562,8,-14,661,201151,8,201143
58563,9,-4,639,513194,9,513185
58564,16,-4,315,524543,16,524527
58565,20,19,274,1242954,20,1242934
58566,6,15,455,1104081,6,1104075
58567,13,-14,600,214253,13,214240
58568,16,18,791,1214759,16,1214743
58569,9,17,248,1160538,9,1160529
58570,8,12,567,1011230,8,1011222
58571,8,-12,411,258612,8,258604
58572,15,17,258,1179833,15,1179818
58573,17,-6,251,461116,17,461099
58574,17,17,47,1178233,17,1178216
58575,16,12,63,1022518,16,1022502
58576,10,-11,916,300756,10,300746
58577,9,-17,901,112566,9,112557
58578,18,17,572,1182074,18,1182056
58579,5,11,497,979050,5,979045
58580,14,-18,801,91099,14,91085
58581,9,19,305,1224358,9,1224349
58582,8,-15,357,163118,8,163110
58583,6,-14,16,186872,6,186866
58584,17,-7,148,429375,17,429358
58585,19,-1,734,622256,19,622237
58586,7,-9,916,364263,7,364256
58587,12,0,339,650624,12,650612
58588,14,7,759,872493,14,872479
58589,9,6,224,817228,9,817219
58590,15,-17,995,122735,15,122720
58591,16,-18,956,92191,16,92175
58592,8,7,30,845399,8,845391
58593,15,9,492,932648,15,932633
58594,7,-15,982,176393,7,176386
58595,7,-5,598,481023,7,481016
58596,5,-16,856,142398,5,142393
58597,6,-18,413,71260,6,71254
58598,15,11,352,993440,15,993425
58599,6,15,218,1099173,6,1099167
58600,16,11,159,991972,16,991956
58601,18,-1,130,617544,18,617526
58602,14,6,569,840404,14,840390
58603,20,13,526,1057117,20,1057097
58604,17,13,662,1058248,17,1058231
58605,12,-10,780,340929,12,340917
58606,5,16,117,1127497,5,1127492
58607,15,-11,130,304721,15,304706
58608,12,-19,794,60147,12,60135
58609,16,-19,837,60440,16,60424
58610,8,15,428,1103470,8,1103462
58611,11,7,834,873035,11,873024
58612,10,7,197,848956,10,848946
58613,8,-19,104,33755,8,33747
58614,10,-8,466,384942,10,384932
58615,15,1,107,680657,15,680642
58616,14,-9,892,373657,14,373643
58617,10,4,600,763647,10,763637
58618,17,-14,214,211001,17,210984
58619,17,-20,392,25783,17,25766
58620,5,17,574,1167479,5,1167474
58621,10,4,143,753669,10,753659
58622,6,13,408,1039612,6,1039606
58623,16,6,916,843093,16,843077
58624,13,-11,415,307059,13,307046
58625,15,-10,548,339157,15,339142
58626,5,-3,610,544128,5,544123
58627,16,-7,944,435294,16,435278
58628,17,-2,209,586666,17,586649
58629,16,-8,320,400158,16,400142
58630,17,12,302,1024369,17,1024352
58631,15,10,859,966414,15,966399
58632,17,10,182,961259,17,961242
58633,7,-7,47,407059,7,407052
58634,11,11,782,996507,11,996496
58635,16,9,867,935493,16,935477
58636,5,-5,884,487275,5,487270
58637,19,-9,607,371413,19,371394
58638,5,-9,489,354662,5,354657
58639,20,3,199,743409,20,743389
58640,12,8,793,904253,12,904241
58641,17,-14,349,212130,17,212113
58642,5,-8,880,394130,5,394125
58643,15,-6,268,461282,15,461267
58644,20,-20,580,27219,20,27199
58645,6,19,872,1236963,6,1236957
58646,8,5,586,793755,8,793747
58647,7,9,205,911097,7,911090
58648,13,-5,346,493676,13,493663
58649,18,4,434,776399,18,776381
58650,15,14,152,1086651,15,1086636
58651,19,13,714,1058559,19,1058540
58652,6,-16,643,137962,6,137956
58653,7,-13,89,220282,7,220275
58654,18,-16,449,150355,18,150337
58655,6,11,359,976116,6,976110
58656,20,-9,727,372118,20,372098
58657,20,9,832,935226,20,935206
58658,20,10,679,965167,20,965147
58659,6,-14,74,188204,6,188198
58660,6,-17,298,99938,6,99932
58661,18,0,729,653912,18,653894
58662,14,12,360,1024716,14,1024702
58663,7,10,700,952632,7,952625
58664,7,-8,375,383258,7,383251
58665,6,-16,687,138746,6,138740
58666,17,19,778,1247091,17,1247074
58667,9,-9,788,361225,9,361216
58668,12,9,542,933011,12,932999
58669,15,-10,511,338889,15,338874
58670,16,-14,467,213124,16,213108
58671,8,-15,219,159981,8,159973
58672,9,-11,511,292585,9,292576
58673,6,2,431,697865,6,697859
58674,7,-6,109,439059,7,439052
58675,16,10,9,959895,16,959879
58676,9,-10,69,314140,9,314131
58677,9,-9,151,346846,9,346837
58678,6,5,215,786168,6,786162
58679,9,-20,224,5102,9,5093
58680,5,-8,465,384927,5,384922
58681,9,7,359,852567,9,852558
58682,9,19,309,1224479,9,1224470
58683,18,11,504,994515,18,994497
58684,17,5,68,804313,17,804296
58685,14,-1,193,618000,14,617986
58686,17,17,24,1178046,17,1178029
58687,17,-8,170,399115,17,399098
58688,16,-3,506,557695,16,557679
58689,8,5,234,786566,8,786558
58690,6,-8,161,378927,6,378921
58691,10,-20,523,11229,10,11219
58692,15,-3,437,557109,15,557094
58693,18,1,109,680680,18,680662
58694,6,-3,537,542621,6,542615
58695,9,-11,370,289374,9,289365
58696,13,7,223,868560,13,868547
58697,9,8,683,890260,9,890251
58698,13,-14,607,214312,13,214299
58699,11,8,138,899027,11,899016
58700,18,5,958,810849,18,810831
58701,9,-8,327,382375,9,382366
58702,13,-2,130,586098,13,586085
58703,20,8,837,904472,20,904452
58704,8,-1,348,601735,8,601727
58705,18,14,67,1085993,18,1085975
58706,11,-2,344,587689,11,587678
58707,18,3,646,746724,18,746706
58708,6,14,544,1073942,6,1073936
58709,5,-8,153,378762,5,378757
58710,18,-3,867,560736,18,560718
58711,8,-18,280,68598,8,68590
58712,13,1,316,682358,13,682345
58713,5,11,939,988660,5,988655
58714,8,-10,915,332053,8,332045
58715,9,11,951,988856,9,988847
58716,6,14,100,1064063,6,1064057
58717,19,16,596,1151306,19,1151287
58718,14,3,959,749196,14,749182
58719,15,-9,403,369695,15,369680
58720,6,-3,65,531883,6,531877
58721,16,1,941,687201,16,687185
58722,9,-8,160,378884,9,378875
58723,20,19,244,1242665,20,1242645
58724,18,-14,882,216391,18,216373
58725,9,-16,773,140678,9,140669
58726,15,6,452,839397,15,839382
58727,14,10,279,961924,14,961910
58728,10,8,634,889099,10,889089
58729,11,-11,283,305944,11,305933
58730,6,-16,989,145358,6,145352
58731,18,18,847,1215153,18,1215135
58732,18,0,840,654648,18,654630
58733,19,-20,962,30075,19,30056
58734,11,15,739,1122273,11,1122262
58735,14,14,942,1092850,14,1092836
58736,14,11,286,992956,14,992942
58737,18,-12,246,274309,18,274291
58738,17,10,438,963167,17,963150
58739,16,-2,959,592462,16,592446
58740,10,9,27,907363,10,907353
58741,13,-18,449,88634,13,88621
58742,10,-5,54,469045,10,469035
58743,16,8,229,899828,16,899812
58744,18,-19,402,57147,18,57129
58745,18,-17,158,116655,18,116637
58746,8,14,655,1076648,8,1076640
58747,20,-4,983,529499,20,529479
58748,8,15,602,1107253,8,1107245
58749,5,-15,57,156554,5,156549
58750,8,-18,414,71297,8,71289
58751,14,1,808,686140,14,686126
58752,18,-9,276,368591,18,368573
58753,6,-13,571,230513,6,230507
58754,15,-14,191,210778,15,210763
58755,16,18,158,1210243,16,1210227
58756,20,-2,113,585992,20,585972
58757,16,-18,818,91223,16,91207
58758,12,-4,828,528120,12,528108
58759,17,3,365,744628,17,744611
58760,8,-9,939,364683,8,364675
58761,12,7,694,872097,12,872085
58762,19,-8,386,400608,19,400589
58763,11,-6,103,459854,11,459843
58764,20,-4,200,523633,20,523613
58765,20,-6,656,464142,20,464122
58766,14,6,705,841500,14,841486
58767,14,2,539,714667,14,714653
58768,9,15,713,1109639,9,1109630
58769,17,-15,616,182301,17,182284
58770,15,-13,87,241669,15,241654
58771,13,-2,386,587954,13,587941
58772,20,-17,323,117897,20,117877
58773,16,8,650,903122,16,903106
58774,20,0,425,651344,20,651324
58775,9,0,929,645547,9,645538
58776,6,-12,601,262522,6,262516
58777,18,5,144,804854,18,804836
58778,10,-11,990,302521,10,302511
58779,20,-1,40,616903,20,616883
58780,12,-12,42,272802,12,272790
58781,9,8,643,889310,9,889301
58782,10,-11,885,300138,10,300128
58783,18,18,831,1214983,18,1214965
58784,6,1,823,674822,6,674816
58785,6,17,296,1161733,6,1161727
58786,18,2,435,713877,18,713859
58787,7,12,356,1006932,7,1006925
58788,20,1,658,685056,20,685036
58789,15,7,987,874024,15,874009
58790,16,5,537,807711,16,807695
58791,16,-18,383,88178,16,88162
58792,15,3,762,747618,15,747603
58793,8,-3,846,549319,8,549311
58794,16,14,32,1085632,16,1085616
58795,5,-6,759,453130,5,453125
58796,9,4,498,761307,9,761298
58797,16,8,878,904760,16,904744
58798,12,0,314,650385,12,650373
58799,15,12,23,1022263,15,1022248
58800,14,0,140,649290,14,649276
58801,13,5,490,807393,13,807380
58802,7,2,81,690324,7,690317
58803,6,-14,343,194155,6,194149
58804,9,3,88,720690,9,720681
58805,11,16,60,1147522,11,1147511
58806,18,-4,730,527549,18,527531
58807,14,11,61,991334,14,991320
58808,17,18,363,1211739,17,1211722
58809,15,-18,905,91786,15,91771
58810,14,-11,305,306189,14,306175
58811,15,-8,316,400119,15,400104
58812,5,-19,30,32149,5,32144
58813,10,-8,57,376659,10,376649
58814,12,1,611,684659,12,684647
58815,8,-15,354,163093,8,163085
58816,20,17,247,1179728,20,1179708
58817,11,16,720,1152229,11,1152218
58818,9,-16,403,132681,9,132672
58819,10,17,568,1167371,10,1167361
58820,6,1,304,663786,6,663780
58821,15,8,139,899037,15,899022
58822,19,-6,443,462509,19,462490
58823,19,9,697,934196,19,934177
58824,15,1,103,680638,15,680623
58825,19,-9,406,369734,19,369715
58826,5,19,577,1230552,5,1230547
58827,9,7,491,855391,9,855382
58828,20,3,950,749094,20,749074
58829,17,6,366,838589,17,838572
58830,18,3,88,742469,18,742451
58831,17,19,981,1248644,17,1248627
58832,5,19,810,1235469,5,1235464
58833,10,10,482,947771,10,947761
58834,8,-9,979,365274,8,365266
58835,13,19,114,1241715,13,1241702
58836,17,19,851,1247646,17,1247629
58837,9,-4,270,505461,9,505452
58838,10,-14,515,197777,10,197767
58839,6,-19,763,48336,6,48330
58840,8,-2,783,579460,8,579452
58841,10,17,410,1164047,10,1164037
58842,14,-11,368,306714,14,306700
58843,19,-5,913,497729,19,497710
58844,18,-5,509,494776,18,494758
58845,18,-10,735,340620,18,340602
58846,20,0,950,655484,20,655464
58847,9,-9,78,345295,9,345286
58848,17,2,185,711980,17,711963
58849,8,4,852,769472,8,769464
58850,14,-7,219,429940,14,429926
58851,18,-20,548,26993,18,26975
58852,8,-11,766,297598,8,297590
58853,18,-16,60,147257,18,147239
58854,14,-14,43,209655,14,209641
58855,20,-9,734,372187,20,372167
58856,9,11,297,974716,9,974707
58857,8,-7,560,417923,8,417915
58858,14,-18,907,91793,14,91779
58859,10,2,97,690746,10,690736
58860,5,-17,858,111600,5,111595
58861,19,-5,852,497232,19,497213
58862,9,-12,644,263465,9,263456
58863,12,16,578,1151171,12,1151159
58864,12,-1,719,622147,12,622135
58865,17,13,163,1054399,17,1054382
58866,13,5,988,811039,13,811026
58867,11,-4,905,528858,11,528847
58868,16,9,803,935015,16,934999
58869,9,18,579,1199048,9,1199039
58870,17,18,207,1210697,17,1210680
58871,16,-6,263,461219,16,461203
58872,14,-5,959,498060,14,498046
58873,8,13,813,1048311,8,1048303
58874,15,8,991,905663,15,905648
58875,17,2,179,711947,17,711930
58876,16,-11,580,308374,16,308358
58877,7,8,972,896326,7,896319
58878,5,-11,358,289085,5,289080
58879,15,-7,841,434414,15,434399
58880,10,8,934,895472,10,895462
58881,16,-14,711,215076,16,215060
58882,5,14,40,1062711,5,1062706
58883,5,-13,27,218974,5,218969
58884,6,-20,7,196,6,190
58885,6,-14,256,192397,6,192391
58886,13,-6,469,462742,13,462729
58887,18,8,762,903990,18,903972
58888,11,17,227,1179543,11,1179532
58889,6,-1,295,600370,6,600364
58890,6,-4,546,511303,6,511297
58891,14,-10,251,336923,14,336909
58892,20,-15,2,177853,20,177833
58893,6,0,283,631410,6,631404
58894,7,-2,35,563592,7,563585
58895,14,15,577,1120975,14,1120961
58896,11,17,963,1185139,11,1185128
58897,9,-17,280,99487,9,99478
58898,16,-7,315,430732,16,430716
58899,9,19,773,1234645,9,1234636
58900,7,8,664,889696,7,889689
58901,13,-16,646,151769,13,151756
58902,17,15,581,1120992,17,1120975
58903,15,18,107,1209838,15,1209823
58904,10,18,564,1198779,10,1198769
58905,6,13,572,1043091,6,1043085
58906,5,4,751,766947,5,766942
58907,8,1,80,658725,8,658717
58908,17,0,494,651936,17,651919
58909,9,8,455,885140,9,885131
58910,17,-15,400,180685,17,180668
58911,16,-9,428,369954,16,369938
58912,20,-10,71,335727,20,335707
58913,19,12,105,1022812,19,1022793
58914,20,-9,569,371218,20,371198
58915,7,14,790,1079648,7,1079641
58916,14,-19,584,58653,14,58639
58917,20,-18,229,87112,20,87092
58918,8,19,971,1238978,8,1238970
58919,16,1,200,681460,16,681444
58920,13,-20,786,28875,13,28862
58921,8,-19,661,46004,8,45996
58922,6,-3,783,548010,6,548004
58923,18,-16,978,154116,18,154098
58924,5,-5,801,485223,5,485218
58925,11,-13,739,246485,11,246474
58926,20,18,472,1212449,20,1212429
58927,13,11,865,997134,13,997121
58928,15,-6,774,465067,15,465052
58929,5,14,903,1082032,5,1082027
58930,17,6,695,841400,17,841383
58931,7,-8,58,376675,7,376668
58932,8,-8,311,381994,8,381986
58933,20,12,916,1029065,20,1029045
58934,10,6,437,822330,10,822320
58935,16,1,233,681741,16,681725
58936,9,17,48,1156402,9,1156393
58937,16,5,792,809555,16,809539
58938,18,2,510,714472,18,714454
58939,9,-10,424,321850,9,321841
58940,12,-12,842,278715,12,278703
58941,17,14,26,1085572,17,1085555
58942,12,-10,403,337971,12,337959
58943,17,18,931,1215782,17,1215765
58944,12,-5,1000,498343,12,498331
58945,14,-19,962,61226,14,61212
58946,14,16,410,1150092,14,1150078
58947,14,-6,747,464877,14,464863
58948,18,-18,157,86479,18,86461
58949,19,2,934,717397,19,717378
58950,7,4,793,767903,7,767896
58951,15,1,914,686981,15,686966
58952,11,-18,312,87689,11,87678
58953,14,1,513,683919,14,683905
58954,7,14,202,1066193,7,1066186
58955,6,-11,101,283302,6,283296
58956,13,-5,214,492549,13,492536
58957,17,-8,492,401252,17,401235
58958,16,9,661,933945,16,933929
58959,6,-16,329,131078,6,131072
58960,9,6,865,831794,9,831785
58961,13,-18,125,86176,13,86163
58962,6,-15,186,159351,6,159345
58963,9,1,580,670009,9,670000
58964,15,17,716,1183234,15,1183219
58965,5,5,970,802129,5,802124
58966,5,10,923,957398,5,957393
58967,16,5,289,805969,16,805953
58968,5,18,650,1200451,5,1200446
58969,11,-16,827,152978,11,152967
58970,19,-9,653,371675,19,371656
58971,13,19,373,1243788,13,1243775
58972,13,-10,378,337792,13,337779
58973,17,9,813,935065,17,935048
58974,10,-17,7,93659,10,93649
58975,19,6,52,836167,19,836148
58976,17,-20,624,27515,17,27498
58977,10,-20,600,13134,10,13124
58978,15,10,890,966618,15,966603
58979,8,6,371,820688,8,820680
58980,18,-13,416,244038,18,244020
58981,14,13,160,1054384,14,1054370
58982,15,-10,727,340542,15,340527
58983,13,-4,419,525357,13,525344
58984,6,-7,378,414107,6,414101
58985,16,-7,321,430782,16,430766
58986,10,-5,653,482143,10,482133
58987,16,16,388,1149899,16,1149883
58988,7,-6,934,456712,7,456705
58989,12,7,337,869491,12,869479
58990,17,-1,313,619084,17,619067
58991,18,4,263,775112,18,775094
58992,17,-3,750,559764,17,559747
58993,13,3,115,742693,13,742680
58994,12,0,286,650214,12,650202
58995,10,-5,908,487824,10,487814
58996,11,-5,297,493266,11,493255
58997,13,-11,659,308985,13,308972
58998,12,-1,544,620885,12,620873
58999,18,-9,738,372267,18,372249
59000,17,-17,745,121183,17,121166
59001,14,-7,711,433491,14,433477
59002,17,15,373,1119522,17,1119505
59003,19,-10,550,339170,19,339151
59004,11,10,833,966253,11,966242
59005,13,14,991,1093242,13,1093229
59006,11,-13,604,245517,11,245506
59007,9,12,802,1016502,9,1016493
59008,14,-16,459,150441,14,150427
59009,18,1,649,684959,18,684941
59010,9,-19,964,52180,9,52171
59011,8,-17,788,110337,8,110329
59012,18,-6,715,464593,18,464575
59013,14,-3,321,556128,14,556114
59014,14,-18,508,88999,14,88985
59015,18,7,376,869774,18,869756
59016,12,-3,422,556955,12,556943
59017,14,4,541,777186,14,777172
59018,14,-7,842,434452,14,434438
59019,17,9,512,932826,17,932809
59020,9,6,594,825763,9,825754
59021,8,8,123,877708,8,877700
59022,7,-15,198,159525,7,159518
59023,19,-9,137,367579,19,367560
59024,6,18,792,1203587,6,1203581
59025,18,15,976,1123979,18,1123961
59026,10,-8,569,387445,10,387435
59027,13,10,437,963146,13,963133
59028,10,18,305,1193371,10,1193361
59029,12,4,828,779392,12,779380
59030,8,-4,609,512534,8,512526
59031,11,-10,608,339618,11,339607
59032,12,16,326,1149475,12,1149463
59033,20,-19,350,56740,20,56720
59034,14,-17,146,116540,14,116526
59035,18,-19,473,57626,18,57608
59036,10,6,680,827645,10,827635
59037,16,-3,606,558574,16,558558
59038,15,-7,692,433339,15,433324
59039,12,0,585,652695,12,652683
59040,10,7,900,863884,10,863874
59041,7,-19,709,47089,7,47082
59042,6,-3,984,552454,6,552448
59043,8,-5,333,475481,8,475473
59044,18,-14,677,214832,18,214814
59045,9,-1,33,594494,9,594485
59046,7,7,351,852381,7,852374
59047,9,8,526,886824,9,886815
59048,20,-16,72,147350,20,147330
59049,5,-12,743,265549,5,265544
59050,18,12,949,1029404,18,1029386
59051,17,14,33,1085656,17,1085639
59052,15,17,718,1183262,15,1183247
59053,18,-1,831,622935,18,622917
59054,18,-8,330,400224,18,400206
59055,8,-11,279,287157,8,287149
59056,13,-16,638,151694,13,151681
59057,7,-5,62,469201,7,469194
59058,15,-15,44,178116,15,178101
59059,14,-1,363,619514,14,619500
59060,6,0,568,637581,6,637575
59061,5,7,896,863838,5,863833
59062,14,3,514,745634,14,745620
59063,15,3,421,745036,15,745021
59064,17,6,735,841730,17,841713
59065,13,-3,123,554679,13,554666
59066,12,-4,797,527975,12,527963
59067,8,-4,265,505384,8,505376
59068,11,-4,626,526821,11,526810
59069,20,-5,140,491998,20,491978
59070,12,-7,499,432061,12,432049
59071,5,-9,746,360119,5,360114
59072,19,-17,13,115675,19,115656
59073,19,8,858,904648,19,904629
59074,16,7,932,873660,16,873644
59075,14,-8,604,402079,14,402065
59076,17,14,88,1086130,17,1086113
59077,17,1,885,686696,17,686679
59078,17,-15,665,182741,17,182724
59079,10,-2,968,583549,10,583539
59080,17,-14,669,214757,17,214740
59081,9,12,13,999367,9,999358
59082,12,18,928,1215756,12,1215744
59083,10,-6,797,453935,10,453925
59084,12,0,384,651002,12,650990
59085,18,1,749,685705,18,685687
59086,20,6,480,839640,20,839620
59087,13,9,104,929820,13,929807
59088,14,4,727,778623,14,778609
59089,9,10,125,940413,9,940404
59090,20,-8,630,402290,20,402270
59091,6,-6,876,455501,6,455495
59092,19,-8,752,403224,19,403205
59093,18,8,959,905409,18,905391
59094,12,7,498,870703,12,870691
59095,8,6,670,827432,8,827424
59096,6,17,633,1168856,6,1168850
59097,5,-1,420,603137,5,603132
59098,14,-16,776,152604,14,152590
59099,13,6,694,841389,13,841376
59100,15,-4,615,526720,15,526705
59101,10,5,312,788063,10,788053
59102,5,12,885,1018532,5,1018527
59103,18,-7,102,429018,18,429000
59104,16,1,906,686908,16,686892
59105,17,-12,567,276706,17,276689
59106,10,-17,156,96720,10,96710
59107,16,12,586,1026376,16,1026360
59108,9,11,443,977878,9,977869
59109,18,3,364,744621,18,744603
59110,8,-2,465,572676,8,572668
59111,15,-16,926,153730,15,153715
59112,7,-8,870,393907,7,393900
59113,10,-12,940,270040,10,270030
59114,20,-4,146,523166,20,523146
59115,10,16,75,1126729,10,1126719
59116,14,-19,380,56973,14,56959
59117,15,-10,401,337952,15,337937
59118,19,19,465,1244627,19,1244608
59119,6,-20,585,12765,6,12759
59120,13,10,212,961431,13,961418
59121,5,-8,297,381663,5,381658
59122,6,-16,359,131645,6,131639
59123,15,11,48,991208,15,991193
59124,8,-16,785,140917,8,140909
59125,12,12,694,1027301,12,1027289
59126,16,6,814,842322,16,842306
59127,5,2,53,689743,5,689738
59128,18,-3,187,555089,18,555071
59129,10,-5,489,478601,10,478591
59130,16,-3,929,561226,16,561210
59131,9,-20,787,17324,9,17315
59132,16,-1,225,618348,16,618332
59133,9,17,4,1155357,9,1155348
59134,17,14,765,1091465,17,1091448
59135,14,5,194,805291,14,805277
59136,9,-2,594,575379,9,575370
59137,16,18,33,1209138,16,1209122
59138,6,7,176,848508,6,848502
59139,16,3,562,745967,16,745951
59140,11,19,46,1241070,11,1241059
59141,16,-3,958,561471,16,561455
59142,5,2,652,702401,5,702396
59143,7,-4,667,513828,7,513821
59144,17,-20,305,25189,17,25172
59145,19,2,494,714339,19,714320
59146,17,19,55,1241174,17,1241157
59147,7,-14,326,193834,7,193827
59148,15,-20,640,27652,15,27637
59149,15,-6,907,466003,15,465988
59150,5,19,412,1226949,5,1226944
59151,10,11,401,977144,10,977134
59152,6,-2,613,575846,6,575840
59153,12,18,503,1212632,12,1212620
59154,9,0,215,630141,9,630132
59155,10,-1,582,606616,10,606606
59156,11,11,43,991173,11,991162
59157,5,-12,701,264655,5,264650
59158,6,-9,531,355676,6,355670
59159,9,-13,229,223250,9,223241
59160,8,-19,668,46151,8,46143
59161,16,6,911,843043,16,843027
59162,6,13,65,1032173,6,1032167
59163,12,12,82,1022670,12,1022658
59164,7,-2,384,570845,7,570838
59165,14,-7,575,432633,14,432619
59166,8,-17,901,112574,8,112566
59167,16,16,569,1151129,16,1151113
59168,9,-9,958,365017,9,365008
59169,8,-1,246,599268,8,599260
59170,17,8,216,899670,17,899653
59171,20,8,61,898355,20,898335
59172,15,-19,174,55426,15,55411
59173,5,-5,815,485561,5,485556
59174,13,14,886,1092391,13,1092378
59175,16,-4,111,522871,16,522855
59176,9,-18,98,64627,9,64618
59177,19,-2,466,588644,19,588625
59178,13,4,389,776023,13,776010
59179,17,-12,159,273701,17,273684
59180,10,-19,116,34114,10,34104
59181,18,10,260,961781,18,961763
59182,11,-12,167,273737,11,273726
59183,10,-4,360,507459,10,507449
59184,6,0,75,626877,6,626871
59185,18,11,292,993026,18,993008
59186,20,-16,952,153897,20,153877
59187,10,-16,93,126024,10,126014
59188,9,19,690,1232768,9,1232759
59189,15,12,530,1025922,15,1025907
59190,7,16,869,1143111,7,1143104
59191,8,-6,503,447709,8,447701
59192,10,14,475,1072351,10,1072341
59193,10,-5,712,483374,10,483364
59194,9,-1,927,614012,9,614003
59195,9,-13,694,232977,9,232968
59196,12,4,707,778430,12,778418
59197,16,9,245,930797,16,930781
59198,16,-13,924,247983,16,247967
59199,19,16,714,1152206,19,1152187
59200,19,14,593,1090010,19,1089991
59201,14,-11,894,310685,14,310671
59202,6,-6,394,445214,6,445208
59203,14,-2,183,586412,14,586398
59204,12,7,782,872657,12,872645
59205,10,-2,660,576807,10,576797
59206,19,-5,830,497048,19,497029
59207,17,-13,564,245206,17,245189
59208,20,-15,340,180270,20,180250
59209,16,-4,369,524985,16,524969
59210,7,16,882,1143432,7,1143425
59211,18,-12,198,273905,18,273887
59212,9,0,66,626729,9,626720
59213,14,-16,751,152410,14,152396
59214,12,17,129,1178812,12,1178800
59215,17,19,681,1246290,17,1246273
59216,14,11,721,996016,14,996002
59217,15,2,354,713284,15,713269
59218,11,-18,529,89145,11,89134
59219,12,-17,8,115631,12,115619
59220,5,18,177,1190750,5,1190745
59221,14,-7,417,431470,14,431456
59222,15,-10,432,338216,15,338201
59223,17,-11,330,306404,17,306387
59224,8,-9,250,349064,8,349056
59225,7,0,915,645219,7,645212
59226,10,-20,860,19048,10,19038
59227,6,16,864,1143022,6,1143016
59228,5,-9,869,363050,5,363045
59229,15,14,317,1087892,15,1087877
59230,12,17,179,1179215,12,1179203
59231,20,0,210,649834,20,649814
59232,16,2,153,711743,16,711727
59233,7,1,984,678399,7,678392
59234,11,13,316,1055505,11,1055494
59235,10,-8,806,392584,10,392574
59236,19,-19,263,56080,19,56061
59237,15,-13,940,248132,15,248117
59238,14,-7,553,432489,14,432475
59239,14,-6,976,466544,14,466530
59240,15,2,909,717257,15,717242
59241,15,-11,353,306594,15,306579
59242,16,-9,215,368083,16,368067
59243,8,-9,650,357944,8,357936
59244,12,-20,925,29837,12,29825
59245,18,-4,475,525643,18,525625
59246,16,5,1,803790,16,803774
59247,12,-8,472,401123,12,401111
59248,20,-15,248,179579,20,179559
59249,12,-15,681,182832,12,182820
59250,19,-12,987,280006,19,279987
59251,12,-15,713,183070,12,183058
59252,15,-15,287,179846,15,179831
59253,6,17,590,1167841,6,1167835
59254,15,-10,594,339480,15,339465
59255,6,13,214,1035304,6,1035298
59256,18,-16,678,151894,18,151876
59257,11,17,786,1183742,11,1183731
59258,16,-9,992,374197,16,374181
59259,12,-20,676,27996,12,27984
59260,6,13,326,1037736,6,1037730
59261,15,-5,809,496898,15,496883
59262,19,19,227,1242546,19,1242527
59263,18,2,196,712081,18,712063
59264,14,-6,555,463475,14,463461
59265,15,1,489,683728,15,683713
59266,11,-11,627,308717,11,308706
59267,15,17,330,1180471,15,1180456
59268,13,-1,613,621323,13,621310
59269,19,-15,244,179519,19,179500
59270,12,15,479,1120163,12,1120151
59271,12,-13,467,244418,12,244406
59272,11,-12,220,274136,11,274125
59273,11,-17,443,118765,11,118754
59274,9,11,920,988386,9,988377
59275,10,12,232,1004212,10,1004202
59276,9,-15,484,165947,9,165938
59277,5,6,60,813481,5,813476
59278,9,-10,276,318516,9,318507
59279,14,-19,539,58181,14,58167
59280,16,3,551,745873,16,745857
59281,11,6,937,843201,11,843190
59282,15,12,353,1024675,15,1024660
59283,13,9,22,929206,13,929193
59284,17,-15,996,185358,17,185341
59285,10,17,22,1155729,10,1155719
59286,17,-20,470,26313,17,26296
59287,14,5,719,809033,14,809019
59288,7,-6,351,444344,7,444337
59289,20,14,628,1090315,20,1090295
59290,16,-6,129,460062,16,460046
59291,9,-11,445,291061,9,291052
59292,20,-1,766,622440,20,622420
59293,9,-14,244,192063,9,192054
59294,17,14,203,1086985,17,1086968
59295,20,-2,673,590185,20,590165
59296,7,10,394,945905,7,945898
59297,14,-14,383,212541,14,212527
59298,16,18,850,1215160,16,1215144
59299,9,-10,54,313796,9,313787
59300,6,16,456,1135030,6,1135024
59301,9,-15,501,166339,9,166330
59302,6,-17,470,103495,6,103489
59303,8,8,394,883830,8,883822
59304,15,-1,38,616886,15,616871
59305,12,9,109,929828,12,929816
59306,10,-4,834,517078,10,517068
59307,17,-19,724,59639,17,59622
59308,19,-2,342,587666,19,587647
59309,13,12,125,1022976,13,1022963
59310,19,2,615,715159,19,715140
59311,8,-18,4,62551,8,62543
59312,8,-19,28,32116,8,32108
59313,8,17,804,1172584,8,1172576
59314,20,5,532,807690,20,807670
59315,17,1,767,685862,17,685845
59316,17,-9,544,371025,17,371008
59317,9,7,201,849060,9,849051
59318,20,9,372,931778,20,931758
59319,7,-1,839,611899,7,611892
59320,18,-10,387,337824,18,337806
59321,19,15,786,1122540,19,1122521
59322,11,-8,161,399044,11,399033
59323,5,18,785,1203363,5,1203358
59324,10,9,168,910362,10,910352
59325,6,-9,392,352239,6,352233
59326,16,-1,84,617214,16,617198
59327,8,6,897,832421,8,832413
59328,10,-17,892,112410,10,112400
59329,9,8,111,877464,9,877455
59330,7,-5,864,486745,7,486738
59331,10,-7,644,419516,10,419506
59332,20,-10,344,337563,20,337543
59333,10,-2,790,579594,10,579584
59334,15,5,676,808697,15,808682
59335,14,4,902,779928,14,779914
59336,9,-15,487,166036,9,166027
59337,17,15,200,1118294,17,1118277
59338,6,-2,303,569333,6,569327
59339,10,13,993,1051943,10,1051933
59340,17,-3,613,558633,17,558616
59341,18,11,467,994263,18,994245
59342,9,-4,385,507964,9,507955
59343,5,5,28,782153,5,782148
59344,9,-14,765,203401,9,203392
59345,9,15,833,1112157,9,1112148
59346,7,13,752,1046886,7,1046879
59347,19,18,992,1216254,19,1216235
59348,6,8,138,878069,6,878063
59349,11,9,212,930623,11,930612
59350,18,-19,260,56035,18,56017
59351,7,-9,285,349809,7,349802
59352,14,-13,227,242728,14,242714
59353,14,6,285,837956,14,837942
59354,16,-20,728,28396,16,28380
59355,13,-13,41,241355,13,241342
59356,10,3,199,723194,10,723184
59357,18,5,415,806779,18,806761
59358,11,-15,418,180843,11,180832
59359,17,9,989,936441,17,936424
59360,8,-2,156,566112,8,566104
59361,14,16,267,1149052,14,1149038
59362,13,19,718,1246601,13,1246588
59363,15,5,529,807623,15,807608
59364,17,-10,252,336949,17,336932
59365,19,0,26,648426,19,648407
59366,8,19,910,1237746,8,1237738
59367,13,2,439,713928,13,713915
59368,18,-4,705,527388,18,527370
59369,19,-6,973,466489,19,466470
59370,14,16,669,1151925,14,1151911
59371,11,-3,629,558814,11,558803
59372,18,18,481,1212514,18,1212496
59373,18,-17,721,120975,18,120957
59374,13,8,307,900387,13,900374
59375,20,-2,95,585838,20,585818
59376,8,-5,463,478030,8,478022
59377,8,14,888,1081760,8,1081752
59378,6,-9,998,365537,6,365531
59379,6,-7,416,414823,6,414817
59380,16,14,305,1087810,16,1087794
59381,14,-8,864,404025,14,404011
59382,16,-20,100,23526,16,23510
59383,7,10,685,952279,7,952272
59384,14,-10,650,339929,14,339915
59385,13,6,845,842541,13,842528
59386,10,-8,223,380265,10,380255
59387,10,-14,101,188750,10,188740
59388,19,-13,144,242060,19,242041
59389,9,-15,910,174821,9,174812
59390,13,-9,983,374165,13,374152
59391,20,7,976,873943,20,873923
59392,18,7,248,868810,18,868792
59393,5,-11,486,291989,5,291984
59394,13,9,714,934345,13,934332
59395,7,-3,495,541604,7,541597
59396,11,-16,12,146830,11,146819
59397,20,-19,24,54068,20,54048
59398,7,-6,275,442813,7,442806
59399,18,-12,908,279411,18,279393
59400,14,7,592,871382,14,871368
59401,8,-15,765,171760,8,171752
59402,15,-16,459,150446,15,150431
59403,20,-4,498,525835,20,525815
59404,7,-14,877,205572,7,205565
59405,18,16,204,1148575,18,1148557
59406,18,-1,172,617850,18,617832
59407,14,1,947,687266,14,687252
59408,20,-11,152,304952,20,304932
59409,17,5,46,804116,17,804099
59410,15,2,133,711615,15,711600
59411,5,-7,394,414476,5,414471
59412,13,-6,613,463825,13,463812
59413,8,-10,19,312994,8,312986
59414,14,7,637,871679,14,871665
59415,20,-6,494,462984,20,462964
59416,12,-6,282,461387,12,461375
59417,20,-14,69,209835,20,209815
59418,13,-16,175,148177,13,148164
59419,6,3,100,720968,6,720962
59420,20,6,683,841253,20,841233
59421,14,-4,624,526794,14,526780
59422,8,8,292,881584,8,881576
59423,13,10,585,964408,13,964395
59424,18,14,490,1089266,18,1089248
59425,8,-1,612,607158,8,607150
59426,13,-1,387,619671,13,619658
59427,7,-20,486,10419,7,10412
59428,17,-9,490,370540,17,370523
59429,20,10,159,961090,20,961070
59430,18,-8,333,400257,18,400239
59431,9,-1,95,595915,9,595906
59432,18,-12,880,279091,18,279073
59433,8,2,798,705240,8,705232
59434,9,-20,486,10428,9,10419
59435,20,-15,315,180047,20,180027
59436,18,7,665,871898,18,871880
59437,15,-17,362,118157,15,118142
59438,18,2,494,714347,18,714329
59439,5,-12,719,265056,5,265051
59440,16,14,47,1085782,16,1085766
59441,17,2,344,713207,17,713190
59442,11,-15,691,182880,11,182869
59443,13,-11,16,303803,13,303790
59444,17,-9,6,366671,17,366654
59445,15,-6,305,461545,15,461530
59446,13,-9,720,372076,13,372063
59447,17,11,267,992769,17,992752
59448,8,-9,442,353443,8,353435
59449,6,-17,968,113878,6,113872
59450,13,-3,111,554587,13,554574
59451,8,-1,646,607814,8,607806
59452,8,-7,828,423321,8,423313
59453,9,8,424,884498,9,884489
59454,9,10,991,958683,9,958674
59455,8,-7,126,408474,8,408466
59456,14,-20,422,25962,14,25948
59457,13,-2,145,586189,13,586176
59458,14,12,779,1027831,14,1027817
59459,8,-15,44,156254,8,156246
59460,10,17,342,1162755,10,1162745
59461,5,-9,63,344981,5,344976
59462,11,19,942,1248360,11,1248349
59463,7,-9,224,348360,7,348353
59464,15,-14,744,215274,15,215259
59465,10,4,177,754450,10,754440
59466,11,16,556,1151037,11,1151026
59467,8,19,744,1234019,8,1234011
59468,9,-11,286,287305,9,287296
59469,14,14,73,1086017,14,1086003
59470,5,17,366,1163155,5,1163150
59471,5,-17,799,110534,5,110529
59472,16,10,661,965024,16,965008
59473,17,11,537,994725,17,994708
59474,6,3,851,737242,6,737236
59475,8,8,365,883167,8,883159
59476,8,-17,452,103071,8,103063
59477,18,10,793,966020,18,966002
59478,20,-4,603,526615,20,526595
59479,14,19,535,1245191,14,1245177
59480,14,-16,812,152878,14,152864
59481,8,-3,935,551458,8,551450
59482,9,-11,894,300277,9,300268
59483,10,1,27,657639,10,657629
59484,20,-1,285,618828,20,618808
59485,14,-5,279,493089,14,493075
59486,16,4,842,779532,16,779516
59487,6,16,561,1137030,6,1137024
59488,8,-20,595,13019,8,13011
59489,5,-12,196,253696,5,253691
59490,6,3,957,739691,6,739685
59491,18,-10,580,339379,18,339361
59492,17,-16,183,148256,17,148239
59493,17,2,463,714138,17,714121
59494,17,-17,952,122505,17,122488
59495,13,5,976,810965,13,810952
59496,7,10,353,944958,7,944951
59497,9,3,246,724165,9,724156
59498,19,13,65,1053711,19,1053692
59499,18,5,703,808923,18,808905
59500,8,5,943,801538,8,801530
59501,14,-20,873,29529,14,29515
59502,7,0,527,636723,7,636716
59503,18,14,869,1092229,18,1092211
59504,13,-4,659,527074,13,527061
59505,13,3,436,745109,13,745096
59506,20,7,156,868164,20,868144
59507,15,12,497,1025700,15,1025685
59508,19,10,763,965731,19,965712
59509,19,-5,414,494064,19,494045
59510,9,-2,25,563324,9,563315
59511,7,13,378,1038836,7,1038829
59512,13,-16,887,153492,13,153479
59513,13,-18,21,85371,13,85358
59514,15,-10,688,340302,15,340287
59515,14,-1,251,618504,14,618490
59516,11,1,392,682972,11,682961
59517,19,3,706,747215,19,747196
59518,7,13,392,1039147,7,1039140
59519,16,11,718,995994,16,995978
59520,5,-14,142,189591,5,189586
59521,12,-5,887,497543,12,497531
59522,15,-6,324,461666,15,461651
59523,17,16,410,1150099,17,1150082
59524,18,-15,411,180801,18,180783
59525,13,6,100,836497,13,836484
59526,7,4,153,753873,7,753866
59527,20,14,289,1087659,20,1087639
59528,17,-15,139,178865,17,178848
59529,14,16,166,1148272,14,1148258
59530,8,19,143,1220638,8,1220630
59531,19,4,502,776863,19,776844
59532,18,-12,321,274921,18,274903
59533,13,6,489,839701,13,839688
59534,16,19,17,1240814,16,1240798
59535,6,6,669,827407,6,827401
59536,15,15,551,1120762,15,1120747
59537,13,-1,792,622660,13,622647
59538,12,-13,765,246701,12,246689
59539,19,3,311,744289,19,744270
59540,20,-5,346,493686,20,493666
59541,8,12,270,1005200,8,1005192
59542,8,3,5,718959,8,718951
59543,14,-2,654,590056,14,590042
59544,20,16,969,1154073,20,1154053
59545,7,7,440,854293,7,854286
59546,17,6,622,840773,17,840756
59547,11,14,624,1090264,11,1090253
59548,7,10,289,943632,7,943625
59549,8,-1,394,602600,8,602592
59550,8,-15,90,157371,8,157363
59551,15,11,522,994638,15,994623
59552,8,3,384,727125,8,727117
59553,8,10,680,952219,8,952211
59554,20,9,305,931212,20,931192
59555,19,16,934,1153793,19,1153774
59556,7,11,72,970035,7,970028
59557,17,7,935,873672,17,873655
59558,5,-15,358,163148,5,163143
59559,12,5,883,810209,12,810197
59560,7,-12,965,270635,7,270628
59561,17,0,447,651496,17,651479
59562,19,10,236,961613,19,961594
59563,9,-4,844,517361,9,517352
59564,6,15,518,1105518,6,1105512
59565,20,8,258,899996,20,899976
59566,19,11,677,995652,19,995633
59567,20,0,675,653404,20,653384
59568,6,19,689,1232740,6,1232734
59569,18,19,515,1245031,18,1245013
59570,7,7,872,863368,7,863361
59571,14,-14,135,210376,14,210362
59572,17,-3,577,558364,17,558347
59573,10,15,305,1101056,10,1101046
59574,13,18,965,1216070,13,1216057
59575,18,1,946,687232,18,687214
59576,6,10,338,944677,6,944671
59577,14,13,520,1057089,14,1057075
59578,7,-15,478,165847,7,165840
59579,7,-13,633,231908,7,231901
59580,19,-5,2,490780,19,490761
59581,13,7,37,867311,13,867298
59582,18,-9,298,368750,18,368732
59583,14,18,33,1209142,14,1209128
59584,12,-2,912,592089,12,592077
59585,17,-11,959,311237,17,311220
59586,8,-19,240,36853,8,36845
59587,10,-18,775,79197,10,79187
59588,15,-15,314,180033,15,180018
59589,8,-3,246,535773,8,535765
59590,17,-10,671,340157,17,340140
59591,18,0,953,655534,18,655516
59592,15,7,524,870926,15,870911
59593,18,-2,264,587125,18,587107
59594,16,7,893,873420,16,873404
59595,20,2,961,717662,20,717642
59596,17,17,322,1180374,17,1180357
59597,9,-16,925,143857,9,143848
59598,19,-14,210,210956,19,210937
59599,13,8,201,899563,13,899550
59600,8,-19,843,50019,8,50011
59601,7,7,871,863331,7,863324
59602,8,-9,103,345791,8,345783
59603,5,15,463,1104219,5,1104214
59604,7,2,249,693969,7,693962
59605,20,-13,238,242799,20,242779
59606,8,7,986,865683,8,865675
59607,11,-4,169,523364,11,523353
59608,9,2,990,709362,9,709353
59609,6,12,693,1014316,6,1014310
59610,5,-5,60,469176,5,469171
59611,12,-18,231,87133,12,87121
59612,8,-18,320,69502,8,69494
59613,15,-17,211,117033,15,117018
59614,15,16,900,1153515,15,1153500
59615,11,-18,483,88887,11,88876
59616,13,-1,202,618096,13,618083
59617,10,-10,823,330217,10,330207
59618,17,11,584,995066,17,995049
59619,6,-13,857,236956,6,236950
59620,6,16,499,1135799,6,1135793
59621,6,11,536,979918,6,979912
59622,11,-15,765,183470,11,183459
59623,15,0,49,648622,15,648607
59624,8,7,943,864679,8,864671
59625,11,12,900,1028906,11,1028895
59626,16,11,722,996021,16,996005
59627,5,15,709,1109533,5,1109528
59628,17,-8,733,403081,17,403064
59629,19,13,494,1056885,19,1056866
59630,12,18,145,1210159,12,1210147
59631,18,3,759,747589,18,747571
59632,19,-20,266,24812,19,24793
59633,7,4,67,752088,7,752081
59634,6,1,744,673226,6,673220
59635,14,-12,647,277258,14,277244
59636,18,17,488,1181568,18,1181550
59637,9,-4,979,520467,9,520458
59638,12,5,716,809013,12,809001
59639,8,12,644,1013249,8,1013241
59640,16,-14,706,215035,16,215019
59641,7,-19,984,52597,7,52590
59642,20,9,352,931607,20,931587
59643,5,3,288,725184,5,725179
59644,8,-16,622,137550,8,137542
59645,20,-9,549,371084,20,371064
59646,11,-3,613,558634,11,558623
59647,10,-6,798,454003,10,453993
59648,14,-3,238,555451,14,555437
59649,5,-13,573,230562,5,230557
59650,13,5,287,805957,13,805944
59651,15,12,542,1026044,15,1026029
59652,8,6,399,821382,8,821374
59653,16,-9,762,372560,16,372544
59654,8,-18,969,83534,8,83526
59655,15,-16,381,149696,15,149681
59656,16,11,623,995305,16,995289
59657,19,-5,1000,498352,19,498333
59658,5,-19,512,42557,5,42552
59659,8,-3,52,531660,8,531652
59660,6,16,890,1143610,6,1143604
59661,16,-20,741,28476,16,28460
59662,5,-3,514,541978,5,541973
59663,6,10,84,939333,6,939327
59664,14,14,871,1092238,14,1092224
59665,17,10,988,967369,17,967352
59666,20,10,645,964915,20,964895
59667,18,-12,355,275182,18,275164
59668,7,19,473,1228304,7,1228297
59669,19,-4,79,522646,19,522627
59670,8,7,705,859718,8,859710
59671,8,2,929,707938,8,707930
59672,15,-19,189,55552,15,55537
59673,5,-20,203,4768,5,4763
59674,8,10,618,950866,8,950858
59675,11,8,103,898728,11,898717
59676,16,13,460,1056641,16,1056625
59677,9,-18,736,78323,9,78314
59678,18,-10,629,339741,18,339723
59679,17,13,425,1056410,17,1056393
59680,13,3,225,743556,13,743543
59681,11,0,378,650941,11,650930
59682,5,-16,84,125699,5,125694
59683,6,-16,78,125553,6,125547
59684,12,2,191,712016,12,712004
59685,6,-2,538,574151,6,574145
59686,11,7,140,868058,11,868047
59687,13,-6,116,459953,13,459940
59688,13,17,561,1182016,13,1182003
59689,16,-6,973,466495,16,466479
59690,18,-7,587,432734,18,432716
59691,14,11,50,991225,14,991211
59692,17,0,753,654054,17,654037
59693,6,-14,56,187753,6,187747
59694,8,9,263,912135,8,912127
59695,9,2,734,704118,9,704109
59696,5,7,395,853346,5,853341
59697,5,14,979,1083768,5,1083763
59698,9,18,812,1203891,9,1203882
59699,11,-3,495,557607,11,557596
59700,9,11,95,970489,9,970480
59701,14,2,327,713053,14,713039
59702,17,-11,159,305009,17,304992
59703,18,-9,932,373951,18,373933
59704,13,-6,542,463360,13,463347
59705,6,14,655,1076654,6,1076648
59706,7,5,654,795083,7,795076
59707,16,17,767,1183543,16,1183527
59708,14,-2,942,592324,14,592310
59709,8,5,947,801718,8,801710
59710,9,-13,553,230134,9,230125
59711,6,13,410,1039626,6,1039620
59712,19,-5,119,491859,19,491840
59713,18,-10,739,340648,18,340630
59714,13,-15,339,180247,13,180234
59715,14,1,296,682203,14,682189
59716,8,-18,731,78170,8,78162
59717,6,10,3,937566,6,937560
59718,19,16,153,1148180,19,1148161
59719,8,4,886,770146,8,770138
59720,13,-1,877,623285,13,623272
59721,9,-20,117,2611,9,2602
59722,8,3,518,729799,8,729791
59723,19,-6,483,462876,19,462857
59724,16,-6,933,466195,16,466179
59725,19,-15,762,183431,19,183412
59726,16,6,883,842792,16,842776
59727,13,3,442,745162,13,745149
59728,15,3,162,743037,15,743022
59729,9,15,392,1102785,9,1102776
59730,13,7,820,872938,13,872925
59731,19,1,320,682408,19,682389
59732,10,10,617,950847,10,950837
59733,8,12,872,1018238,8,1018230
59734,20,7,177,868297,20,868277
59735,12,-3,63,554209,12,554197
59736,19,14,893,1092463,19,1092444
59737,9,-4,769,515882,9,515873
59738,14,-8,203,399347,14,399333
59739,6,9,583,919076,6,919070
59740,17,7,871,873322,17,873305
59741,17,-6,683,464336,17,464319
59742,18,0,442,651422,18,651404
59743,14,-16,834,153015,14,153001
59744,8,-18,956,83279,8,83271
59745,18,0,109,649089,18,649071
59746,5,-13,74,219982,5,219977
59747,13,4,60,773674,13,773661
59748,8,13,782,1047531,8,1047523
59749,5,8,588,888063,5,888058
59750,19,-1,968,623904,19,623885
59751,7,15,888,1113308,7,1113301
59752,18,18,287,1211217,18,1211199
59753,8,-8,483,385352,8,385344
59754,10,4,752,766983,10,766973
59755,15,-7,262,430243,15,430228
59756,10,4,44,751518,10,751508
59757,16,18,630,1213471,16,1213455
59758,15,2,744,716169,15,716154
59759,6,17,725,1170757,6,1170751
59760,10,-4,194,503671,10,503661
59761,14,-6,899,465946,14,465932
59762,7,-4,898,518700,7,518693
59763,12,-2,446,588481,12,588469
59764,19,-13,915,247929,19,247910
59765,20,-19,67,54382,20,54362
59766,10,-12,69,251102,10,251092
59767,14,-9,544,371029,14,371015
59768,8,10,453,947181,8,947173
59769,5,-17,798,110510,5,110505
59770,18,-10,662,340088,18,340070
59771,20,-11,244,305603,20,305583
59772,6,2,558,700421,6,700415
59773,9,7,620,857936,9,857927
59774,16,-14,204,210907,16,210891
59775,12,1,976,687438,12,687426
59776,9,11,306,974898,9,974889
59777,19,1,652,685002,19,684983
59778,9,-1,704,609042,9,609033
59779,13,-5,84,491525,13,491512
59780,9,10,335,944620,9,944611
59781,16,-19,964,61239,16,61223
59782,6,-12,5,249749,6,249743
59783,19,-5,113,491780,19,491761
59784,12,-14,811,215894,12,215882
59785,17,5,738,809182,17,809165
59786,6,13,317,1037516,6,1037510
59787,12,15,229,1118517,12,1118505
59788,18,-1,415,619856,18,619838
59789,5,6,281,818613,5,818608
59790,19,-7,697,433383,19,433364
59791,15,12,100,1022758,15,1022743
59792,11,2,800,716446,11,716435
59793,17,-15,403,180714,17,180697
59794,15,5,945,810755,15,810740
59795,9,-17,851,111482,9,111473
59796,13,15,565,1120869,13,1120856
59797,7,7,974,865359,7,865352
59798,15,-15,455,181124,15,181109
59799,15,10,125,960869,15,960854
59800,17,0,544,652340,17,652323
59801,15,-1,14,616610,15,616595
59802,18,-15,100,178561,18,178543
59803,17,-9,742,372318,17,372301
59804,10,14,233,1066983,10,1066973
59805,18,-11,300,306102,18,306084
59806,18,-14,633,214494,18,214476
59807,14,-9,569,371222,14,371208
59808,5,-12,881,268768,5,268763
59809,19,-4,276,524229,19,524210
59810,19,-12,938,279586,19,279567
59811,14,-12,900,279276,14,279262
59812,7,2,318,695436,7,695429
59813,19,17,890,1184631,19,1184612
59814,11,9,913,935853,11,935842
59815,9,1,74,658630,9,658621
59816,19,-7,985,435615,19,435596
59817,7,10,578,949931,7,949924
59818,18,-11,616,308645,18,308627
59819,7,-15,990,176493,7,176486
59820,6,-3,898,550537,6,550531
59821,9,7,809,861975,9,861966
59822,8,5,793,798193,8,798185
59823,20,5,86,804450,20,804430
59824,6,9,958,927105,6,927099
59825,6,13,491,1041260,6,1041254
59826,12,-6,489,462928,12,462916
59827,8,15,714,1109691,8,1109683
59828,12,-13,710,246245,12,246233
59829,18,-3,566,558279,18,558261
59830,19,17,440,1181202,19,1181183
59831,15,-4,898,528824,15,528809
59832,11,19,373,1243789,11,1243778
59833,18,15,874,1123167,18,1123149
59834,14,-6,417,462337,14,462323
59835,14,-15,227,179385,14,179371
59836,6,-3,841,549196,6,549190
59837,15,10,307,962110,15,962095
59838,11,-13,44,241375,11,241364
59839,13,0,490,651888,13,651875
59840,7,6,852,831488,7,831481
59841,8,5,405,789883,8,789875
59842,15,-8,854,403930,15,403915
59843,17,13,187,1054587,17,1054570
59844,7,1,802,674452,7,674445
59845,9,9,825,924258,9,924249
59846,10,-2,598,575457,10,575447
59847,20,5,613,808306,20,808286
59848,7,-15,713,170642,7,170635
59849,19,10,591,964447,19,964428
59850,9,12,536,1010612,9,1010603
59851,20,12,769,1027764,20,1027744
59852,8,-12,868,268513,8,268505
59853,9,5,258,787050,9,787041
59854,11,7,717,872221,11,872210
59855,13,-11,63,304173,13,304160
59856,12,-16,354,149514,12,149502
59857,19,-15,624,182358,19,182339
59858,13,16,70,1147594,13,1147581
59859,17,-17,296,117717,17,117700
59860,20,-4,958,529291,20,529271
59861,6,8,974,896351,6,896345
59862,7,0,108,627818,7,627811
59863,12,-14,9,209413,12,209401
59864,20,-18,518,89071,20,89051
59865,12,-11,444,307314,12,307302
59866,7,-9,717,359381,7,359374
59867,9,-20,352,7763,9,7754
59868,17,3,487,745465,17,745448
59869,18,8,941,905268,18,905250
59870,20,-7,702,433425,20,433405
59871,18,4,419,776250,18,776232
59872,17,-17,342,118041,17,118024
59873,14,-3,234,555397,14,555383
59874,12,-20,277,24923,12,24911
59875,8,13,430,1040018,8,1040010
59876,15,18,418,1212144,15,1212129
59877,18,16,127,1147953,18,1147935
59878,9,-17,796,110444,9,110435
59879,14,-17,128,116444,14,116430
59880,12,-13,877,247594,12,247582
59881,9,-18,586,75048,9,75039
59882,13,-15,859,184282,13,184269
59883,14,18,951,1215973,14,1215959
59884,6,16,661,1139068,6,1139062
59885,14,-6,386,462107,14,462093
59886,18,19,694,1246415,18,1246397
59887,14,16,813,1152955,14,1152941
59888,10,-9,1000,365613,10,365603
59889,6,-20,707,15614,6,15608
59890,8,3,528,729891,8,729883
59891,11,7,299,869166,11,869155
59892,14,5,821,809775,14,809761
59893,18,4,685,778279,18,778261
59894,10,0,512,636431,10,636421
59895,20,-3,967,561549,20,561529
59896,14,-6,285,461403,14,461389
59897,16,5,45,804102,16,804086
59898,16,-15,844,184124,16,184108
59899,16,19,104,1241609,16,1241593
59900,6,15,387,1102696,6,1102690
59901,16,-18,197,86820,16,86804
59902,7,-18,183,66503,7,66496
59903,14,15,275,1118819,14,1118805
59904,18,4,731,778645,18,778627
59905,7,-10,988,333813,7,333806
59906,17,10,317,962240,17,962223
59907,9,3,95,720874,9,720865
59908,5,-9,559,356226,5,356221
59909,9,12,781,1016046,9,1016037
59910,10,-5,693,483013,10,483003
59911,16,4,799,779116,16,779100
59912,5,-8,92,377350,5,377345
59913,8,14,214,1066452,8,1066444
59914,6,12,720,1014871,6,1014865
59915,16,-1,777,622578,16,622562
59916,6,4,242,755953,6,755947
59917,5,3,841,736931,5,736926
59918,9,-12,499,260418,9,260409
59919,16,-16,41,147046,16,147030
59920,15,12,543,1026063,15,1026048
59921,5,2,807,705429,5,705424
59922,16,8,202,899577,16,899561
59923,19,-12,39,272778,19,272759
59924,8,10,682,952275,8,952267
59925,19,8,84,898549,19,898530
59926,16,10,531,963930,16,963914
59927,14,-20,368,25631,14,25617
59928,12,-4,414,525324,12,525312
59929,15,8,315,900447,15,900432
59930,16,-2,403,588132,16,588116
59931,9,-7,957,426326,9,426317
59932,18,-1,617,621376,18,621358
59933,17,15,693,1121868,17,1121851
59934,7,-16,981,145114,7,145107
59935,7,-11,944,301404,7,301397
59936,19,0,785,654230,19,654211
59937,11,15,152,1117934,11,1117923
59938,13,-2,373,587863,13,587850
59939,18,-4,936,529081,18,529063
59940,18,13,226,1054901,18,1054883
59941,10,-17,32,94220,10,94210
59942,20,-8,365,400427,20,400407
59943,20,9,306,931234,20,931214
59944,14,-16,347,149450,14,149436
59945,9,-10,833,330473,9,330464
59946,9,15,334,1101635,9,1101626
59947,13,1,473,683570,13,683557
59948,16,-16,752,152436,16,152420
59949,6,3,636,732451,6,732445
59950,11,-4,808,528041,11,528030
59951,17,-3,215,555283,17,555266
59952,19,16,34,1147314,19,1147295
59953,20,-20,49,23171,20,23151
59954,19,-15,812,183851,19,183832
59955,11,8,270,900060,11,900049
59956,13,-20,34,19787,13,19774
59957,18,2,171,711902,18,711884
59958,6,19,60,1218761,6,1218755
59959,18,12,434,1025255,18,1025237
59960,16,4,776,778971,16,778955
59961,12,4,838,779488,12,779476
59962,5,-4,847,517450,5,517445
59963,15,-4,734,527564,15,527549
59964,14,18,851,1215187,14,1215173
59965,9,7,175,848484,9,848475
59966,15,14,93,1086190,15,1086175
59967,11,10,389,962757,11,962746
59968,18,-20,16,9147,18,9129
59969,15,-6,235,461009,15,460994
59970,5,2,371,696703,5,696698
59971,13,16,290,1149218,13,1149205
59972,17,-15,306,179996,17,179979
59973,16,-10,460,338450,16,338434
59974,6,2,987,709300,6,709294
59975,5,-6,668,451142,5,451137
59976,5,6,395,821256,5,821251
59977,7,12,582,1011573,7,1011566
59978,11,7,223,868561,11,868550
59979,6,-14,197,190757,6,190751
59980,12,16,136,1148046,12,1148034
59981,11,4,5,773347,11,773336
59982,12,-5,812,496903,12,496891
59983,11,-10,181,336425,11,336414
59984,12,-4,807,528033,12,528021
59985,15,12,638,1026781,15,1026766
59986,14,13,218,1054849,14,1054835
59987,8,-7,881,424663,8,424655
59988,11,14,212,1087053,11,1087042
59989,15,-9,516,370736,15,370721
59990,6,7,759,860846,6,860840
59991,7,-15,301,161876,7,161869
59992,8,-17,46,94509,8,94501
59993,7,11,260,973780,7,973773
59994,10,9,979,927657,10,927647
59995,11,-5,333,493603,11,493592
59996,10,-9,359,351503,10,351493
59997,15,-19,871,60704,15,60689
59998,7,17,994,1176707,7,1176700
59999,9,5,120,784072,9,784063
60000,7,0,613,638656,7,638649
60001,19,-7,347,430983,19,430964
60002,8,12,156,1002561,8,1002553
60003,14,-10,964,342329,14,342315
60004,18,8,741,903820,18,903802
60005,13,14,258,1087433,13,1087420
60006,16,2,532,714623,16,714607
60007,18,5,782,809470,18,809452
60008,6,11,371,976403,6,976397
60009,13,-19,388,57026,13,57013
60010,7,13,831,1048621,7,1048614
60011,19,-1,744,622298,19,622279
60012,13,10,354,962484,13,962471
60013,14,18,408,1212055,14,1212041
60014,6,-9,733,359767,6,359761
60015,6,-9,470,354143,6,354137
60016,10,3,42,719716,10,719706
60017,19,6,58,836214,19,836195
60018,12,-2,881,591877,12,591865
60019,8,9,605,919609,8,919601
60020,17,-15,602,182198,17,182181
60021,20,9,154,930186,20,930166
60022,11,-12,997,280085,11,280074
60023,12,6,224,837440,12,837428
60024,6,-14,836,204692,6,204686
60025,20,7,665,871908,20,871888
60026,20,-10,138,336156,20,336136
60027,9,9,167,910324,9,910315
60028,17,-13,388,243894,17,243877
60029,12,-11,454,307406,12,307394
60030,6,-13,381,226347,6,226341
60031,12,16,946,1153824,12,1153812
60032,12,14,974,1093057,12,1093045
60033,15,-16,592,151356,15,151341
60034,12,-7,202,429802,12,429790
60035,17,18,966,1216079,17,1216062
60036,16,-10,699,340375,16,340359
60037,17,8,169,899293,17,899276
60038,12,-3,568,558291,12,558279
60039,11,-10,26,335335,11,335324
60040,12,16,461,1150422,12,1150410
60041,9,7,275,850688,9,850679
60042,17,9,902,935765,17,935748
60043,16,5,443,806996,16,806980
60044,8,6,780,829774,8,829766
60045,18,-19,683,59325,18,59307
60046,20,-8,931,404444,20,404424
60047,18,-10,991,342623,18,342605
60048,15,-4,124,522999,15,522984
60049,15,-20,392,25788,15,25773
60050,15,0,984,655808,15,655793
60051,17,-11,489,307649,17,307632
60052,15,0,653,653264,15,653249
60053,20,-10,754,340779,20,340759
60054,15,-13,69,241539,15,241524
60055,7,16,297,1131453,7,1131446
60056,10,-4,992,520820,10,520810
60057,17,19,47,1241086,17,1241069
60058,8,-16,164,127559,8,127551
60059,19,-2,872,591777,19,591758
60060,9,-9,920,364310,9,364301
60061,11,18,974,1216149,11,1216138
60062,15,-8,905,404333,15,404318
60063,18,-20,14,7937,18,7919
60064,11,-8,876,404085,11,404074
60065,10,10,28,938146,10,938136
60066,7,-2,237,567845,7,567838
60067,17,13,274,1055191,17,1055174
60068,15,-7,999,435769,15,435754
60069,17,10,957,967204,17,967187
60070,11,-8,538,401653,11,401642
60071,8,11,24,968978,8,968970
60072,7,-20,387,8424,7,8417
60073,20,7,246,868788,20,868768
60074,18,-3,173,555008,18,554990
60075,9,9,414,915365,9,915356
60076,14,-14,955,216901,14,216887
60077,13,13,82,1053817,13,1053804
60078,9,-12,747,265677,9,265668
60079,7,-18,114,64949,7,64942
60080,5,-12,933,269850,5,269845
60081,12,12,687,1027249,12,1027237
60082,11,-13,175,242309,11,242298
60083,12,-15,389,180613,12,180601
60084,8,0,533,636874,8,636866
60085,5,19,479,1228441,5,1228436
60086,17,11,716,995976,17,995959
60087,14,-5,621,495572,14,495558
60088,5,-15,936,175329,5,175324
60089,20,17,353,1180607,20,1180587
60090,20,3,259,743842,20,743822
60091,12,5,331,806223,12,806211
60092,7,-6,564,449000,7,448993
60093,18,11,244,992585,18,992567
60094,7,14,535,1073776,7,1073769
60095,15,-11,557,308196,15,308181
60096,14,1,679,685169,14,685155
60097,9,18,42,1187526,9,1187517
60098,16,13,933,1060163,16,1060147
60099,18,0,492,651905,18,651887
60100,13,-17,146,116543,13,116530
60101,17,-19,386,57013,17,56996
60102,15,-2,431,588383,15,588368
60103,17,-14,908,216582,17,216565
60104,19,-7,707,433454,19,433435
60105,10,1,550,669359,10,669349
60106,19,18,567,1213068,19,1213049
60107,13,10,629,964772,13,964759
60108,19,17,184,1179277,19,1179258
60109,20,-18,608,89632,20,89612
60110,8,-18,409,71191,8,71183
60111,6,-19,133,34529,6,34523
60112,8,-10,611,325871,8,325863
60113,20,-6,713,464570,20,464550
60114,17,-15,1,177843,17,177826
60115,6,16,0,1125150,6,1125144
60116,5,9,715,921805,5,921800
60117,14,13,106,1054009,14,1053995
60118,17,-7,608,432791,17,432774
60119,9,15,897,1113555,9,1113546
60120,17,-12,905,279327,17,279310
60121,6,9,0,906735,6,906729
60122,10,2,753,704550,10,704540
60123,19,-15,579,182062,19,182043
60124,13,-6,956,466364,13,466351
60125,5,-3,798,548262,5,548257
60126,8,-12,16,249938,8,249930
60127,11,6,788,842077,11,842066
60128,10,2,787,705025,10,705015
60129,9,5,208,786037,9,786028
60130,16,-7,60,428750,16,428734
60131,11,-19,329,56533,11,56522
60132,18,17,585,1182188,18,1182170
60133,18,8,757,903934,18,903916
60134,9,12,275,1005347,9,1005338
60135,15,-17,461,118944,15,118929
60136,12,-19,902,60834,12,60822
60137,16,-9,417,369823,16,369807
60138,16,9,586,933400,16,933384
60139,18,12,34,1022350,18,1022332
60140,12,3,471,745373,12,745361
60141,13,-2,448,588512,13,588499
60142,16,-14,358,212185,16,212169
60143,8,-3,248,535865,8,535857
60144,8,-4,978,520449,8,520441
60145,5,14,175,1065674,5,1065669
60146,16,-6,87,459717,16,459701
60147,10,-16,905,143415,10,143405
60148,9,10,338,944686,9,944677
60149,13,5,229,805549,13,805536
60150,15,-8,103,398631,15,398616
60151,20,-10,625,339719,20,339699
60152,15,6,979,843586,15,843571
60153,16,12,894,1028831,16,1028815
60154,10,19,496,1228813,10,1228803
60155,10,-12,85,251405,10,251395
60156,16,-4,33,522276,16,522260
60157,12,1,612,684676,12,684664
60158,16,-15,527,181637,16,181621
60159,11,-6,727,464716,11,464705
60160,17,-18,24,85392,17,85375
60161,17,4,538,777140,17,777123
60162,5,14,352,1069533,5,1069528
60163,14,-12,772,278178,14,278164
60164,8,-8,629,388715,8,388707
60165,5,1,166,660797,5,660792
60166,19,8,665,903215,19,903196
60167,16,-12,759,278096,16,278080
60168,11,17,682,1182913,11,1182902
60169,8,5,229,786473,8,786465
60170,16,-2,813,591267,16,591251
60171,12,1,304,682253,12,682241
60172,5,4,592,763431,5,763426
60173,15,12,316,1024429,15,1024414
60174,6,16,413,1134128,6,1134122
60175,13,-18,528,89143,13,89130
60176,19,-15,981,185232,19,185213
60177,10,-16,871,142794,10,142784
60178,18,-17,543,119562,18,119544
60179,16,19,527,1245161,16,1245145
60180,12,3,663,746847,12,746835
60181,15,13,202,1054728,15,1054713
60182,11,-20,759,28653,11,28642
60183,12,11,60,991323,12,991311
60184,19,-4,241,524008,19,523989
60185,10,11,450,977994,10,977984
60186,8,12,860,1017906,8,1017898
60187,18,14,948,1092894,18,1092876
60188,16,4,151,774364,16,774348
60189,13,14,318,1087899,13,1087886
60190,7,5,797,798269,7,798262
60191,19,-9,243,368349,19,368330
60192,19,-17,672,120571,19,120552
60193,13,0,759,654104,13,654091
60194,12,3,373,744670,12,744658
60195,19,3,502,745574,19,745555
60196,15,-17,428,118606,15,118591
60197,6,-9,239,348774,6,348768
60198,19,17,997,1185462,19,1185443
60199,10,4,40,751404,10,751394
60200,20,5,254,805696,20,805676
60201,6,19,305,1224364,6,1224358
60202,18,3,467,745343,18,745325
60203,18,-10,447,338375,18,338357
60204,10,18,820,1204062,10,1204052
60205,9,-10,159,316089,9,316080
60206,19,2,37,710780,19,710761
60207,5,12,455,1008831,5,1008826
60208,7,18,7,1186698,7,1186691
60209,11,18,35,1209152,11,1209141
60210,11,-12,10,272587,11,272576
60211,7,-3,111,532832,7,532825
60212,8,14,575,1074574,8,1074566
60213,11,19,271,1242927,11,1242916
60214,8,9,386,914820,8,914812
60215,6,-6,735,452633,6,452627
60216,14,11,531,994694,14,994680
60217,5,-5,579,480579,5,480574
60218,17,12,678,1027175,17,1027158
60219,20,-9,66,367125,20,367105
60220,7,-15,198,159532,7,159525
60221,18,4,662,778069,18,778051
60222,8,12,736,1015154,8,1015146
60223,6,-9,943,364771,6,364765
60224,12,0,358,650738,12,650726
60225,15,-3,47,554155,15,554140
60226,13,-12,973,279886,13,279873
60227,12,3,488,745482,12,745470
60228,13,-3,149,554834,13,554821
60229,16,-20,223,24493,16,24477
60230,19,-16,19,146913,19,146894
60231,5,-15,16,155676,5,155671
60232,14,-9,523,370832,14,370818
60233,20,-7,612,432831,20,432811
60234,17,-7,391,431303,17,431286
60235,9,3,171,722470,9,722461
60236,18,-9,422,369881,18,369863
60237,20,-5,349,493703,20,493683
60238,18,-7,869,434667,18,434649
60239,6,8,498,886119,6,886113
60240,16,-3,618,558702,16,558686
60241,14,9,941,936105,14,936091
60242,6,1,112,659538,6,659532
60243,12,-5,324,493540,12,493528
60244,14,-9,953,374079,14,374065
60245,15,6,723,841641,15,841626
60246,16,2,98,711334,16,711318
60247,11,-14,955,216902,11,216891
60248,18,-16,200,148401,18,148383
60249,15,4,288,775267,15,775252
60250,18,4,965,780326,18,780308
60251,19,-5,455,494383,19,494364
60252,10,18,38,1187416,10,1187406
60253,17,15,16,1116903,17,1116886
60254,12,-9,411,369765,12,369753
60255,16,-12,426,275596,16,275580
60256,9,-18,997,84125,9,84116
60257,14,-4,243,524016,14,524002
60258,15,3,486,745459,15,745444
60259,16,-5,71,491388,16,491372
60260,11,-11,241,305577,11,305566
60261,9,-13,843,236629,9,236620
60262,15,17,934,1184896,15,1184881
60263,11,3,921,748804,11,748793
60264,11,-9,725,372094,11,372083
60265,10,8,629,889008,10,888998
60266,15,14,574,1089885,15,1089870
60267,7,5,36,782371,7,782364
60268,15,7,31,867238,15,867223
60269,18,16,355,1149716,18,1149698
60270,6,-19,191,35803,6,35797
60271,19,-11,195,305291,19,305272
60272,6,-13,394,226609,6,226603
60273,6,5,182,785430,6,785424
60274,16,5,102,804539,16,804523
60275,19,-17,719,120935,19,120916
60276,13,3,694,747158,13,747145
60277,9,-14,36,187289,9,187280
60278,14,5,123,804674,14,804660
60279,19,14,751,1091341,19,1091322
60280,15,-7,792,434022,15,434007
60281,7,-17,805,110664,7,110657
60282,11,15,216,1118426,11,1118415
60283,19,6,335,838390,19,838371
60284,12,18,565,1213051,12,1213039
60285,12,-19,771,60011,12,59999
60286,12,-8,987,404918,12,404906
60287,12,2,24,710650,12,710638
60288,18,3,937,748956,18,748938
60289,12,-10,106,335892,12,335880
60290,16,-18,716,90462,16,90446
60291,14,10,411,962980,14,962966
60292,8,-17,457,103226,8,103218
60293,19,-18,102,86014,19,85995
60294,16,-6,351,461894,16,461878
60295,11,1,452,683407,11,683396
60296,10,-2,341,569999,10,569989
60297,14,18,51,1209304,14,1209290
60298,15,8,196,899490,15,899475
60299,6,-18,440,71814,6,71808
60300,7,5,167,785004,7,784997
60301,5,0,245,630681,5,630676
60302,7,-2,876,581563,7,581556
60303,20,-7,39,428631,20,428611
60304,12,17,187,1179305,12,1179293
60305,15,-7,14,428403,15,428388
60306,6,-17,997,114439,6,114433
60307,17,-17,493,119194,17,119177
60308,12,-2,985,592628,12,592616
60309,10,-14,898,205993,10,205983
60310,11,-10,278,337079,11,337068
60311,8,-16,852,142312,8,142304
60312,5,-11,541,293234,5,293229
60313,5,8,966,896165,5,896160
60314,17,14,474,1089117,17,1089100
60315,19,16,256,1148969,19,1148950
60316,7,2,168,692283,7,692276
60317,12,-12,143,273590,12,273578
60318,7,5,916,800858,7,800851
60319,19,-13,867,247490,19,247471
60320,20,-6,495,462995,20,462975
60321,20,6,361,838556,20,838536
60322,19,-14,720,215129,19,215110
60323,11,-13,126,241923,11,241912
60324,18,-5,254,492919,18,492901
60325,14,18,147,1210184,14,1210170
60326,8,-12,640,263400,8,263392
60327,13,-11,490,307657,13,307644
60328,5,-4,897,518664,5,518659
60329,7,-10,379,320773,7,320766
60330,17,-3,294,555934,17,555917
60331,17,6,936,843195,17,843178
60332,10,9,284,912606,10,912596
60333,7,-20,968,21284,7,21277
60334,11,15,463,1120043,11,1120032
60335,17,10,494,963572,17,963555
60336,20,-15,911,184712,20,184692
60337,9,7,244,850034,9,850025
60338,14,18,616,1213362,14,1213348
60339,12,-17,917,122300,12,122288
60340,7,10,719,952993,7,952986
60341,18,-12,608,276916,18,276898
60342,8,-18,333,69692,8,69684
60343,6,-6,461,446670,6,446664
60344,16,6,682,841238,16,841222
60345,16,-17,161,116664,16,116648
60346,7,1,125,659897,7,659890
60347,15,2,816,716556,15,716541
60348,5,-11,293,287439,5,287434
60349,14,-8,116,398718,14,398704
60350,5,-5,945,488557,5,488552
60351,19,-1,649,621583,19,621564
60352,6,12,766,1015734,6,1015728
60353,19,-17,950,122489,19,122470
60354,6,-20,426,9073,6,9067
60355,16,19,31,1240972,16,1240956
60356,7,0,853,643881,7,643874
60357,7,4,310,757209,7,757202
60358,19,8,438,901479,19,901460
60359,10,-9,80,345357,10,345347
60360,6,-1,222,598650,6,598644
60361,20,-19,830,60376,20,60356
60362,8,15,448,1103965,8,1103957
60363,11,-16,957,153962,11,153951
60364,7,1,24,657579,7,657572
60365,12,-16,698,152038,12,152026
60366,20,-7,513,432193,20,432173
60367,19,7,594,871389,19,871370
60368,17,12,331,1024559,17,1024542
60369,6,-10,0,312525,6,312519
60370,18,-16,182,148248,18,148230
60371,14,19,997,1248775,14,1248761
60372,10,-7,384,414201,10,414191
60373,7,10,945,957852,7,957845
60374,10,2,9,688687,10,688677
60375,18,-16,422,150056,18,150038
60376,18,-1,736,622268,18,622250
60377,11,-10,600,339543,11,339532
60378,18,14,575,1089892,18,1089874
60379,14,-5,864,497319,14,497305
60380,12,7,855,873165,12,873153
60381,19,-9,967,374139,19,374120
60382,7,11,761,984785,7,984778
60383,14,-15,207,179225,14,179211
60384,19,17,554,1182002,19,1181983
60385,8,19,852,1236425,8,1236417
60386,8,12,904,1019024,8,1019016
60387,12,8,592,902610,12,902598
60388,19,2,668,715616,19,715597
60389,11,3,260,743842,11,743831
60390,7,13,857,1049175,7,1049168
60391,17,-15,881,184443,17,184426
60392,19,11,520,994608,19,994589
60393,9,2,138,691552,9,691543
60394,16,14,604,1090112,16,1090096
60395,11,12,522,1025847,11,1025836
60396,5,-2,175,566410,5,566405
60397,19,-1,70,617110,19,617091
60398,5,-9,591,356897,5,356892
60399,13,-19,541,58182,13,58169
60400,5,6,966,834023,5,834018
60401,16,-6,936,466233,16,466217
60402,20,-7,937,435259,20,435239
60403,7,13,156,1033973,7,1033966
60404,18,17,712,1183198,18,1183180
60405,14,19,949,1248395,14,1248381
60406,12,-15,531,181685,12,181673
60407,9,-20,798,17671,9,17662
60408,12,0,176,649573,12,649561
60409,16,-10,978,342462,16,342446
60410,11,-3,626,558765,11,558754
60411,19,14,247,1087374,19,1087355
60412,14,14,499,1089377,14,1089363
60413,9,-10,386,320875,9,320866
60414,20,18,246,1210942,20,1210922
60415,8,4,673,765136,8,765128
60416,15,-5,104,491730,15,491715
60417,12,17,166,1179132,12,1179120
60418,19,0,883,654990,19,654971
60419,17,12,789,1027927,17,1027910
60420,20,8,824,904392,20,904372
60421,20,-18,53,85604,20,85584
60422,11,-12,93,273213,11,273202
60423,18,19,395,1244002,18,1243984
60424,13,-11,578,308351,13,308338
60425,9,-19,221,36445,9,36436
60426,16,10,906,966751,16,966735
60427,8,9,731,922102,8,922094
60428,5,-16,138,127030,5,127025
60429,17,5,488,807378,17,807361
60430,6,-8,924,395064,6,395058
60431,6,-12,945,270166,6,270160
60432,12,-3,695,559307,12,559295
60433,9,5,474,791445,9,791436
60434,20,-14,742,215256,20,215236
60435,8,-12,392,258124,8,258116
60436,5,12,796,1016378,5,1016373
60437,10,9,958,927115,10,927105
60438,13,16,81,1147655,13,1147642
60439,16,11,216,992343,16,992327
60440,13,-20,833,29256,13,29243
60441,5,12,731,1015073,5,1015068
60442,5,9,615,919851,5,919846
60443,5,-2,258,568317,5,568312
60444,8,7,330,851914,8,851906
60445,20,2,239,712354,20,712334
60446,10,-12,365,257568,10,257558
60447,16,18,457,1212368,16,1212352
60448,18,4,432,776375,18,776357
60449,11,12,277,1024179,11,1024168
60450,15,-6,270,461294,15,461279
60451,12,-10,84,335819,12,335807
60452,19,-18,942,92059,19,92040
60453,17,18,522,1212819,17,1212802
60454,10,-19,527,42983,10,42973
60455,11,9,821,935130,11,935119
60456,12,15,268,1118796,12,1118784
60457,17,-9,932,373958,17,373941
60458,13,6,637,840926,13,840913
60459,9,-9,428,353050,9,353041
60460,12,17,807,1183995,12,1183983
60461,13,12,954,1029446,13,1029433
60462,11,4,826,779366,11,779355
60463,7,-11,183,285106,7,285099
60464,6,6,456,822690,6,822684
60465,8,18,340,1194083,8,1194075
60466,17,-7,338,430921,17,430904
60467,6,16,820,1142209,6,1142203
60468,6,8,256,880749,6,880743
60469,18,6,623,840780,18,840762
60470,16,-5,711,496225,16,496209
60471,20,-10,991,342633,20,342613
60472,16,19,564,1245384,16,1245368
60473,17,-15,940,184941,17,184924
60474,8,8,820,893009,8,893001
60475,15,-10,791,341016,15,341001
60476,20,11,946,997685,20,997665
60477,12,6,949,843314,12,843302
60478,16,-3,661,559057,16,559041
60479,13,-17,881,122045,13,122032
60480,6,8,245,880617,6,880611
60481,9,-11,655,295579,9,295570
60482,11,-7,225,429992,11,429981
60483,10,14,157,1065396,10,1065386
60484,6,18,811,1203873,6,1203867
60485,9,19,344,1225241,9,1225232
60486,17,-2,311,587468,17,587451
60487,14,-7,175,429633,14,429619
60488,18,-1,462,620250,18,620232
60489,6,-11,97,283184,6,283178
60490,11,19,732,1246730,11,1246719
60491,19,-12,603,276892,19,276873
60492,20,-20,148,23908,20,23888
60493,20,-7,490,432002,20,431982
60494,8,-7,345,413377,8,413369
60495,18,15,47,1117145,18,1117127
60496,9,-13,424,227181,9,227172
60497,18,3,249,743752,18,743734
60498,7,-3,67,531935,7,531928
60499,12,-12,892,279190,12,279178
60500,10,11,281,974292,10,974282
60501,15,-15,592,182131,15,182116
60502,19,-16,559,151117,19,151098
60503,6,16,23,1125678,6,1125672
60504,18,0,548,652383,18,652365
60505,15,-16,256,148836,15,148821
60506,13,-6,618,463882,13,463869
60507,18,8,231,899865,18,899847
60508,17,9,342,931520,17,931503
60509,12,-15,139,178867,12,178855
60510,15,-4,202,523672,15,523657
60511,15,-15,265,179684,15,179669
60512,12,16,742,1152382,12,1152370
60513,18,-14,158,210519,18,210501
60514,15,-4,0,522045,15,522030
60515,11,-15,604,182202,11,182191
60516,12,8,203,899588,12,899576
60517,10,9,917,926250,10,926240
60518,9,10,675,952128,9,952119
60519,6,-16,88,125837,6,125831
60520,16,-10,331,337420,16,337404
60521,18,-15,40,178094,18,178076
60522,14,4,817,779276,14,779262
60523,17,15,745,1122334,17,1122317
60524,16,6,487,839684,16,839668
60525,6,11,919,988370,6,988364
60526,6,-18,156,65908,6,65902
60527,16,9,786,934852,16,934836
60528,13,-10,470,338604,13,338591
60529,13,6,215,837329,13,837316
60530,15,-14,77,209920,15,209905
60531,20,3,181,743237,20,743217
60532,17,5,499,807426,17,807409
60533,7,4,997,772258,7,772251
60534,5,6,522,824213,5,824208
60535,5,-8,524,386391,5,386386
60536,18,7,665,871916,18,871898
60537,9,-5,718,483562,9,483553
60538,8,-5,70,469404,8,469396
60539,6,-20,542,11820,6,11814
60540,9,-18,528,73778,9,73769
60541,15,-2,29,585360,15,585345
60542,18,13,761,1058926,18,1058908
60543,11,-6,755,464914,11,464903
60544,16,5,197,805319,16,805303
60545,14,-16,200,148405,14,148391
60546,16,-7,844,434470,16,434454
60547,8,-7,478,416061,8,416053
60548,13,-7,893,434927,13,434914
60549,19,-3,373,556564,19,556545
60550,9,9,659,920597,9,920588
60551,14,-9,831,373133,14,373119
60552,6,4,778,767585,6,767579
60553,13,-4,821,528114,13,528101
60554,13,-12,294,274680,13,274667
60555,13,19,393,1243974,13,1243961
60556,16,18,834,1215013,16,1214997
60557,7,18,729,1201928,7,1201921
60558,14,14,233,1087237,14,1087223
60559,6,-8,526,386469,6,386463
60560,5,-19,793,48810,5,48805
60561,15,-6,499,463009,15,462994
60562,12,13,493,1056871,12,1056859
60563,6,16,422,1134254,6,1134248
60564,5,10,658,951751,5,951746
60565,11,-9,197,367957,11,367946
60566,17,19,489,1244802,17,1244785
60567,10,-9,971,365171,10,365161
60568,18,9,296,931103,18,931085
60569,9,-7,321,412869,9,412860
60570,11,14,218,1087107,11,1087096
60571,14,-14,765,215494,14,215480
60572,16,18,980,1216187,16,1216171
60573,20,-6,687,464407,20,464387
60574,14,9,505,932756,14,932742
60575,11,-17,867,121932,11,121921
60576,9,3,840,736897,9,736888
60577,17,-2,81,585726,17,585709
60578,10,5,564,793254,10,793244
60579,12,-1,614,621332,12,621320
60580,10,-18,396,70946,10,70936
60581,11,19,499,1244878,11,1244867
60582,17,14,925,1092659,17,1092642
60583,17,-16,15,146885,17,146868
60584,6,17,404,1163900,6,1163894
60585,5,4,340,757866,5,757861
60586,9,9,342,913975,9,913966
60587,17,0,217,649888,17,649871
60588,12,4,567,777373,12,777361
60589,5,-18,417,71343,5,71338
60590,10,15,719,1109798,10,1109788
60591,19,-15,608,182231,19,182212
60592,5,6,704,828304,5,828299
60593,9,7,381,853036,9,853027
60594,16,0,650,653220,16,653204
60595,17,6,272,837843,17,837826
60596,18,-1,241,618478,18,618460
60597,18,-17,860,121891,18,121873
60598,12,17,336,1180482,12,1180470
60599,7,7,199,849004,7,848997
60600,18,-7,489,431991,18,431973
60601,8,-3,707,546376,8,546368
60602,10,-9,607,357171,10,357161
60603,11,-18,948,92091,11,92080
60604,10,6,128,814934,10,814924
60605,15,-6,933,466200,15,466185
60606,15,-2,288,587302,15,587287
60607,19,-13,498,244690,19,244671
60608,19,-2,778,590988,19,590969
60609,16,3,241,743700,16,743684
60610,9,-9,551,356131,9,356122
60611,12,5,231,805555,12,805543
60612,15,5,161,804964,15,804949
60613,7,2,350,696207,7,696200
60614,10,9,188,910704,10,910694
60615,19,2,101,711348,19,711329
60616,20,11,540,994749,20,994729
60617,18,-8,962,404723,18,404705
60618,5,-8,270,381161,5,381156
60619,16,-10,953,342239,16,342223
60620,6,-7,878,424569,6,424563
60621,20,13,551,1057404,20,1057384
60622,7,7,460,854683,7,854676
60623,11,4,732,778662,11,778651
60624,10,-20,922,20365,10,20355
60625,6,19,513,1229227,6,1229221
60626,13,-3,266,555647,13,555634
60627,14,16,656,1151808,14,1151794
60628,17,-7,668,433116,17,433099
60629,16,-5,269,493025,16,493009
60630,16,6,308,838117,16,838101
60631,17,1,204,681509,17,681492
60632,7,4,428,759888,7,759881
60633,15,2,71,711101,15,711086
60634,5,-9,639,357749,5,357744
60635,9,15,937,1114404,9,1114395
60636,15,11,665,995564,15,995549
60637,18,3,230,743628,18,743610
60638,13,9,599,933505,13,933492
60639,9,-4,747,515391,9,515382
60640,8,5,694,796050,8,796042
60641,20,9,919,935940,20,935920
60642,14,15,376,1119541,14,1119527
60643,20,-1,297,618913,20,618893
60644,15,-13,272,243107,15,243092
60645,8,-17,212,97981,8,97973
60646,11,-11,57,304124,11,304113
60647,12,-13,260,242998,12,242986
60648,20,-18,228,87103,20,87083
60649,8,-6,638,450536,8,450528
60650,17,-14,159,210536,17,210519
60651,13,-5,971,498202,13,498189
60652,18,-8,674,402678,18,402660
60653,13,-2,396,588053,13,588040
60654,15,14,812,1091833,15,1091818
60655,20,-3,147,554818,20,554798
60656,12,-12,459,275828,12,275816
60657,7,-16,73,125408,7,125401
60658,15,-5,576,495278,15,495263
60659,17,7,490,870681,17,870664
60660,13,3,238,743679,13,743666
60661,20,13,762,1058955,20,1058935
60662,7,-15,320,162358,7,162351
60663,19,10,489,963559,19,963540
60664,19,-10,529,338962,19,338943
60665,16,-5,297,493272,16,493256
60666,8,-11,377,289549,8,289541
60667,18,8,42,898189,18,898171
60668,20,17,236,1179638,20,1179618
60669,16,2,441,713973,16,713957
60670,5,-11,745,297252,5,297247
60671,6,-11,38,281898,6,281892
60672,20,6,939,843230,20,843210
60673,15,9,673,934025,15,934010
60674,6,-7,468,415847,6,415841
60675,15,6,858,842597,15,842582
60676,5,-6,288,443108,5,443103
60677,20,-18,637,89882,20,89862
60678,20,19,691,1246375,20,1246355
60679,7,-10,732,328383,7,328376
60680,9,12,545,1010872,9,1010863
60681,5,-2,832,580637,5,580632
60682,14,7,1000,874128,14,874114
60683,6,-4,626,512931,6,512925
60684,13,-15,817,183917,13,183904
60685,12,2,714,715999,12,715987
60686,13,0,987,655826,13,655813
60687,16,-3,430,557033,16,557017
60688,8,5,479,791605,8,791597
60689,11,18,658,1213729,11,1213718
60690,19,-4,346,524815,19,524796
60691,12,2,856,716856,12,716844
60692,8,-14,200,190855,8,190847
60693,14,13,198,1054685,14,1054671
60694,15,-18,538,89180,15,89165
60695,9,-8,837,393224,9,393215
60696,11,-9,713,372051,11,372040
60697,7,12,75,1000679,7,1000672
60698,18,-3,332,556249,18,556231
60699,13,-17,945,122459,13,122446
60700,14,2,62,711000,14,710986
60701,16,0,865,654825,16,654809
60702,8,0,282,631362,8,631354
60703,12,-2,409,588176,12,588164
60704,17,-18,462,88764,17,88747
60705,5,-19,837,49794,5,49789
60706,11,-2,683,590278,11,590267
60707,16,5,88,804462,16,804446
60708,9,-11,581,294079,9,294070
60709,16,-5,162,492219,16,492203
60710,16,9,525,932906,16,932890
60711,19,-7,913,435047,19,435028
60712,5,-4,755,515533,5,515528
60713,8,-6,105,438966,8,438958
60714,10,-16,664,138330,10,138320
60715,8,19,844,1236279,8,1236271
60716,7,-8,436,384362,7,384355
60717,13,16,320,1149444,13,1149431
60718,18,-1,351,619402,18,619384
60719,12,18,625,1213430,12,1213418
60720,15,-13,494,244646,15,244631
60721,14,-16,449,150359,14,150345
60722,11,0,742,653984,11,653973
60723,16,6,68,836267,16,836251
60724,16,-2,129,586087,16,586071
60725,14,18,611,1213336,14,1213322
60726,9,-17,483,103821,9,103812
60727,10,-9,903,363948,10,363938
60728,15,-6,114,459932,15,459917
60729,20,-14,28,209556,20,209536
60730,7,18,294,1193198,7,1193191
60731,10,15,916,1113947,10,1113937
60732,8,-20,530,11457,8,11449
60733,19,-1,143,617613,19,617594
60734,12,19,181,1242183,12,1242171
60735,15,11,384,993698,15,993683
60736,18,10,94,960615,18,960597
60737,9,17,678,1169820,9,1169811
60738,7,-11,731,296956,7,296949
60739,11,-17,580,119907,11,119896
60740,11,1,352,682690,11,682679
60741,14,-7,509,432158,14,432144
60742,15,-19,83,54574,15,54559
60743,8,6,851,831457,8,831449
60744,6,7,871,863347,6,863341
60745,7,-6,529,448227,7,448220
60746,15,4,638,777897,15,777882
60747,18,-15,900,184579,18,184561
60748,8,-11,824,298789,8,298781
60749,5,-20,834,18495,5,18490
60750,18,12,927,1029192,18,1029174
60751,20,-10,103,335889,20,335869
60752,14,18,969,1216117,14,1216103
60753,17,-8,122,398741,17,398724
60754,15,14,61,1085906,15,1085891
60755,7,8,912,895008,7,895001
60756,14,-20,105,23551,14,23537
60757,12,17,991,1185422,12,1185410
60758,11,16,472,1150480,11,1150469
60759,7,5,588,793814,7,793807
60760,8,13,215,1035338,8,1035330
60761,13,-17,943,122445,13,122432
60762,14,8,943,905296,14,905282
60763,18,12,668,1027060,18,1027042
60764,12,4,307,775403,12,775391
60765,12,-10,576,339364,12,339352
60766,12,17,474,1181464,12,1181452
60767,20,-7,453,431728,20,431708
60768,15,-13,140,242039,15,242024
60769,14,8,149,899111,14,899097
60770,10,-18,23,62910,10,62900
60771,10,-10,122,315261,10,315251
60772,6,-18,53,63530,6,63524
60773,15,-3,6,553903,15,553888
60774,6,7,771,861080,6,861074
60775,8,-3,258,536044,8,536036
60776,14,-14,270,211540,14,211526
60777,6,8,860,893840,6,893834
60778,20,-7,715,433532,20,433512
60779,17,-7,845,434493,17,434476
60780,15,6,152,836926,15,836911
60781,13,18,886,1215453,13,1215440
60782,12,-6,367,461970,12,461958
60783,15,11,823,996792,15,996777
60784,18,18,226,1210800,18,1210782
60785,12,9,314,931317,12,931305
60786,15,-15,421,180887,15,180872
60787,8,-2,124,565508,8,565500
60788,8,12,955,1020158,8,1020150
60789,8,3,276,724867,8,724859
60790,8,-2,359,570357,8,570349
60791,9,-7,698,420665,9,420656
60792,16,14,736,1091201,16,1091185
60793,12,-14,697,214977,12,214965
60794,15,-7,878,434747,15,434732
60795,15,-18,747,90700,15,90685
60796,10,2,519,699712,10,699702
60797,18,-6,796,465216,18,465198
60798,6,1,156,660624,6,660618
60799,10,-12,101,251715,10,251705
60800,19,11,647,995442,19,995423
60801,12,8,283,900231,12,900219
60802,9,9,337,913850,9,913841
60803,15,15,54,1117199,15,1117184
60804,10,-5,926,488168,10,488158
60805,17,3,835,748092,17,748075
60806,9,13,174,1034376,9,1034367
60807,7,-8,969,396083,7,396076
60808,10,-6,537,448419,10,448409
60809,13,-4,405,525262,13,525249
60810,17,15,422,1119764,17,1119747
60811,16,-6,417,462343,16,462327
60812,10,-10,584,325242,10,325232
60813,14,-9,203,367987,14,367973
60814,18,18,647,1213636,18,1213618
60815,12,9,593,933473,12,933461
60816,20,16,554,1151037,20,1151017
60817,7,-9,139,346534,7,346527
60818,20,-6,578,463565,20,463545
60819,18,12,631,1026720,18,1026702
60820,5,-1,469,604344,5,604339
60821,8,2,925,707842,8,707834
60822,13,18,110,1209872,13,1209859
60823,10,-2,454,572479,10,572469
60824,20,2,417,713805,20,713785
60825,12,-12,234,274220,12,274208
60826,10,-1,422,603165,10,603155
60827,20,11,171,992057,20,992037
60828,12,3,476,745389,12,745377
60829,18,-18,751,90755,18,90737
60830,18,18,921,1215667,18,1215649
60831,13,-3,486,557534,13,557521
60832,16,11,30,991098,16,991082
60833,16,-5,286,493169,16,493153
60834,13,-1,732,622219,13,622206
60835,17,-14,555,213777,17,213760
60836,14,8,637,903039,14,903025
60837,15,12,227,1023728,15,1023713
60838,19,-12,63,272979,19,272960
60839,16,11,320,993200,16,993184
60840,16,17,747,1183442,16,1183426
60841,6,7,600,857563,6,857557
60842,5,-3,815,548657,5,548652
60843,18,6,634,840886,18,840868
60844,17,-14,831,215997,17,215980
60845,19,-18,345,87921,19,87902
60846,7,14,701,1077763,7,1077756
60847,15,-8,22,398056,15,398041
60848,5,-5,747,484161,5,484156
60849,19,-7,528,432330,19,432311
60850,19,17,869,1184525,19,1184506
60851,14,-18,954,92160,14,92146
60852,12,19,182,1242195,12,1242183
60853,19,-3,299,555966,19,555947
60854,18,18,824,1214910,18,1214892
60855,8,15,846,1112463,8,1112455
60856,18,-7,196,429755,18,429737
60857,10,9,984,927744,10,927734
60858,8,-5,658,482291,8,482283
60859,20,-12,833,278654,20,278634
60860,14,-13,466,244412,14,244398
60861,9,15,218,1099182,9,1099173
60862,8,-16,754,140303,8,140295
60863,7,-1,973,614852,7,614845
60864,14,-4,102,522808,14,522794
60865,12,12,470,1025483,12,1025471
60866,11,-3,199,555173,11,555162
60867,5,14,575,1074589,5,1074584
60868,19,16,247,1148863,19,1148844
60869,13,5,692,808846,13,808833
60870,11,-16,431,150161,11,150150
60871,15,16,62,1147534,15,1147519
60872,8,-16,58,125111,8,125103
60873,9,-9,191,347624,9,347615
60874,18,2,889,717114,18,717096
60875,15,2,550,714742,15,714727
60876,6,6,170,815896,6,815890
60877,17,-5,886,497533,17,497516
60878,19,-20,300,25148,19,25129
60879,19,-17,424,118602,19,118583
60880,8,-10,361,320386,8,320378
60881,12,-12,530,276483,12,276471
60882,17,-19,506,57889,17,57872
60883,9,11,801,985607,9,985598
60884,13,-13,281,243193,13,243180
60885,12,-11,482,307586,12,307574
60886,20,-19,94,54657,20,54637
60887,13,8,558,902323,13,902310
60888,11,-12,513,276338,11,276327
60889,15,-1,607,621286,15,621271
60890,9,-12,509,260697,9,260688
60891,19,-17,724,121007,19,120988
60892,6,-8,563,387237,6,387231
60893,9,7,763,860928,9,860919
60894,10,1,390,665730,10,665720
60895,6,-7,488,416295,6,416289
60896,15,6,287,837969,15,837954
60897,15,11,393,993756,15,993741
60898,5,8,327,882443,5,882438
60899,17,-6,507,463079,17,463062
60900,5,6,307,819148,5,819143
60901,7,-4,275,505568,7,505561
60902,16,-19,223,55813,16,55797
60903,7,-2,949,583183,7,583176
60904,8,-19,780,48641,8,48633
60905,7,9,2,906766,7,906759
60906,19,3,379,744728,19,744709
60907,17,3,841,748141,17,748124
60908,8,-14,476,196986,8,196978
60909,16,5,81,804402,16,804386
60910,20,11,597,995169,20,995149
60911,15,-9,420,369863,15,369848
60912,18,-18,345,87929,18,87911
60913,15,12,569,1026208,15,1026193
60914,15,-13,918,247943,15,247928
60915,14,-3,22,553973,14,553959
60916,8,0,546,637141,8,637133
60917,19,-12,446,275741,19,275722
60918,15,-1,693,621903,15,621888
60919,6,7,105,847085,6,847079
60920,14,15,968,1123908,14,1123894
60921,5,-7,226,410650,5,410645
60922,20,19,926,1248227,20,1248207
60923,13,15,149,1117930,13,1117917
60924,17,-7,991,435651,17,435634
60925,6,-13,761,234750,6,234744
60926,8,13,106,1033011,8,1033003
60927,12,-9,215,368085,12,368073
60928,7,-16,122,126729,7,126722
60929,7,-17,399,101924,7,101917
60930,7,12,623,1012596,7,1012589
60931,8,-4,736,515208,8,515200
60932,5,11,874,987302,5,987297
60933,20,8,12,898008,20,897988
60934,14,-16,928,153773,14,153759
60935,14,9,872,935512,14,935498
60936,14,10,398,962816,14,962802
60937,6,16,628,1138360,6,1138354
60938,9,9,399,915066,9,915057
60939,8,-12,684,264323,8,264315
60940,9,16,794,1141611,9,1141602
60941,10,5,743,797152,10,797142
60942,13,-17,190,116854,13,116841
60943,17,-14,839,216033,17,216016
60944,17,10,857,966411,17,966394
60945,13,14,243,1087312,13,1087299
60946,5,-11,812,298510,5,298505
60947,15,1,405,683069,15,683054
60948,18,2,37,710788,18,710770
60949,18,13,967,1060407,18,1060389
60950,11,-14,485,213241,11,213230
60951,9,-12,123,252244,9,252235
60952,10,17,990,1176649,10,1176639
60953,6,-15,361,163217,6,163211
60954,10,16,121,1127560,10,1127550
60955,9,9,241,911796,9,911787
60956,7,-10,526,323947,7,323940
60957,8,3,917,738717,8,738709
60958,14,4,299,775349,14,775335
60959,8,-8,137,378356,8,378348
60960,13,9,562,933211,13,933198
60961,10,-11,740,297123,10,297113
60962,7,-12,624,262973,7,262966
60963,7,17,793,1172298,7,1172291
60964,14,-9,801,372904,14,372890
60965,6,0,257,630965,6,630959
60966,5,-11,224,285895,5,285890
60967,5,-12,937,269943,5,269938
60968,12,10,601,964560,12,964548
60969,10,14,31,1062496,10,1062486
60970,19,13,108,1054033,19,1054014
60971,18,19,969,1248545,18,1248527
60972,15,1,634,684862,15,684847
60973,6,-16,723,139563,6,139557
60974,17,-16,261,148870,17,148853
60975,20,-14,766,215513,20,215493
60976,19,10,632,964790,19,964771
60977,5,-1,668,608236,5,608231
60978,16,-20,668,27936,16,27920
60979,19,-5,250,492860,19,492841
60980,8,10,337,944662,8,944654
60981,5,-16,817,141559,5,141554
60982,10,12,533,1010528,10,1010518
60983,16,-8,170,399121,16,399105
60984,16,3,555,745926,16,745910
60985,17,-5,118,491842,17,491825
60986,16,-6,787,465171,16,465155
60987,20,-16,345,149435,20,149415
60988,9,7,817,862107,9,862098
60989,9,15,847,1112478,9,1112469
60990,14,10,378,962640,14,962626
60991,12,6,530,840090,12,840078
60992,14,16,255,1148948,14,1148934
60993,17,-2,686,590323,17,590306
60994,20,-15,881,184453,20,184433
60995,8,7,891,863695,8,863687
60996,10,17,436,1164556,10,1164546
60997,13,-2,903,592022,13,592009
60998,16,-7,319,430776,16,430760
60999,19,-8,638,402360,19,402341
61000,12,9,784,934838,12,934826
61001,14,-19,675,59244,14,59230
61002,17,-9,73,367187,17,367170
61003,14,-16,655,151786,14,151772
61004,7,-12,531,261131,7,261124
61005,16,-8,962,404729,16,404713
61006,10,9,508,917525,10,917515
61007,16,9,607,933567,16,933551
61008,5,-5,387,476488,5,476483
61009,18,-20,328,25419,18,25401
61010,14,-1,811,622816,14,622802
61011,18,-5,79,491476,18,491458
61012,18,9,660,933930,18,933912
61013,6,9,893,925641,6,925635
61014,18,10,403,962900,18,962882
61015,19,4,154,774375,19,774356
61016,20,11,95,991554,20,991534
61017,8,-5,538,479703,8,479695
61018,19,-4,596,526567,19,526548
61019,12,-1,301,618971,12,618959
61020,13,11,114,991654,13,991641
61021,9,-10,805,329882,9,329873
61022,19,-18,989,92415,19,92396
61023,7,12,464,1009084,7,1009077
61024,17,-8,791,403545,17,403528
61025,16,12,980,1029686,16,1029670
61026,11,12,76,1022585,11,1022574
61027,19,-14,44,209678,19,209659
61028,8,8,460,885265,8,885257
61029,7,-7,163,409241,7,409234
61030,19,-18,136,86252,19,86233
61031,8,-9,706,359133,8,359125
61032,7,0,588,638128,7,638121
61033,12,-11,128,304699,12,304687
61034,5,-3,252,535939,5,535934
61035,11,-3,567,558279,11,558268
61036,5,5,720,796637,5,796632
61037,11,0,609,652849,11,652838
61038,5,-10,152,315984,5,315979
61039,13,-8,212,399407,13,399394
61040,16,3,665,746864,16,746848
61041,12,4,841,779527,12,779515
61042,18,15,513,1120515,18,1120497
61043,11,-3,164,554927,11,554916
61044,17,-11,186,305225,17,305208
61045,12,9,797,934964,12,934952
61046,6,-6,600,449767,6,449761
61047,17,-14,113,210195,17,210178
61048,19,-9,499,370617,19,370598
61049,15,14,856,1092094,15,1092079
61050,11,19,56,1241184,11,1241173
61051,14,13,841,1059542,14,1059528
61052,15,-10,270,337035,15,337020
61053,10,17,31,1155958,10,1155948
61054,12,2,239,712356,12,712344
61055,18,5,414,806770,18,806752
61056,15,-14,951,216876,15,216861
61057,12,-6,162,460376,12,460364
61058,5,7,462,854701,5,854696
61059,9,2,379,696859,9,696850
61060,13,-3,957,561453,13,561440
61061,16,3,135,742867,16,742851
61062,15,11,701,995816,15,995801
61063,17,2,784,716357,17,716340
61064,12,-19,187,55549,12,55537
61065,10,0,473,635688,10,635678
61066,13,4,85,773866,13,773853
61067,18,-3,448,557230,18,557212
61068,9,15,421,1103251,9,1103242
61069,8,3,642,732608,8,732600
61070,12,17,493,1181584,12,1181572
61071,18,-19,29,54102,18,54084
61072,10,15,81,1096167,10,1096157
61073,9,-16,125,126818,9,126809
61074,8,18,510,1197704,8,1197696
61075,9,19,850,1236389,9,1236380
61076,15,-14,193,210804,15,210789
61077,18,0,367,650816,18,650798
61078,15,10,956,967191,15,967176
61079,16,17,778,1183651,16,1183635
61080,12,-20,990,30365,12,30353
61081,10,-4,710,514685,10,514675
61082,10,-6,549,448701,10,448691
61083,15,5,385,806626,15,806611
61084,20,-6,579,463587,20,463567
61085,8,12,724,1014972,8,1014964
61086,18,15,883,1123218,18,1123200
61087,19,-14,190,210768,19,210749
61088,7,3,409,727575,7,727568
61089,11,-3,352,556363,11,556352
61090,11,2,97,711324,11,711313
61091,15,-13,403,243966,15,243951
61092,18,-11,845,310310,18,310292
61093,10,-2,518,573768,10,573758
61094,19,-15,346,180315,19,180296
61095,5,8,556,887404,5,887399
61096,17,-5,769,496619,17,496602
61097,9,-5,345,475705,9,475696
61098,5,6,618,826274,5,826269
61099,15,6,163,836970,15,836955
61100,7,-14,119,189078,7,189071
61101,19,17,237,1179661,19,1179642
61102,8,12,527,1010367,8,1010359
61103,17,5,496,807416,17,807399
61104,16,-14,602,214267,16,214251
61105,15,6,63,836226,15,836211
61106,14,19,378,1243822,14,1243808
61107,7,-16,706,139173,7,139166
61108,16,-8,631,402300,16,402284
61109,5,-18,875,81335,5,81330
61110,18,5,700,808907,18,808889
61111,5,19,179,1221479,5,1221474
61112,8,-9,55,344838,8,344830
61113,9,-14,569,198988,9,198979
61114,5,-2,344,570067,5,570062
61115,19,-17,628,120201,19,120182
61116,10,5,610,794313,10,794303
61117,11,5,533,807696,11,807685
61118,11,6,205,837255,11,837244
61119,20,-9,155,367705,20,367685
61120,8,-8,664,389650,8,389642
61121,6,10,839,955579,6,955573
61122,14,-4,545,526242,14,526228
61123,19,2,150,711737,19,711718
61124,5,-2,422,571739,5,571734
61125,6,-9,182,347443,6,347437
61126,5,-12,587,262215,5,262210
61127,5,11,26,969028,5,969023
61128,14,-3,269,555682,14,555668
61129,13,4,88,773909,13,773896
61130,17,13,340,1055726,17,1055709
61131,19,-6,797,465248,19,465229
61132,11,-10,862,341568,11,341557
61133,6,-13,78,220054,6,220048
61134,14,-16,536,150942,14,150928
61135,18,-18,17,85336,18,85318
61136,11,-17,115,116422,11,116411
61137,5,-16,105,126310,5,126305
61138,5,-20,177,4064,5,4059
61139,9,-17,865,111745,9,111736
61140,19,-11,365,306681,19,306662
61141,9,17,968,1176150,9,1176141
61142,10,1,988,678461,10,678451
61143,10,13,987,1051791,10,1051781
61144,20,-19,956,61200,20,61180
61145,17,5,427,806868,17,806851
61146,12,18,434,1212249,12,1212237
61147,7,-18,292,68874,7,68867
61148,20,19,501,1244892,20,1244872
61149,19,-16,565,151157,19,151138
61150,16,-16,762,152517,16,152501
61151,17,-20,498,26558,17,26541
61152,10,13,862,1049304,10,1049294
61153,5,-16,80,125611,5,125606
61154,18,1,432,683233,18,683215
61155,6,13,128,1033452,6,1033446
61156,6,14,879,1081516,6,1081510
61157,6,3,809,736255,6,736249
61158,9,4,317,757351,9,757342
61159,6,-10,469,322931,6,322925
61160,11,-15,361,180402,11,180391
61161,12,9,595,933501,12,933489
61162,12,-5,82,491510,12,491498
61163,10,-2,701,577820,10,577810
61164,17,6,825,842396,17,842379
61165,8,-6,356,444397,8,444389
61166,9,-19,494,42130,9,42121
61167,11,1,476,683594,11,683583
61168,12,10,235,961589,12,961577
61169,6,6,301,819051,6,819045
61170,11,-10,129,336082,11,336071
61171,6,2,130,691422,6,691416
61172,7,11,353,975968,7,975961
61173,19,-10,529,338971,19,338952
61174,11,-7,707,433455,11,433444
61175,17,-18,347,87948,17,87931
61176,8,-9,250,349072,8,349064
61177,8,11,168,971917,8,971909
61178,13,-6,481,462855,13,462842
61179,7,18,234,1191904,7,1191897
61180,6,0,170,629181,6,629175
61181,17,-11,880,310639,17,310622
61182,11,11,541,994755,11,994744
61183,9,-16,578,136546,9,136537
61184,12,11,538,994739,12,994727
61185,16,2,200,712129,16,712113
61186,16,0,338,650592,16,650576
61187,5,-15,985,176453,5,176448
61188,14,-20,990,30369,14,30355
61189,19,-6,89,459741,19,459722
61190,6,-17,253,98834,6,98828
61191,15,1,101,680628,15,680613
61192,19,-14,562,213884,19,213865
61193,20,-9,850,373290,20,373270
61194,14,-10,653,339973,14,339959
61195,14,3,596,746281,14,746267
61196,18,6,187,837164,18,837146
61197,5,-15,559,167433,5,167428
61198,19,12,726,1027513,19,1027494
61199,17,-12,883,279116,17,279099
61200,16,5,682,808785,16,808769
61201,10,-10,327,319614,10,319604
61202,10,-5,257,473716,10,473706
61203,10,-5,457,477855,10,477845
61204,10,-17,459,103261,10,103251
61205,19,19,866,1247801,19,1247782
61206,13,-7,271,430326,13,430313
61207,10,-14,504,197537,10,197527
61208,20,8,419,901319,20,901299
61209,14,10,306,962095,14,962081
61210,11,-12,345,275099,11,275088
61211,11,-1,462,620251,11,620240
61212,14,3,442,745166,14,745152
61213,11,-20,395,25817,11,25806
61214,5,0,282,631367,5,631362
61215,5,19,51,1218514,5,1218509
61216,9,-6,541,448477,9,448468
61217,14,-11,903,310802,14,310788
61218,5,-15,904,174651,5,174646
61219,10,-13,248,223644,10,223634
61220,17,-9,235,368284,17,368267
61221,15,18,333,1211552,15,1211537
61222,11,-7,688,433287,11,433276
61223,17,-7,694,433376,17,433359
61224,17,14,570,1089866,17,1089849
61225,14,12,246,1023857,14,1023843
61226,10,-8,818,392902,10,392892
61227,13,-2,259,587074,13,587061
61228,18,-8,107,398654,18,398636
61229,6,-8,897,394569,6,394563
61230,7,-4,626,512938,7,512931
61231,14,-20,238,24600,14,24586
61232,18,-12,291,274663,18,274645
61233,9,-9,746,360128,9,360119
61234,16,-6,631,463983,16,463967
61235,9,-19,476,41770,9,41761
61236,19,-13,999,248598,19,248579
61237,9,3,994,740637,9,740628
61238,18,6,663,841103,18,841085
61239,19,13,424,1056398,19,1056379
61240,13,-17,623,120165,13,120152
61241,19,-7,52,428673,19,428654
61242,19,-5,47,491202,19,491183
61243,8,9,960,927183,8,927175
61244,11,18,908,1215584,11,1215573
61245,6,13,782,1047537,6,1047531
61246,19,-6,741,464839,19,464820
61247,5,2,956,708635,5,708630
61248,18,12,249,1023902,18,1023884
61249,8,-4,773,515943,8,515935
61250,5,15,636,1107957,5,1107952
61251,5,-19,160,35259,5,35254
61252,9,-7,971,426597,9,426588
61253,5,-4,793,516339,5,516334
61254,18,2,698,715881,18,715863
61255,16,14,11,1085461,16,1085445
61256,16,0,594,652752,16,652736
61257,14,2,659,715540,14,715526
61258,18,13,577,1057636,18,1057618
61259,6,-6,516,447986,6,447980
61260,11,-4,203,523674,11,523663
61261,16,-4,414,525330,16,525314
61262,9,-6,888,455784,9,455775
61263,7,-2,803,579904,7,579897
61264,8,-7,63,407300,8,407292
61265,19,12,386,1024879,19,1024860
61266,11,0,169,649523,11,649512
61267,15,-1,514,620657,15,620642
61268,16,3,614,746415,16,746399
61269,18,15,736,1122251,18,1122233
61270,18,19,902,1248095,18,1248077
61271,15,18,654,1213692,15,1213677
61272,9,-2,815,580214,9,580205
61273,6,-13,416,226993,6,226987
61274,19,-16,208,148466,19,148447
61275,8,16,599,1137770,8,1137762
61276,11,8,563,902367,11,902356
61277,17,-14,731,215208,17,215191
61278,8,1,181,661128,8,661120
61279,6,11,480,978695,6,978689
61280,20,-20,810,29127,20,29107
61281,17,-9,687,371861,17,371844
61282,8,7,963,865117,8,865109
61283,17,-12,229,274201,17,274184
61284,14,-8,391,400659,14,400645
61285,11,-12,891,279180,11,279169
61286,20,13,601,1057810,20,1057790
61287,10,5,830,798958,10,798948
61288,17,13,602,1057829,17,1057812
61289,14,11,723,996040,14,996026
61290,13,-16,374,149645,13,149632
61291,14,2,369,713383,14,713369
61292,15,8,310,900401,15,900386
61293,10,-10,720,328093,10,328083
61294,10,7,25,845274,10,845264
61295,20,14,491,1089291,20,1089271
61296,5,6,398,821365,5,821360
61297,11,-16,190,148322,11,148311
61298,13,-9,552,371110,13,371097
61299,6,1,934,677346,6,677340
61300,19,-12,980,279955,19,279936
61301,13,9,982,936412,13,936399
61302,5,11,782,985199,5,985194
61303,20,-18,225,87039,20,87019
61304,17,10,724,965437,17,965420
61305,5,14,614,1075544,5,1075539
61306,9,7,716,859894,9,859885
61307,19,-1,383,619635,19,619616
61308,17,-13,995,248541,17,248524
61309,11,7,266,868920,11,868909
61310,10,9,131,909560,10,909550
61311,8,-6,460,446617,8,446609
61312,19,1,520,683961,19,683942
61313,8,-12,829,267529,8,267521
61314,18,-4,901,528847,18,528829
61315,12,-16,220,148610,12,148598
61316,7,13,720,1046161,7,1046154
61317,5,0,882,644501,5,644496
61318,8,13,132,1033543,8,1033535
61319,9,-8,470,385006,9,384997
61320,13,-20,734,28428,13,28415
61321,8,11,974,989356,8,989348
61322,6,-9,233,348635,6,348629
61323,15,-9,372,369444,15,369429
61324,15,-14,138,210404,15,210389
61325,16,-6,899,465952,16,465936
61326,10,2,425,697791,10,697781
61327,9,10,705,952744,9,952735
61328,8,16,339,1132347,8,1132339
61329,11,-13,748,246562,11,246551
61330,12,4,56,773651,12,773639
61331,10,17,573,1167465,10,1167455
61332,12,-12,621,277039,12,277027
61333,19,3,880,748447,19,748428
61334,16,16,854,1153196,16,1153180
61335,16,-3,454,557286,16,557270
61336,15,2,602,715088,15,715073
61337,6,-10,168,316323,6,316317
61338,9,-10,810,330006,9,329997
61339,9,19,561,1230185,9,1230176
61340,10,14,665,1076890,10,1076880
61341,19,8,547,902266,19,902247
61342,6,-15,583,167998,6,167992
61343,18,-18,881,91598,18,91580
61344,20,7,392,869919,20,869899
61345,11,19,156,1242019,11,1242008
61346,8,17,275,1161213,8,1161205
61347,20,7,687,872046,20,872026
61348,19,-17,409,118469,19,118450
61349,14,4,402,776107,14,776093
61350,20,10,306,962105,20,962085
61351,17,-19,116,54930,17,54913
61352,14,16,58,1147517,14,1147503
61353,14,19,70,1241322,14,1241308
61354,7,1,259,662875,7,662868
61355,6,-13,832,236379,6,236373
61356,20,4,874,779783,20,779763
61357,8,19,212,1222192,8,1222184
61358,11,-15,70,178275,11,178264
61359,7,17,157,1158490,7,1158483
61360,20,-17,915,122289,20,122269
61361,16,2,592,715026,16,715010
61362,19,10,487,963543,19,963524
61363,7,-15,431,164795,7,164788
61364,12,17,372,1180727,12,1180715
61365,6,9,651,920490,6,920484
61366,18,14,923,1092645,18,1092627
61367,7,-14,899,206018,7,206011
61368,12,12,167,1023282,12,1023270
61369,17,-11,528,307967,17,307950
61370,8,14,397,1070608,8,1070600
61371,5,-17,494,104142,5,104137
61372,17,-5,902,497639,17,497622
61373,5,3,827,736630,5,736625
61374,12,-15,725,183190,12,183178
61375,9,4,892,770238,9,770229
61376,7,-7,245,411011,7,411004
61377,16,7,447,870382,16,870366
61378,17,18,332,1211543,17,1211526
61379,7,-4,445,509149,7,509142
61380,6,11,685,983028,6,983022
61381,12,18,568,1213076,12,1213064
61382,11,12,83,1022680,11,1022669
61383,15,-5,502,494741,15,494726
61384,14,8,36,898139,14,898125
61385,16,10,540,963980,16,963964
61386,6,-18,575,74813,6,74807
61387,18,19,429,1244406,18,1244388
61388,20,6,42,836148,20,836128
61389,16,-7,264,430274,16,430258
61390,12,-20,908,29772,12,29760
61391,20,-15,703,182996,20,182976
61392,12,14,740,1091249,12,1091237
61393,7,-1,341,601606,7,601599
61394,20,-6,910,466043,20,466023
61395,5,-10,790,329430,5,329425
61396,6,-9,477,354331,6,354325
61397,9,4,707,765858,9,765849
61398,19,10,259,961764,19,961745
61399,8,0,539,636989,8,636981
61400,18,0,665,653331,18,653313
61401,6,11,795,985494,6,985488
61402,19,-3,215,555292,19,555273
61403,12,18,679,1213857,12,1213845
61404,20,10,189,961288,20,961268
61405,14,-4,88,522721,14,522707
61406,17,-5,394,493932,17,493915
61407,12,-3,133,554726,12,554714
61408,11,5,281,805912,11,805901
61409,8,-15,786,172152,8,172144
61410,10,9,890,925565,10,925555
61411,9,11,281,974301,9,974292
61412,16,7,599,871449,16,871433
61413,16,15,130,1117781,16,1117765
61414,6,-6,253,442370,6,442364
61415,19,-15,229,179424,19,179405
61416,7,-12,447,259233,7,259226
61417,5,-12,569,261851,5,261846
61418,5,12,36,999863,5,999858
61419,10,0,5,625296,10,625286
61420,19,-18,276,87390,19,87371
61421,11,18,687,1213920,11,1213909
61422,10,14,356,1069647,10,1069637
61423,15,-10,236,336799,15,336784
61424,18,-13,603,245495,18,245477
61425,18,2,728,716084,18,716066
61426,6,-20,74,1663,6,1657
61427,19,-5,976,498207,19,498188
61428,8,10,27,938117,8,938109
61429,13,-6,334,461752,13,461739
61430,12,3,58,742280,12,742268
61431,20,15,913,1123473,20,1123453
61432,20,-17,492,119158,20,119138
61433,13,16,586,1151243,13,1151230
61434,12,19,366,1243758,12,1243746
61435,19,-5,333,493612,19,493593
61436,14,-20,552,27018,14,27004
61437,19,-20,653,27782,19,27763
61438,15,-4,866,528478,15,528463
61439,8,10,725,953109,8,953101
61440,12,-6,733,464759,12,464747
61441,13,-3,713,559452,13,559439
61442,16,10,544,964015,16,963999
61443,19,-3,160,554909,19,554890
61444,13,1,232,681725,13,681712
61445,19,6,716,841593,19,841574
61446,14,17,528,1181803,14,1181789
61447,10,2,877,706861,10,706851
61448,6,-7,344,413351,6,413345
61449,16,4,725,778596,16,778580
61450,10,7,754,860712,10,860702
61451,9,-4,221,504405,9,504396
61452,17,-7,130,429232,17,429215
61453,6,12,987,1020868,6,1020862
61454,8,-17,651,107531,8,107523
61455,16,18,175,1210360,16,1210344
61456,12,-16,549,151037,12,151025
61457,15,-4,666,527137,15,527122
61458,6,-3,121,533043,6,533037
61459,7,-19,623,45184,7,45177
61460,5,6,808,830557,5,830552
61461,19,10,596,964500,19,964481
61462,13,-17,563,119759,13,119746
61463,16,9,773,934735,16,934719
61464,6,14,409,1070921,6,1070915
61465,7,1,602,670350,7,670343
61466,18,6,279,837930,18,837912
61467,8,16,340,1132394,8,1132386
61468,6,11,929,988579,6,988573
61469,7,-20,429,9151,7,9144
61470,5,-1,258,599472,5,599467
61471,17,4,824,779348,17,779331
61472,18,11,831,996846,18,996828
61473,10,17,891,1174505,10,1174495
61474,8,-1,489,604735,8,604727
61475,7,1,312,663962,7,663955
61476,7,18,864,1204975,7,1204968
61477,16,13,461,1056655,16,1056639
61478,13,14,50,1085811,13,1085798
61479,12,17,276,1179980,12,1179968
61480,9,10,524,948722,9,948713
61481,14,4,772,778932,14,778918
61482,5,7,89,846768,5,846763
61483,8,-19,374,39553,8,39545
61484,19,-5,507,494768,19,494749
61485,17,-2,260,587096,17,587079
61486,20,-11,52,304069,20,304049
61487,5,-5,168,471772,5,471767
61488,10,-8,359,382899,10,382889
61489,8,-3,730,546821,8,546813
61490,9,0,846,643713,9,643704
61491,18,6,830,842444,18,842426
61492,16,13,360,1055885,16,1055869
61493,13,-13,687,246011,13,245998
61494,20,0,603,652823,20,652803
61495,12,-16,360,149533,12,149521
61496,7,7,415,853726,7,853719
61497,14,-18,29,85423,14,85409
61498,6,19,199,1221894,6,1221888
61499,18,-16,189,148307,18,148289
61500,9,12,10,999233,9,999224
61501,15,-5,552,495107,15,495092
61502,17,2,535,714649,17,714632
61503,17,8,765,904010,17,903993
61504,15,-3,522,557867,15,557852
61505,19,-1,605,621269,19,621250
61506,7,-7,657,419684,7,419677
61507,13,-12,60,272953,13,272940
61508,15,-17,777,121401,15,121386
61509,5,-2,22,563262,5,563257
61510,11,9,393,931876,11,931865
61511,19,-7,970,435495,19,435476
61512,5,-13,489,228670,5,228665
61513,8,1,235,662349,8,662341
61514,17,-20,530,26805,17,26788
61515,16,-20,184,24246,16,24230
61516,14,-15,468,181242,14,181228
61517,6,-9,506,355072,6,355066
61518,6,2,110,690969,6,690963
61519,18,8,563,902375,18,902357
61520,19,5,78,804378,19,804359
61521,14,-2,956,592427,14,592413
61522,19,19,987,1248712,19,1248693
61523,17,15,738,1122259,17,1122242
61524,8,14,696,1077710,8,1077702
61525,7,-16,357,131588,7,131581
61526,10,-17,824,110953,10,110943
61527,13,-12,361,275238,13,275225
61528,17,-5,333,493619,17,493602
61529,5,-19,475,41762,5,41757
61530,7,8,700,890639,7,890632
61531,17,16,181,1148417,17,1148400
61532,18,13,655,1058188,18,1058170
61533,14,15,87,1117446,14,1117432
61534,15,-15,454,181120,15,181105
61535,13,-2,649,589996,13,589983
61536,10,-16,433,133460,10,133450
61537,15,-16,393,149759,15,149744
61538,18,7,867,873288,18,873270
61539,5,-1,546,605861,5,605856
61540,16,-3,939,561318,16,561302
61541,13,-18,144,86326,13,86313
61542,7,-17,445,102910,7,102903
61543,14,19,491,1244804,14,1244790
61544,12,-16,903,153573,12,153561
61545,13,8,124,898917,13,898904
61546,13,13,262,1055123,13,1055110
61547,10,-4,208,504087,10,504077
61548,16,18,253,1211038,16,1211022
61549,16,-15,648,182619,16,182603
61550,7,-3,718,546579,7,546572
61551,17,-4,868,528520,17,528503
61552,12,-18,195,86801,12,86789
61553,9,2,127,691348,9,691339
61554,13,-18,289,87469,13,87456
61555,8,-4,135,502380,8,502372
61556,12,-19,267,56110,12,56098
61557,11,13,505,1056988,11,1056977
61558,12,2,29,710684,12,710672
61559,16,-14,933,216741,16,216725
61560,5,17,733,1170939,5,1170934
61561,13,-5,12,490835,13,490822
61562,11,-20,826,29212,11,29201
61563,19,10,91,960552,19,960533
61564,5,10,945,957857,5,957852
61565,9,6,603,825914,9,825905
61566,19,-9,260,368508,19,368489
61567,15,-14,586,214136,15,214121
61568,19,7,83,867644,19,867625
61569,11,5,679,808735,11,808724
61570,13,-11,289,305995,13,305982
61571,9,-18,339,69791,9,69782
61572,12,16,42,1147362,12,1147350
61573,18,12,747,1027638,18,1027620
61574,15,-7,574,432626,15,432611
61575,9,11,424,977550,9,977541
61576,10,-18,664,76677,10,76667
61577,20,-18,932,92003,20,91983
61578,7,-3,913,550917,7,550910
61579,6,-19,697,46869,6,46863
61580,17,-4,834,528172,17,528155
61581,7,-9,568,356436,7,356429
61582,10,-16,178,127827,10,127817
61583,6,4,250,756095,6,756089
61584,11,-11,137,304814,11,304803
61585,13,-20,980,30257,13,30244
61586,18,-16,74,147385,18,147367
61587,5,0,510,636388,5,636383
61588,17,-19,74,54467,17,54450
61589,10,14,602,1075235,10,1075225
61590,6,-11,18,281458,6,281452
61591,11,2,995,717825,11,717814
61592,8,14,804,1079970,8,1079962
61593,7,15,628,1107809,7,1107802
61594,18,-12,122,273471,18,273453
61595,17,14,33,1085663,17,1085646
61596,16,4,839,779505,16,779489
61597,7,8,169,878801,7,878794
61598,15,5,645,808492,15,808477
61599,5,2,882,706958,5,706953
61600,7,15,1000,1115723,7,1115716
61601,7,-14,974,207763,7,207756
61602,12,-3,58,554179,12,554167
61603,6,4,354,758193,6,758187
61604,20,-13,219,242638,20,242618
61605,11,2,588,714989,11,714978
61606,12,-16,905,153588,12,153576
61607,19,-1,460,620227,19,620208
61608,16,-11,296,306050,16,306034
61609,19,-16,858,153227,19,153208
61610,11,18,266,1211116,11,1211105
61611,6,14,63,1063273,6,1063267
61612,14,-10,417,338120,14,338106
61613,18,-19,471,57610,18,57592
61614,20,6,316,838191,20,838171
61615,19,1,968,687404,19,687385
61616,14,10,636,964836,14,964822
61617,11,-13,77,241607,11,241596
61618,19,14,476,1089138,19,1089119
61619,18,-4,337,524700,18,524682
61620,12,8,657,903140,12,903128
61621,9,18,296,1193242,9,1193233
61622,6,-7,781,422390,6,422384
61623,16,4,420,776271,16,776255
61624,10,2,94,690666,10,690656
61625,19,-10,331,337429,19,337410
61626,13,14,594,1090019,13,1090006
61627,5,-4,895,518592,5,518587
61628,5,11,83,970234,5,970229
61629,10,-19,518,42732,10,42722
61630,20,10,304,962089,20,962069
61631,15,-11,56,304110,15,304095
61632,12,8,149,899113,12,899101
61633,10,-7,658,419724,10,419714
61634,16,-18,542,89228,16,89212
61635,8,1,737,673049,8,673041
61636,14,11,660,995549,14,995535
61637,9,19,837,1236110,9,1236101
61638,5,-4,945,519709,5,519704
61639,6,4,120,753164,6,753158
61640,19,-2,521,589079,19,589060
61641,16,0,292,650267,16,650251
61642,8,1,861,675745,8,675737
61643,19,10,130,960897,19,960878
61644,19,-4,709,527423,19,527404
61645,18,7,108,867815,18,867797
61646,18,-18,146,86353,18,86335
61647,11,-4,626,526822,11,526811
61648,8,-9,800,361490,8,361482
61649,18,16,979,1154132,18,1154114
61650,9,8,251,880705,9,880696
61651,17,16,190,1148486,17,1148469
61652,16,10,480,963485,16,963469
61653,9,-7,720,421106,9,421097
61654,18,5,277,805859,18,805841
61655,15,-1,521,620736,15,620721
61656,20,-8,450,401003,20,400983
61657,6,-11,21,281518,6,281512
61658,10,-3,816,548673,10,548663
61659,14,13,544,1057332,14,1057318
61660,8,7,913,864155,8,864147
61661,17,7,740,872406,17,872389
61662,12,-18,893,91701,12,91689
61663,6,7,151,848016,6,848010
61664,5,13,454,1040527,5,1040522
61665,18,-16,903,153581,18,153563
61666,10,4,991,772142,10,772132
61667,20,18,787,1214718,20,1214698
61668,11,8,193,899449,11,899438
61669,6,16,382,1133305,6,1133299
61670,7,-12,96,251606,7,251599
61671,12,-9,853,373329,12,373317
61672,17,-8,828,403799,17,403782
61673,10,8,781,892436,10,892426
61674,16,-5,636,495688,16,495672
61675,8,-3,398,539193,8,539185
61676,15,-14,955,216907,15,216892
61677,19,9,46,929428,19,929409
61678,10,2,911,707564,10,707554
61679,6,-5,438,477451,6,477445
61680,17,12,958,1029479,17,1029462
61681,13,-10,457,338438,13,338425
61682,6,-20,218,4961,6,4955
61683,12,-11,608,308601,12,308589
61684,16,6,333,838348,16,838332
61685,8,-4,402,508368,8,508360
61686,18,3,939,748992,18,748974
61687,13,-2,364,587804,13,587791
61688,20,-4,324,524635,20,524615
61689,5,-19,697,46874,5,46869
61690,11,-7,955,435407,11,435396
61691,17,-19,643,59074,17,59057
61692,13,4,690,778306,13,778293
61693,15,-14,475,213174,15,213159
61694,14,15,797,1122615,14,1122601
61695,18,-8,367,400452,18,400434
61696,8,-17,870,111851,8,111843
61697,19,11,145,991883,19,991864
61698,8,0,292,631593,8,631585
61699,12,12,905,1028981,12,1028969
61700,6,13,110,1033083,6,1033077
61701,15,-5,276,493066,15,493051
61702,11,-3,275,555719,11,555708
61703,5,-1,228,598861,5,598856
61704,15,6,594,840588,15,840573
61705,8,15,838,1112266,8,1112258
61706,18,19,559,1245353,18,1245335
61707,20,-7,641,433004,20,432984
61708,19,15,862,1123086,19,1123067
61709,7,15,607,1107363,7,1107356
61710,20,14,640,1090422,20,1090402
61711,6,5,7,781753,6,781747
61712,10,-5,487,478539,10,478529
61713,6,0,627,638972,6,638966
61714,13,4,446,776442,13,776429
61715,7,14,156,1065377,7,1065370
61716,7,-5,693,483020,7,483013
61717,7,0,416,634417,7,634410
61718,18,-18,279,87422,18,87404
61719,14,-19,976,61317,14,61303
61720,19,-15,363,180434,19,180415
61721,15,1,493,683764,15,683749
61722,6,-14,88,188507,6,188501
61723,16,-18,353,87991,16,87975
61724,17,-17,503,119252,17,119235
61725,10,-3,641,544888,10,544878
61726,5,11,736,984156,5,984151
61727,10,4,796,767963,10,767953
61728,20,-13,659,245821,20,245801
61729,18,13,736,1058719,18,1058701
61730,6,-4,936,519480,6,519474
61731,13,14,412,1088680,13,1088667
61732,11,-10,128,336057,11,336046
61733,5,11,950,988828,5,988823
61734,17,4,218,774856,17,774839
61735,17,-15,428,180975,17,180958
61736,17,15,473,1120119,17,1120102
61737,7,-16,293,130379,7,130372
61738,10,7,426,853952,10,853942
61739,13,-4,132,523072,13,523059
61740,11,-14,950,216851,11,216840
61741,12,-6,861,465639,12,465627
61742,14,-18,195,86805,14,86791
61743,6,-7,816,423059,6,423053
61744,6,7,950,864841,6,864835
61745,9,14,360,1069757,9,1069748
61746,10,-5,959,488852,10,488842
61747,15,-1,397,619729,15,619714
61748,15,8,313,900425,15,900410
61749,17,17,966,1185181,17,1185164
61750,11,-11,303,306158,11,306147
61751,17,-14,216,211024,17,211007
61752,19,5,706,808952,19,808933
61753,5,-4,566,511619,5,511614
61754,17,-9,201,367980,17,367963
61755,8,-3,549,542841,8,542833
61756,19,2,869,716992,19,716973
61757,20,17,698,1183105,20,1183085
61758,7,-7,780,422375,7,422368
61759,9,7,485,855262,9,855253
61760,13,16,254,1148937,13,1148924
61761,6,18,603,1199410,6,1199404
61762,20,-20,26,15323,20,15303
61763,15,-9,170,367773,15,367758
61764,17,6,870,842711,17,842694
61765,16,11,312,993149,16,993133
61766,6,7,946,864774,6,864768
61767,15,-16,663,151806,15,151791
61768,11,5,740,809196,11,809185
61769,7,16,768,1141004,7,1140997
61770,13,-1,671,621710,13,621697
61771,11,-18,817,91218,11,91207
61772,17,-5,19,490925,17,490908
61773,11,-17,983,122703,11,122692
61774,13,9,783,934831,13,934818
61775,11,-8,922,404400,11,404389
61776,17,17,980,1185303,17,1185286
61777,18,3,826,748035,18,748017
61778,13,-15,744,183325,13,183312
61779,16,4,632,777879,16,777863
61780,14,8,40,898167,14,898153
61781,12,-1,948,623800,12,623788
61782,15,-12,817,278503,15,278488
61783,18,-9,599,371342,18,371324
61784,5,-12,212,254066,5,254061
61785,20,-19,935,61036,20,61016
61786,19,-11,754,309573,19,309554
61787,11,16,716,1152223,11,1152212
61788,16,-13,410,243992,16,243976
61789,20,11,344,993376,20,993356
61790,17,-19,118,54947,17,54930
61791,14,10,610,964623,14,964609
61792,8,-10,287,318723,8,318715
61793,10,2,985,709254,10,709244
61794,12,4,244,775041,12,775029
61795,9,-13,582,230801,9,230792
61796,6,-1,485,604662,6,604656
61797,11,-16,527,150878,11,150867
61798,10,-6,794,453836,10,453826
61799,14,-3,49,554172,14,554158
61800,18,-12,273,274537,18,274519
61801,14,1,511,683899,14,683885
61802,17,-18,842,91315,17,91298
61803,16,7,644,871737,16,871721
61804,5,-12,126,252338,5,252333
61805,14,-18,558,89326,14,89312
61806,10,-11,306,287920,10,287910
61807,6,12,919,1019370,6,1019364
61808,14,-18,62,85680,14,85666
61809,7,-8,136,378333,7,378326
61810,9,-18,771,79160,9,79151
61811,10,10,89,939538,10,939528
61812,7,19,198,1221884,7,1221877
61813,12,-5,316,493428,12,493416
61814,12,-7,451,431720,12,431708
61815,17,-19,502,57853,17,57836
61816,10,-17,233,98364,10,98354
61817,11,10,118,960813,11,960802
61818,14,-9,255,368449,14,368435
61819,16,19,574,1245495,16,1245479
61820,20,-16,697,152032,20,152012
61821,16,-13,927,248027,16,248011
61822,16,16,193,1148527,16,1148511
61823,11,-16,764,152526,11,152515
61824,17,6,20,835974,17,835957
61825,17,18,240,1210905,17,1210888
61826,5,14,498,1072971,5,1072966
61827,5,-17,777,110124,5,110119
61828,10,9,218,911449,10,911439
61829,20,-10,461,338466,20,338446
61830,10,16,565,1137127,10,1137117
61831,8,-5,961,488925,8,488917
61832,6,3,826,736620,6,736614
61833,11,4,243,775031,11,775020
61834,20,9,411,932024,20,932004
61835,17,0,163,649469,17,649452
61836,10,13,316,1037485,10,1037475
61837,6,18,623,1199918,6,1199912
61838,11,-6,7,459201,11,459190
61839,18,7,704,872158,18,872140
61840,11,10,136,960944,11,960933
61841,10,-3,41,531394,10,531384
61842,9,-2,74,564436,9,564427
61843,6,-5,742,484061,6,484055
61844,14,9,415,932032,14,932018
61845,12,14,515,1089472,12,1089460
61846,6,17,22,1155735,6,1155729
61847,17,6,805,842231,17,842214
61848,17,11,91,991519,17,991502
61849,11,14,30,1085610,11,1085599
61850,16,9,234,930732,16,930716
61851,5,4,435,760002,5,759997
61852,19,1,565,684363,19,684344
61853,7,3,830,736709,7,736702
61854,10,17,5,1155396,10,1155386
61855,7,12,655,1013368,7,1013361
61856,12,18,485,1212529,12,1212517
61857,11,15,84,1117423,11,1117412
61858,15,-7,919,435112,15,435097
61859,7,-15,243,160546,7,160539
61860,18,8,174,899319,18,899301
61861,20,13,387,1056094,20,1056074
61862,7,14,465,1072178,7,1072171
61863,16,16,410,1150105,16,1150089
61864,20,15,203,1118326,20,1118306
61865,20,18,236,1210878,20,1210858
61866,18,14,781,1091615,18,1091597
61867,7,2,806,705419,7,705412
61868,7,13,685,1045504,7,1045497
61869,6,-19,64,32821,6,32815
61870,8,-5,221,472874,8,472866
61871,11,7,856,873178,11,873167
61872,9,-4,200,503818,9,503809
61873,14,4,675,778197,14,778183
61874,13,11,878,997228,13,997215
61875,14,-16,981,154145,14,154131
61876,12,-6,432,462461,12,462449
61877,16,-15,851,184213,16,184197
61878,6,-15,165,158963,6,158957
61879,19,-2,598,589610,19,589591
61880,8,-8,812,392762,8,392754
61881,17,-3,569,558311,17,558294
61882,11,-1,403,619765,11,619754
61883,16,15,798,1122631,16,1122615
61884,5,-15,787,172176,5,172171
61885,11,-3,242,555463,11,555452
61886,17,-18,13,85307,17,85290
61887,8,7,53,846019,8,846011
61888,6,-7,207,410244,6,410238
61889,13,-5,884,497521,13,497508
61890,8,5,607,794248,8,794240
61891,7,-15,10,155502,7,155495
61892,8,5,187,785536,8,785528
61893,8,-8,807,392626,8,392618
61894,17,-1,394,619709,17,619692
61895,6,-11,455,291314,6,291308
61896,13,2,352,713261,13,713248
61897,16,17,771,1183583,16,1183567
61898,20,19,10,1240742,20,1240722
61899,11,18,155,1210215,11,1210204
61900,5,-5,98,470264,5,470259
61901,12,-18,705,90375,12,90363
61902,5,-20,197,4649,5,4644
61903,6,-5,981,489403,6,489397
61904,11,12,337,1024604,11,1024593
61905,8,5,595,793941,8,793933
61906,9,3,830,736718,9,736709
61907,16,-9,305,368819,16,368803
61908,11,-1,821,622857,11,622846
61909,6,-7,549,417689,6,417683
61910,17,-6,974,466506,17,466489
61911,14,3,425,745048,14,745034
61912,20,-7,812,434224,20,434204
61913,10,-5,72,469469,10,469459
61914,19,-17,658,120467,19,120448
61915,12,-12,373,275294,12,275282
61916,13,12,821,1028174,13,1028161
61917,18,16,388,1149907,18,1149889
61918,16,-11,599,308505,16,308489
61919,15,2,771,716313,15,716298
61920,20,17,199,1179387,20,1179367
61921,13,19,290,1243060,13,1243047
61922,17,8,791,904217,17,904200
61923,10,11,280,974253,10,974243
61924,7,-3,761,547501,7,547494
61925,13,12,940,1029328,13,1029315
61926,12,9,824,935139,12,935127
61927,10,17,579,1167568,10,1167558
61928,6,13,334,1038022,6,1038016
61929,13,1,405,683072,13,683059
61930,18,2,87,711185,18,711167
61931,20,-4,25,522237,20,522217
61932,6,-6,899,456018,6,456012
61933,7,-9,659,358102,7,358095
61934,9,15,730,1110054,9,1110045
61935,20,13,35,1053487,20,1053467
61936,11,9,608,933567,11,933556
61937,15,-19,605,58770,15,58755
61938,19,14,403,1088603,19,1088584
61939,5,15,899,1113582,5,1113577
61940,7,4,989,772102,7,772095
61941,18,7,113,867848,18,867830
61942,6,14,834,1080578,6,1080572
61943,17,-14,92,210063,17,210046
61944,16,-11,878,310616,16,310600
61945,13,-4,674,527164,13,527151
61946,14,17,480,1181514,14,1181500
61947,9,-13,629,231813,9,231804
61948,10,-9,759,360506,10,360496
61949,14,18,690,1213943,14,1213929
61950,19,0,91,648916,19,648897
61951,17,-12,897,279236,17,279219
61952,8,-15,267,161107,8,161099
61953,17,-5,206,492456,17,492439
61954,6,18,918,1206130,6,1206124
61955,16,-16,590,151343,16,151327
61956,7,-9,592,356913,7,356906
61957,12,-13,225,242704,12,242692
61958,17,0,646,653146,17,653129
61959,15,4,845,779584,15,779569
61960,7,15,197,1098699,7,1098692
61961,16,19,722,1246637,16,1246621
61962,8,17,251,1160615,8,1160607
61963,15,18,846,1215136,15,1215121
61964,16,-13,93,241707,16,241691
61965,17,-10,730,340561,17,340544
61966,8,-10,6,312629,8,312621
61967,5,-20,171,3823,5,3818
61968,18,-18,541,89211,18,89193
61969,20,-10,816,341237,20,341217
61970,7,-8,887,394298,7,394291
61971,18,15,537,1120684,18,1120666
61972,17,-13,512,244821,17,244804
61973,17,6,146,836859,17,836842
61974,19,-8,425,400839,19,400820
61975,5,1,116,659647,5,659642
61976,6,-3,758,547419,6,547413
61977,5,6,523,824237,5,824232
61978,6,0,840,643602,6,643596
61979,8,4,699,765604,8,765596
61980,17,19,996,1248762,17,1248745
61981,6,-3,741,546984,6,546978
61982,7,1,145,660343,7,660336
61983,19,-6,587,463634,19,463615
61984,12,-12,751,278019,12,278007
61985,8,15,200,1098747,8,1098739
61986,19,-4,158,523265,19,523246
61987,17,11,25,991068,17,991051
61988,16,-8,450,401009,16,400993
61989,6,-7,512,416826,6,416820
61990,5,-12,468,259732,5,259727
61991,11,-8,849,403891,11,403880
61992,14,5,874,810146,14,810132
61993,13,11,607,995198,13,995185
61994,19,17,755,1183510,19,1183491
61995,20,1,154,681102,20,681082
61996,20,-14,227,211173,20,211153
61997,19,16,710,1152169,19,1152150
61998,20,4,685,778289,20,778269
61999,19,13,537,1057237,19,1057218
62000,13,-14,982,217144,13,217131
62001,12,14,866,1092202,12,1092190
62002,8,-14,243,192039,8,192031
62003,6,16,618,1138143,6,1138137
62004,19,-15,306,180005,19,179986
62005,17,5,741,809202,17,809185
62006,18,-17,476,119012,18,118994
62007,7,10,394,945912,7,945905
62008,17,-16,515,150796,17,150779
62009,12,15,715,1122093,12,1122081
62010,13,12,761,1027687,13,1027674
62011,19,17,697,1183089,19,1183070
62012,13,-3,946,561374,13,561361
62013,10,2,636,702072,10,702062
62014,20,19,216,1242469,20,1242449
62015,13,5,419,806813,13,806800
62016,11,-16,780,152635,11,152624
62017,18,-15,678,182820,18,182802
62018,14,-16,910,153647,14,153633
62019,8,-20,150,3341,8,3333
62020,10,7,333,852022,10,852012
62021,8,11,997,989761,8,989753
62022,20,-17,779,121417,20,121397
62023,12,-13,161,242201,12,242189
62024,16,-16,175,148183,16,148167
62025,7,-9,692,358813,7,358806
62026,17,16,416,1150153,17,1150136
62027,12,-3,624,558756,12,558744
62028,11,-1,672,621737,11,621726
62029,19,19,297,1243138,19,1243119
62030,15,7,941,873696,15,873681
62031,6,-15,559,167439,6,167433
62032,20,-4,754,527666,20,527646
62033,8,-2,321,569665,8,569657
62034,18,19,47,1241094,18,1241076
62035,12,-4,523,526080,12,526068
62036,9,-20,551,12068,9,12059
62037,19,-11,764,309693,19,309674
62038,9,-2,871,581400,9,581391
62039,14,15,561,1120839,14,1120825
62040,11,13,783,1059088,11,1059077
62041,9,9,366,914447,9,914438
62042,6,10,719,952999,6,952993
62043,11,6,668,841139,11,841128
62044,8,-4,433,508959,8,508951
62045,10,-12,405,258455,10,258445
62046,10,-13,340,225537,10,225527
62047,12,-18,945,92086,12,92074
62048,20,-20,794,28967,20,28947
62049,19,-2,717,590545,19,590526
62050,7,16,759,1140875,7,1140868
62051,12,-1,466,620303,12,620291
62052,6,-17,769,109944,6,109938
62053,20,17,688,1182993,20,1182973
62054,14,7,94,867691,14,867677
62055,12,2,544,714711,12,714699
62056,18,-20,370,25656,18,25638
62057,10,7,235,849786,10,849776
62058,16,-20,637,27633,16,27617
62059,14,6,213,837304,14,837290
62060,14,15,22,1116940,14,1116926
62061,12,10,607,964593,12,964581
62062,9,-10,428,321918,9,321909
62063,13,-19,545,58239,13,58226
62064,15,-19,983,61354,15,61339
62065,10,18,684,1201115,10,1201105
62066,8,3,228,723803,8,723795
62067,20,-11,619,308673,20,308653
62068,18,6,73,836300,18,836282
62069,9,-5,847,486338,9,486329
62070,9,-13,31,219091,9,219082
62071,14,16,122,1147912,14,1147898
62072,20,-10,574,339356,20,339336
62073,20,16,237,1148805,20,1148785
62074,20,3,809,747946,20,747926
62075,20,-8,964,404755,20,404735
62076,10,-15,109,157810,10,157800
62077,19,-4,387,525102,19,525083
62078,13,-8,895,404255,13,404242
62079,19,9,606,933553,19,933534
62080,19,9,815,935101,19,935082
62081,9,8,966,896174,9,896165
62082,7,-2,449,572363,7,572356
62083,11,14,20,1085527,11,1085516
62084,14,9,661,933949,14,933935
62085,16,-3,959,561483,16,561467
62086,16,-8,140,398888,16,398872
62087,19,-5,780,496662,19,496643
62088,16,-14,751,215323,16,215307
62089,5,0,136,628415,5,628410
62090,15,19,136,1241848,15,1241833
62091,11,19,895,1248022,11,1248011
62092,6,12,259,1004908,6,1004902
62093,7,-12,60,250880,7,250873
62094,6,-13,534,229671,6,229665
62095,10,-15,449,165115,10,165105
62096,11,-17,38,115840,11,115829
62097,19,-12,312,274853,19,274834
62098,13,2,124,711535,13,711522
62099,11,-18,495,88922,11,88911
62100,10,7,713,859852,10,859842
62101,17,-15,786,183613,17,183596
62102,16,3,571,746071,16,746055
62103,18,10,671,965093,18,965075
62104,15,8,618,902836,15,902821
62105,16,-12,909,279420,16,279404
62106,15,-20,173,24093,15,24078
62107,5,17,657,1169382,5,1169377
62108,8,8,253,880727,8,880719
62109,15,2,630,715311,15,715296
62110,8,-9,669,358295,8,358287
62111,12,18,509,1212697,12,1212685
62112,13,-6,661,464187,13,464174
62113,7,-11,878,299968,7,299961
62114,10,-18,825,80332,10,80322
62115,18,-18,148,86375,18,86357
62116,7,17,89,1157170,7,1157163
62117,13,8,202,899580,13,899567
62118,17,-18,501,88966,17,88949
62119,5,-4,395,508235,5,508230
62120,18,-1,709,622054,18,622036
62121,7,-7,524,417091,7,417084
62122,18,3,887,748490,18,748472
62123,15,-9,231,368238,15,368223
62124,10,-20,674,14867,10,14857
62125,14,17,436,1181162,14,1181148
62126,17,3,160,743018,17,743001
62127,20,-14,859,216221,20,216201
62128,8,13,406,1039568,8,1039560
62129,17,12,177,1023347,17,1023330
62130,13,-14,278,211620,13,211607
62131,20,-11,854,310417,20,310397
62132,20,-8,684,402751,20,402731
62133,19,-7,474,431894,19,431875
62134,6,1,419,666317,6,666311
62135,6,3,698,734027,6,734021
62136,15,18,609,1213309,15,1213294
62137,6,-13,413,226926,6,226920
62138,15,-19,820,60285,15,60270
62139,10,-3,775,547859,10,547849
62140,11,7,208,868468,11,868457
62141,5,0,151,628726,5,628721
62142,14,-7,798,434079,14,434065
62143,14,17,303,1180225,14,1180211
62144,6,-4,16,499664,6,499658
62145,18,-18,515,89043,18,89025
62146,5,-15,826,173050,5,173045
62147,11,-10,457,338439,11,338428
62148,6,15,670,1108659,6,1108653
62149,19,8,103,898737,19,898718
62150,11,-10,449,338391,11,338380
62151,6,16,535,1136556,6,1136550
62152,13,18,159,1210254,13,1210241
62153,18,17,114,1178664,18,1178646
62154,9,12,139,1002143,9,1002134
62155,15,-4,53,522420,15,522405
62156,20,-12,478,276025,20,276005
62157,5,5,750,797292,5,797287
62158,15,-18,305,87613,15,87598
62159,9,-4,502,510309,9,510300
62160,14,-13,948,248199,14,248185
62161,12,-10,375,337784,12,337772
62162,15,-16,581,151293,15,151278
62163,17,13,157,1054371,17,1054354
62164,12,-15,962,185104,12,185092
62165,15,8,910,905073,15,905058
62166,9,16,854,1142832,9,1142823
62167,10,10,184,941510,10,941500
62168,16,4,96,774000,16,773984
62169,6,-11,678,296068,6,296062
62170,19,-2,284,587258,19,587239
62171,5,-13,277,224346,5,224341
62172,7,1,946,677556,7,677549
62173,18,-11,380,306799,18,306781
62174,7,13,886,1049780,7,1049773
62175,20,-10,412,338076,20,338056
62176,20,-20,510,26678,20,26658
62177,10,11,735,984135,10,984125
62178,10,-16,424,133162,10,133152
62179,19,-7,973,435526,19,435507
62180,10,5,949,801764,10,801754
62181,11,6,209,837279,11,837268
62182,7,-17,88,95353,7,95346
62183,15,-9,185,367871,15,367856
62184,15,-7,519,432269,15,432254
62185,16,-16,799,152767,16,152751
62186,10,-13,419,227065,10,227055
62187,15,17,445,1181253,15,1181238
62188,13,-7,189,429701,13,429688
62189,15,-19,581,58630,15,58615
62190,18,14,298,1087723,18,1087705
62191,5,-10,909,331978,5,331973
62192,15,-4,622,526766,15,526751
62193,17,19,248,1242716,17,1242699
62194,15,6,875,842751,15,842736
62195,8,-6,583,449335,8,449327
62196,18,-11,664,309017,18,308999
62197,8,-12,547,261416,8,261408
62198,8,-3,907,550725,8,550717
62199,6,17,199,1159493,6,1159487
62200,14,-20,130,23751,14,23737
62201,17,-1,547,620900,17,620883
62202,8,9,62,908057,8,908049
62203,15,-2,302,587407,15,587392
62204,20,-15,560,181906,20,181886
62205,8,-9,242,348850,8,348842
62206,11,19,12,1240756,11,1240745
62207,17,-11,531,307999,17,307982
62208,14,-16,770,152551,14,152537
62209,6,-2,447,572308,6,572302
62210,6,-15,422,164596,6,164590
62211,13,18,391,1211925,13,1211912
62212,14,17,240,1179685,14,1179671
62213,18,-20,97,23492,18,23474
62214,6,6,734,828926,6,828920
62215,10,5,857,799498,10,799488
62216,9,-18,903,82045,9,82036
62217,8,-3,431,539993,8,539985
62218,7,-10,629,326140,7,326133
62219,20,-6,435,462483,20,462463
62220,12,9,781,934827,12,934815
62221,20,-20,979,30255,20,30235
62222,15,-3,280,555751,15,555736
62223,8,-16,704,139139,8,139131
62224,9,-8,277,381327,9,381318
62225,9,9,968,927447,9,927438
62226,12,14,619,1090222,12,1090210
62227,20,13,82,1053827,20,1053807
62228,17,18,113,1209882,17,1209865
62229,12,-20,275,24901,12,24889
62230,20,-15,271,179740,20,179720
62231,11,-19,531,58119,11,58108
62232,18,8,485,901784,18,901766
62233,5,-6,118,439229,5,439224
62234,5,-8,145,378554,5,378549
62235,16,1,281,682104,16,682088
62236,6,1,22,657536,6,657530
62237,20,-7,317,430763,20,430743
62238,19,-9,417,369832,19,369813
62239,8,5,529,792594,8,792586
62240,19,-16,454,150394,19,150375
62241,7,6,834,831132,7,831125
62242,19,11,575,995014,19,994995
62243,16,-13,946,248171,16,248155
62244,20,-11,804,309977,20,309957
62245,16,-16,202,148424,16,148408
62246,19,-13,705,246197,19,246178
62247,9,12,98,1001231,9,1001222
62248,16,13,249,1055033,16,1055017
62249,19,-18,421,88453,19,88434
62250,9,-9,378,351895,9,351886
62251,17,-15,291,179909,17,179892
62252,7,-4,867,517915,7,517908
62253,14,9,728,934395,14,934381
62254,12,17,44,1178222,12,1178210
62255,17,-12,893,279203,17,279186
62256,8,-14,386,195234,8,195226
62257,12,19,763,1246943,12,1246931
62258,12,-8,911,404375,12,404363
62259,15,18,652,1213662,15,1213647
62260,20,-6,674,464281,20,464261
62261,19,-2,700,590434,19,590415
62262,19,-6,151,460291,19,460272
62263,17,-10,552,339195,17,339178
62264,7,-14,791,203874,7,203867
62265,7,18,756,1202626,7,1202619
62266,10,3,15,719171,10,719161
62267,10,-15,704,170455,10,170445
62268,6,-12,156,252914,6,252908
62269,13,-12,52,272893,13,272880
62270,17,14,731,1091182,17,1091165
62271,16,-17,209,116998,16,116982
62272,16,-11,177,305168,16,305152
62273,15,17,957,1185060,15,1185045
62274,19,-6,85,459698,19,459679
62275,15,7,532,870961,15,870946
62276,19,-9,736,372251,19,372232
62277,19,12,564,1026177,19,1026158
62278,7,-10,336,319858,7,319851
62279,15,-5,295,493254,15,493239
62280,6,11,865,987017,6,987011
62281,5,14,782,1079485,5,1079480
62282,9,-9,604,357101,9,357092
62283,19,-1,274,618693,19,618674
62284,13,-19,310,56398,13,56385
62285,18,-13,717,246310,18,246292
62286,16,17,984,1185343,16,1185327
62287,7,14,522,1073496,7,1073489
62288,11,18,454,1212349,11,1212338
62289,9,-4,102,501599,9,501590
62290,7,6,220,817072,7,817065
62291,5,16,820,1142214,5,1142209
62292,13,-20,827,29222,13,29209
62293,12,9,364,931708,12,931696
62294,17,-17,444,118774,17,118757
62295,7,0,592,638202,7,638195
62296,7,-15,713,170649,7,170642
62297,7,17,807,1172677,7,1172670
62298,17,17,664,1182796,17,1182779
62299,18,-2,142,586170,18,586152
62300,7,-11,881,300073,7,300066
62301,11,19,750,1246858,11,1246847
62302,7,8,671,889941,7,889934
62303,16,19,659,1246124,16,1246108
62304,13,14,801,1091729,13,1091716
62305,8,-8,22,375829,8,375821
62306,11,-10,76,335795,11,335784
62307,9,14,926,1082478,9,1082469
62308,13,-18,862,91472,13,91459
62309,5,-13,344,225645,5,225640
62310,6,6,907,832657,6,832651
62311,5,-1,267,599703,5,599698
62312,13,-5,576,495281,13,495268
62313,16,4,847,779609,16,779593
62314,12,5,119,804655,12,804643
62315,13,-7,283,430452,13,430439
62316,16,1,543,684181,16,684165
62317,19,12,916,1029074,19,1029055
62318,15,-2,546,589228,15,589213
62319,19,2,66,711020,19,711001
62320,19,-9,591,371336,19,371317
62321,5,-5,330,475415,5,475410
62322,13,19,656,1246086,13,1246073
62323,13,1,666,685112,13,685099
62324,10,18,258,1192489,10,1192479
62325,13,0,949,655466,13,655453
62326,11,-10,641,339879,11,339868
62327,11,-13,918,247944,11,247933
62328,12,19,551,1245290,12,1245278
62329,12,-6,547,463403,12,463391
62330,15,-5,828,497005,15,496990
62331,12,-5,210,492507,12,492495
62332,16,-12,493,276165,16,276149
62333,6,18,89,1188686,6,1188680
62334,6,17,782,1171986,6,1171980
62335,17,1,656,685041,17,685024
62336,19,1,152,681074,19,681055
62337,16,12,789,1027933,16,1027917
62338,16,-2,534,589133,16,589117
62339,5,7,205,849151,5,849146
62340,12,14,274,1087543,12,1087531
62341,15,-2,232,586883,15,586868
62342,17,6,717,841601,17,841584
62343,6,-16,833,141886,6,141880
62344,11,17,74,1178437,11,1178426
62345,10,4,945,771263,10,771253
62346,9,5,28,782162,9,782153
62347,17,17,379,1180770,17,1180753
62348,12,13,330,1055650,12,1055638
62349,17,10,71,960402,17,960385
62350,9,-16,281,130143,9,130134
62351,11,-8,151,398994,11,398983
62352,5,-7,706,420815,5,420810
62353,13,19,224,1242526,13,1242513
62354,19,2,428,713858,19,713839
62355,7,13,221,1035467,7,1035460
62356,10,0,519,636541,10,636531
62357,20,-18,171,86609,20,86589
62358,7,18,759,1202721,7,1202714
62359,20,-4,511,525993,20,525973
62360,11,4,53,773633,11,773622
62361,12,-18,640,89899,12,89887
62362,17,0,246,650051,17,650034
62363,8,14,609,1075434,8,1075426
62364,11,-17,866,121919,11,121908
62365,10,4,555,762505,10,762495
62366,15,-12,467,275935,15,275920
62367,19,16,995,1154265,19,1154246
62368,19,0,491,651896,19,651877
62369,5,-11,844,299188,5,299183
62370,15,18,47,1209279,15,1209264
62371,14,-14,955,216911,14,216897
62372,19,-16,751,152419,19,152400
62373,16,3,980,749377,16,749361
62374,19,-6,811,465358,19,465339
62375,19,-6,539,463339,19,463320
62376,17,11,885,997292,17,997275
62377,9,9,340,913872,9,913863
62378,18,12,589,1026390,18,1026372
62379,10,-7,175,409598,10,409588
62380,12,14,929,1092685,12,1092673
62381,9,4,782,767702,9,767693
62382,16,13,325,1055593,16,1055577
62383,18,4,644,777949,18,777931
62384,13,-11,379,306784,13,306771
62385,10,-11,208,285600,10,285590
62386,6,2,707,703551,6,703545
62387,10,-6,908,456199,10,456189
62388,19,-15,686,182840,19,182821
62389,15,3,44,742143,15,742128
62390,14,-8,618,402209,14,402195
62391,7,8,588,888070,7,888063
62392,13,-7,295,430550,13,430537
62393,10,-5,684,482820,10,482810
62394,12,-8,593,401998,12,401986
62395,15,-17,288,117638,15,117623
62396,9,1,601,670324,9,670315
62397,12,-2,906,592036,12,592024
62398,6,3,360,726644,6,726638
62399,18,14,996,1093308,18,1093290
62400,12,10,269,961864,12,961852
62401,9,10,523,948707,9,948698
62402,20,10,940,967059,20,967039
62403,14,-11,328,306379,14,306365
62404,5,4,88,752538,5,752533
62405,19,-16,516,150818,19,150799
62406,8,11,272,974071,8,974063
62407,16,-19,659,59144,16,59128
62408,8,5,59,782932,8,782924
62409,7,-11,620,294899,7,294892
62410,15,11,127,991730,15,991715
62411,8,19,763,1234390,8,1234382
62412,19,-1,637,621475,19,621456
62413,12,-4,645,526923,12,526911
62414,12,11,152,991912,12,991900
62415,17,-4,530,526121,17,526104
62416,16,1,70,680302,16,680286
62417,20,13,94,1053932,20,1053912
62418,15,5,344,806318,15,806303
62419,12,-10,133,336117,12,336105
62420,13,15,746,1122338,13,1122325
62421,13,5,447,807068,13,807055
62422,20,-10,335,337491,20,337471
62423,19,16,145,1148119,19,1148100
62424,14,18,233,1210830,14,1210816
62425,12,-3,764,559911,12,559899
62426,16,4,742,778716,16,778700
62427,10,-20,543,11857,10,11847
62428,11,0,856,654732,11,654721
62429,20,1,608,684635,20,684615
62430,15,-13,45,241400,15,241385
62431,18,-12,967,279849,18,279831
62432,6,18,876,1205249,6,1205243
62433,12,-2,634,589884,12,589872
62434,5,-11,839,299120,5,299115
62435,10,17,856,1173775,10,1173765
62436,6,6,106,814526,6,814520
62437,15,-1,221,618279,15,618264
62438,6,9,311,913300,6,913294
62439,15,-14,492,213309,15,213294
62440,5,18,336,1194046,5,1194041
62441,8,4,103,752867,8,752859
62442,19,19,323,1243376,19,1243357
62443,14,-1,491,620488,14,620474
62444,11,16,550,1151002,11,1150991
62445,5,-9,998,365542,5,365537
62446,19,4,226,774916,19,774897
62447,15,15,856,1123034,15,1123019
62448,17,-17,540,119534,17,119517
62449,19,-15,126,178740,19,178721
62450,9,-5,2,467794,9,467785
62451,13,15,910,1123422,13,1123409
62452,20,2,860,716908,20,716888
62453,14,6,939,843234,14,843220
62454,20,3,526,745698,20,745678
62455,8,-3,920,551123,8,551115
62456,15,11,50,991230,15,991215
62457,19,3,209,743471,19,743452
62458,5,-17,991,114324,5,114319
62459,20,-8,396,400713,20,400693
62460,10,17,688,1170013,10,1170003
62461,20,19,666,1246175,20,1246155
62462,19,0,327,650498,19,650479
62463,10,4,326,757583,10,757573
62464,7,4,826,768707,7,768700
62465,15,-15,901,184604,15,184589
62466,16,12,51,1022434,16,1022418
62467,16,-7,538,432406,16,432390
62468,17,4,598,777623,17,777606
62469,18,-18,456,88709,18,88691
62470,15,-16,527,150883,15,150868
62471,7,10,928,957509,7,957502
62472,15,19,23,1240890,15,1240875
62473,14,0,442,651426,14,651412
62474,7,12,935,1019670,7,1019663
62475,19,8,743,903838,19,903819
62476,16,19,157,1242040,16,1242024
62477,20,-2,163,586266,20,586246
62478,8,11,144,971488,8,971480
62479,8,13,54,1031967,8,1031959
62480,13,-20,694,28164,13,28151
62481,7,-1,353,601832,7,601825
62482,10,-15,561,167487,10,167477
62483,5,-9,567,356400,5,356395
62484,18,-18,998,92476,18,92458
62485,8,-3,916,550977,8,550969
62486,19,-9,387,369563,19,369544
62487,13,-17,957,122524,13,122511
62488,10,1,276,663199,10,663189
62489,19,-17,757,121273,19,121254
62490,7,5,286,787682,7,787675
62491,10,17,943,1175495,10,1175485
62492,7,9,777,923139,7,923132
62493,5,11,100,970645,5,970640
62494,11,15,723,1122144,11,1122133
62495,5,15,226,1099392,5,1099387
62496,16,8,605,902714,16,902698
62497,10,-4,551,511360,10,511350
62498,14,-3,299,555970,14,555956
62499,9,12,487,1009610,9,1009601
62500,13,14,805,1091754,13,1091741
62501,11,0,973,655730,11,655719
62502,16,11,241,992571,16,992555
62503,5,8,271,881075,5,881070
62504,20,7,517,870880,20,870860
62505,5,-18,599,75276,5,75271
62506,15,0,31,648475,15,648460
62507,14,-3,344,556327,14,556313
62508,10,-18,824,80295,10,80285
62509,15,0,209,649815,15,649800
62510,16,6,462,839462,16,839446
62511,11,-13,286,243218,11,243207
62512,19,16,165,1148267,19,1148248
62513,18,4,457,776528,18,776510
62514,9,-18,276,68507,9,68498
62515,5,-6,193,441139,5,441134
62516,19,-17,813,121622,19,121603
62517,19,6,310,838136,19,838117
62518,11,-13,289,243245,11,243234
62519,14,-1,505,620578,14,620564
62520,19,11,864,997123,19,997104
62521,6,16,30,1125816,6,1125810
62522,15,18,839,1215041,15,1215026
62523,8,-5,946,488584,8,488576
62524,15,-11,287,305965,15,305950
62525,20,-10,155,336243,20,336223
62526,15,-10,945,342195,15,342180
62527,18,-3,770,559980,18,559962
62528,19,-1,923,623626,19,623607
62529,20,0,715,653780,20,653760
62530,11,-18,844,91315,11,91304
62531,17,-6,202,460717,17,460700
62532,16,-10,416,338117,16,338101
62533,9,-18,526,73741,9,73732
62534,18,12,180,1023362,18,1023344
62535,13,-13,938,248129,13,248116
62536,12,18,243,1210927,12,1210915
62537,14,4,899,779898,14,779884
62538,18,-12,536,276532,18,276514
62539,11,-20,918,29817,11,29806
62540,13,8,202,899583,13,899570
62541,15,-11,107,304538,15,304523
62542,20,8,361,900810,20,900790
62543,16,-5,106,491746,16,491730
62544,10,15,87,1096318,10,1096308
62545,6,-4,289,505822,6,505816
62546,20,16,510,1150724,20,1150704
62547,12,-4,868,528522,12,528510
62548,16,1,844,686391,16,686375
62549,10,-8,567,387388,10,387378
62550,12,-6,0,459144,12,459132
62551,13,6,698,841435,13,841422
62552,10,0,295,631640,10,631630
62553,9,6,723,828680,9,828671
62554,20,15,442,1119920,20,1119900
62555,10,-12,639,263373,10,263363
62556,7,4,378,758847,7,758840
62557,15,5,328,806182,15,806167
62558,12,6,947,843311,12,843299
62559,12,-13,601,245467,12,245455
62560,15,7,924,873602,15,873587
62561,7,13,8,1031044,7,1031037
62562,20,5,378,806579,20,806559
62563,9,19,295,1224060,9,1224051
62564,6,-10,289,318763,6,318757
62565,7,-4,160,502817,7,502810
62566,19,19,276,1242973,19,1242954
62567,10,14,548,1074085,10,1074075
62568,9,-11,716,296609,9,296600
62569,9,-19,682,46531,9,46522
62570,20,14,303,1087769,20,1087749
62571,18,5,186,805206,18,805188
62572,5,-6,836,454679,5,454674
62573,12,-14,914,216649,12,216637
62574,8,8,412,884260,8,884252
62575,10,0,840,643612,10,643602
62576,17,-20,966,30105,17,30088
62577,17,-18,40,85499,17,85482
62578,11,-19,303,56348,11,56337
62579,11,-15,550,181855,11,181844
62580,16,6,662,841088,16,841072
62581,8,-13,405,226756,8,226748
62582,9,-8,265,381083,9,381074
62583,5,-9,72,345125,5,345120
62584,13,12,946,1029378,13,1029365
62585,18,12,815,1028100,18,1028082
62586,8,9,886,925486,8,925478
62587,8,18,972,1207350,8,1207342
62588,18,-4,734,527572,18,527554
62589,6,18,509,1197677,6,1197671
62590,15,-1,98,617311,15,617296
62591,9,-17,906,112697,9,112688
62592,17,-4,604,526633,17,526616
62593,7,13,997,1052109,7,1052102
62594,18,17,659,1182766,18,1182748
62595,6,2,266,694374,6,694368
62596,11,17,76,1178436,11,1178425
62597,8,10,929,957553,8,957545
62598,13,1,176,681253,13,681240
62599,11,-8,911,404376,11,404365
62600,19,12,882,1028709,19,1028690
62601,15,-5,161,492200,15,492185
62602,19,0,282,650202,19,650183
62603,5,2,40,689503,5,689498
62604,13,-10,108,335903,13,335890
62605,10,2,886,707100,10,707090
62606,7,-7,922,425562,7,425555
62607,5,-15,121,158123,5,158118
62608,5,13,882,1049669,5,1049664
62609,20,-4,798,527984,20,527964
62610,18,-1,712,622093,18,622075
62611,8,19,434,1227584,8,1227576
62612,17,-1,985,624073,17,624056
62613,10,-20,751,16553,10,16543
62614,11,-3,141,554794,11,554783
62615,20,3,933,748929,20,748909
62616,17,-6,408,462275,17,462258
62617,5,-18,200,66817,5,66812
62618,12,9,461,932374,12,932362
62619,19,-14,533,213620,19,213601
62620,15,-4,861,528442,15,528427
62621,7,12,536,1010619,7,1010612
62622,8,-19,41,32353,8,32345
62623,14,6,302,838086,14,838072
62624,17,7,623,871583,17,871566
62625,5,-16,549,135976,5,135971
62626,14,-20,573,27168,14,27154
62627,12,-11,158,304986,12,304974
62628,14,11,692,995746,14,995732
62629,5,-13,547,229975,5,229970
62630,9,6,500,823645,9,823636
62631,20,17,286,1180071,20,1180051
62632,7,18,579,1199055,7,1199048
62633,20,13,370,1055953,20,1055933
62634,12,4,759,778853,12,778841
62635,19,-1,881,623344,19,623325
62636,18,-5,389,493871,18,493853
62637,14,6,370,838655,14,838641
62638,5,1,86,658886,5,658881
62639,5,-18,432,71695,5,71690
62640,9,13,563,1042890,9,1042881
62641,7,-17,812,110785,7,110778
62642,6,9,664,920722,6,920716
62643,18,0,492,651913,18,651895
62644,18,13,193,1054646,18,1054628
62645,5,15,2,1094400,5,1094395
62646,10,-6,101,438922,10,438912
62647,9,-17,227,98228,9,98219
62648,11,6,567,840372,11,840361
62649,11,-12,489,276100,11,276089
62650,11,-10,99,335867,11,335856
62651,16,13,903,1059934,16,1059918
62652,7,-17,536,104987,7,104980
62653,9,18,323,1193750,9,1193741
62654,16,18,743,1214324,16,1214308
62655,20,-15,814,183869,20,183849
62656,11,10,719,965391,11,965380
62657,18,17,966,1185189,18,1185171
62658,5,19,253,1223073,5,1223068
62659,16,-2,431,588389,16,588373
62660,5,-8,447,384546,5,384541
62661,19,-10,991,342642,19,342623
62662,11,3,171,743114,11,743103
62663,16,13,351,1055813,16,1055797
62664,6,4,33,751279,6,751273
62665,7,6,332,819792,7,819785
62666,10,12,347,1006713,10,1006703
62667,14,9,601,933520,14,933506
62668,10,17,830,1173173,10,1173163
62669,13,-2,689,590341,13,590328
62670,19,-3,257,555578,19,555559
62671,12,11,460,994207,12,994195
62672,15,4,829,779410,15,779395
62673,16,14,157,1086712,16,1086696
62674,17,1,313,682330,17,682313
62675,15,2,354,713289,15,713274
62676,5,-11,273,287020,5,287015
62677,11,-5,894,497603,11,497592
62678,12,-18,56,85635,12,85623
62679,20,2,320,712998,20,712978
62680,5,19,454,1227948,5,1227943
62681,11,2,318,712951,11,712940
62682,15,-2,82,585741,15,585726
62683,14,18,8,1208975,14,1208961
62684,18,-17,900,122184,18,122166
62685,5,8,556,887409,5,887404
62686,9,-8,513,386098,9,386089
62687,17,14,814,1091862,17,1091845
62688,16,-8,232,399554,16,399538
62689,15,1,127,680842,15,680827
62690,10,0,119,628054,10,628044
62691,20,0,965,655667,20,655647
62692,8,-11,110,283517,8,283509
62693,20,13,995,1060583,20,1060563
62694,5,5,55,782837,5,782832
62695,16,-15,497,181433,16,181417
62696,5,13,306,1037265,5,1037260
62697,14,-9,24,366775,14,366761
62698,20,8,687,903432,20,903412
62699,7,1,911,676822,7,676815
62700,16,-15,660,182724,16,182708
62701,6,15,17,1094853,6,1094847
62702,16,-17,535,119487,16,119471
62703,16,6,17,835940,16,835924
62704,15,5,780,809443,15,809428
62705,16,-6,594,463659,16,463643
62706,12,9,14,929143,12,929131
62707,5,19,370,1225890,5,1225885
62708,18,-2,704,590446,18,590428
62709,19,11,883,997281,19,997262
62710,16,11,591,995130,16,995114
62711,18,13,240,1054981,18,1054963
62712,9,13,23,1031288,9,1031279
62713,18,11,45,991189,18,991171
62714,15,-8,674,402683,15,402668
62715,18,-12,127,273499,18,273481
62716,13,10,961,967219,13,967206
62717,6,17,183,1159132,6,1159126
62718,6,10,926,957459,6,957453
62719,8,-20,446,9542,8,9534
62720,15,12,256,1023979,15,1023964
62721,11,-8,638,402361,11,402350
62722,13,-18,117,86087,13,86074
62723,6,18,166,1190425,6,1190419
62724,17,-5,114,491793,17,491776
62725,18,14,517,1089495,18,1089477
62726,19,-16,861,153263,19,153244
62727,20,-20,160,23967,20,23947
62728,20,-6,108,459877,20,459857
62729,17,12,134,1023011,17,1022994
62730,6,-8,451,384635,6,384629
62731,20,-17,742,121148,20,121128
62732,10,12,57,1000368,10,1000358
62733,9,-5,64,469260,9,469251
62734,11,2,834,716719,11,716708
62735,16,-7,269,430307,16,430291
62736,11,9,935,936050,11,936039
62737,8,-16,368,131879,8,131871
62738,13,10,880,966557,13,966544
62739,13,14,774,1091559,13,1091546
62740,6,-20,986,21811,6,21805
62741,5,-17,593,106331,5,106326
62742,19,-19,805,60205,19,60186
62743,11,0,886,655019,11,655008
62744,7,-2,799,579771,7,579764
62745,7,-7,92,407808,7,407801
62746,11,-18,52,85585,11,85574
62747,13,-9,692,371912,13,371899
62748,8,4,220,755429,8,755421
62749,8,19,544,1229835,8,1229827
62750,8,-2,187,566742,8,566734
62751,11,-12,647,277259,11,277248
62752,17,-3,268,555679,17,555662
62753,17,6,479,839621,17,839604
62754,5,0,45,626268,5,626263
62755,8,18,283,1193011,8,1193003
62756,11,-13,429,244164,11,244153
62757,17,-19,560,58383,17,58366
62758,7,-5,696,483060,7,483053
62759,19,17,176,1179208,19,1179189
62760,17,-15,120,178693,17,178676
62761,10,12,853,1017763,10,1017753
62762,12,1,591,684530,12,684518
62763,11,-19,501,57835,11,57824
62764,8,-4,850,517516,8,517508
62765,12,1,335,682553,12,682541
62766,12,-15,956,185069,12,185057
62767,7,-10,86,314518,7,314511
62768,18,16,85,1147685,18,1147667
62769,15,-17,693,120705,15,120690
62770,18,-17,281,117596,18,117578
62771,7,19,938,1238233,7,1238226
62772,20,-13,643,245732,20,245712
62773,19,9,641,933817,19,933798
62774,9,0,6,625320,9,625311
62775,6,6,843,831297,6,831291
62776,8,16,810,1142012,8,1142004
62777,5,10,350,944907,5,944902
62778,20,-6,663,464197,20,464177
62779,5,14,456,1071975,5,1071970
62780,16,11,715,995954,16,995938
62781,7,9,25,907295,7,907288
62782,6,12,101,1001296,6,1001290
62783,19,7,330,869431,19,869412
62784,17,1,826,686246,17,686229
62785,13,9,391,931866,13,931853
62786,14,0,523,652146,14,652132
62787,18,19,832,1247503,18,1247485
62788,15,11,838,996912,15,996897
62789,13,15,200,1118297,13,1118284
62790,7,8,189,879191,7,879184
62791,11,14,270,1087514,11,1087503
62792,11,-16,375,149656,11,149645
62793,19,-12,526,276449,19,276430
62794,9,13,296,1037081,9,1037072
62795,9,-10,116,315074,9,315065
62796,6,19,534,1229594,6,1229588
62797,10,-12,96,251616,10,251606
62798,14,-12,27,272701,14,272687
62799,12,-16,538,150957,12,150945
62800,16,-12,737,277874,16,277858
62801,16,-15,708,183052,16,183036
62802,16,-16,39,147026,16,147010
62803,18,16,271,1149090,18,1149072
62804,13,6,469,839544,13,839531
62805,6,-18,687,77084,6,77078
62806,14,-3,429,557028,14,557014
62807,6,9,84,908499,6,908493
62808,5,-15,972,176168,5,176163
62809,5,-3,704,546317,5,546312
62810,11,12,873,1028643,11,1028632
62811,20,4,928,780109,20,780089
62812,20,-2,282,587230,20,587210
62813,18,-17,734,121065,18,121047
62814,9,-19,320,38469,9,38460
62815,18,9,305,931220,18,931202
62816,5,7,484,855224,5,855219
62817,15,-16,714,152137,15,152122
62818,19,-14,386,212576,19,212557
62819,15,1,998,687557,15,687542
62820,13,14,24,1085550,13,1085537
62821,13,-19,887,60776,13,60763
62822,15,8,284,900249,15,900234
62823,7,-1,898,613271,7,613264
62824,17,18,395,1211945,17,1211928
62825,11,-13,485,244555,11,244544
62826,8,-19,453,41240,8,41232
62827,12,17,43,1178218,12,1178206
62828,20,3,618,746490,20,746470
62829,20,19,284,1243021,20,1243001
62830,7,-20,58,1201,7,1194
62831,6,7,413,853683,6,853677
62832,18,19,379,1243847,18,1243829
62833,11,-16,387,149732,11,149721
62834,16,0,943,655415,16,655399
62835,20,17,984,1185353,20,1185333
62836,10,-15,329,162515,10,162505
62837,10,0,61,626617,10,626607
62838,15,1,397,683022,15,683007
62839,10,-20,504,10879,10,10869
62840,13,-2,978,592598,13,592585
62841,8,4,142,753650,8,753642
62842,13,16,366,1149785,13,1149772
62843,15,7,879,873359,15,873344
62844,12,6,579,840468,12,840456
62845,5,-9,30,344275,5,344270
62846,20,-7,455,431765,20,431745
62847,5,17,77,1156974,5,1156969
62848,11,16,439,1150273,11,1150262
62849,9,-6,804,454110,9,454101
62850,7,-16,313,130748,7,130741
62851,17,10,727,965475,17,965458
62852,14,-18,545,89265,14,89251
62853,7,9,130,909544,7,909537
62854,16,7,898,873447,16,873431
62855,13,9,827,935171,13,935158
62856,6,15,883,1113225,6,1113219
62857,16,3,274,743958,16,743942
62858,13,-20,946,29972,13,29959
62859,10,4,192,754748,10,754738
62860,18,-17,657,120456,18,120438
62861,8,-7,275,411680,8,411672
62862,18,-1,527,620776,18,620758
62863,20,18,249,1210988,20,1210968
62864,10,9,755,922533,10,922523
62865,10,5,249,786840,10,786830
62866,18,-19,939,61071,18,61053
62867,19,-17,80,116146,19,116127
62868,15,-13,195,242485,15,242470
62869,10,-17,701,108522,10,108512
62870,8,0,991,646895,8,646887
62871,16,-5,756,496553,16,496537
62872,11,-16,714,152138,11,152127
62873,15,-2,34,585386,15,585371
62874,7,1,511,668475,7,668468
62875,14,18,140,1210111,14,1210097
62876,14,-20,502,26608,14,26594
62877,10,19,582,1230651,10,1230641
62878,13,4,459,776553,13,776540
62879,6,-20,27,654,6,648
62880,6,-7,302,412345,6,412339
62881,10,9,290,912738,10,912728
62882,20,8,140,899055,20,899035
62883,7,-1,412,602987,7,602980
62884,12,19,680,1246284,12,1246272
62885,9,-8,11,375576,9,375567
62886,10,9,541,918201,10,918191
62887,9,-13,983,239631,9,239622
62888,20,-16,469,150512,20,150492
62889,18,13,921,1060050,18,1060032
62890,15,11,833,996861,15,996846
62891,11,4,958,780295,11,780284
62892,15,8,342,900677,15,900662
62893,19,-14,705,215030,19,215011
62894,7,-16,740,139871,7,139864
62895,15,-6,523,463208,15,463193
62896,5,-9,321,350620,5,350615
62897,15,9,937,936077,15,936062
62898,6,0,462,635447,6,635441
62899,6,-12,9,249803,6,249797
62900,15,4,94,773960,15,773945
62901,12,0,470,651690,12,651678
62902,16,3,990,749446,16,749430
62903,16,-6,705,464539,16,464523
62904,16,6,198,837222,16,837206
62905,18,5,596,808141,18,808123
62906,5,8,929,895349,5,895344
62907,20,-12,471,275985,20,275965
62908,17,-18,955,92166,17,92149
62909,18,-5,268,493020,18,493002
62910,8,6,705,828331,8,828323
62911,18,15,167,1118019,18,1118001
62912,11,-3,674,559164,11,559153
62913,20,-1,190,617967,20,617947
62914,12,7,317,869326,12,869314
62915,18,-9,738,372275,18,372257
62916,18,19,657,1246110,18,1246092
62917,11,-1,507,620581,11,620570
62918,10,17,307,1161971,10,1161961
62919,9,14,119,1064502,9,1064493
62920,16,-17,470,118975,16,118959
62921,7,-3,183,534323,7,534316
62922,17,11,245,992601,17,992584
62923,5,-10,444,322252,5,322247
62924,12,-11,987,311446,12,311434
62925,16,-2,117,585998,16,585982
62926,7,-2,725,578268,7,578261
62927,19,3,803,747904,19,747885
62928,17,-4,285,524273,17,524256
62929,18,14,874,1092277,18,1092259
62930,7,8,518,886627,7,886620
62931,16,10,462,963373,16,963357
62932,16,7,173,868248,16,868232
62933,9,7,804,861828,9,861819
62934,18,9,55,929488,18,929470
62935,17,-17,659,120473,17,120456
62936,14,-1,529,620797,14,620783
62937,7,15,30,1095118,7,1095111
62938,10,-6,159,440196,10,440186
62939,12,-4,209,523730,12,523718
62940,20,1,881,686642,20,686622
62941,6,12,103,1001345,6,1001339
62942,11,10,105,960695,11,960684
62943,6,4,136,753525,6,753519
62944,17,17,928,1184859,17,1184842
62945,13,-5,727,496358,13,496345
62946,13,16,490,1150601,13,1150588
62947,8,-20,764,16775,8,16767
62948,6,6,300,819017,6,819011
62949,15,-12,583,276786,15,276771
62950,14,6,909,843017,14,843003
62951,18,-7,805,434150,18,434132
62952,13,-17,506,119286,13,119273
62953,19,-5,455,494392,19,494373
62954,12,19,688,1246352,12,1246340
62955,9,18,440,1196143,9,1196134
62956,16,5,765,809354,16,809338
62957,12,8,298,900314,12,900302
62958,14,-15,255,179620,14,179606
62959,7,-3,795,548216,7,548209
62960,9,0,297,631679,9,631670
62961,19,6,203,837253,19,837234
62962,18,4,924,780091,18,780073
62963,20,-2,82,585751,20,585731
62964,10,-20,972,21398,10,21388
62965,11,11,373,993593,11,993582
62966,6,11,969,989198,6,989192
62967,11,11,949,997692,11,997681
62968,15,-14,239,211273,15,211258
62969,19,8,120,898895,19,898876
62970,12,0,920,655254,12,655242
62971,18,-18,193,86788,18,86770
62972,18,-2,804,591180,18,591162
62973,7,12,509,1009968,7,1009961
62974,15,1,264,682009,15,681994
62975,11,-10,661,340070,11,340059
62976,8,-7,13,406350,8,406342
62977,15,-15,234,179428,15,179413
62978,18,-18,189,86757,18,86739
62979,17,-2,967,592493,17,592476
62980,18,15,122,1117731,18,1117713
62981,19,-5,670,495876,19,495857
62982,19,1,225,681686,19,681667
62983,14,-17,888,122111,14,122097
62984,6,6,105,814489,6,814483
62985,5,17,13,1155525,5,1155520
62986,9,4,97,752744,9,752735
62987,10,15,420,1103223,10,1103213
62988,16,-17,467,118967,16,118951
62989,16,10,757,965654,16,965638
62990,17,-4,690,527297,17,527280
62991,17,6,875,842758,17,842741
62992,20,19,902,1248105,20,1248085
62993,5,-10,204,317030,5,317025
62994,18,-2,472,588719,18,588701
62995,7,18,863,1204954,7,1204947
62996,17,1,882,686663,17,686646
62997,6,17,110,1157587,6,1157581
62998,8,-19,483,41897,8,41889
62999,5,-7,183,409750,5,409745
63000,11,-11,471,307514,11,307503
63001,15,-14,563,213903,15,213888
63002,15,15,250,1118653,15,1118638
63003,16,6,576,840444,16,840428
63004,20,9,234,930742,20,930722
63005,6,14,872,1081376,6,1081370
63006,11,18,402,1212019,11,1212008
63007,9,4,411,759545,9,759536
63008,9,19,421,1227291,9,1227282
63009,5,-13,975,239462,5,239457
63010,6,11,854,986801,6,986795
63011,6,18,225,1191704,6,1191698
63012,18,-13,476,244484,18,244466
63013,19,-10,438,338264,19,338245
63014,20,-15,584,182090,20,182070
63015,18,19,16,1240785,18,1240767
63016,11,-2,978,592599,11,592588
63017,8,-4,627,512965,8,512957
63018,10,16,613,1138039,10,1138029
63019,18,3,160,743026,18,743008
63020,5,-19,149,34967,5,34962
63021,18,19,41,1241019,18,1241001
63022,17,3,213,743489,17,743472
63023,13,0,642,653117,13,653104
63024,8,6,369,820592,8,820584
63025,14,6,48,836154,14,836140
63026,15,-14,15,209452,15,209437
63027,8,3,194,723085,8,723077
63028,10,12,853,1017773,10,1017763
63029,9,12,210,1003727,9,1003718
63030,15,13,136,1054204,15,1054189
63031,9,8,424,884507,9,884498
63032,15,-19,80,54527,15,54512
63033,11,5,571,807944,11,807933
63034,6,-2,485,573153,6,573147
63035,14,6,188,837167,14,837153
63036,7,2,146,691707,7,691700
63037,8,7,325,851821,8,851813
63038,14,-12,328,274988,14,274974
63039,8,7,869,863271,8,863263
63040,8,17,34,1156021,8,1156013
63041,7,-4,811,516686,7,516679
63042,10,-1,41,594712,10,594702
63043,7,11,935,988627,7,988620
63044,15,-6,53,459493,15,459478
63045,15,-16,192,148351,15,148336
63046,20,-12,551,276601,20,276581
63047,15,6,529,840086,15,840071
63048,15,-11,686,309165,15,309150
63049,20,17,288,1180081,20,1180061
63050,10,12,113,1001607,10,1001597
63051,12,17,510,1181741,12,1181729
63052,12,-18,976,92328,12,92316
63053,16,-19,329,56539,16,56523
63054,11,6,878,842773,11,842762
63055,9,-7,591,418534,9,418525
63056,10,-20,906,20103,10,20093
63057,12,0,824,654497,12,654485
63058,8,-5,639,481852,8,481844
63059,19,-13,501,244719,19,244700
63060,8,-17,544,105230,8,105222
63061,18,15,743,1122314,18,1122296
63062,6,-1,261,599551,6,599545
63063,14,-7,11,428366,14,428352
63064,10,5,166,784988,10,784978
63065,6,-10,288,318738,6,318732
63066,5,-1,903,613452,5,613447
63067,19,-9,291,368718,19,368699
63068,5,-8,488,385443,5,385438
63069,20,-10,937,342163,20,342143
63070,18,5,254,805704,18,805686
63071,8,-11,504,292447,8,292439
63072,11,-18,556,89306,11,89295
63073,17,18,97,1209693,17,1209676
63074,5,-7,390,414373,5,414368
63075,9,-15,503,166378,9,166369
63076,16,-15,208,179242,16,179226
63077,5,-19,879,50700,5,50695
63078,17,6,797,842138,17,842121
63079,8,7,803,861785,8,861777
63080,19,-17,482,119073,19,119054
63081,5,-16,180,127906,5,127901
63082,8,7,344,852277,8,852269
63083,20,18,638,1213591,20,1213571
63084,5,-2,217,567411,5,567406
63085,5,15,759,1110628,5,1110623
63086,19,-9,337,369144,19,369125
63087,7,16,772,1141126,7,1141119
63088,11,-9,988,374181,11,374170
63089,13,15,864,1123100,13,1123087
63090,11,-19,692,59382,11,59371
63091,9,-2,369,570493,9,570484
63092,17,3,412,744969,17,744952
63093,14,17,415,1181011,14,1180997
63094,10,-12,536,261262,10,261252
63095,8,4,612,763921,8,763913
63096,10,0,700,640701,10,640691
63097,17,-11,86,304339,17,304322
63098,18,5,29,803947,18,803929
63099,12,0,761,654129,12,654117
63100,16,4,163,774464,16,774448
63101,6,7,554,856574,6,856568
63102,15,-5,249,492830,15,492815
63103,18,7,122,867892,18,867874
63104,8,16,401,1133757,8,1133749
63105,16,-8,600,402043,16,402027
63106,6,-6,25,437435,6,437429
63107,20,-19,336,56630,20,56610
63108,20,-18,790,91009,20,90989
63109,14,12,76,1022589,14,1022575
63110,10,11,675,982797,10,982787
63111,9,-7,359,413689,9,413680
63112,13,-1,291,618876,13,618863
63113,8,3,677,733458,8,733450
63114,11,-17,964,122561,11,122550
63115,8,18,364,1194593,8,1194585
63116,16,-17,86,116203,16,116187
63117,10,-8,60,376742,10,376732
63118,9,-10,952,332915,9,332906
63119,13,16,179,1148394,13,1148381
63120,18,-12,846,278772,18,278754
63121,20,0,102,649052,20,649032
63122,20,-2,504,588938,20,588918
63123,6,-19,823,49433,6,49427
63124,15,-19,797,60166,15,60151
63125,15,0,631,653022,15,653007
63126,17,-17,64,115963,17,115946
63127,7,-3,593,543790,7,543783
63128,8,-7,172,409457,8,409449
63129,10,1,885,676248,10,676238
63130,5,-18,691,77172,5,77167
63131,5,-15,801,172495,5,172490
63132,7,13,708,1045919,7,1045912
63133,19,18,826,1214955,19,1214936
63134,11,2,348,713211,11,713200
63135,19,-10,787,340974,19,340955
63136,10,-14,449,196494,10,196484
63137,11,14,41,1085734,11,1085723
63138,16,-6,391,462136,16,462120
63139,6,3,901,738203,6,738197
63140,13,4,35,773540,13,773527
63141,10,-2,694,577650,10,577640
63142,11,0,202,649786,11,649775
63143,8,14,605,1075312,8,1075304
63144,7,-9,609,357222,7,357215
63145,9,-20,900,19978,9,19969
63146,15,-19,944,61114,15,61099
63147,6,8,1000,896907,6,896901
63148,6,12,589,1011747,6,1011741
63149,9,-9,698,358978,9,358969
63150,14,0,28,648440,14,648426
63151,17,-1,785,622609,17,622592
63152,11,10,704,965322,11,965311
63153,16,-11,843,310284,16,310268
63154,14,-18,393,88244,14,88230
63155,6,13,285,1036786,6,1036780
63156,8,-15,303,161918,8,161910
63157,13,-17,696,120719,13,120706
63158,20,-19,373,56903,20,56883
63159,19,16,11,1147176,19,1147157
63160,7,-8,431,384253,7,384246
63161,9,19,491,1228686,9,1228677
63162,17,10,112,960748,17,960731
63163,17,14,650,1090529,17,1090512
63164,6,19,551,1229941,6,1229935
63165,7,-4,584,512024,7,512017
63166,6,-15,781,172089,6,172083
63167,14,0,419,651304,14,651290
63168,16,12,897,1028871,16,1028855
63169,14,7,862,873252,14,873238
63170,18,-14,400,212696,18,212678
63171,17,10,687,965227,17,965210
63172,10,18,804,1203777,10,1203767
63173,19,-7,347,430992,19,430973
63174,7,-19,30,32156,7,32149
63175,6,2,197,692943,6,692937
63176,14,7,855,873169,14,873155
63177,18,2,48,710886,18,710868
63178,14,-10,34,335418,14,335404
63179,15,-2,695,590389,15,590374
63180,14,12,426,1025165,14,1025151
63181,7,10,656,951719,7,951712
63182,9,14,495,1072880,9,1072871
63183,9,-19,230,36653,9,36644
63184,6,18,698,1201350,6,1201344
63185,17,-8,909,404375,17,404358
63186,18,6,456,839412,18,839394
63187,13,0,860,654755,13,654742
63188,7,-4,331,506717,7,506710
63189,7,-14,596,199743,7,199736
63190,8,2,923,707800,8,707792
63191,11,17,924,1184840,11,1184829
63192,13,18,784,1214660,13,1214647
63193,16,-17,172,116736,16,116720
63194,19,-14,336,212032,19,212013
63195,15,-13,777,246838,15,246823
63196,7,4,888,770168,7,770161
63197,12,-16,916,153669,12,153657
63198,11,-9,527,370873,11,370862
63199,17,-2,6,585158,17,585141
63200,15,3,547,745840,15,745825
63201,7,-1,359,601992,7,601985
63202,20,-8,837,403839,20,403819
63203,16,-2,453,588572,16,588556
63204,8,18,696,1201320,8,1201312
63205,13,-12,722,277799,13,277786
63206,13,2,871,716995,13,716982
63207,14,-12,416,275574,14,275560
63208,13,-10,962,342301,13,342288
63209,15,-8,462,401063,15,401048
63210,14,-2,393,588002,14,587988
63211,5,13,432,1040060,5,1040055
63212,11,16,104,1147808,11,1147797
63213,6,9,96,908754,6,908748
63214,8,13,354,1038423,8,1038415
63215,17,-17,903,122189,17,122172
63216,13,-11,517,307858,13,307845
63217,16,-18,226,87060,16,87044
63218,11,-2,656,590071,11,590060
63219,6,2,761,704652,6,704646
63220,6,-14,188,190522,6,190516
63221,20,-13,851,247361,20,247341
63222,19,5,828,809821,19,809802
63223,17,-3,901,561028,17,561011
63224,7,-18,71,63984,7,63977
63225,11,-9,973,374164,11,374153
63226,17,12,941,1029340,17,1029323
63227,14,15,108,1117594,14,1117580
63228,19,9,126,930018,19,929999
63229,13,4,401,776089,13,776076
63230,17,12,87,1022702,17,1022685
63231,14,6,775,841968,14,841954
63232,14,-15,146,178892,14,178878
63233,6,-14,563,198757,6,198751
63234,15,13,411,1056309,15,1056294
63235,13,8,458,901575,13,901562
63236,8,5,473,791419,8,791411
63237,9,2,105,690892,9,690883
63238,12,8,434,901426,12,901414
63239,19,-11,86,304348,19,304329
63240,19,13,628,1058024,19,1058005
63241,9,1,946,677565,9,677556
63242,9,17,520,1166496,9,1166487
63243,17,9,41,929367,17,929350
63244,18,-4,366,524968,18,524950
63245,9,-2,982,583837,9,583828
63246,11,-12,244,274303,11,274292
63247,17,7,429,870224,17,870207
63248,20,4,138,774265,20,774245
63249,10,4,426,759853,10,759843
63250,10,-4,160,502827,10,502817
63251,15,-12,301,274765,15,274750
63252,16,-2,972,592526,16,592510
63253,6,-17,300,99992,6,99986
63254,17,0,94,648982,17,648965
63255,13,5,289,805972,13,805959
63256,10,19,475,1228377,10,1228367
63257,14,-14,185,210712,14,210698
63258,12,-1,81,617205,12,617193
63259,5,13,609,1043922,5,1043917
63260,10,16,222,1129944,10,1129934
63261,15,-3,587,558431,15,558416
63262,9,3,152,722095,9,722086
63263,13,-20,171,24057,13,24044
63264,8,0,771,642276,8,642268
63265,19,10,869,966488,19,966469
63266,18,9,821,935138,18,935120
63267,19,6,518,840006,19,839987
63268,15,1,991,687506,15,687491
63269,15,-16,158,148093,15,148078
63270,19,0,543,652331,19,652312
63271,20,-11,292,306013,20,305993
63272,10,14,488,1072707,10,1072697
63273,9,4,104,752891,9,752882
63274,11,-18,802,91101,11,91090
63275,19,-17,886,122085,19,122066
63276,6,3,493,729396,6,729390
63277,15,19,616,1245797,15,1245782
63278,7,19,214,1222268,7,1222261
63279,20,13,13,1053337,20,1053317
63280,5,17,25,1155824,5,1155819
63281,18,-14,96,210080,18,210062
63282,11,12,741,1027570,11,1027559
63283,12,-13,625,245699,12,245687
63284,9,15,383,1102604,9,1102595
63285,12,2,681,715735,12,715723
63286,5,-14,201,190879,5,190874
63287,20,8,216,899680,20,899660
63288,16,1,94,680526,16,680510
63289,14,-11,599,308509,14,308495
63290,13,-14,256,211463,13,211450
63291,18,4,893,779857,18,779839
63292,20,-13,442,244242,20,244222
63293,20,6,727,841691,20,841671
63294,9,7,952,864885,9,864876
63295,10,3,145,721966,10,721956
63296,18,-17,557,119679,18,119661
63297,20,-19,65,54374,20,54354
63298,5,9,769,922920,5,922915
63299,5,-2,501,573446,5,573441
63300,7,10,620,950891,7,950884
63301,5,7,654,858641,5,858636
63302,9,5,200,785907,9,785898
63303,16,13,83,1053846,16,1053830
63304,15,7,33,867255,15,867240
63305,15,-12,491,276125,15,276110
63306,12,-2,689,590343,12,590331
63307,9,18,217,1191558,9,1191549
63308,20,-20,537,26904,20,26884
63309,19,1,895,686780,19,686761
63310,9,11,317,975158,9,975149
63311,13,19,337,1243492,13,1243479
63312,8,8,260,880817,8,880809
63313,18,13,809,1059315,18,1059297
63314,13,0,567,652520,13,652507
63315,13,-1,480,620421,13,620408
63316,14,16,146,1148131,14,1148117
63317,7,10,489,947904,7,947897
63318,20,-6,137,460136,20,460116
63319,5,9,544,918245,5,918240
63320,17,15,487,1120254,17,1120237
63321,11,-13,343,243595,11,243584
63322,9,4,344,757929,9,757920
63323,17,-10,935,342116,17,342099
63324,5,2,961,708769,5,708764
63325,9,-17,475,103578,9,103569
63326,13,-8,117,398726,13,398713
63327,14,11,284,992927,14,992913
63328,15,17,959,1185100,15,1185085
63329,8,-3,108,532770,8,532762
63330,14,-8,618,402213,14,402199
63331,10,17,370,1163270,10,1163260
63332,13,-15,651,182655,13,182642
63333,7,-17,437,102708,7,102701
63334,13,13,65,1053714,13,1053701
63335,18,13,94,1053940,18,1053922
63336,5,11,420,977466,5,977461
63337,13,11,469,994272,13,994259
63338,16,-6,34,459418,16,459402
63339,17,-2,627,589843,17,589826
63340,6,-14,683,201673,6,201667
63341,6,12,906,1019086,6,1019080
63342,6,18,875,1205214,6,1205208
63343,20,-9,241,368335,20,368315
63344,5,-6,905,456123,5,456118
63345,19,17,612,1182422,19,1182403
63346,10,14,687,1077499,10,1077489
63347,19,-7,91,428931,19,428912
63348,10,-15,247,160727,10,160717
63349,14,5,90,804473,14,804459
63350,5,-16,803,141234,5,141229
63351,14,1,629,684800,14,684786
63352,15,18,332,1211548,15,1211533
63353,19,9,637,933807,19,933788
63354,11,-20,558,27058,11,27047
63355,6,14,145,1065110,6,1065104
63356,7,-17,179,97192,7,97185
63357,6,12,807,1016582,6,1016576
63358,20,3,396,744859,20,744839
63359,7,-19,820,49379,7,49372
63360,10,-3,575,543432,10,543422
63361,6,-17,383,101672,6,101666
63362,11,13,495,1056891,11,1056880
63363,14,7,555,871113,14,871099
63364,15,-13,324,243462,15,243447
63365,12,-9,924,373887,12,373875
63366,10,19,396,1226538,10,1226528
63367,6,-2,319,569624,6,569618
63368,11,13,76,1053792,11,1053781
63369,8,10,161,941057,8,941049
63370,5,17,968,1176155,5,1176150
63371,11,-11,886,310656,11,310645
63372,6,-13,915,238184,6,238178
63373,7,13,291,1036975,7,1036968
63374,9,15,71,1095960,9,1095951
63375,5,-1,185,597659,5,597654
63376,19,-19,828,60351,19,60332
63377,11,-14,572,214026,11,214015
63378,18,5,610,808279,18,808261
63379,5,1,948,677638,5,677633
63380,8,12,278,1005382,8,1005374
63381,17,-16,598,151417,17,151400
63382,16,-5,772,496635,16,496619
63383,9,-3,906,550708,9,550699
63384,6,-7,591,418540,6,418534
63385,6,-5,591,480850,6,480844
63386,18,7,941,873704,18,873686
63387,10,19,908,1237734,10,1237724
63388,10,16,941,1144786,10,1144776
63389,5,9,522,917781,5,917776
63390,12,10,341,962399,12,962387
63391,8,1,681,671955,8,671947
63392,5,4,191,754701,5,754696
63393,10,4,835,768918,10,768908
63394,6,1,912,676857,6,676851
63395,8,-5,292,474508,8,474500
63396,17,13,470,1056722,17,1056705
63397,7,15,331,1101559,7,1101552
63398,18,13,422,1056390,18,1056372
63399,14,7,376,869778,14,869764
63400,19,-12,415,275561,19,275542
63401,5,-18,591,75150,5,75145
63402,6,4,622,764110,6,764104
63403,17,-10,114,335947,17,335930
63404,18,2,281,712648,18,712630
63405,18,-3,778,560087,18,560069
63406,6,-17,560,105532,6,105526
63407,19,-14,950,216860,19,216841
63408,6,-20,526,11315,6,11309
63409,19,11,194,992238,19,992219
63410,5,-11,938,301251,5,301246
63411,10,-8,995,396709,10,396699
63412,19,17,336,1180491,19,1180472
63413,10,6,657,827143,10,827133
63414,14,-17,71,116024,14,116010
63415,5,11,200,972522,5,972517
63416,20,-15,287,179856,20,179836
63417,17,-1,354,619445,17,619428
63418,13,-10,32,335402,13,335389
63419,8,0,974,646518,8,646510
63420,17,-19,603,58753,17,58736
63421,9,3,743,734922,9,734913
63422,20,9,963,936281,20,936261
63423,20,-14,226,211138,20,211118
63424,19,-20,242,24641,19,24622
63425,5,11,136,971313,5,971308
63426,9,2,933,708017,9,708008
63427,5,-11,957,301787,5,301782
63428,11,-19,397,57110,11,57099
63429,12,0,991,655848,12,655836
63430,13,13,799,1059254,13,1059241
63431,11,10,515,963822,11,963811
63432,7,13,696,1045696,7,1045689
63433,20,-7,984,435602,20,435582
63434,8,-2,954,583224,8,583216
63435,7,-10,538,324218,7,324211
63436,16,-17,876,122012,16,121996
63437,7,-3,610,544135,7,544128
63438,20,-7,858,434585,20,434565
63439,9,11,276,974190,9,974181
63440,8,-11,489,292096,8,292088
63441,6,-8,225,380295,6,380289
63442,16,8,439,901502,16,901486
63443,18,-2,32,585366,18,585348
63444,6,10,686,952332,6,952326
63445,10,7,598,857524,10,857514
63446,9,-14,287,192987,9,192978
63447,6,12,636,1012919,6,1012913
63448,15,-19,122,54985,15,54970
63449,19,-13,761,246672,19,246653
63450,19,-9,491,370555,19,370536
63451,20,15,528,1120607,20,1120587
63452,18,1,269,682059,18,682041
63453,15,-16,39,147031,15,147016
63454,15,19,89,1241521,15,1241506
63455,9,16,149,1128250,9,1128241
63456,7,-8,722,390839,7,390832
63457,20,-12,500,276256,20,276236
63458,14,-5,238,492752,14,492738
63459,13,6,394,838906,13,838893
63460,17,19,66,1241278,17,1241261
63461,9,-9,699,359006,9,358997
63462,19,12,684,1027223,19,1027204
63463,18,-19,662,59163,18,59145
63464,18,14,679,1090786,18,1090768
63465,19,-6,728,464735,19,464716
63466,20,18,892,1215516,20,1215496
63467,20,-12,219,274131,20,274111
63468,16,6,639,840946,16,840930
63469,7,18,121,1189470,7,1189463
63470,10,14,220,1066572,10,1066562
63471,17,18,734,1214208,17,1214191
63472,15,-6,683,464341,15,464326
63473,19,4,364,775853,19,775834
63474,5,3,423,727883,5,727878
63475,15,18,423,1212171,15,1212156
63476,17,15,711,1122058,17,1122041
63477,16,-1,912,623540,16,623524
63478,13,-17,761,121276,13,121263
63479,17,2,439,713935,17,713918
63480,5,17,769,1171592,5,1171587
63481,11,-13,680,245958,11,245947
63482,18,10,70,960388,18,960370
63483,6,-9,452,353618,6,353612
63484,18,-10,405,337999,18,337981
63485,18,-12,115,273394,18,273376
63486,5,-17,164,96889,5,96884
63487,14,18,601,1213224,14,1213210
63488,18,13,50,1053603,18,1053585
63489,15,18,833,1215006,15,1214991
63490,16,1,243,681801,16,681785
63491,16,17,72,1178409,16,1178393
63492,6,-10,238,317753,6,317747
63493,14,4,294,775304,14,775290
63494,20,-15,946,185005,20,184985
63495,18,-7,759,433812,18,433794
63496,8,17,405,1163912,8,1163904
63497,18,-18,88,85890,18,85872
63498,18,9,316,931330,18,931312
63499,20,7,506,870767,20,870747
63500,12,-20,83,23412,12,23400
63501,9,-15,587,168080,9,168071
63502,16,16,343,1149610,16,1149594
63503,15,16,423,1150179,15,1150164
63504,19,19,77,1241409,19,1241390
63505,5,-4,851,517567,5,517562
63506,17,-15,276,179777,17,179760
63507,8,10,649,951602,8,951594
63508,9,-3,233,535435,9,535426
63509,18,-4,400,525226,18,525208
63510,5,6,420,821855,5,821850
63511,13,7,790,872736,13,872723
63512,17,10,810,966164,17,966147
63513,12,15,13,1116854,12,1116842
63514,7,-1,638,607671,7,607664
63515,9,10,657,951747,9,951738
63516,6,-16,511,135179,6,135173
63517,8,8,927,895280,8,895272
63518,12,9,211,930614,12,930602
63519,17,6,629,840850,17,840833
63520,10,-4,292,505886,10,505876
63521,16,10,151,961036,16,961020
63522,18,2,324,713042,18,713024
63523,8,-1,1,593744,8,593736
63524,10,19,604,1231025,10,1231015
63525,8,-16,83,125675,8,125667
63526,6,-10,865,331099,6,331093
63527,10,-20,534,11589,10,11579
63528,7,-8,811,392722,7,392715
63529,14,-15,403,180718,14,180704
63530,15,-13,234,242762,15,242747
63531,15,-14,511,213496,15,213481
63532,8,2,977,709087,8,709079
63533,18,3,594,746268,18,746250
63534,16,17,264,1179879,16,1179863
63535,19,12,254,1023953,19,1023934
63536,18,17,747,1183450,18,1183432
63537,18,-12,854,278868,18,278850
63538,11,1,47,680156,11,680145
63539,7,-3,208,534850,7,534843
63540,5,11,499,979100,5,979095
63541,5,15,808,1111523,5,1111518
63542,13,-13,935,248101,13,248088
63543,10,-6,371,444752,10,444742
63544,6,3,906,738365,6,738359
63545,10,10,554,949287,10,949277
63546,17,-1,914,623568,17,623551
63547,12,2,213,712205,12,712193
63548,5,5,409,789981,5,789976
63549,17,5,328,806189,17,806172
63550,5,13,946,1050989,5,1050984
63551,6,-8,586,387650,6,387644
63552,13,-15,17,177955,13,177942
63553,18,5,591,808107,18,808089
63554,14,-20,534,26839,14,26825
63555,16,1,149,681046,16,681030
63556,9,-7,100,407979,9,407970
63557,7,7,276,850694,7,850687
63558,11,15,571,1120933,11,1120922
63559,19,-15,468,181251,19,181232
63560,8,14,670,1077011,8,1077003
63561,8,17,422,1164275,8,1164267
63562,7,-15,423,164632,7,164625
63563,12,10,76,960431,12,960419
63564,11,14,616,1090213,11,1090202
63565,6,-9,621,357380,6,357374
63566,18,18,75,1209533,18,1209515
63567,8,13,176,1034429,8,1034421
63568,12,-18,968,92259,12,92247
63569,5,-9,670,358315,5,358310
63570,5,-6,303,443426,5,443421
63571,8,0,174,629288,8,629280
63572,12,-5,344,493668,12,493656
63573,8,9,285,912642,8,912634
63574,9,-7,894,425058,9,425049
63575,14,-7,536,432402,14,432388
63576,7,-1,629,607486,7,607479
63577,16,4,795,779099,16,779083
63578,17,15,629,1121408,17,1121391
63579,6,5,526,792558,6,792552
63580,16,-5,95,491653,16,491637
63581,14,7,632,871649,14,871635
63582,16,-11,627,308723,16,308707
63583,17,-19,395,57107,17,57090
63584,10,-11,65,282567,10,282557
63585,12,-16,983,154153,12,154141
63586,13,-19,850,60516,13,60503
63587,12,10,640,964861,12,964849
63588,19,18,106,1209834,19,1209815
63589,19,14,199,1086967,19,1086948
63590,14,3,54,742252,14,742238
63591,19,0,338,650601,19,650582
63592,8,-6,678,451260,8,451252
63593,17,-19,202,55672,17,55655
63594,17,15,981,1124006,17,1123989
63595,15,-10,609,339647,15,339632
63596,7,2,728,704027,7,704020
63597,12,6,633,840869,12,840857
63598,10,-17,58,94653,10,94643
63599,15,-2,191,586504,15,586489
63600,13,6,965,843440,13,843427
63601,17,-12,897,279243,17,279226
63602,15,-12,520,276381,15,276366
63603,11,12,626,1026686,11,1026675
63604,17,17,826,1184151,17,1184134
63605,7,14,675,1077162,7,1077155
63606,5,15,760,1110642,5,1110637
63607,9,-4,446,509185,9,509176
63608,18,-12,504,276302,18,276284
63609,17,16,731,1152331,17,1152314
63610,18,-9,530,370899,18,370881
63611,6,-20,515,11083,6,11077
63612,19,-10,979,342480,19,342461
63613,9,0,895,644799,9,644790
63614,15,11,552,994811,15,994796
63615,7,12,632,1012812,7,1012805
63616,8,11,844,986535,8,986527
63617,12,-13,161,242203,12,242191
63618,11,-10,585,339412,11,339401
63619,18,10,549,964053,18,964035
63620,16,-9,530,370905,16,370889
63621,15,-2,415,588222,15,588207
63622,18,-4,773,527820,18,527802
63623,13,4,439,776407,13,776394
63624,5,-9,163,347045,5,347040
63625,6,-11,23,281576,6,281570
63626,17,-6,424,462412,17,462395
63627,15,14,259,1087453,15,1087438
63628,7,14,948,1083087,7,1083080
63629,5,-17,177,97151,5,97146
63630,6,14,867,1081253,6,1081247
63631,9,-10,350,320194,9,320185
63632,10,12,707,1014620,10,1014610
63633,7,-13,906,237892,7,237885
63634,14,-4,635,526869,14,526855
63635,17,14,402,1088595,17,1088578
63636,16,14,767,1091486,16,1091470
63637,18,19,718,1246609,18,1246591
63638,14,14,456,1089029,14,1089015
63639,14,-11,329,306388,14,306374
63640,17,10,433,963124,17,963107
63641,11,4,83,773846,11,773835
63642,5,-8,948,395632,5,395627
63643,6,-10,823,330223,6,330217
63644,6,2,818,705634,6,705628
63645,12,-2,464,588632,12,588620
63646,17,-18,859,91442,17,91425
63647,13,2,673,715655,13,715642
63648,13,2,687,715777,13,715764
63649,11,-4,345,524788,11,524777
63650,13,12,457,1025393,13,1025380
63651,9,-8,531,386538,9,386529
63652,14,-9,327,369008,14,368994
63653,7,8,67,876472,7,876465
63654,15,11,397,993810,15,993795
63655,5,-12,123,252249,5,252244
63656,8,-13,50,219458,8,219450
63657,6,18,318,1193628,6,1193622
63658,15,-9,55,367068,15,367053
63659,8,-13,350,225743,8,225735
63660,12,-2,502,588922,12,588910
63661,16,-20,984,30317,16,30301
63662,10,15,74,1096025,10,1096015
63663,16,-18,569,89364,16,89348
63664,18,-5,808,496871,18,496853
63665,16,12,535,1025968,16,1025952
63666,5,14,387,1070329,5,1070324
63667,10,-9,286,349848,10,349838
63668,6,18,196,1191241,6,1191235
63669,18,14,246,1087354,18,1087336
63670,10,4,422,759782,10,759772
63671,10,7,383,853093,10,853083
63672,14,0,54,648644,14,648630
63673,7,-5,488,478574,7,478567
63674,14,16,588,1151254,14,1151240
63675,14,2,101,711352,14,711338
63676,15,-10,791,341021,15,341006
63677,15,-16,525,150872,15,150857
63678,16,2,36,710764,16,710748
63679,10,1,284,663371,10,663361
63680,19,-14,319,211875,19,211856
63681,8,8,794,892671,8,892663
63682,15,-18,707,90390,15,90375
63683,15,-9,442,370086,15,370071
63684,11,15,135,1117801,11,1117790
63685,15,4,642,777924,15,777909
63686,12,5,220,805492,12,805480
63687,17,-9,47,367002,17,366985
63688,17,17,288,1180088,17,1180071
63689,15,12,617,1026615,15,1026600
63690,19,-13,95,241727,19,241708
63691,7,1,763,673606,7,673599
63692,18,-10,971,342412,18,342394
63693,13,15,581,1120995,13,1120982
63694,20,-19,210,55748,20,55728
63695,6,5,674,795550,6,795544
63696,13,6,651,841019,13,841006
63697,8,16,430,1134479,8,1134471
63698,20,-5,393,493912,20,493892
63699,8,7,352,852408,8,852400
63700,13,-4,31,522267,13,522254
63701,19,15,668,1121699,19,1121680
63702,9,12,252,1004642,9,1004633
63703,9,13,66,1032221,9,1032212
63704,14,14,8,1085434,14,1085420
63705,15,3,684,747049,15,747034
63706,8,-15,18,155741,8,155733
63707,16,8,48,898253,16,898237
63708,6,-8,111,377700,6,377694
63709,19,-13,994,248532,19,248513
63710,20,-6,536,463300,20,463280
63711,8,-4,445,509157,8,509149
63712,6,4,785,767748,6,767742
63713,11,17,861,1184487,11,1184476
63714,8,-4,806,516584,8,516576
63715,14,18,486,1212538,14,1212524
63716,9,5,360,788967,9,788958
63717,10,-14,822,204498,10,204488
63718,7,8,180,878992,7,878985
63719,7,-8,106,377603,7,377596
63720,18,8,407,901226,18,901208
63721,20,-12,754,278057,20,278037
63722,19,-12,10,272596,19,272577
63723,19,5,184,805184,19,805165
63724,9,13,843,1048882,9,1048873
63725,10,-10,513,323796,10,323786
63726,14,-18,153,86434,14,86420
63727,16,-12,375,275303,16,275287
63728,5,1,473,667536,5,667531
63729,19,8,437,901455,19,901436
63730,12,-20,465,26294,12,26282
63731,18,11,451,994127,18,994109
63732,6,6,988,834496,6,834490
63733,5,-11,661,295724,5,295719
63734,20,-16,122,147841,20,147821
63735,8,13,979,1051694,8,1051686
63736,9,-15,957,175889,9,175880
63737,16,16,443,1150325,16,1150309
63738,16,-2,594,589590,16,589574
63739,12,15,783,1122524,12,1122512
63740,11,-18,99,85979,11,85968
63741,19,13,502,1056942,19,1056923
63742,10,-5,638,481815,10,481805
63743,19,-19,78,54487,19,54468
63744,15,7,847,873135,15,873120
63745,20,-15,815,183887,20,183867
63746,7,-2,108,565174,7,565167
63747,17,-13,104,241835,17,241818
63748,18,-8,780,403437,18,403419
63749,11,-20,142,23843,11,23832
63750,11,-19,334,56601,11,56590
63751,6,-8,46,376355,6,376349
63752,13,11,600,995178,13,995165
63753,18,-1,332,619219,18,619201
63754,5,8,463,885360,5,885355
63755,9,-3,316,537279,9,537270
63756,14,-4,499,525850,14,525836
63757,14,0,4,648210,14,648196
63758,11,-18,190,86757,11,86746
63759,11,-4,450,525505,11,525494
63760,17,-19,112,54880,17,54863
63761,8,16,733,1140294,8,1140286
63762,17,16,621,1151467,17,1151450
63763,16,2,571,714863,16,714847
63764,5,-8,535,386652,5,386647
63765,19,19,295,1243115,19,1243096
63766,7,9,723,921964,7,921957
63767,16,15,498,1120319,16,1120303
63768,18,-15,914,184738,18,184720
63769,5,-20,876,19456,5,19451
63770,9,10,321,944351,9,944342
63771,12,9,719,934365,12,934353
63772,20,-16,637,151674,20,151654
63773,19,13,176,1054502,19,1054483
63774,7,17,269,1161041,7,1161034
63775,7,-13,908,237942,7,237935
63776,8,-7,88,407722,8,407714
63777,11,4,358,775815,11,775804
63778,13,-7,877,434736,13,434723
63779,17,-5,940,497942,17,497925
63780,12,1,459,683474,12,683462
63781,20,8,534,902190,20,902170
63782,12,2,835,716738,12,716726
63783,18,-12,975,279908,18,279890
63784,10,12,37,999907,10,999897
63785,15,-5,926,497829,15,497814
63786,6,-14,22,186952,6,186946
63787,20,5,946,810764,20,810744
63788,20,-5,862,497306,20,497286
63789,10,6,782,829843,10,829833
63790,14,17,610,1182409,14,1182395
63791,13,5,75,804348,13,804335
63792,14,8,544,902231,14,902217
63793,18,-6,53,459501,18,459483
63794,13,12,147,1023099,13,1023086
63795,19,0,361,650782,19,650763
63796,18,-8,522,401508,18,401490
63797,14,4,804,779144,14,779130
63798,12,-17,232,117162,12,117150
63799,10,3,207,723333,10,723323
63800,15,7,788,872730,15,872715
63801,15,3,747,747475,15,747460
63802,12,13,613,1057916,12,1057904
63803,20,10,714,965372,20,965352
63804,9,-15,625,168866,9,168857
63805,10,12,468,1009150,10,1009140
63806,5,17,167,1158781,5,1158776
63807,13,-16,958,153984,13,153971
63808,14,2,997,717844,14,717830
63809,15,-13,909,247828,15,247813
63810,9,2,61,689961,9,689952
63811,13,-13,256,242942,13,242929
63812,19,7,541,871040,19,871021
63813,15,-5,703,496176,15,496161
63814,9,-8,850,393472,9,393463
63815,17,-5,976,498214,17,498197
63816,7,15,544,1106062,7,1106055
63817,13,3,177,743169,13,743156
63818,19,17,629,1182519,19,1182500
63819,7,1,272,663135,7,663128
63820,18,-2,312,587475,18,587457
63821,8,-14,556,198572,8,198564
63822,12,17,409,1180957,12,1180945
63823,16,8,944,905310,16,905294
63824,16,14,606,1090137,16,1090121
63825,19,18,133,1210010,19,1209991
63826,7,17,311,1162033,7,1162026
63827,10,-10,467,322845,10,322835
63828,6,-5,62,469207,6,469201
63829,15,-18,51,85580,15,85565
63830,12,-19,791,60127,12,60115
63831,15,12,18,1022214,15,1022199
63832,10,-16,204,128487,10,128477
63833,8,-9,413,352618,8,352610
63834,9,-3,811,548554,9,548545
63835,10,-7,665,419825,10,419815
63836,15,15,318,1119115,15,1119100
63837,13,-5,409,494020,13,494007
63838,5,-10,464,322728,5,322723
63839,20,-16,645,151758,20,151738
63840,10,1,509,668401,10,668391
63841,16,-18,939,92045,16,92029
63842,6,-5,871,486987,6,486981
63843,15,12,471,1025487,15,1025472
63844,7,-7,550,417705,7,417698
63845,6,-7,755,421818,6,421812
63846,17,15,893,1123289,17,1123272
63847,10,14,436,1071585,10,1071575
63848,14,8,314,900435,14,900421
63849,12,-13,599,245441,12,245429
63850,18,12,527,1025895,18,1025877
63851,16,0,406,651148,16,651132
63852,5,-18,613,75550,5,75545
63853,19,10,911,966852,19,966833
63854,8,0,82,627041,8,627033
63855,14,-8,333,400261,14,400247
63856,6,-14,570,199025,6,199019
63857,5,14,929,1082575,5,1082570
63858,5,5,879,800146,5,800141
63859,13,-3,212,555272,13,555259
63860,10,-3,996,552731,10,552721
63861,17,-19,440,57397,17,57380
63862,15,-18,812,91164,15,91149
63863,5,2,275,694517,5,694512
63864,17,11,386,993721,17,993704
63865,11,10,412,962985,11,962974
63866,9,3,922,738849,9,738840
63867,6,-2,609,575738,6,575732
63868,19,2,186,711988,19,711969
63869,18,-6,122,459987,18,459969
63870,15,-4,155,523251,15,523236
63871,9,9,602,919534,9,919525
63872,11,-3,590,558444,11,558433
63873,5,-19,104,33760,5,33755
63874,20,-20,916,29812,20,29792
63875,19,-19,150,55255,19,55236
63876,7,-13,7,218437,7,218430
63877,16,-1,747,622311,16,622295
63878,13,12,260,1024019,13,1024006
63879,18,8,600,902679,18,902661
63880,8,-19,241,36870,8,36862
63881,7,19,898,1237489,7,1237482
63882,10,5,350,788802,10,788792
63883,15,17,250,1179766,15,1179751
63884,13,-17,857,121866,13,121853
63885,12,14,170,1086781,12,1086769
63886,7,-5,553,479959,7,479952
63887,19,13,964,1060379,19,1060360
63888,15,-4,979,529459,15,529444
63889,9,12,260,1004950,9,1004941
63890,5,8,555,887385,5,887380
63891,9,7,54,846033,9,846024
63892,6,15,105,1096758,6,1096752
63893,14,-16,959,153999,14,153985
63894,11,-5,95,491654,11,491643
63895,7,11,561,980488,7,980481
63896,7,10,573,949816,7,949809
63897,13,-1,890,623381,13,623368
63898,5,11,851,986719,5,986714
63899,7,14,406,1070837,7,1070830
63900,20,10,454,963273,20,963253
63901,17,-7,987,435626,17,435609
63902,13,-15,474,181279,13,181266
63903,13,-20,8,5093,13,5080
63904,6,12,191,1003301,6,1003295
63905,12,18,667,1213804,12,1213792
63906,6,5,96,783605,6,783599
63907,20,15,330,1119212,20,1119192
63908,16,-19,68,54407,16,54391
63909,17,16,777,1152625,17,1152608
63910,6,-4,790,516292,6,516286
63911,5,9,863,925111,5,925106
63912,18,-3,34,554068,18,554050
63913,12,12,218,1023680,12,1023668
63914,13,-19,207,55722,13,55709
63915,16,-12,236,274250,16,274234
63916,15,-9,694,371932,15,371917
63917,14,-6,575,463543,14,463529
63918,14,-14,736,215238,14,215224
63919,18,12,540,1026034,18,1026016
63920,8,7,921,864325,8,864317
63921,10,10,19,937925,10,937915
63922,16,-12,236,274256,16,274240
63923,13,-4,93,522761,13,522748
63924,5,3,313,725795,5,725790
63925,14,-20,221,24479,14,24465
63926,13,10,434,963126,13,963113
63927,16,2,491,714314,16,714298
63928,13,12,247,1023873,13,1023860
63929,8,-2,640,576338,8,576330
63930,20,8,503,901953,20,901933
63931,7,-13,322,225215,7,225208
63932,15,-11,593,308445,15,308430
63933,15,-11,434,307255,15,307240
63934,8,-20,851,18916,8,18908
63935,15,11,96,991572,15,991557
63936,10,-2,743,578555,10,578545
63937,14,-18,631,89816,14,89802
63938,16,-8,284,399880,16,399864
63939,15,13,429,1056430,15,1056415
63940,6,0,694,640583,6,640577
63941,18,10,603,964579,18,964561
63942,7,1,730,672904,7,672897
63943,19,12,744,1027607,19,1027588
63944,11,-19,688,59371,11,59360
63945,6,-1,958,614557,6,614551
63946,18,10,769,965777,18,965759
63947,6,11,851,986725,6,986719
63948,11,2,519,714572,11,714561
63949,20,10,854,966374,20,966354
63950,6,-20,794,17533,6,17527
63951,11,16,408,1150065,11,1150054
63952,5,-4,936,519485,5,519480
63953,11,3,960,749201,11,749190
63954,16,11,668,995583,16,995567
63955,19,-1,79,617189,19,617170
63956,15,8,579,902493,15,902478
63957,5,-2,226,567595,5,567590
63958,12,-18,282,87441,12,87429
63959,17,-12,688,277566,17,277549
63960,17,-3,933,561255,17,561238
63961,20,-19,36,54138,20,54118
63962,17,19,746,1246861,17,1246844
63963,15,8,433,901410,15,901395
63964,6,12,924,1019484,6,1019478
63965,16,-6,147,460253,16,460237
63966,19,10,644,964895,19,964876
63967,15,-19,382,56982,15,56967
63968,14,19,111,1241680,14,1241666
63969,17,-11,565,308228,17,308211
63970,10,7,678,859211,10,859201
63971,14,-4,119,522912,14,522898
63972,6,15,496,1104914,6,1104908
63973,12,5,959,810869,12,810857
63974,10,-2,91,564767,10,564757
63975,6,14,73,1063464,6,1063458
63976,5,12,554,1010995,5,1010990
63977,6,7,652,858569,6,858563
63978,11,-6,864,465639,11,465628
63979,5,-8,213,380057,5,380052
63980,5,-12,399,258296,5,258291
63981,8,19,85,1219425,8,1219417
63982,10,18,816,1203980,10,1203970
63983,12,4,486,776732,12,776720
63984,7,-19,50,32554,7,32547
63985,14,-5,23,490993,14,490979
63986,6,-12,492,260214,6,260208
63987,12,-15,177,179057,12,179045
63988,20,9,734,934450,20,934430
63989,10,-20,394,8571,10,8561
63990,10,10,605,950582,10,950572
63991,17,4,828,779399,17,779382
63992,10,-11,532,292979,10,292969
63993,11,13,309,1055471,11,1055460
63994,16,16,218,1148702,16,1148686
63995,8,-20,917,20293,8,20285
63996,19,7,996,874084,19,874065
63997,15,9,94,929763,15,929748
63998,10,-9,967,365106,10,365096
63999,8,6,43,813171,8,813163
64000,13,-6,40,459442,13,459429
64001,13,-7,773,433951,13,433938
64002,5,-5,973,489217,5,489212
64003,16,-18,752,90766,16,90750
64004,15,-4,302,524424,15,524409
64005,17,11,583,995051,17,995034
64006,10,17,251,1160625,10,1160615
64007,20,3,914,748743,20,748723
64008,5,-14,955,207304,5,207299
64009,6,11,973,989312,6,989306
64010,5,-1,74,595402,5,595397
64011,17,-9,508,370686,17,370669
64012,12,19,277,1242987,12,1242975
64013,18,-13,305,243338,18,243320
64014,19,-3,316,556092,19,556073
64015,18,-1,219,618270,18,618252
64016,9,-15,63,156660,9,156651
64017,12,1,499,683814,12,683802
64018,14,9,312,931292,14,931278
64019,20,-15,26,178013,20,177993
64020,13,6,184,837142,13,837129
64021,7,-11,606,294590,7,294583
64022,16,-18,693,90261,16,90245
64023,7,-17,572,105881,7,105874
64024,18,-8,50,398291,18,398273
64025,5,-1,244,599242,5,599237
64026,8,0,128,628301,8,628293
64027,7,-3,13,530880,7,530873
64028,8,-11,821,298658,8,298650
64029,9,-17,420,102319,9,102310
64030,9,-9,796,361403,9,361394
64031,8,9,66,908130,8,908122
64032,14,-1,67,617069,14,617055
64033,15,-14,546,213700,15,213685
64034,14,3,149,742970,14,742956
64035,11,15,861,1123078,11,1123067
64036,12,-1,24,616700,12,616688
64037,5,3,228,723808,5,723803
64038,9,-4,677,514068,9,514059
64039,6,-1,214,598415,6,598409
64040,17,-2,460,588604,17,588587
64041,17,3,716,747288,17,747271
64042,19,-20,430,26012,19,25993
64043,8,-16,547,135925,8,135917
64044,20,-3,522,557877,20,557857
64045,18,17,689,1183009,18,1182991
64046,7,10,258,942916,7,942909
64047,10,-13,876,237349,10,237339
64048,14,-4,701,527353,14,527339
64049,12,9,841,935324,12,935312
64050,8,-19,562,43794,8,43786
64051,8,18,285,1193036,8,1193028
64052,13,18,925,1215714,13,1215701
64053,14,-4,771,527808,14,527794
64054,17,-3,156,554861,17,554844
64055,10,-8,690,390292,10,390282
64056,17,13,495,1056898,17,1056881
64057,7,11,5,968560,7,968553
64058,16,-2,626,589837,16,589821
64059,15,1,178,681294,15,681279
64060,7,8,924,895218,7,895211
64061,11,-6,716,464601,11,464590
64062,11,-11,736,309422,11,309411
64063,18,-4,688,527292,18,527274
64064,16,-6,947,466313,16,466297
64065,13,7,32,867244,13,867231
64066,14,19,215,1242447,14,1242433
64067,6,10,719,953015,6,953009
64068,19,15,940,1123648,19,1123629
64069,7,-15,104,157717,7,157710
64070,14,0,19,648352,14,648338
64071,11,18,940,1215832,11,1215821
64072,20,6,102,836511,20,836491
64073,15,9,904,935786,15,935771
64074,8,3,334,726187,8,726179
64075,8,18,882,1205340,8,1205332
64076,10,-13,111,220795,10,220785
64077,17,19,617,1245808,17,1245791
64078,9,7,504,855607,9,855598
64079,12,-3,50,554173,12,554161
64080,7,-3,885,550229,7,550222
64081,7,-5,134,470995,7,470988
64082,18,1,445,683332,18,683314
64083,15,15,575,1120968,15,1120953
64084,11,-16,607,151467,11,151456
64085,8,10,29,938173,8,938165
64086,9,-16,612,137337,9,137328
64087,10,17,922,1175092,10,1175082
64088,20,-18,379,88155,20,88135
64089,7,-7,328,413019,7,413012
64090,8,19,855,1236546,8,1236538
64091,6,-20,326,7288,6,7282
64092,17,-18,706,90381,17,90364
64093,17,10,413,963000,17,962983
64094,17,-3,305,556018,17,556001
64095,20,-19,554,58379,20,58359
64096,12,-20,701,28195,12,28183
64097,8,-4,941,519640,8,519632
64098,18,-9,357,369331,18,369313
64099,5,-18,231,67574,5,67569
64100,12,-15,500,181467,12,181455
64101,15,7,550,871082,15,871067
64102,16,-5,321,493490,16,493474
64103,15,15,40,1117100,15,1117085
64104,7,3,41,719687,7,719680
64105,9,6,489,823453,9,823444
64106,19,10,555,964106,19,964087
64107,12,-13,227,242730,12,242718
64108,6,14,999,1084305,6,1084299
64109,16,-4,539,526185,16,526169
64110,12,15,264,1118737,12,1118725
64111,11,0,645,653135,11,653124
64112,13,18,610,1213319,13,1213306
64113,5,-5,18,468162,5,468157
64114,13,12,853,1028495,13,1028482
64115,5,8,953,895884,5,895879
64116,13,12,830,1028244,13,1028231
64117,18,13,828,1059442,18,1059424
64118,19,11,234,992488,19,992469
64119,9,-14,679,201575,9,201566
64120,20,-2,859,591678,20,591658
64121,10,-1,643,607738,10,607728
64122,8,-16,10,124044,8,124036
64123,11,-19,933,61013,11,61002
64124,5,-16,606,137201,5,137196
64125,11,14,680,1090807,11,1090796
64126,15,-6,414,462308,15,462293
64127,14,18,318,1211409,14,1211395
64128,15,-20,869,29486,15,29471
64129,8,3,952,739527,8,739519
64130,19,-16,880,153461,19,153442
64131,8,19,422,1227305,8,1227297
64132,12,-14,492,213311,12,213299
64133,12,-19,799,60186,12,60174
64134,13,-17,569,119791,13,119778
64135,15,6,830,842449,15,842434
64136,6,9,241,911802,6,911796
64137,16,-19,214,55774,16,55758
64138,11,-15,245,179543,11,179532
64139,7,0,868,644197,7,644190
64140,14,-14,570,214014,14,214000
64141,10,7,431,854063,10,854053
64142,10,1,572,669874,10,669864
64143,8,14,974,1083593,8,1083585
64144,6,5,729,796809,6,796803
64145,18,-3,695,559315,18,559297
64146,17,16,678,1151971,17,1151954
64147,15,-7,435,431591,15,431576
64148,13,-14,41,209626,13,209613
64149,16,6,151,836914,16,836898
64150,14,-16,404,149882,14,149868
64151,13,-16,753,152443,13,152430
64152,14,9,479,932523,14,932509
64153,9,5,445,790863,9,790854
64154,12,1,638,684887,12,684875
64155,13,-15,280,179793,13,179780
64156,16,-5,422,494122,16,494106
64157,9,-5,824,485744,9,485735
64158,14,-18,941,92051,14,92037
64159,11,-20,986,30341,11,30330
64160,7,-20,664,14637,7,14630
64161,11,-3,990,561691,11,561680
64162,10,11,69,969968,10,969958
64163,7,1,283,663334,7,663327
64164,9,12,6,999189,9,999180
64165,5,16,468,1135231,5,1135226
64166,8,16,405,1133888,8,1133880
64167,9,18,794,1203609,9,1203600
64168,9,13,49,1031823,9,1031814
64169,9,0,77,626918,9,626909
64170,8,-1,217,598488,8,598480
64171,9,9,348,914078,9,914069
64172,6,17,683,1169897,6,1169891
64173,19,-9,840,373183,19,373164
64174,13,16,698,1152067,13,1152054
64175,8,-2,130,565669,8,565661
64176,13,17,605,1182366,13,1182353
64177,17,8,84,898556,17,898539
64178,18,17,587,1182208,18,1182190
64179,11,11,240,992541,11,992530
64180,10,-10,128,315418,10,315408
64181,16,16,181,1148423,16,1148407
64182,20,-6,978,466575,20,466555
64183,20,-18,849,91348,20,91328
64184,8,-15,320,162366,8,162358
64185,18,19,772,1247053,18,1247035
64186,11,-4,862,528448,11,528437
64187,12,-14,819,215922,12,215910
64188,11,-7,591,432763,11,432752
64189,17,-10,546,339145,17,339128
64190,18,-16,137,147955,18,147937
64191,14,-6,465,462718,14,462704
64192,13,-16,632,151666,13,151653
64193,18,14,491,1089299,18,1089281
64194,6,-2,826,580470,6,580464
64195,15,18,952,1215980,15,1215965
64196,8,-17,329,100582,8,100574
64197,5,14,586,1074817,5,1074812
64198,13,-16,186,148281,13,148268
64199,5,19,922,1237949,5,1237944
64200,14,-18,112,86063,14,86049
64201,9,19,192,1221772,9,1221763
64202,9,9,596,919433,9,919424
64203,10,1,280,663265,10,663255
64204,6,-11,17,281443,6,281437
64205,14,5,380,806585,14,806571
64206,17,1,394,682984,17,682967
64207,12,-16,899,153542,12,153530
64208,15,1,586,684517,15,684502
64209,18,2,372,713424,18,713406
64210,17,5,1,803797,17,803780
64211,6,13,988,1051816,6,1051810
64212,20,-20,655,27795,20,27775
64213,6,-19,877,50634,6,50628
64214,10,8,987,896665,10,896655
64215,8,12,375,1007238,8,1007230
64216,7,10,114,940135,7,940128
64217,15,-3,231,555385,15,555370
64218,18,-16,825,152979,18,152961
64219,14,1,649,684963,14,684949
64220,10,-17,60,94687,10,94677
64221,12,-12,193,273874,12,273862
64222,6,-9,157,346967,6,346961
64223,7,-7,744,421580,7,421573
64224,7,-12,821,267370,7,267363
64225,7,3,323,725978,7,725971
64226,8,-9,217,348180,8,348172
64227,5,-20,78,1780,5,1775
64228,11,-3,349,556336,11,556325
64229,7,-11,184,285112,7,285105
64230,9,8,859,893810,9,893801
64231,14,-5,290,493208,14,493194
64232,9,-13,373,226171,9,226162
64233,15,3,465,745321,15,745306
64234,18,19,498,1244878,18,1244860
64235,7,-8,474,385075,7,385068
64236,11,0,196,649748,11,649737
64237,17,-5,131,491961,17,491944
64238,7,-4,650,513384,7,513377
64239,9,12,903,1019007,9,1018998
64240,14,-7,532,432362,14,432348
64241,9,-3,187,534390,9,534381
64242,6,-8,47,376395,6,376389
64243,8,-17,400,101971,8,101963
64244,20,2,514,714513,20,714493
64245,19,9,321,931361,19,931342
64246,12,-19,146,55173,12,55161
64247,13,-16,670,151826,13,151813
64248,8,-15,568,167643,8,167635
64249,17,-9,607,371420,17,371403
64250,10,12,812,1016699,10,1016689
64251,10,-13,928,238480,10,238470
64252,11,-1,334,619252,11,619241
64253,6,12,137,1002098,6,1002092
64254,12,10,1,959838,12,959826
64255,5,0,866,644172,5,644167
64256,19,-3,556,558179,19,558160
64257,6,2,18,688919,6,688913
64258,6,-11,221,285834,6,285828
64259,19,-9,69,367148,19,367129
64260,11,9,585,933376,11,933365
64261,17,13,327,1055642,17,1055625
64262,11,9,794,934944,11,934933
64263,19,13,341,1055753,19,1055734
64264,14,-18,869,91537,14,91523
64265,17,6,747,841779,17,841762
64266,13,-10,23,335302,13,335289
64267,16,13,178,1054518,16,1054502
64268,9,5,114,783942,9,783933
64269,19,7,195,868396,19,868377
64270,8,5,273,787347,8,787339
64271,10,4,477,760859,10,760849
64272,17,-10,208,336616,17,336599
64273,16,6,627,840829,16,840813
64274,9,-19,657,45971,9,45962
64275,6,-14,10,186685,6,186679
64276,17,8,805,904308,17,904291
64277,7,2,969,708919,7,708912
64278,19,8,499,901929,19,901910
64279,8,-3,449,540500,8,540492
64280,12,-3,86,554367,12,554355
64281,11,10,915,966889,11,966878
64282,6,15,181,1098316,6,1098310
64283,20,9,310,931258,20,931238
64284,18,-9,884,373606,18,373588
64285,7,12,960,1020310,7,1020303
64286,12,2,563,714816,12,714804
64287,11,15,999,1124110,11,1124099
64288,7,1,862,675787,7,675780
64289,15,-19,132,55064,15,55049
64290,5,-15,281,161393,5,161388
64291,7,-8,560,387148,7,387141
64292,20,-14,490,213292,20,213272
64293,10,-8,686,390138,10,390128
64294,15,7,225,868585,15,868570
64295,10,-8,168,379085,10,379075
64296,14,-10,159,336264,14,336250
64297,8,14,563,1074373,8,1074365
64298,12,17,480,1181516,12,1181504
64299,5,-20,852,18940,5,18935
64300,5,19,437,1227677,5,1227672
64301,17,18,885,1215433,17,1215416
64302,17,-3,631,558846,17,558829
64303,6,-15,142,158524,6,158518
64304,9,18,166,1190434,9,1190425
64305,8,9,688,921217,8,921209
64306,17,17,357,1180639,17,1180622
64307,15,-16,729,152256,15,152241
64308,7,-13,333,225387,7,225380
64309,7,-10,9,312726,7,312719
64310,12,1,192,681378,12,681366
64311,10,-20,294,6577,10,6567
64312,17,1,920,687051,17,687034
64313,13,-20,826,29215,13,29202
64314,8,-12,196,253704,8,253696
64315,17,1,249,681874,17,681857
64316,10,15,425,1103398,10,1103388
64317,10,10,884,956498,10,956488
64318,6,-17,264,99108,6,99102
64319,7,17,131,1158023,7,1158016
64320,11,-3,921,561172,11,561161
64321,7,11,763,984830,7,984823
64322,18,-20,83,23420,18,23402
64323,5,-2,776,579301,5,579296
64324,17,-10,198,336536,17,336519
64325,7,-15,425,164657,7,164650
64326,9,-20,826,18364,9,18355
64327,16,17,421,1181047,16,1181031
64328,13,-3,506,557698,13,557685
64329,9,15,674,1108734,9,1108725
64330,13,0,571,652568,13,652555
64331,20,-4,567,526374,20,526354
64332,19,-3,68,554262,19,554243
64333,17,13,405,1056262,17,1056245
64334,7,4,476,760831,7,760824
64335,9,15,450,1103988,9,1103979
64336,13,-5,415,494085,13,494072
64337,15,19,328,1243417,15,1243402
64338,14,18,39,1209187,14,1209173
64339,10,-10,563,324901,10,324891
64340,15,-9,988,374186,15,374171
64341,11,-2,111,585971,11,585960
64342,17,-2,473,588733,17,588716
64343,14,9,834,935251,14,935237
64344,16,14,715,1091126,16,1091110
64345,18,4,425,776340,18,776322
64346,12,-1,404,619782,12,619770
64347,15,-12,455,275804,15,275789
64348,17,10,423,963075,17,963058
64349,14,-4,192,523538,14,523524
64350,12,0,544,652342,12,652330
64351,15,-2,369,587817,15,587802
64352,5,2,895,707233,5,707228
64353,8,15,839,1112294,8,1112286
64354,19,0,93,648960,19,648941
64355,18,3,191,743338,18,743320
64356,19,16,749,1152399,19,1152380
64357,20,16,310,1149379,20,1149359
64358,10,-4,100,501554,10,501544
64359,12,13,371,1055957,12,1055945
64360,19,6,15,835908,19,835889
64361,8,-10,491,323318,8,323310
64362,14,-1,253,618510,14,618496
64363,11,11,788,996558,11,996547
64364,8,8,291,881567,8,881559
64365,11,-18,225,87040,11,87029
64366,13,-10,559,339243,13,339230
64367,19,18,657,1213717,19,1213698
64368,20,-10,500,338790,20,338770
64369,9,-16,622,137559,9,137550
64370,11,11,509,994546,11,994535
64371,7,7,798,861675,7,861668
64372,16,-13,120,241910,16,241894
64373,10,-18,651,76357,10,76347
64374,17,17,249,1179754,17,1179737
64375,13,9,440,932237,13,932224
64376,12,2,236,712337,12,712325
64377,9,12,368,1007159,9,1007150
64378,16,-1,230,618401,16,618385
64379,20,12,519,1025828,20,1025808
64380,5,12,976,1020612,5,1020607
64381,5,-9,813,361720,5,361715
64382,15,2,698,715886,15,715871
64383,7,-10,160,316130,7,316123
64384,6,-8,442,384471,6,384465
64385,15,-3,5,553891,15,553876
64386,5,-11,579,294002,5,293997
64387,7,-1,550,605972,7,605965
64388,16,7,341,869505,16,869489
64389,11,12,257,1023991,11,1023980
64390,18,-18,805,91130,18,91112
64391,11,-5,537,495021,11,495010
64392,12,10,84,960488,12,960476
64393,18,-9,516,370744,18,370726
64394,6,-1,208,598231,6,598225
64395,16,-4,539,526191,16,526175
64396,6,16,942,1144791,6,1144785
64397,19,-13,878,247602,19,247583
64398,11,-5,215,492559,11,492548
64399,18,-10,926,342037,18,342019
64400,15,-10,120,335992,15,335977
64401,18,3,160,743034,18,743016
64402,9,-16,373,132012,9,132003
64403,19,-1,624,621410,19,621391
64404,8,-17,835,111209,8,111201
64405,15,7,907,873501,15,873486
64406,14,19,298,1243153,14,1243139
64407,7,12,693,1014323,7,1014316
64408,17,-13,159,242198,17,242181
64409,12,17,41,1178179,12,1178167
64410,5,17,766,1171540,5,1171535
64411,15,11,520,994613,15,994598
64412,13,18,53,1209317,13,1209304
64413,6,-1,802,611085,6,611079
64414,11,-6,531,463235,11,463224
64415,15,3,691,747130,15,747115
64416,10,-6,48,437859,10,437849
64417,5,-4,412,508546,5,508541
64418,13,-6,745,464867,13,464854
64419,12,1,41,680110,12,680098
64420,20,3,359,744585,20,744565
64421,12,17,345,1180556,12,1180544
64422,5,0,778,642405,5,642400
64423,19,-7,945,435317,19,435298
64424,11,0,754,654062,11,654051
64425,20,-8,334,400270,20,400250
64426,6,-4,839,517210,6,517204
64427,15,19,171,1242122,15,1242107
64428,15,6,2,835744,15,835729
64429,15,14,342,1088106,15,1088091
64430,14,-3,928,561212,14,561198
64431,14,10,440,963189,14,963175
64432,20,4,591,777583,20,777563
64433,18,-1,982,624033,18,624015
64434,10,15,68,1095909,10,1095899
64435,10,9,465,916432,10,916422
64436,9,-20,148,3290,9,3281
64437,7,5,856,799479,7,799472
64438,8,-11,97,283192,8,283184
64439,19,-8,813,403731,19,403712
64440,20,17,835,1184228,20,1184208
64441,9,-4,911,518997,9,518988
64442,8,-14,542,198215,8,198207
64443,14,6,665,841125,14,841111
64444,13,15,130,1117784,13,1117771
64445,16,-8,61,398400,16,398384
64446,19,8,167,899266,19,899247
64447,15,17,278,1180009,15,1179994
64448,17,4,32,773493,17,773476
64449,15,-17,875,121989,15,121974
64450,18,1,36,680088,18,680070
64451,12,11,491,994434,12,994422
64452,13,13,1,1053256,13,1053243
64453,9,17,594,1167942,9,1167933
64454,6,17,652,1169268,6,1169262
64455,13,-7,565,432571,13,432558
64456,15,5,822,809783,15,809768
64457,12,-7,177,429633,12,429621
64458,12,-20,705,28220,12,28208
64459,7,-7,721,421132,7,421125
64460,6,-10,297,318957,6,318951
64461,7,17,574,1167486,7,1167479
64462,18,-17,740,121113,18,121095
64463,12,-15,671,182770,12,182758
64464,11,2,208,712149,11,712138
64465,16,14,93,1086196,16,1086180
64466,14,-19,794,60151,14,60137
64467,16,-7,345,430954,16,430938
64468,17,-4,489,525738,17,525721
64469,8,17,455,1165112,8,1165104
64470,9,2,193,692820,9,692811
64471,13,-5,487,494655,13,494642
64472,12,0,509,652020,12,652008
64473,19,-13,708,246235,19,246216
64474,6,-20,261,5774,6,5768
64475,14,-17,150,116592,14,116578
64476,8,13,189,1034723,8,1034715
64477,12,-1,871,623201,12,623189
64478,16,10,207,961402,16,961386
64479,14,-10,553,339198,14,339184
64480,5,-1,741,609762,5,609757
64481,18,-12,858,278910,18,278892
64482,20,7,799,872793,20,872773
64483,15,12,167,1023287,15,1023272
64484,13,-7,863,434626,13,434613
64485,12,14,220,1087112,12,1087100
64486,14,-6,77,459620,14,459606
64487,14,-18,499,88942,14,88928
64488,5,5,86,783428,5,783423
64489,15,11,21,991030,15,991015
64490,7,-18,481,72793,7,72786
64491,13,-15,5,177860,13,177847
64492,11,-9,45,366957,11,366946
64493,8,-18,432,71703,8,71695
64494,10,17,732,1170925,10,1170915
64495,7,-16,502,134992,7,134985
64496,19,18,346,1211610,19,1211591
64497,6,-2,966,583511,6,583505
64498,8,-3,331,537721,8,537713
64499,14,-2,718,590559,14,590545
64500,12,-3,838,560492,12,560480
64501,12,9,530,932936,12,932924
64502,16,-6,702,464517,16,464501
64503,7,16,515,1136157,7,1136150
64504,6,-16,948,144364,6,144358
64505,18,15,599,1121166,18,1121148
64506,20,0,585,652705,20,652685
64507,12,-16,753,152445,12,152433
64508,10,-8,235,380507,10,380497
64509,6,-2,854,581081,6,581075
64510,18,-11,563,308216,18,308198
64511,14,-13,909,247832,14,247818
64512,9,19,57,1218687,9,1218678
64513,15,-17,944,122449,15,122434
64514,7,-9,457,353746,7,353739
64515,14,-18,659,90081,14,90067
64516,11,5,580,808019,11,808008
64517,9,16,510,1136054,9,1136045
64518,7,-3,135,533355,7,533348
64519,16,-7,420,431494,16,431478
64520,9,-17,429,102549,9,102540
64521,11,7,773,872594,11,872583
64522,5,-11,952,301687,5,301682
64523,13,9,983,936416,13,936403
64524,10,19,387,1226299,10,1226289
64525,5,13,598,1043681,5,1043676
64526,15,-3,396,556704,15,556689
64527,17,15,794,1122594,17,1122577
64528,20,0,410,651193,20,651173
64529,7,18,6,1186673,7,1186666
64530,5,-11,807,298425,5,298420
64531,16,11,320,993206,16,993190
64532,11,13,258,1055094,11,1055083
64533,9,-20,863,19146,9,19137
64534,11,13,546,1057350,11,1057339
64535,18,7,473,870550,18,870532
64536,17,19,46,1241077,17,1241060
64537,20,19,693,1246401,20,1246381
64538,16,11,891,997351,16,997335
64539,18,-8,812,403696,18,403678
64540,16,1,337,682595,16,682579
64541,18,-6,327,461712,18,461694
64542,8,-15,565,167601,8,167593
64543,9,0,212,630075,9,630066
64544,17,18,736,1214228,17,1214211
64545,13,-4,352,524848,13,524835
64546,11,9,336,931484,11,931473
64547,8,11,313,975076,8,975068
64548,17,-11,174,305126,17,305109
64549,6,19,476,1228392,6,1228386
64550,7,3,849,737174,7,737167
64551,14,16,172,1148306,14,1148292
64552,16,1,1000,687573,16,687557
64553,11,-19,25,54078,11,54067
64554,8,-12,220,254330,8,254322
64555,20,-7,241,430070,20,430050
64556,10,-2,811,580124,10,580114
64557,8,15,450,1103996,8,1103988
64558,16,19,193,1242289,16,1242273
64559,13,8,460,901606,13,901593
64560,16,-17,612,120089,16,120073
64561,19,-1,208,618163,19,618144
64562,10,-5,860,486646,10,486636
64563,6,10,19,937931,6,937925
64564,16,18,423,1212177,16,1212161
64565,18,-9,356,369324,18,369306
64566,9,-12,362,257531,9,257522
64567,9,15,21,1094911,9,1094902
64568,13,3,208,743463,13,743450
64569,16,2,327,713059,16,713043
64570,16,5,323,806137,16,806121
64571,19,-7,756,433782,19,433763
64572,19,-4,29,522254,19,522235
64573,14,15,525,1120588,14,1120574
64574,16,10,318,962265,16,962249
64575,12,-13,817,247089,12,247077
64576,19,8,590,902594,19,902575
64577,5,19,122,1220156,5,1220151
64578,8,14,744,1078680,8,1078672
64579,17,-4,928,529014,17,528997
64580,13,-7,628,432914,13,432901
64581,16,10,5,959857,16,959841
64582,6,9,247,911926,6,911920
64583,13,-10,167,336337,13,336324
64584,6,0,531,636808,6,636802
64585,7,7,565,856826,7,856819
64586,20,-18,314,87700,20,87680
64587,5,9,979,927662,5,927657
64588,17,1,91,680482,17,680465
64589,10,10,286,943587,10,943577
64590,18,0,948,655445,18,655427
64591,14,15,409,1119679,14,1119665
64592,16,16,141,1148096,16,1148080
64593,7,-19,707,47046,7,47039
64594,6,4,750,766937,6,766931
64595,13,4,711,778505,13,778492
64596,19,8,884,904805,19,904786
64597,6,19,415,1227099,6,1227093
64598,5,-12,389,258026,5,258021
64599,8,-2,157,566134,8,566126
64600,20,-20,379,25725,20,25705
64601,18,18,895,1215523,18,1215505
64602,14,9,768,934676,14,934662
64603,9,-5,384,476435,9,476426
64604,8,13,718,1046134,8,1046126
64605,19,5,360,806413,19,806394
64606,15,14,855,1092078,15,1092063
64607,7,1,104,659364,7,659357
64608,6,4,951,771415,6,771409
64609,15,-1,938,623734,15,623719
64610,19,6,568,840392,19,840373
64611,18,-20,749,28576,18,28558
64612,5,4,283,756660,5,756655
64613,20,3,757,747551,20,747531
64614,8,19,269,1223457,8,1223449
64615,5,-5,958,488814,5,488809
64616,19,-11,6,303736,19,303717
64617,5,12,772,1015838,5,1015833
64618,14,-5,216,492566,14,492552
64619,15,-12,786,278256,15,278241
64620,12,-14,723,215157,12,215145
64621,7,-5,41,468793,7,468786
64622,11,-6,966,466442,11,466431
64623,12,-19,518,57978,12,57966
64624,8,-6,460,446625,8,446617
64625,18,-20,686,28109,18,28091
64626,19,6,963,843412,19,843393
64627,13,-16,168,148133,13,148120
64628,8,-14,868,205359,8,205351
64629,10,19,530,1229561,10,1229551
64630,19,0,970,655719,19,655700
64631,16,-4,478,525678,16,525662
64632,9,-5,517,479230,9,479221
64633,11,-4,895,528781,11,528770
64634,20,-11,970,311314,20,311294
64635,11,11,174,992072,11,992061
64636,5,13,779,1047491,5,1047486
64637,19,-14,639,214556,19,214537
64638,18,18,251,1211032,18,1211014
64639,8,-5,93,470152,8,470144
64640,11,6,78,836306,11,836295
64641,9,-8,47,376404,9,376395
64642,11,-1,561,620978,11,620967
64643,16,-12,609,276932,16,276916
64644,13,-9,345,369231,13,369218
64645,19,-3,883,560866,19,560847
64646,12,-14,248,211356,12,211344
64647,5,17,940,1175436,5,1175431
64648,13,-3,407,556806,13,556793
64649,6,13,350,1038331,6,1038325
64650,11,18,880,1215353,11,1215342
64651,8,-10,904,331912,8,331904
64652,20,-15,77,178325,20,178305
64653,11,6,65,836242,11,836231
64654,15,11,244,992590,15,992575
64655,9,18,224,1191660,9,1191651
64656,14,-4,205,523711,14,523697
64657,20,-15,345,180290,20,180270
64658,19,-2,13,585226,19,585207
64659,10,1,987,678441,10,678431
64660,15,-8,490,401237,15,401222
64661,14,5,718,809021,14,809007
64662,8,16,184,1129091,8,1129083
64663,8,-10,938,332665,8,332657
64664,10,-9,243,348879,10,348869
64665,8,14,9,1061928,8,1061920
64666,8,-8,764,391740,8,391732
64667,7,-7,621,419020,7,419013
64668,20,10,890,966628,20,966608
64669,10,-20,843,18774,10,18764
64670,6,-16,467,134290,6,134284
64671,9,-20,99,2218,9,2209
64672,9,-18,899,81945,9,81936
64673,16,1,254,681921,16,681905
64674,10,-13,102,220683,10,220673
64675,14,-15,38,178072,14,178058
64676,6,12,115,1001647,6,1001641
64677,17,6,357,838545,17,838528
64678,14,5,191,805260,14,805246
64679,13,2,115,711461,13,711448
64680,5,-16,522,135400,5,135395
64681,10,17,35,1156040,10,1156030
64682,18,18,474,1212471,18,1212453
64683,5,16,640,1138683,5,1138678
64684,14,-1,7,616552,14,616538
64685,20,10,483,963522,20,963502
64686,20,-20,189,24312,20,24292
64687,20,9,949,936157,20,936137
64688,20,-5,331,493604,20,493584
64689,14,-20,485,26437,14,26423
64690,8,-17,573,105898,8,105890
64691,7,5,454,791041,7,791034
64692,7,-6,695,451785,7,451778
64693,5,7,971,865247,5,865242
64694,14,-15,791,183637,14,183623
64695,16,-7,621,432863,16,432847
64696,15,-14,657,214644,15,214629
64697,11,-17,503,119253,11,119242
64698,10,11,694,983192,10,983182
64699,9,-3,31,531232,9,531223
64700,10,16,18,1125581,10,1125571
64701,10,6,640,826772,10,826762
64702,11,-3,314,556067,11,556056
64703,17,1,546,684227,17,684210
64704,16,16,960,1153937,16,1153921
64705,9,-19,97,33603,9,33594
64706,18,3,68,742318,18,742300
64707,14,-6,127,460029,14,460015
64708,11,-4,24,522228,11,522217
64709,9,8,324,882374,9,882365
64710,5,-8,694,390339,5,390334
64711,5,-17,538,105030,5,105025
64712,12,-19,55,54268,12,54256
64713,20,-10,249,336907,20,336887
64714,19,-18,375,88102,19,88083
64715,9,6,686,827768,9,827759
64716,19,-16,367,149594,19,149575
64717,9,-1,509,605090,9,605081
64718,9,-15,637,169165,9,169156
64719,10,9,758,922607,10,922597
64720,16,-1,413,619835,16,619819
64721,8,11,128,971172,8,971164
64722,6,-10,940,332707,6,332701
64723,17,-16,100,147658,17,147641
64724,7,-1,167,597344,7,597337
64725,12,11,498,994476,12,994464
64726,19,-10,659,340032,19,340013
64727,20,-5,663,495844,20,495824
64728,13,8,893,904884,13,904871
64729,11,4,213,774805,11,774794
64730,6,-3,773,547762,6,547756
64731,18,-16,97,147647,18,147629
64732,16,11,369,993572,16,993556
64733,10,-1,707,609123,10,609113
64734,18,-15,822,183939,18,183921
64735,14,-14,627,214447,14,214433
64736,13,-1,232,618403,13,618390
64737,19,-2,250,587019,19,587000
64738,17,-14,315,211838,17,211821
64739,20,-16,452,150378,20,150358
64740,11,9,507,932776,11,932765
64741,9,6,826,830884,9,830875
64742,16,-11,618,308649,16,308633
64743,7,11,878,987381,7,987374
64744,14,-13,899,247721,14,247707
64745,18,9,787,934869,18,934851
64746,11,-12,932,279528,11,279517
64747,11,0,869,654844,11,654833
64748,7,12,596,1011845,7,1011838
64749,19,-8,438,400918,19,400899
64750,19,-5,315,493413,19,493394
64751,20,14,20,1085537,20,1085517
64752,7,7,668,858992,7,858985
64753,18,-15,759,183408,18,183390
64754,19,0,796,654334,19,654315
64755,14,13,107,1054023,14,1054009
64756,17,-3,433,557056,17,557039
64757,20,-6,191,460659,20,460639
64758,12,11,2,990867,12,990855
64759,9,3,874,737709,9,737700
64760,7,18,897,1205766,7,1205759
64761,17,-14,331,212015,17,211998
64762,11,-3,951,561419,11,561408
64763,5,6,486,823370,5,823365
64764,16,4,556,777280,16,777264
64765,6,4,155,753913,6,753907
64766,15,18,473,1212464,15,1212449
64767,12,-10,257,336981,12,336969
64768,19,-16,216,148577,19,148558
64769,5,-4,592,512180,5,512175
64770,11,-18,254,87301,11,87290
64771,17,-19,11,53960,17,53943
64772,15,12,881,1028696,15,1028681
64773,7,13,172,1034331,7,1034324
64774,20,7,666,871936,20,871916
64775,9,8,505,886322,9,886313
64776,20,4,589,777552,20,777532
64777,11,7,615,871524,11,871513
64778,5,-7,390,414378,5,414373
64779,19,-9,611,371440,19,371421
64780,8,-16,106,126347,8,126339
64781,8,15,505,1105191,8,1105183
64782,14,2,130,711595,14,711581
64783,20,-3,760,559869,20,559849
64784,8,12,309,1006018,8,1006010
64785,15,-6,358,461916,15,461901
64786,6,16,519,1136274,6,1136268
64787,19,6,272,837852,19,837833
64788,18,-3,350,556343,18,556325
64789,12,-1,64,617022,12,617010
64790,13,-7,676,433207,13,433194
64791,15,2,276,712622,15,712607
64792,9,14,646,1076404,9,1076395
64793,13,4,240,775023,13,775010
64794,19,14,48,1085802,19,1085783
64795,15,12,831,1028260,15,1028245
64796,17,-12,283,274608,17,274591
64797,17,-5,289,493205,17,493188
64798,11,-14,64,209802,11,209791
64799,13,-15,729,183213,13,183200
64800,5,-6,788,453756,5,453751
64801,14,0,71,648773,14,648759
64802,15,-15,953,185058,15,185043
64803,7,-2,543,574223,7,574216
64804,7,6,667,827367,7,827360
64805,13,-18,72,85757,13,85744
64806,7,17,102,1157361,7,1157354
64807,12,6,899,842923,12,842911
64808,13,17,93,1178524,13,1178511
64809,19,5,705,808938,19,808919
64810,19,0,570,652556,19,652537
64811,12,4,845,779586,12,779574
64812,18,6,513,839950,18,839932
64813,14,-1,980,623989,14,623975
64814,16,-14,241,211300,16,211284
64815,5,0,455,635264,5,635259
64816,10,15,992,1115571,10,1115561
64817,7,17,704,1170315,7,1170308
64818,17,-5,510,494797,17,494780
64819,9,-18,297,68995,9,68986
64820,8,-5,73,469516,8,469508
64821,16,-5,856,497261,16,497245
64822,11,-10,782,340943,11,340932
64823,18,-1,238,618462,18,618444
64824,7,0,732,641469,7,641462
64825,11,-19,308,56373,11,56362
64826,9,-1,529,605595,9,605586
64827,15,-1,790,622644,15,622629
64828,8,-17,889,112337,8,112329
64829,13,-4,157,523253,13,523240
64830,8,-4,95,501443,8,501435
64831,6,-15,545,167191,6,167185
64832,11,18,275,1211167,11,1211156
64833,7,4,39,751390,7,751383
64834,17,1,337,682602,17,682585
64835,17,-6,474,462786,17,462769
64836,20,19,940,1248343,20,1248323
64837,20,2,630,715321,20,715301
64838,15,5,33,803986,15,803971
64839,9,18,508,1197622,9,1197613
64840,20,-6,449,462560,20,462540
64841,5,-16,933,144103,5,144098
64842,8,-16,988,145295,8,145287
64843,18,-3,552,558149,18,558131
64844,19,18,84,1209600,19,1209581
64845,15,17,477,1181495,15,1181480
64846,17,17,578,1182100,17,1182083
64847,18,-8,449,400989,18,400971
64848,19,-14,632,214485,19,214466
64849,6,8,453,885089,6,885083
64850,5,-1,85,595631,5,595626
64851,5,-5,590,480815,5,480810
64852,14,10,780,965890,14,965876
64853,13,6,402,838993,13,838980
64854,12,-8,360,400402,12,400390
64855,7,1,372,665415,7,665408
64856,13,-8,488,401209,13,401196
64857,17,-1,379,619597,17,619580
64858,13,-2,52,585562,13,585549
64859,19,15,91,1117468,19,1117449
64860,15,1,861,686529,15,686514
64861,13,18,206,1210672,13,1210659
64862,8,-18,659,76575,8,76567
64863,15,-2,898,591983,15,591968
64864,15,10,400,962848,15,962833
64865,13,6,869,842701,13,842688
64866,11,-20,877,29555,11,29544
64867,5,-13,646,232104,5,232099
64868,13,12,257,1023994,13,1023981
64869,5,2,551,700274,5,700269
64870,15,-11,668,309055,15,309040
64871,11,10,295,962034,11,962023
64872,10,-7,108,408147,10,408137
64873,6,13,552,1042630,6,1042624
64874,11,-3,411,556838,11,556827
64875,5,-17,155,96684,5,96679
64876,9,6,104,814444,9,814435
64877,6,12,616,1012401,6,1012395
64878,7,-18,783,79425,7,79418
64879,6,12,301,1005790,6,1005784
64880,9,-13,373,226180,9,226171
64881,17,3,171,743121,17,743104
64882,6,4,153,753879,6,753873
64883,8,-14,941,206931,8,206923
64884,10,-18,537,73921,10,73911
64885,14,-18,221,86987,14,86973
64886,7,-7,504,416625,7,416618
64887,18,8,155,899181,18,899163
64888,10,14,405,1070807,10,1070797
64889,7,17,126,1157924,7,1157917
64890,17,-18,573,89398,17,89381
64891,15,2,66,711025,15,711010
64892,16,-13,760,246664,16,246648
64893,11,3,644,746692,11,746681
64894,15,-1,904,623504,15,623489
64895,14,-6,404,462222,14,462208
64896,6,2,22,689064,6,689058
64897,11,-1,675,621750,11,621739
64898,8,-6,369,444652,8,444644
64899,10,-13,688,232876,10,232866
64900,11,-17,674,120586,11,120575
64901,10,14,402,1070727,10,1070717
64902,14,7,241,868749,14,868735
64903,5,17,688,1170018,5,1170013
64904,16,-8,684,402757,16,402741
64905,11,-17,360,118154,11,118143
64906,8,-15,789,172187,8,172179
64907,20,-3,789,560148,20,560128
64908,12,-2,604,589678,12,589666
64909,19,13,972,1060441,19,1060422
64910,16,18,256,1211045,16,1211029
64911,8,10,40,938360,8,938352
64912,11,-19,30,54108,11,54097
64913,14,-5,293,493241,14,493227
64914,18,-2,684,590285,18,590267
64915,7,5,931,801230,7,801223
64916,19,-1,841,623013,19,622994
64917,7,10,55,938718,7,938711
64918,19,-9,614,371457,19,371438
64919,10,0,710,640897,10,640887
64920,9,4,884,770062,9,770053
64921,17,4,483,776720,17,776703
64922,20,19,541,1245246,20,1245226
64923,11,17,757,1183517,11,1183506
64924,18,12,116,1022909,18,1022891
64925,20,2,673,715665,20,715645
64926,7,-3,889,550326,7,550319
64927,12,5,190,805240,12,805228
64928,20,16,887,1153388,20,1153368
64929,10,-9,395,352310,10,352300
64930,10,-20,296,6627,10,6617
64931,6,-19,703,46934,6,46928
64932,18,-20,967,30112,18,30094
64933,19,7,978,873967,19,873948
64934,9,15,913,1113895,9,1113886
64935,20,-8,302,399987,20,399967
64936,6,-18,922,82452,6,82446
64937,8,4,715,766057,8,766049
64938,17,-10,450,338419,17,338402
64939,11,0,137,649271,11,649260
64940,7,4,344,757936,7,757929
64941,14,-16,100,147662,14,147648
64942,20,7,518,870909,20,870889
64943,6,-7,772,422249,6,422243
64944,5,-5,434,477390,5,477385
64945,11,8,26,898075,11,898064
64946,18,6,573,840415,18,840397
64947,8,-1,899,613308,8,613300
64948,12,8,803,904290,12,904278
64949,12,-18,698,90281,12,90269
64950,18,-2,578,589476,18,589458
64951,10,14,773,1079298,10,1079288
64952,12,13,978,1060472,12,1060460
64953,20,19,443,1244515,20,1244495
64954,13,-16,256,148839,13,148826
64955,6,6,159,815594,6,815588
64956,20,16,951,1153876,20,1153856
64957,12,-13,466,244414,12,244402
64958,17,2,289,712768,17,712751
64959,13,6,75,836301,13,836288
64960,11,17,517,1181773,11,1181762
64961,15,-12,458,275827,15,275812
64962,6,5,373,789333,6,789327
64963,13,-16,33,146974,13,146961
64964,5,16,380,1133266,5,1133261
64965,18,-10,266,337034,18,337016
64966,9,-6,250,442287,9,442278
64967,18,14,996,1093316,18,1093298
64968,11,19,822,1247397,11,1247386
64969,15,-16,92,147584,15,147569
64970,8,-3,554,542972,8,542964
64971,15,10,793,966025,15,966010
64972,19,-2,62,585634,19,585615
64973,9,6,498,823598,9,823589
64974,6,14,74,1063469,6,1063463
64975,12,-8,310,400078,12,400066
64976,12,15,766,1122443,12,1122431
64977,10,-3,327,537548,10,537538
64978,12,14,578,1089911,12,1089899
64979,18,9,47,929435,18,929417
64980,6,12,407,1007817,6,1007811
64981,14,8,666,903233,14,903219
64982,20,-19,596,58709,20,58689
64983,13,8,848,904570,13,904557
64984,14,-1,303,618983,14,618969
64985,7,4,45,751542,7,751535
64986,18,-9,343,369213,18,369195
64987,8,11,374,976471,8,976463
64988,5,-9,551,356136,5,356131
64989,5,-5,240,473333,5,473328
64990,13,13,997,1060619,13,1060606
64991,18,6,588,840522,18,840504
64992,10,2,404,697422,10,697412
64993,16,-16,776,152610,16,152594
64994,15,2,309,712910,15,712895
64995,9,11,965,989131,9,989122
64996,12,0,901,655116,12,655104
64997,11,-9,87,367288,11,367277
64998,16,-4,639,526907,16,526891
64999,9,14,422,1071293,9,1071284
65000,8,0,659,639784,8,639776
65001,9,-18,224,67303,9,67294
65002,7,17,336,1162619,7,1162612
65003,14,9,466,932408,14,932394
65004,10,7,156,848145,10,848135
65005,5,-16,962,144737,5,144732
65006,14,11,871,997197,14,997183
65007,18,-1,266,618634,18,618616
65008,17,9,951,936177,17,936160
65009,8,-11,757,297420,8,297412
65010,20,-18,245,87240,20,87220
65011,19,12,195,1023425,19,1023406
65012,11,-18,75,85811,11,85800
65013,8,-8,843,393320,8,393312
65014,9,-10,335,319828,9,319819
65015,14,-20,683,28064,14,28050
65016,11,-5,689,496072,11,496061
65017,14,-6,240,461044,14,461030
65018,9,14,655,1076663,9,1076654
65019,5,6,604,825956,5,825951
65020,13,-10,335,337494,13,337481
65021,5,7,473,855001,5,854996
65022,10,-8,684,390081,10,390071
65023,10,15,93,1096425,10,1096415
65024,11,15,288,1118935,11,1118924
65025,19,-16,348,149476,19,149457
65026,17,5,301,806011,17,805994
65027,11,-16,482,150572,11,150561
65028,7,-8,328,382397,7,382390
65029,18,12,758,1027666,18,1027648
65030,11,-11,748,309546,11,309535
65031,12,-4,754,527668,12,527656
65032,14,-4,400,525230,14,525216
65033,13,14,769,1091511,13,1091498
65034,7,3,783,735614,7,735607
65035,8,-16,693,138890,8,138882
65036,5,-5,449,477667,5,477662
65037,16,-9,45,366963,16,366947
65038,12,-12,551,276603,12,276591
65039,15,0,796,654339,15,654324
65040,15,-17,838,121777,15,121762
65041,14,1,214,681589,14,681575
65042,6,-20,615,13435,6,13429
65043,14,5,982,810993,14,810979
65044,5,-6,137,439661,5,439656
65045,19,15,968,1123917,19,1123898
65046,12,17,751,1183478,12,1183466
65047,8,0,758,641974,8,641966
65048,15,-20,127,23728,15,23713
65049,10,-20,297,6664,10,6654
65050,6,-5,816,485566,6,485560
65051,6,-6,541,448483,6,448477
65052,16,-17,399,118409,16,118393
65053,14,-7,502,432097,14,432083
65054,19,17,712,1183207,19,1183188
65055,6,1,112,659544,6,659538
65056,10,9,30,907453,10,907443
65057,19,14,654,1090578,19,1090559
65058,19,9,958,936223,19,936204
65059,18,0,161,649437,18,649419
65060,9,5,858,799535,9,799526
65061,6,-20,485,10393,6,10387
65062,5,5,216,786172,5,786167
65063,16,16,634,1151644,16,1151628
65064,17,8,988,905621,17,905604
65065,13,-11,982,311387,13,311374
65066,12,0,170,649525,12,649513
65067,14,-5,608,495519,14,495505
65068,6,-10,213,317278,6,317272
65069,8,-16,615,137424,8,137416
65070,16,-14,688,214937,16,214921
65071,8,2,190,692747,8,692739
65072,15,1,80,680382,15,680367
65073,18,0,253,650082,18,650064
65074,12,-3,95,554449,12,554437
65075,17,14,15,1085497,17,1085480
65076,17,-1,732,622226,17,622209
65077,11,5,463,807180,11,807169
65078,12,10,44,960190,12,960178
65079,13,17,850,1184383,13,1184370
65080,8,7,55,846059,8,846051
65081,6,-13,494,228782,6,228776
65082,17,-10,917,341965,17,341948
65083,18,6,496,839767,18,839749
65084,12,-6,437,462483,12,462471
65085,5,11,609,981525,5,981520
65086,10,0,280,631347,10,631337
65087,9,1,816,674724,9,674715
65088,11,16,212,1148660,11,1148649
65089,13,11,984,997938,13,997925
65090,10,-4,422,508812,10,508802
65091,12,-6,700,464508,12,464496
65092,13,0,348,650672,13,650659
65093,19,5,777,809417,19,809398
65094,10,-3,754,547337,10,547327
65095,12,1,156,681119,12,681107
65096,9,4,63,751962,9,751953
65097,6,15,390,1102733,6,1102727
65098,17,-9,218,368101,17,368084
65099,12,-17,492,119160,12,119148
65100,19,10,393,962782,19,962763
65101,12,-3,951,561421,12,561409
65102,19,-13,984,248454,19,248435
65103,11,-17,490,119134,11,119123
65104,18,18,155,1210223,18,1210205
65105,11,6,17,835941,11,835930
65106,11,5,155,804906,11,804895
65107,5,12,144,1002223,5,1002218
65108,14,-15,633,182462,14,182448
65109,6,13,643,1044598,6,1044592
65110,7,6,876,832010,7,832003
65111,19,-8,377,400551,19,400532
65112,13,-8,275,399821,13,399808
65113,16,16,187,1148455,16,1148439
65114,10,10,431,946778,10,946768
65115,20,-9,753,372414,20,372394
65116,17,-14,490,213299,17,213282
65117,8,-4,541,511217,8,511209
65118,9,-5,317,475137,9,475128
65119,15,-11,301,306133,15,306118
65120,17,-9,682,371819,17,371802
65121,11,7,234,868660,11,868649
65122,13,19,527,1245164,13,1245151
65123,15,-1,689,621873,15,621858
65124,5,-3,156,533753,5,533748
65125,18,-18,902,91768,18,91750
65126,7,-11,119,283765,7,283758
65127,6,15,992,1115577,6,1115571
65128,7,-20,882,19600,7,19593
65129,20,14,652,1090559,20,1090539
65130,18,16,375,1149854,18,1149836
65131,11,2,462,714125,11,714114
65132,10,-13,973,239434,10,239424
65133,20,-2,217,586779,20,586759
65134,12,-8,852,403903,12,403891
65135,20,10,536,963952,20,963932
65136,14,-17,15,115692,14,115678
65137,10,-14,331,193958,10,193948
65138,18,-8,40,398211,18,398193
65139,16,-19,835,60414,16,60398
65140,16,14,453,1089000,16,1088984
65141,18,19,61,1241223,18,1241205
65142,10,19,94,1219573,10,1219563
65143,15,-10,334,337472,15,337457
65144,19,3,920,748791,19,748772
65145,11,-7,311,430665,11,430654
65146,19,-5,34,491073,19,491054
65147,9,8,716,891066,9,891057
65148,6,-16,4,123871,6,123865
65149,17,10,761,965696,17,965679
65150,10,-11,807,298435,10,298425
65151,17,-1,254,618521,17,618504
65152,7,19,190,1221725,7,1221718
65153,8,17,65,1156726,8,1156718
65154,11,4,946,780215,11,780204
65155,5,-19,225,36512,5,36507
65156,14,12,272,1024155,14,1024141
65157,18,5,86,804458,18,804440
65158,12,1,723,685492,12,685480
65159,5,4,100,752832,5,752827
65160,7,-2,305,569358,7,569351
65161,14,5,514,807533,14,807519
65162,10,-16,318,130876,10,130866
65163,12,-11,537,308060,12,308048
65164,15,19,686,1246335,15,1246320
65165,9,-5,755,484283,9,484274
65166,9,16,325,1132087,9,1132078
65167,18,-15,656,182700,18,182682
65168,6,16,211,1129659,6,1129653
65169,14,14,937,1092795,14,1092781
65170,14,8,526,902145,14,902131
65171,15,18,233,1210835,15,1210820
65172,19,-10,780,340938,19,340919
65173,18,-11,625,308709,18,308691
65174,14,-16,713,152133,14,152119
65175,12,-4,224,523859,12,523847
65176,20,19,413,1244225,20,1244205
65177,20,14,97,1086244,20,1086224
65178,11,7,44,867376,11,867365
65179,18,-11,871,310536,18,310518
65180,18,12,527,1025903,18,1025885
65181,19,-2,650,590019,19,590000
65182,15,-19,514,57954,15,57939
65183,17,13,257,1055077,17,1055060
65184,6,-19,498,42227,6,42221
65185,19,6,411,839077,19,839058
65186,15,0,998,655946,15,655931
65187,10,-8,588,387743,10,387733
65188,13,6,86,836382,13,836369
65189,5,-10,365,320464,5,320459
65190,20,-6,894,465922,20,465902
65191,18,-16,860,153245,18,153227
65192,7,-16,269,129846,7,129839
65193,10,-17,162,96831,10,96821
65194,9,-12,429,258864,9,258855
65195,15,-20,280,24964,15,24949
65196,9,14,356,1069656,9,1069647
65197,15,-18,274,87383,15,87368
65198,16,15,169,1118041,16,1118025
65199,6,-12,516,260858,6,260852
65200,19,-19,606,58778,19,58759
65201,6,0,190,629638,6,629632
65202,19,-5,820,496940,19,496921
65203,11,16,446,1150338,11,1150327
65204,14,1,231,681711,14,681697
65205,11,16,95,1147727,11,1147716
65206,14,14,60,1085895,14,1085881
65207,10,2,607,701435,10,701425
65208,5,5,237,786620,5,786615
65209,16,16,647,1151780,16,1151764
65210,16,8,277,900147,16,900131
65211,14,-10,183,336433,14,336419
65212,16,-1,902,623472,16,623456
65213,10,2,311,695330,10,695320
65214,16,-15,238,179472,16,179456
65215,7,-14,251,192221,7,192214
65216,19,15,345,1119338,19,1119319
65217,18,-5,607,495507,18,495489
65218,19,4,495,776787,19,776768
65219,20,-20,204,24429,20,24409
65220,11,14,396,1088526,11,1088515
65221,9,-16,600,137113,9,137104
65222,15,-18,803,91105,15,91090
65223,8,-6,556,448866,8,448858
65224,10,6,748,829144,10,829134
65225,17,19,849,1247621,17,1247604
65226,10,-12,750,265760,10,265750
65227,13,19,818,1247377,13,1247364
65228,8,-9,981,365300,8,365292
65229,10,-19,196,35928,10,35918
65230,16,4,574,777427,16,777411
65231,18,-5,903,497650,18,497632
65232,15,8,617,902820,15,902805
65233,13,17,494,1181605,13,1181592
65234,20,14,151,1086642,20,1086622
65235,6,3,209,723399,6,723393
65236,13,7,774,872599,13,872586
65237,7,4,573,762919,7,762912
65238,16,-18,197,86826,16,86810
65239,15,15,688,1121804,15,1121789
65240,9,-15,268,161125,9,161116
65241,19,17,518,1181782,19,1181763
65242,18,-1,368,619559,18,619541
65243,5,-17,843,111344,5,111339
65244,13,8,6,897948,13,897935
65245,16,-17,492,119166,16,119150
65246,8,-9,693,358852,8,358844
65247,5,15,767,1110741,5,1110736
65248,7,10,806,955024,7,955017
65249,18,-2,437,588426,18,588408
65250,10,17,904,1174797,10,1174787
65251,17,2,468,714157,17,714140
65252,12,-11,964,311278,12,311266
65253,10,4,596,763491,10,763481
65254,10,-5,774,484624,10,484614
65255,13,-16,12,146833,13,146820
65256,15,-18,650,89989,15,89974
65257,16,0,612,652871,16,652855
65258,18,16,332,1149509,18,1149491
65259,11,-16,335,149385,11,149374
65260,18,10,316,962221,18,962203
65261,15,-6,14,459246,15,459231
65262,9,6,928,833071,9,833062
65263,14,-4,84,522678,14,522664
65264,10,2,148,691765,10,691755
65265,16,14,591,1089977,16,1089961
65266,19,-7,478,431921,19,431902
65267,8,12,887,1018585,8,1018577
65268,16,19,854,1247675,16,1247659
65269,17,18,840,1215065,17,1215048
65270,6,11,870,987184,6,987178
65271,19,-20,546,26974,19,26955
65272,17,-18,551,89294,17,89277
65273,6,10,877,956388,6,956382
65274,7,11,897,987829,7,987822
65275,13,-13,74,241600,13,241587
65276,12,-20,229,24533,12,24521
65277,18,8,569,902432,18,902414
65278,17,6,346,838486,17,838469
65279,16,15,979,1123998,16,1123982
65280,17,-4,287,524301,17,524284
65281,16,-10,998,342718,16,342702
65282,12,7,0,867018,12,867006
65283,9,-19,514,42637,9,42628
65284,6,5,17,781980,6,781974
65285,6,14,496,1072905,6,1072899
65286,11,14,425,1088807,11,1088796
65287,11,-18,443,88574,11,88563
65288,11,-13,489,244622,11,244611
65289,14,-17,976,122634,14,122620
65290,6,12,374,1007231,6,1007225
65291,13,-8,387,400616,13,400603
65292,19,1,544,684207,19,684188
65293,9,7,376,852952,9,852943
65294,8,0,502,636250,8,636242
65295,8,-18,946,82958,8,82950
65296,12,4,419,776252,12,776240
65297,16,14,357,1088201,16,1088185
65298,15,16,955,1153897,15,1153882
65299,19,-6,350,461878,19,461859
65300,15,-17,732,121048,15,121033
65301,11,-2,112,585973,11,585962
65302,9,-15,475,165748,9,165739
65303,20,-5,285,493163,20,493143
65304,9,-5,545,479823,9,479814
65305,19,14,32,1085641,19,1085622
65306,9,-9,646,357866,9,357857
65307,19,14,642,1090433,19,1090414
65308,20,-11,75,304270,20,304250
65309,20,14,204,1086994,20,1086974
65310,5,15,115,1097002,5,1096997
65311,20,5,40,804072,20,804052
65312,14,13,225,1054894,14,1054880
65313,12,11,526,994667,12,994655
65314,16,-10,787,340980,16,340964
65315,10,14,877,1081462,10,1081452
65316,17,0,895,655075,17,655058
65317,11,10,219,961484,11,961473
65318,9,2,196,692910,9,692901
65319,11,2,224,712268,11,712257
65320,17,-10,255,336965,17,336948
65321,12,-5,177,492308,12,492296
65322,9,-5,388,476506,9,476497
65323,11,-18,538,89181,11,89170
65324,9,15,345,1101909,9,1101900
65325,16,-8,863,404009,16,403993
65326,18,-9,100,367364,18,367346
65327,20,-5,515,494854,20,494834
65328,6,-10,430,321942,6,321936
65329,15,11,298,993096,15,993081
65330,6,-11,362,289151,6,289145
65331,14,13,181,1054566,14,1054552
65332,10,-1,200,598007,10,597997
65333,10,1,167,660832,10,660822
65334,16,-12,239,274288,16,274272
65335,13,2,800,716449,13,716436
65336,12,13,322,1055560,12,1055548
65337,6,-1,215,598427,6,598421
65338,19,1,99,680603,19,680584
65339,11,6,396,838950,11,838939
65340,6,-1,599,606975,6,606969
65341,19,7,730,872345,19,872326
65342,12,-16,83,147474,12,147462
65343,17,6,898,842910,17,842893
65344,6,15,563,1106436,6,1106430
65345,19,7,858,873190,19,873171
65346,11,2,643,715372,11,715361
65347,9,-4,685,514228,9,514219
65348,19,-13,304,243331,19,243312
65349,16,11,551,994804,16,994788
65350,7,-3,429,539962,7,539955
65351,7,11,851,986732,7,986725
65352,15,-5,967,498176,15,498161
65353,8,-13,759,234697,8,234689
65354,9,6,63,813538,9,813529
65355,19,2,677,715714,19,715695
65356,12,19,150,1241973,12,1241961
65357,17,-9,695,371939,17,371922
65358,16,-7,781,433980,16,433964
65359,20,-19,60,54303,20,54283
65360,19,-5,669,495868,19,495849
65361,9,-18,891,81725,9,81716
65362,6,14,580,1074725,6,1074719
65363,15,-15,832,184041,15,184026
65364,15,12,482,1025610,15,1025595
65365,10,16,979,1145699,10,1145689
65366,15,17,936,1184908,15,1184893
65367,11,15,11,1116843,11,1116832
65368,10,19,677,1232499,10,1232489
65369,16,-15,88,178459,16,178443
65370,6,9,793,923553,6,923547
65371,8,-16,366,131817,8,131809
65372,18,17,303,1180233,18,1180215
65373,7,9,596,919440,7,919433
65374,14,-1,679,621780,14,621766
65375,20,5,296,805994,20,805974
65376,18,7,569,871222,18,871204
65377,18,-20,32,18237,18,18219
65378,16,-1,416,619865,16,619849
65379,16,6,618,840744,16,840728
65380,6,6,14,812495,6,812489
65381,20,14,298,1087733,20,1087713
65382,17,19,951,1248425,17,1248408
65383,16,1,710,685318,16,685302
65384,17,-17,518,119398,17,119381
65385,13,8,185,899383,13,899370
65386,8,18,264,1192646,8,1192638
65387,11,5,121,804671,11,804660
65388,20,17,304,1180265,20,1180245
65389,19,10,400,962857,19,962838
65390,8,0,662,639846,8,639838
65391,15,1,707,685309,15,685294
65392,8,2,590,701021,8,701013
65393,5,9,171,910445,5,910440
65394,13,13,452,1056617,13,1056604
65395,16,-20,619,27502,16,27486
65396,5,-14,357,194450,5,194445
65397,20,-13,496,244664,20,244644
65398,19,-15,934,184877,19,184858
65399,10,-12,771,266176,10,266166
65400,6,10,830,955418,6,955412
65401,18,4,543,777204,18,777186
65402,18,-8,37,398189,18,398171
65403,14,-9,875,373505,14,373491
65404,6,-6,688,451617,6,451611
65405,19,-11,135,304793,19,304774
65406,7,-19,600,44684,7,44677
65407,15,-13,801,247005,15,246990
65408,7,-5,585,480734,7,480727
65409,12,6,617,840735,12,840723
65410,16,5,430,806895,16,806879
65411,12,-8,59,398381,12,398369
65412,11,1,430,683206,11,683195
65413,9,14,157,1065415,9,1065406
65414,11,14,232,1087234,11,1087223
65415,13,10,328,962308,13,962295
65416,7,7,447,854426,7,854419
65417,5,10,723,953073,5,953068
65418,5,15,821,1111826,5,1111821
65419,9,6,276,818505,9,818496
65420,16,12,62,1022510,16,1022494
65421,10,-16,178,127837,10,127827
65422,11,5,377,806562,11,806551
65423,6,4,455,760419,6,760413
65424,6,1,863,675808,6,675802
65425,10,-1,0,593717,10,593707
65426,10,16,286,1131256,10,1131246
65427,20,-17,139,116519,20,116499
65428,10,13,986,1051772,10,1051762
65429,7,18,72,1188360,7,1188353
65430,20,-16,288,149068,20,149048
65431,12,11,240,992543,12,992531
65432,18,-18,45,85560,18,85542
65433,15,-6,967,466446,15,466431
65434,9,-20,790,17407,9,17398
65435,5,0,828,643329,5,643324
65436,18,18,54,1209348,18,1209330
65437,10,-10,394,321127,10,321117
65438,9,-3,830,548906,9,548897
65439,18,10,535,963941,18,963923
65440,13,3,597,746293,13,746280
65441,19,17,187,1179314,19,1179295
65442,16,-8,496,401286,16,401270
65443,8,10,477,947638,8,947630
65444,10,10,692,952448,10,952438
65445,10,10,921,957339,10,957329
65446,15,-13,960,248309,15,248294
65447,19,15,533,1120672,19,1120653
65448,9,-7,65,407347,9,407338
65449,7,8,171,878850,7,878843
65450,14,-4,758,527685,14,527671
65451,10,-13,427,227298,10,227288
65452,9,2,43,689553,9,689544
65453,19,-14,489,213283,19,213264
65454,13,11,95,991557,13,991544
65455,18,-12,215,274068,18,274050
65456,19,-1,554,620951,19,620932
65457,6,14,132,1064809,6,1064803
65458,20,7,415,870109,20,870089
65459,11,13,556,1057424,11,1057413
65460,14,16,424,1150188,14,1150174
65461,7,-12,805,266913,7,266906
65462,6,13,898,1050017,6,1050011
65463,10,6,667,827377,10,827367
65464,19,2,203,712135,19,712116
65465,19,1,459,683483,19,683464
65466,16,10,252,961714,16,961698
65467,18,13,389,1056120,18,1056102
65468,16,10,893,966656,16,966640
65469,16,18,700,1214003,16,1213987
65470,5,-15,545,167196,5,167191
65471,7,13,176,1034446,7,1034439
65472,7,-11,71,282674,7,282667
65473,20,12,539,1026021,20,1026001
65474,19,-4,53,522429,19,522410
65475,7,-15,490,166121,7,166114
65476,19,-20,268,24829,19,24810
65477,18,17,629,1182527,18,1182509
65478,16,8,751,903866,16,903850
65479,12,11,167,992024,12,992012
65480,15,-4,111,522876,15,522861
65481,16,-20,644,27692,16,27676
65482,17,5,679,808742,17,808725
65483,19,-7,84,428876,19,428857
65484,16,-11,86,304354,16,304338
65485,19,3,894,748548,19,748529
65486,11,9,761,934578,11,934567
65487,16,-19,121,54968,16,54952
65488,11,14,380,1088383,11,1088372
65489,9,-18,695,77277,9,77268
65490,6,8,229,880230,6,880224
65491,7,6,71,813736,7,813729
65492,11,-20,376,25707,11,25696
65493,10,-8,562,387232,10,387222
65494,18,-18,127,86202,18,86184
65495,18,14,174,1086808,18,1086790
65496,19,-9,697,371950,19,371931
65497,7,-1,460,604076,7,604069
65498,11,-8,605,402095,11,402084
65499,7,19,964,1238829,7,1238822
65500,14,19,265,1242886,14,1242872
65501,9,13,481,1041065,9,1041056
65502,18,-15,81,178376,18,178358
65503,14,-4,167,523346,14,523332
65504,7,4,828,768776,7,768769
65505,17,4,948,780245,17,780228
65506,14,-11,483,307589,14,307575
65507,20,7,149,868107,20,868087
65508,16,13,966,1060400,16,1060384
65509,14,19,855,1247705,14,1247691
65510,13,-14,672,214781,13,214768
65511,18,7,560,871135,18,871117
65512,10,6,846,831379,10,831369
65513,8,-10,807,329920,8,329912
65514,19,-7,791,434018,19,433999
65515,9,11,57,969729,9,969720
65516,5,0,412,634287,5,634282
65517,17,17,266,1179912,17,1179895
65518,12,10,349,962436,12,962424
65519,5,0,118,627999,5,627994
65520,6,12,218,1003905,6,1003899
65521,16,14,892,1092447,16,1092431
65522,12,-15,639,182529,12,182517
65523,15,-4,34,522288,15,522273
65524,15,-1,256,618543,15,618528
65525,6,-20,962,21169,6,21163
65526,5,-11,58,282371,5,282366
65527,10,6,980,834319,10,834309
65528,5,-12,801,266792,5,266787
65529,7,11,955,988894,7,988887
65530,16,-2,289,587313,16,587297
65531,16,8,138,899033,16,899017
65532,9,8,965,896122,9,896113
65533,15,-13,557,245137,15,245122
65534,11,4,206,774726,11,774715
65535,9,4,875,769869,9,769860
65536,10,11,494,979008,10,978998
65537,19,6,270,837820,19,837801
65538,19,-19,518,57987,19,57968
65539,15,11,699,995789,15,995774
65540,15,4,119,774098,15,774083
65541,5,-18,8,62651,5,62646
65542,16,-10,45,335497,16,335481
65543,11,17,400,1180903,11,1180892
65544,19,17,323,1180398,19,1180379
65545,19,-2,733,590631,19,590612
65546,11,-4,93,522762,11,522751
65547,5,16,837,1142575,5,1142570
65548,13,-14,680,214843,13,214830
65549,6,16,868,1143095,6,1143089
65550,14,6,148,836894,14,836880
65551,20,-13,287,243227,20,243207
65552,18,-15,345,180298,18,180280
65553,12,9,927,935991,12,935979
65554,10,-13,796,235626,10,235616
65555,13,2,208,712152,13,712139
65556,14,6,586,840507,14,840493
65557,19,-1,215,618235,19,618216
65558,14,4,767,778895,14,778881
65559,10,9,523,917807,10,917797
65560,10,-20,864,19193,10,19183
65561,12,12,638,1026783,12,1026771
65562,11,3,357,744563,11,744552
65563,13,-7,479,431930,13,431917
65564,15,-17,591,119963,15,119948
65565,15,-2,986,592640,15,592625
65566,9,-7,268,411517,9,411508
65567,12,-9,93,367328,12,367316
65568,10,9,73,908284,10,908274
65569,13,-5,135,491975,13,491962
65570,16,-15,385,180585,16,180569
65571,11,1,768,685862,11,685851
65572,17,-6,552,463458,17,463441
65573,15,-13,864,247478,15,247463
65574,14,5,959,810873,14,810859
65575,12,17,710,1183175,12,1183163
65576,6,-4,760,515590,6,515584
65577,20,7,482,870628,20,870608
65578,9,-4,453,509307,9,509298
65579,14,1,2,679759,14,679745
65580,16,-1,331,619205,16,619189
65581,7,-18,962,83391,7,83384
65582,8,-15,630,168984,8,168976
65583,12,9,836,935277,12,935265
65584,9,19,381,1226107,9,1226098
65585,5,0,238,630582,5,630577
65586,12,-14,216,211026,12,211014
65587,12,19,319,1243331,12,1243319
65588,6,10,399,946017,6,946011
65589,15,-2,669,590165,15,590150
65590,7,-19,117,34140,7,34133
65591,10,-1,666,608197,10,608187
65592,15,-5,882,497510,15,497495
65593,12,-20,810,29129,12,29117
65594,13,-14,387,212588,13,212575
65595,5,-9,478,354370,5,354365
65596,16,12,52,1022457,16,1022441
65597,8,-6,863,455210,8,455202
65598,10,14,158,1065434,10,1065424
65599,5,-16,324,131000,5,130995
65600,18,17,630,1182535,18,1182517
65601,8,7,250,850183,8,850175
65602,9,-18,817,80149,9,80140
65603,14,-15,326,180124,14,180110
65604,12,18,9,1208985,12,1208973
65605,15,-20,223,24498,15,24483
65606,19,14,304,1087794,19,1087775
65607,10,-20,494,10593,10,10583
65608,12,14,786,1091642,12,1091630
65609,19,-2,834,591484,19,591465
65610,7,-8,115,377772,7,377765
65611,18,12,839,1028352,18,1028334
65612,20,-3,283,555782,20,555762
65613,10,-7,240,410864,10,410854
65614,17,3,272,743945,17,743928
65615,19,14,7,1085413,19,1085394
65616,19,-3,519,557815,19,557796
65617,16,-4,353,524862,16,524846
65618,9,15,212,1098997,9,1098988
65619,15,19,223,1242513,15,1242498
65620,16,2,889,717120,16,717104
65621,15,18,666,1213803,15,1213788
65622,19,-19,294,56282,19,56263
65623,5,8,751,891701,5,891696
65624,8,16,762,1140910,8,1140902
65625,20,12,450,1025349,20,1025329
65626,20,-7,340,430939,20,430919
65627,13,3,98,742533,13,742520
65628,16,-16,991,154247,16,154231
65629,15,-9,769,372634,15,372619
65630,18,2,894,717143,18,717125
65631,6,3,251,724294,6,724288
65632,9,0,692,640514,9,640505
65633,16,-8,2,397845,16,397829
65634,12,3,361,744610,12,744598
65635,12,-12,917,279450,12,279438
65636,13,-7,654,433055,13,433042
65637,6,-16,523,135432,6,135426
65638,7,-15,935,175309,7,175302
65639,17,-18,865,91491,17,91474
65640,15,-2,155,586234,15,586219
65641,7,-4,566,511626,7,511619
65642,8,6,574,825290,8,825282
65643,18,10,379,962649,18,962631
65644,18,7,892,873415,18,873397
65645,17,-3,308,556023,17,556006
65646,7,4,694,765539,7,765532
65647,14,17,825,1184138,14,1184124
65648,14,-3,675,559177,14,559163
65649,12,-1,1,616509,12,616497
65650,9,-6,927,456575,9,456566
65651,5,10,249,942700,5,942695
65652,13,15,424,1119770,13,1119757
65653,10,-20,85,1933,10,1923
65654,18,-1,534,620821,18,620803
65655,8,-18,969,83542,8,83534
65656,8,-20,711,15704,8,15696
65657,15,14,435,1088883,15,1088868
65658,19,-7,270,430324,19,430305
65659,16,11,186,992142,16,992126
65660,9,-13,839,236575,9,236566
65661,5,-4,365,507566,5,507561
65662,11,8,671,903292,11,903281
65663,11,-19,37,54141,11,54130
65664,20,3,8,741860,20,741840
65665,5,-16,929,143974,5,143969
65666,7,-13,469,228191,7,228184
65667,11,9,505,932757,11,932746
65668,16,1,386,682953,16,682937
65669,11,-2,553,589317,11,589306
65670,11,-10,270,337036,11,337025
65671,10,-7,892,425006,10,424996
65672,12,-9,805,372935,12,372923
65673,20,13,760,1058912,20,1058892
65674,11,7,287,869073,11,869062
65675,19,17,103,1178572,19,1178553
65676,18,-6,228,460956,18,460938
65677,18,-10,631,339759,18,339741
65678,12,-16,416,149987,12,149975
65679,13,5,981,810983,13,810970
65680,12,12,178,1023355,12,1023343
65681,11,-13,722,246346,11,246335
65682,13,-20,225,24510,13,24497
65683,20,13,206,1054757,20,1054737
65684,5,18,351,1194260,5,1194255
65685,10,-3,214,534975,10,534965
65686,17,-13,763,246691,17,246674
65687,20,2,477,714254,20,714234
65688,16,8,513,902042,16,902026
65689,13,-19,458,57500,13,57487
65690,10,5,262,787156,10,787146
65691,19,10,521,963869,19,963850
65692,9,16,940,1144767,9,1144758
65693,13,13,231,1054930,13,1054917
65694,18,-3,79,554348,18,554330
65695,7,10,768,954024,7,954017
65696,11,16,593,1151297,11,1151286
65697,11,0,107,649083,11,649072
65698,19,-13,601,245476,19,245457
65699,5,-2,308,569412,5,569407
65700,11,-13,868,247496,11,247485
65701,20,0,380,650977,20,650957
65702,12,14,461,1089055,12,1089043
65703,13,6,982,843588,13,843575
65704,10,-20,754,16637,10,16627
65705,12,-16,757,152499,12,152487
65706,18,-19,498,57816,18,57798
65707,18,-9,78,367239,18,367221
65708,14,11,514,994577,14,994563
65709,12,-12,688,277568,12,277556
65710,8,-7,85,407641,8,407633
65711,11,-8,630,402291,11,402280
65712,15,-8,220,399489,15,399474
65713,16,-11,367,306706,16,306690
65714,14,-1,190,617971,14,617957
65715,7,5,486,791699,7,791692
65716,18,-6,69,459600,18,459582
65717,14,16,319,1149432,14,1149418
65718,9,-6,406,445459,9,445450
65719,17,-7,923,435141,17,435124
65720,18,-17,847,121810,18,121792
65721,10,-16,300,130527,10,130517
65722,5,-3,1000,552850,5,552845
65723,5,14,46,1062841,5,1062836
65724,7,12,528,1010417,7,1010410
65725,12,9,134,930058,12,930046
65726,15,-3,848,560564,15,560549
65727,15,-20,641,27665,15,27650
65728,14,-20,445,26179,14,26165
65729,17,11,258,992696,17,992679
65730,17,-10,188,336471,17,336454
65731,6,-20,93,2064,6,2058
65732,20,-5,558,495165,20,495145
65733,6,-19,915,51192,6,51186
65734,6,2,361,696510,6,696504
65735,12,-2,518,589041,12,589029
65736,5,9,702,921524,5,921519
65737,17,14,182,1086846,17,1086829
65738,20,-20,492,26503,20,26483
65739,8,18,772,1203046,8,1203038
65740,8,-3,562,543122,8,543114
65741,14,-9,425,369924,14,369910
65742,14,-5,916,497760,14,497746
65743,15,4,580,777463,15,777448
65744,11,0,696,653619,11,653608
65745,12,11,964,997774,12,997762
65746,7,-16,905,143432,7,143425
65747,5,19,40,1218262,5,1218257
65748,14,4,801,779128,14,779114
65749,16,1,31,680020,16,680004
65750,6,13,154,1033951,6,1033945
65751,18,-7,352,431018,18,431000
65752,9,-19,819,49343,9,49334
65753,18,-17,561,119725,18,119707
65754,10,1,846,675361,10,675351
65755,9,-4,725,514955,9,514946
65756,18,12,826,1028197,18,1028179
65757,10,-1,519,605337,10,605327
65758,14,-20,964,30079,14,30065
65759,9,-4,938,519528,9,519519
65760,7,-20,162,3566,7,3559
65761,13,17,484,1181543,13,1181530
65762,10,10,970,958249,10,958239
65763,13,14,586,1089947,13,1089934
65764,12,17,240,1179687,12,1179675
65765,14,2,146,711702,14,711688
65766,14,-8,667,402622,14,402608
65767,13,5,63,804284,13,804271
65768,9,-4,418,508731,9,508722
65769,20,1,930,687139,20,687119
65770,20,-18,931,91992,20,91972
65771,10,-15,991,176531,10,176521
65772,9,-9,869,363059,9,363050
65773,10,-13,305,224898,10,224888
65774,17,-10,75,335795,17,335778
65775,17,5,910,810414,17,810397
65776,15,9,109,929833,15,929818
65777,9,0,330,632315,9,632306
65778,17,10,909,966800,17,966783
65779,7,-2,72,564393,7,564386
65780,19,16,913,1153654,19,1153635
65781,6,4,253,756153,6,756147
65782,15,-1,517,620673,15,620658
65783,7,-20,835,18540,7,18533
65784,5,0,287,631474,5,631469
65785,15,-6,142,460206,15,460191
65786,10,19,635,1231662,10,1231652
65787,20,7,818,872920,20,872900
65788,18,-10,711,340427,18,340409
65789,15,11,217,992361,15,992346
65790,13,-14,113,210198,13,210185
65791,8,-14,610,200125,8,200117
65792,20,10,597,964519,20,964499
65793,17,16,276,1149109,17,1149092
65794,9,0,470,635616,9,635607
65795,11,-2,764,590828,11,590817
65796,6,16,867,1143070,6,1143064
65797,9,1,380,665506,9,665497
65798,10,6,871,831912,10,831902
65799,20,1,823,686226,20,686206
65800,18,-4,894,528770,18,528752
65801,19,5,738,809191,19,809172
65802,11,-17,846,121803,11,121792
65803,9,-2,97,564906,9,564897
65804,6,-13,565,230387,6,230381
65805,7,-20,140,3067,7,3060
65806,10,16,683,1139476,10,1139466
65807,9,5,745,797193,9,797184
65808,10,18,503,1197494,10,1197484
65809,17,13,332,1055674,17,1055657
65810,15,-15,145,178888,15,178873
65811,6,11,710,983580,6,983574
65812,16,-17,283,117603,16,117587
65813,10,-2,112,565279,10,565269
65814,10,6,991,834577,10,834567
65815,17,-9,530,370912,17,370895
65816,16,-8,508,401408,16,401392
65817,6,-17,192,97469,6,97463
65818,7,4,581,763115,7,763108
65819,20,-9,391,369636,20,369616
65820,14,-6,293,461468,14,461454
65821,17,6,725,841667,17,841650
65822,20,1,753,685716,20,685696
65823,9,-7,944,426006,9,425997
65824,17,6,561,840284,17,840267
65825,13,-13,869,247507,13,247494
65826,8,1,712,672433,8,672425
65827,5,-14,265,192581,5,192576
65828,11,-19,927,60989,11,60978
65829,6,19,467,1228175,6,1228169
65830,17,0,691,653569,17,653552
65831,5,13,654,1044847,5,1044842
65832,15,-1,513,620650,15,620635
65833,9,-11,345,288745,9,288736
65834,17,4,172,774529,17,774512
65835,7,2,29,689206,7,689199
65836,6,-6,86,438559,6,438553
65837,6,-12,455,259392,6,259386
65838,14,-18,82,85840,14,85826
65839,17,14,672,1090721,17,1090704
65840,8,-8,848,393445,8,393437
65841,19,10,955,967178,19,967159
65842,18,-5,844,497152,18,497134
65843,14,2,360,713331,14,713317
65844,8,9,347,914050,8,914042
65845,6,13,719,1046145,6,1046139
65846,17,6,679,841215,17,841198
65847,15,-16,267,148940,15,148925
65848,20,7,355,869604,20,869584
65849,15,19,219,1242484,15,1242469
65850,13,8,288,900253,13,900240
65851,6,-9,307,350302,6,350296
65852,12,3,675,746989,12,746977
65853,8,12,19,999491,8,999483
65854,16,13,490,1056837,16,1056821
65855,10,10,425,946627,10,946617
65856,13,2,338,713153,13,713140
65857,18,3,625,746538,18,746520
65858,10,8,934,895482,10,895472
65859,15,-6,947,466318,15,466303
65860,10,3,898,738190,10,738180
65861,14,19,592,1245588,14,1245574
65862,6,9,36,907574,6,907568
65863,9,15,946,1114644,9,1114635
65864,12,-9,715,372051,12,372039
65865,16,-9,200,367972,16,367956
65866,19,-13,829,247181,19,247162
65867,16,11,866,997148,16,997132
65868,18,-14,969,217034,18,217016
65869,17,1,136,680943,17,680926
65870,18,-16,11,146820,18,146802
65871,13,0,505,651998,13,651985
65872,7,-3,135,533362,7,533355
65873,14,-10,963,342312,14,342298
65874,11,4,914,780006,11,779995
65875,15,-10,354,337619,15,337604
65876,6,-18,288,68730,6,68724
65877,13,-18,776,90890,13,90877
65878,8,-12,355,257364,8,257356
65879,16,17,879,1184557,16,1184541
65880,12,-6,986,466646,12,466634
65881,10,16,132,1127903,10,1127893
65882,14,17,964,1185152,14,1185138
65883,6,-15,717,170778,6,170772
65884,18,9,992,936480,18,936462
65885,15,17,771,1183588,15,1183573
65886,7,-20,50,1085,7,1078
65887,12,1,199,681451,12,681439
65888,14,-8,937,404514,14,404500
65889,20,-8,656,402522,20,402502
65890,10,-13,451,227792,10,227782
65891,6,4,597,763525,6,763519
65892,20,18,645,1213627,20,1213607
65893,13,-19,578,58598,13,58585
65894,11,-3,628,558801,11,558790
65895,17,-2,328,587572,17,587555
65896,9,-10,9,312735,9,312726
65897,7,-9,455,353711,7,353704
65898,18,-14,615,214357,18,214339
65899,15,15,950,1123764,15,1123749
65900,16,-19,306,56365,16,56349
65901,13,-19,861,60630,13,60617
65902,13,15,623,1121354,13,1121341
65903,7,13,759,1047021,7,1047014
65904,6,-12,902,269271,6,269265
65905,7,-12,256,255020,7,255013
65906,11,12,991,1029732,11,1029721
65907,17,3,727,747366,17,747349
65908,11,-3,710,559440,11,559429
65909,19,-6,133,460101,19,460082
65910,9,9,767,922838,9,922829
65911,6,10,624,950996,6,950990
65912,12,-15,344,180281,12,180269
65913,10,17,817,1172874,10,1172864
65914,9,-19,351,39140,9,39131
65915,9,11,537,979955,9,979946
65916,20,12,333,1024573,20,1024553
65917,17,-3,898,560996,17,560979
65918,11,-8,391,400660,11,400649
65919,5,1,160,660690,5,660685
65920,20,8,437,901465,20,901445
65921,12,-1,948,623802,12,623790
65922,9,17,542,1166884,9,1166875
65923,7,-16,275,129993,7,129986
65924,6,-7,927,425664,6,425658
65925,15,13,347,1055773,15,1055758
65926,10,-8,571,387473,10,387463
65927,16,-1,839,622994,16,622978
65928,6,-10,765,328998,6,328992
65929,10,17,326,1162340,10,1162330
65930,19,-13,752,246598,19,246579
65931,19,6,123,836723,19,836704
65932,16,16,200,1148550,16,1148534
65933,17,-7,202,429809,17,429792
65934,16,-16,277,149022,16,149006
65935,10,-13,976,239471,10,239461
65936,12,-14,925,216703,12,216691
65937,15,-6,882,465771,15,465756
65938,19,3,659,746827,19,746808
65939,18,15,611,1121247,18,1121229
65940,15,-3,948,561392,15,561377
65941,7,-5,584,480702,7,480695
65942,19,-6,406,462245,19,462226
65943,7,-5,480,478368,7,478361
65944,14,13,490,1056841,14,1056827
65945,12,-14,872,216289,12,216277
65946,19,11,940,997673,19,997654
65947,12,-20,550,27000,12,26988
65948,17,15,274,1118813,17,1118796
65949,18,14,575,1089900,18,1089882
65950,13,4,329,775590,13,775577
65951,16,11,765,996377,16,996361
65952,15,4,534,777130,15,777115
65953,18,14,115,1086380,18,1086362
65954,10,6,58,813458,10,813448
65955,17,-13,903,247762,17,247745
65956,15,5,751,809255,15,809240
65957,18,-8,55,398360,18,398342
65958,19,-5,607,495516,19,495497
65959,10,-13,4,218413,10,218403
65960,6,9,432,915732,6,915726
65961,10,9,105,908966,10,908956
65962,6,-1,866,612484,6,612478
65963,19,-11,515,307849,19,307830
65964,18,-17,753,121228,18,121210
65965,8,10,117,940219,8,940211
65966,10,2,555,700365,10,700355
65967,12,-11,645,308867,12,308855
65968,20,12,611,1026541,20,1026521
65969,17,13,115,1054072,17,1054055
65970,14,15,355,1119399,14,1119385
65971,18,-19,661,59150,18,59132
65972,16,-9,540,370975,16,370959
65973,20,1,467,683527,20,683507
65974,17,-12,322,274930,17,274913
65975,7,-16,467,134297,7,134290
65976,16,-7,365,431125,16,431109
65977,14,-12,111,273357,14,273343
65978,20,15,566,1120885,20,1120865
65979,20,9,845,935345,20,935325
65980,5,-20,117,2616,5,2611
65981,7,-3,361,538327,7,538320
65982,5,-11,630,295085,5,295080
65983,12,-8,282,399858,12,399846
65984,12,18,174,1210334,12,1210322
65985,18,1,601,684568,18,684550
65986,14,-16,66,147298,14,147284
65987,17,4,522,777052,17,777035
65988,9,6,834,831141,9,831132
65989,10,11,513,979429,10,979419
65990,7,-5,116,470648,7,470641
65991,7,-14,784,203796,7,203789
65992,19,-10,251,336932,19,336913
65993,15,-2,845,591561,15,591546
65994,15,18,539,1212928,15,1212913
65995,5,0,200,629899,5,629894
65996,15,4,549,777244,15,777229
65997,18,-19,566,58474,18,58456
65998,15,-3,914,561128,15,561113
65999,8,-1,344,601674,8,601666
66000,16,-1,98,617317,16,617301
66001,16,19,999,1248788,16,1248772
66002,10,-17,56,94630,10,94620
66003,11,-10,647,339910,11,339899
66004,15,-6,976,466549,15,466534
66005,6,0,278,631331,6,631325
66006,8,-14,388,195328,8,195320
66007,7,14,920,1082291,7,1082284
66008,13,13,122,1054130,13,1054117
66009,5,-7,973,426655,5,426650
66010,18,-9,29,366814,18,366796
66011,12,12,786,1027914,12,1027902
66012,15,-20,863,29443,15,29428
66013,9,-4,842,517273,9,517264
66014,5,-12,1000,271480,5,271475
66015,19,-10,667,340142,19,340123
66016,9,-17,557,105474,9,105465
66017,20,10,326,962293,20,962273
66018,6,-4,58,500581,6,500575
66019,11,18,815,1214858,11,1214847
66020,11,7,682,872008,11,871997
66021,20,11,268,992790,20,992770
66022,20,19,614,1245758,20,1245738
66023,11,-19,153,55289,11,55278
66024,11,2,819,716581,11,716570
66025,12,-14,673,214797,12,214785
66026,7,4,827,768733,7,768726
66027,19,-16,132,147936,19,147917
66028,11,-5,871,497398,11,497387
66029,8,-8,854,393565,8,393557
66030,11,17,552,1181987,11,1181976
66031,9,8,296,881661,9,881652
66032,11,-9,915,373841,11,373830
66033,12,-5,238,492754,12,492742
66034,15,-15,834,184054,15,184039
66035,10,-17,12,93822,10,93812
66036,20,7,904,873471,20,873451
66037,8,-7,871,424375,8,424367
66038,10,-10,823,330233,10,330223
66039,12,-13,385,243851,12,243839
66040,15,-11,535,308052,15,308037
66041,15,14,980,1093139,15,1093124
66042,19,2,491,714323,19,714304
66043,13,-20,509,26664,13,26651
66044,8,-19,379,39725,8,39717
66045,19,-16,820,152918,19,152899
66046,13,-13,334,243511,13,243498
66047,20,-2,781,591002,20,590982
66048,20,-3,270,555698,20,555678
66049,7,-8,564,387281,7,387274
66050,8,3,208,723370,8,723362
66051,16,3,691,747136,16,747120
66052,16,8,374,900871,16,900855
66053,8,-1,436,603512,8,603504
66054,10,-11,438,290920,10,290910
66055,20,-14,384,212550,20,212530
66056,10,5,79,783279,10,783269
66057,17,-8,168,399099,17,399082
66058,15,6,231,837503,15,837488
66059,18,-7,453,431736,18,431718
66060,12,9,323,931362,12,931350
66061,7,-5,425,477192,7,477185
66062,18,19,330,1243442,18,1243424
66063,6,-14,243,192045,6,192039
66064,7,-14,226,191613,7,191606
66065,12,1,832,686276,12,686264
66066,20,-18,52,85595,20,85575
66067,18,2,421,713816,18,713798
66068,20,-1,549,620914,20,620894
66069,14,-14,778,215627,14,215613
66070,12,3,168,743096,12,743084
66071,11,6,571,840403,11,840392
66072,8,-5,852,486462,8,486454
66073,12,10,746,965617,12,965605
66074,13,13,752,1058825,13,1058812
66075,13,7,512,870819,13,870806
66076,8,-1,788,610811,8,610803
66077,16,-16,693,152005,16,151989
66078,12,-6,735,464780,12,464768
66079,8,-17,648,107419,8,107411
66080,18,-9,374,369459,18,369441
66081,6,16,559,1137006,6,1137000
66082,11,-17,964,122562,11,122551
66083,16,-16,920,153695,16,153679
66084,16,15,884,1123227,16,1123211
66085,11,-15,503,181479,11,181468
66086,12,-5,883,497515,12,497503
66087,17,15,364,1119429,17,1119412
66088,10,-2,838,580764,10,580754
66089,12,10,16,959943,12,959931
66090,16,-19,907,60866,16,60850
66091,8,-2,872,581447,8,581439
66092,15,-17,747,121195,15,121180
66093,17,-18,342,87893,17,87876
66094,20,8,574,902469,20,902449
66095,10,-5,212,472664,10,472654
66096,6,16,307,1131660,6,1131654
66097,18,8,52,898263,18,898245
66098,8,4,954,771476,8,771468
66099,9,-13,80,220094,9,220085
66100,6,-13,78,220060,6,220054
66101,15,11,912,997492,15,997477
66102,14,2,968,717705,14,717691
66103,6,-20,273,6038,6,6032
66104,16,15,69,1117285,16,1117269
66105,5,14,330,1069129,5,1069124
66106,16,0,54,648650,16,648634
66107,14,18,98,1209705,14,1209691
66108,16,10,40,960152,16,960136
66109,17,5,468,807257,17,807240
66110,12,-12,153,273666,12,273654
66111,14,-12,107,273310,14,273296
66112,11,1,692,685245,11,685234
66113,12,3,855,748270,12,748258
66114,16,19,325,1243385,16,1243369
66115,14,2,785,716369,14,716355
66116,16,12,688,1027254,16,1027238
66117,19,-13,724,246373,19,246354
66118,10,-10,770,329051,10,329041
66119,17,-3,946,561381,17,561364
66120,13,12,14,1022188,13,1022175
66121,7,-16,773,140685,7,140678
66122,14,-19,824,60319,14,60305
66123,7,-9,824,361946,7,361939
66124,9,1,224,662110,9,662101
66125,12,18,918,1215633,12,1215621
66126,19,-5,736,496436,19,496417
66127,5,-15,874,174054,5,174049
66128,15,18,404,1212029,15,1212014
66129,9,10,543,949081,9,949072
66130,6,-2,998,584078,6,584072
66131,18,13,313,1055497,18,1055479
66132,20,-9,206,368007,20,367987
66133,8,-14,743,202868,8,202860
66134,6,-14,348,194276,6,194270
66135,16,19,417,1244266,16,1244250
66136,18,3,541,745814,18,745796
66137,5,7,802,861757,5,861752
66138,18,9,122,929962,18,929944
66139,11,-7,626,432905,11,432894
66140,19,9,606,933562,19,933543
66141,14,15,513,1120519,14,1120505
66142,16,-14,110,210170,16,210154
66143,11,17,639,1182602,11,1182591
66144,11,-9,588,371308,11,371297
66145,11,-3,403,556784,11,556773
66146,6,-20,951,20938,6,20932
66147,9,-3,970,552211,9,552202
66148,11,-14,359,212200,11,212189
66149,6,19,368,1225818,6,1225812
66150,15,-10,306,337265,15,337250
66151,9,10,4,937595,9,937586
66152,9,-3,746,547097,9,547088
66153,5,-8,895,394519,5,394514
66154,10,-9,742,360045,10,360035
66155,7,-14,552,198446,7,198439
66156,14,19,229,1242548,14,1242534
66157,11,8,831,904415,11,904404
66158,15,1,919,687038,15,687023
66159,13,-9,577,371263,13,371250
66160,8,2,152,691822,8,691814
66161,12,8,8,897965,12,897953
66162,18,-11,701,309223,18,309205
66163,14,18,13,1209010,14,1208996
66164,14,16,339,1149565,14,1149551
66165,8,-3,985,552481,8,552473
66166,17,-17,31,115788,17,115771
66167,13,-17,861,121900,13,121887
66168,19,5,872,810137,19,810118
66169,7,4,602,763683,7,763676
66170,20,3,994,749490,20,749470
66171,13,17,280,1180035,13,1180022
66172,17,-14,211,210964,17,210947
66173,11,-1,522,620742,11,620731
66174,8,9,208,911200,8,911192
66175,9,-11,902,300553,9,300544
66176,6,-8,471,385031,6,385025
66177,20,4,965,780336,20,780316
66178,8,-10,421,321790,8,321782
66179,17,-1,282,618774,17,618757
66180,12,-18,814,91178,12,91166
66181,6,10,66,938944,6,938938
66182,7,-15,89,157339,7,157332
66183,12,-19,366,56845,12,56833
66184,15,-20,485,26442,15,26427
66185,13,-7,81,428857,13,428844
66186,14,7,177,868301,14,868287
66187,15,3,535,745745,15,745730
66188,19,-16,55,147194,19,147175
66189,16,1,718,685420,16,685404
66190,6,9,10,906938,6,906932
66191,8,-8,929,395193,8,395185
66192,10,-14,146,189662,10,189652
66193,15,0,573,652595,15,652580
66194,18,-11,363,306651,18,306633
66195,7,-20,663,14611,7,14604
66196,6,-2,413,571469,6,571463
66197,17,0,103,649066,17,649049
66198,19,18,925,1215723,19,1215704
66199,19,2,684,715749,19,715730
66200,18,15,614,1121286,18,1121268
66201,9,3,361,726709,9,726700
66202,5,8,0,875151,5,875146
66203,17,-20,970,30125,17,30108
66204,12,-3,67,554239,12,554227
66205,18,-11,287,305973,18,305955
66206,17,16,136,1148053,17,1148036
66207,14,-4,379,525051,14,525037
66208,7,4,230,755673,7,755666
66209,6,-16,805,141323,6,141317
66210,18,13,434,1056484,18,1056466
66211,14,16,497,1150649,14,1150635
66212,16,6,963,843418,16,843402
66213,9,-3,208,534859,9,534850
66214,11,-6,325,461691,11,461680
66215,9,-4,327,506653,9,506644
66216,16,-18,212,86919,16,86903
66217,15,-10,562,339279,15,339264
66218,12,8,871,904713,12,904701
66219,18,-5,73,491416,18,491398
66220,19,-17,562,119743,19,119724
66221,16,9,440,932243,16,932227
66222,19,10,384,962698,19,962679
66223,6,-12,495,260314,6,260308
66224,20,-11,949,311135,20,311115
66225,5,-16,771,140621,5,140616
66226,19,6,755,841854,19,841835
66227,16,-10,485,338680,16,338664
66228,6,4,103,752873,6,752867
66229,9,-9,139,346543,9,346534
66230,7,-7,36,406886,7,406879
66231,10,14,123,1064583,10,1064573
66232,16,12,36,1022359,16,1022343
66233,7,-3,722,546685,7,546678
66234,20,-12,208,273999,20,273979
66235,18,8,503,901961,18,901943
66236,13,16,143,1148106,13,1148093
66237,19,-8,71,398513,19,398494
66238,8,16,217,1129810,8,1129802
66239,12,16,362,1149756,12,1149744
66240,20,-10,522,338916,20,338896
66241,8,5,372,789298,8,789290
66242,10,-8,97,377407,10,377397
66243,5,11,582,980943,5,980938
66244,20,8,224,899765,20,899745
66245,18,0,851,654697,18,654679
66246,9,16,790,1141541,9,1141532
66247,20,-1,162,617752,20,617732
66248,9,-5,13,468006,9,467997
66249,17,-16,122,147848,17,147831
66250,5,-10,595,325495,5,325490
66251,20,11,51,991256,20,991236
66252,7,4,132,753454,7,753447
66253,7,13,969,1051459,7,1051452
66254,15,-12,684,277548,15,277533
66255,11,19,911,1248163,11,1248152
66256,18,-19,560,58391,18,58373
66257,16,-18,157,86485,16,86469
66258,8,6,904,832609,8,832601
66259,9,-16,213,128711,9,128702
66260,10,8,478,885605,10,885595
66261,9,11,122,971026,9,971017
66262,19,12,176,1023328,19,1023309
66263,9,0,990,646878,9,646869
66264,5,-9,316,350555,5,350550
66265,9,-5,483,478465,9,478456
66266,13,5,892,810245,13,810232
66267,19,12,916,1029083,19,1029064
66268,9,9,478,916736,9,916727
66269,20,3,682,747033,20,747013
66270,14,-18,466,88795,14,88781
66271,16,13,399,1056190,16,1056174
66272,19,-18,927,91963,19,91944
66273,14,-4,602,526606,14,526592
66274,13,-8,264,399747,13,399734
66275,18,4,731,778653,18,778635
66276,12,-18,67,85731,12,85719
66277,9,-18,546,74187,9,74178
66278,18,3,197,743368,18,743350
66279,7,-15,372,163464,7,163457
66280,8,12,134,1002004,8,1001996
66281,10,-9,410,352542,10,352532
66282,13,-1,89,617254,13,617241
66283,18,2,457,714094,18,714076
66284,12,-5,743,496464,12,496452
66285,19,-5,418,494106,19,494087
66286,15,1,192,681383,15,681368
66287,12,-20,59,23247,12,23235
66288,8,19,692,1232798,8,1232790
66289,8,18,465,1196702,8,1196694
66290,15,18,161,1210270,15,1210255
66291,17,-7,462,431806,17,431789
66292,20,10,419,963046,20,963026
66293,14,10,163,961132,14,961118
66294,5,-1,907,613537,5,613532
66295,6,-18,300,69031,6,69025
66296,17,-14,254,211435,17,211418
66297,14,2,721,716043,14,716029
66298,14,0,894,655061,14,655047
66299,9,4,168,754233,9,754224
66300,9,16,368,1133007,9,1132998
66301,10,-13,792,235560,10,235550
66302,16,-8,64,398426,16,398410
66303,9,-9,433,353163,9,353154
66304,11,6,794,842117,11,842106
66305,7,-5,472,478215,7,478208
66306,16,9,382,931823,16,931807
66307,5,-18,70,63968,5,63963
66308,17,-20,613,27452,17,27435
66309,11,10,251,961701,11,961690
66310,17,-8,369,400480,17,400463
66311,5,-12,150,252815,5,252810
66312,18,-18,98,85971,18,85953
66313,19,8,950,905349,19,905330
66314,17,8,903,905006,17,904989
66315,19,-2,215,586739,19,586720
66316,9,4,236,755811,9,755802
66317,11,-3,28,554013,11,554002
66318,20,-8,332,400250,20,400230
66319,6,12,855,1017810,6,1017804
66320,7,2,350,696214,7,696207
66321,13,-1,773,622512,13,622499
66322,13,5,484,807369,13,807356
66323,17,16,185,1148450,17,1148433
66324,6,-4,605,512447,6,512441
66325,5,-7,309,412564,5,412559
66326,18,-2,193,586537,18,586519
66327,16,1,232,681731,16,681715
66328,18,4,501,776855,18,776837
66329,7,-10,20,313009,7,313002
66330,17,16,857,1153218,17,1153201
66331,20,-13,600,245462,20,245442
66332,7,-15,653,169572,7,169565
66333,8,-3,115,532930,8,532922
66334,8,-9,365,351651,8,351643
66335,17,19,425,1244351,17,1244334
66336,17,-9,397,369679,17,369662
66337,10,-13,552,230106,10,230096
66338,5,15,887,1113292,5,1113287
66339,14,-12,225,274184,14,274170
66340,5,3,562,730669,5,730664
66341,8,-11,472,291681,8,291673
66342,6,2,465,698575,6,698569
66343,11,5,140,804820,11,804809
66344,17,-17,681,120620,17,120603
66345,10,12,776,1015925,10,1015915
66346,16,3,554,745907,16,745891
66347,9,12,107,1001430,9,1001421
66348,11,-2,585,589532,11,589521
66349,7,-16,133,126958,7,126951
66350,7,13,875,1049589,7,1049582
66351,17,-17,576,119885,17,119868
66352,15,-14,192,210782,15,210767
66353,11,3,79,742420,11,742409
66354,15,9,712,934330,15,934315
66355,15,9,509,932792,15,932777
66356,8,3,787,735712,8,735704
66357,5,-4,824,516901,5,516896
66358,15,-7,720,433558,15,433543
66359,14,1,128,680856,14,680842
66360,12,2,356,713294,12,713282
66361,5,10,586,950131,5,950126
66362,17,-15,48,178136,17,178119
66363,13,-12,390,275356,13,275343
66364,7,-15,40,156200,7,156193
66365,11,13,541,1057267,11,1057256
66366,15,-6,542,463365,15,463350
66367,5,-17,597,106415,5,106410
66368,13,15,498,1120322,13,1120309
66369,17,3,306,744228,17,744211
66370,8,6,178,816068,8,816060
66371,19,-12,515,276356,19,276337
66372,16,0,885,655001,16,654985
66373,5,7,885,863570,5,863565
66374,18,6,434,839238,18,839220
66375,15,-9,175,367783,15,367768
66376,10,-5,656,482227,10,482217
66377,12,-18,635,89866,12,89854
66378,5,-7,999,427221,5,427216
66379,10,-3,721,546649,10,546639
66380,15,-19,740,59838,15,59823
66381,11,6,931,843166,11,843155
66382,20,8,293,900283,20,900263
66383,18,-15,190,179117,18,179099
66384,6,9,137,909691,6,909685
66385,17,-8,597,402039,17,402022
66386,10,-16,542,135827,10,135817
66387,7,-4,952,519855,7,519848
66388,7,3,228,723815,7,723808
66389,13,-5,931,497888,13,497875
66390,12,-11,883,310649,12,310637
66391,18,1,872,686604,18,686586
66392,9,8,496,886053,9,886044
66393,11,3,447,745203,11,745192
66394,19,3,983,749403,19,749384
66395,18,-17,87,116211,18,116193
66396,10,-5,233,473125,10,473115
66397,17,9,452,932305,17,932288
66398,14,9,202,930545,14,930531
66399,18,-2,10,585185,18,585167
66400,5,-13,701,233194,5,233189
66401,13,-16,287,149059,13,149046
66402,9,5,509,792129,9,792120
66403,13,19,645,1246039,13,1246026
66404,19,-12,664,277426,19,277407
66405,15,-13,675,245894,15,245879
66406,13,-19,742,59870,13,59857
66407,20,-4,428,525413,20,525393
66408,12,7,897,873442,12,873430
66409,10,0,872,644228,10,644218
66410,6,2,118,691136,6,691130
66411,10,17,838,1173345,10,1173335
66412,8,0,119,628062,8,628054
66413,17,17,699,1183111,17,1183094
66414,7,-8,214,380063,7,380056
66415,10,-7,820,423157,10,423147
66416,5,-18,530,73820,5,73815
66417,17,-1,285,618835,17,618818
66418,17,-7,895,434945,17,434928
66419,7,19,744,1234026,7,1234019
66420,18,5,131,804719,18,804701
66421,14,-4,959,529306,14,529292
66422,5,3,907,738389,5,738384
66423,13,-4,122,522960,13,522947
66424,17,0,66,648741,17,648724
66425,20,-18,225,87050,20,87030
66426,17,2,513,714499,17,714482
66427,7,7,648,858492,7,858485
66428,17,19,212,1242432,17,1242415
66429,18,4,916,780037,18,780019
66430,19,19,420,1244315,19,1244296
66431,6,11,418,977434,6,977428
66432,6,-19,638,45557,6,45551
66433,19,-6,613,463834,19,463815
66434,13,-19,45,54215,13,54202
66435,13,19,508,1244973,13,1244960
66436,19,15,856,1123043,19,1123024
66437,7,-7,120,408346,7,408339
66438,12,0,370,650861,12,650849
66439,10,-11,983,302325,10,302315
66440,8,17,481,1165653,8,1165645
66441,19,15,618,1121326,19,1121307
66442,9,-17,96,95522,9,95513
66443,5,-19,863,50382,5,50377
66444,13,-12,749,278019,13,278006
66445,9,-1,166,597330,9,597321
66446,20,-12,852,278834,20,278814
66447,14,-19,813,60238,14,60224
66448,13,1,874,686607,13,686594
66449,17,-3,522,557884,17,557867
66450,17,-10,59,335630,17,335613
66451,13,11,471,994294,13,994281
66452,16,2,391,713563,16,713547
66453,11,-10,873,341636,11,341625
66454,20,-12,516,276374,20,276354
66455,6,3,175,722560,6,722554
66456,14,-1,584,621131,14,621117
66457,18,2,167,711876,18,711858
66458,19,-14,358,212194,19,212175
66459,9,-11,491,292169,9,292160
66460,16,10,165,961151,16,961135
66461,17,-2,304,587418,17,587401
66462,9,19,299,1224223,9,1224214
66463,6,9,794,923598,6,923592
66464,16,-6,836,465477,16,465461
66465,9,-6,53,437981,9,437972
66466,19,14,276,1087581,19,1087562
66467,10,-8,668,389737,10,389727
66468,6,-11,37,281863,6,281857
66469,5,18,591,1199179,5,1199174
66470,14,2,525,714595,14,714581
66471,19,-20,305,25198,19,25179
66472,6,8,920,895151,6,895145
66473,18,-19,954,61173,18,61155
66474,11,13,379,1056008,11,1055997
66475,7,-5,561,480179,7,480172
66476,9,2,609,701462,9,701453
66477,15,7,910,873518,15,873503
66478,18,19,470,1244662,18,1244644
66479,6,13,315,1037466,6,1037460
66480,18,-1,487,620474,18,620456
66481,5,12,162,1002650,5,1002645
66482,15,-15,331,180168,15,180153
66483,8,1,804,674488,8,674480
66484,10,4,940,771158,10,771148
66485,17,4,655,778040,17,778023
66486,11,6,394,838907,11,838896
66487,19,-13,355,243634,19,243615
66488,19,-14,567,213992,19,213973
66489,9,-5,310,474897,9,474888
66490,15,5,13,803872,15,803857
66491,13,-14,417,212815,13,212802
66492,14,1,839,686325,14,686311
66493,19,-14,997,217253,19,217234
66494,7,-3,212,534941,7,534934
66495,7,-6,629,450271,7,450264
66496,12,3,573,746095,12,746083
66497,20,17,778,1183661,20,1183641
66498,14,7,156,868168,14,868154
66499,19,-3,616,558683,19,558664
66500,8,-14,62,187839,8,187831
66501,14,7,77,867568,14,867554
66502,11,9,925,935979,11,935968
66503,8,5,838,799174,8,799166
66504,9,-20,579,12636,9,12627
66505,18,-14,443,212963,18,212945
66506,14,10,268,961862,14,961848
66507,13,-2,110,585965,13,585952
66508,9,-12,717,265033,9,265024
66509,8,-6,744,452818,8,452810
66510,5,13,579,1043288,5,1043283
66511,16,-3,337,556265,16,556249
66512,15,14,47,1085787,15,1085772
66513,17,13,629,1058038,17,1058021
66514,14,8,495,901882,14,901868
66515,12,-3,402,556741,12,556729
66516,11,14,882,1092350,11,1092339
66517,14,10,594,964488,14,964474
66518,11,-15,786,183614,11,183603
66519,6,9,327,913651,6,913645
66520,14,11,239,992520,14,992506
66521,7,13,277,1036617,7,1036610
66522,6,-12,955,270429,6,270423
66523,18,-19,73,54448,18,54430
66524,10,12,988,1020886,10,1020876
66525,12,0,950,655486,12,655474
66526,5,-17,663,107756,5,107751
66527,19,19,305,1243217,19,1243198
66528,12,6,40,836112,12,836100
66529,5,6,200,816560,5,816555
66530,13,-5,779,496641,13,496628
66531,6,-19,182,35600,6,35594
66532,18,-7,314,430709,18,430691
66533,18,11,332,993306,18,993288
66534,8,-20,1,52,8,44
66535,8,-1,340,601532,8,601524
66536,10,-10,521,323870,10,323860
66537,11,9,444,932261,11,932250
66538,12,7,864,873262,12,873250
66539,5,-18,983,83815,5,83810
66540,12,3,928,748888,12,748876
66541,6,-1,133,596710,6,596704
66542,15,-19,88,54609,15,54594
66543,7,-16,261,129706,7,129699
66544,16,-4,915,528946,16,528930
66545,5,-20,874,19438,5,19433
66546,8,6,570,825173,8,825165
66547,17,-4,923,528976,17,528959
66548,5,-9,703,359073,5,359068
66549,15,10,454,963278,15,963263
66550,12,0,629,652997,12,652985
66551,17,19,4,1240679,17,1240662
66552,18,-5,431,494174,18,494156
66553,19,0,879,654911,19,654892
66554,11,-6,373,462035,11,462024
66555,15,-8,715,402944,15,402929
66556,9,-9,862,362829,9,362820
66557,17,6,624,840786,17,840769
66558,19,-11,5,303710,19,303691
66559,20,18,729,1214181,20,1214161
66560,11,-19,819,60276,11,60265
66561,12,4,644,777951,12,777939
66562,20,6,692,841351,20,841331
66563,9,-19,759,48249,9,48240
66564,15,-12,833,278659,15,278644
66565,16,18,625,1213436,16,1213420
66566,19,-14,637,214537,19,214518
66567,20,16,795,1152792,20,1152772
66568,8,10,83,939294,8,939286
66569,6,-20,592,12931,6,12925
66570,19,18,525,1212842,19,1212823
66571,11,5,585,808049,11,808038
66572,10,-3,45,531524,10,531514
66573,14,-1,898,623431,14,623417
66574,18,-2,179,586370,18,586352
66575,13,-1,722,622168,13,622155
66576,20,12,197,1023455,20,1023435
66577,9,9,955,927057,9,927048
66578,18,8,238,899922,18,899904
66579,17,-13,485,244562,17,244545
66580,19,-20,845,29356,19,29337
66581,17,-13,278,243150,17,243133
66582,19,18,329,1211502,19,1211483
66583,5,-12,816,267247,5,267242
66584,7,16,476,1135422,7,1135415
66585,15,-18,146,86358,15,86343
66586,15,-12,880,279096,15,279081
66587,9,6,46,813197,9,813188
66588,17,-12,248,274327,17,274310
66589,10,-19,616,44997,10,44987
66590,8,-8,516,386195,8,386187
66591,17,-18,770,90869,17,90852
66592,5,-17,593,106336,5,106331
66593,10,-19,818,49295,10,49285
66594,18,18,517,1212786,18,1212768
66595,9,3,325,726002,9,725993
66596,9,-2,522,573889,9,573880
66597,16,-3,891,560909,16,560893
66598,8,-10,328,319641,8,319633
66599,16,-1,576,621106,16,621090
66600,17,-16,305,149198,17,149181
66601,20,17,960,1185119,20,1185099
66602,11,4,293,775301,11,775290
66603,17,-18,352,87986,17,87969
66604,9,13,192,1034791,9,1034782
66605,19,-9,852,373328,19,373309
66606,6,9,950,926943,6,926937
66607,20,18,60,1209423,20,1209403
66608,18,-8,576,401904,18,401886
66609,8,6,130,814955,8,814947
66610,17,-13,431,244188,17,244171
66611,5,5,147,784608,5,784603
66612,6,-18,493,73058,6,73052
66613,16,-15,933,184868,16,184852
66614,10,-2,291,569076,10,569066
66615,8,-11,229,286019,8,286011
66616,10,4,353,758158,10,758148
66617,13,5,142,804823,13,804810
66618,9,12,715,1014773,9,1014764
66619,16,11,864,997129,16,997113
66620,11,8,940,905261,11,905250
66621,8,16,651,1138876,8,1138868
66622,8,17,437,1164610,8,1164602
66623,10,-9,831,362114,10,362104
66624,5,-19,425,40658,5,40653
66625,9,-17,471,103523,9,103514
66626,13,15,299,1119019,13,1119006
66627,12,-17,609,120078,12,120066
66628,13,0,650,653223,13,653210
66629,13,14,125,1086458,13,1086445
66630,18,4,401,776097,18,776079
66631,10,-4,403,508417,10,508407
66632,7,-15,862,173820,7,173813
66633,19,-4,957,529273,19,529254
66634,19,14,644,1090459,19,1090440
66635,18,-5,411,494055,18,494037
66636,7,13,110,1033090,7,1033083
66637,13,-13,989,248498,13,248485
66638,16,19,572,1245451,16,1245435
66639,9,-16,362,131741,9,131732
66640,19,-20,780,28837,19,28818
66641,9,16,365,1132928,9,1132919
66642,13,0,371,650878,13,650865
66643,7,-19,641,45648,7,45641
66644,8,-2,404,571307,8,571299
66645,12,12,175,1023313,12,1023301
66646,20,-9,812,372979,20,372959
66647,19,3,251,743777,19,743758
66648,16,-10,901,341857,16,341841
66649,11,6,804,842210,11,842199
66650,7,19,743,1233998,7,1233991
66651,20,-2,581,589510,20,589490
66652,8,10,753,953661,8,953653
66653,10,-6,678,451270,10,451260
66654,13,14,920,1092601,13,1092588
66655,16,-16,1000,154316,16,154300
66656,10,8,106,877334,10,877324
66657,18,-16,401,149825,18,149807
66658,17,-11,891,310684,17,310667
66659,10,-13,236,223370,10,223360
66660,15,-13,197,242523,15,242508
66661,10,-11,115,283672,10,283662
66662,10,6,903,832592,10,832582
66663,12,1,321,682442,12,682430
66664,6,1,27,657645,6,657639
66665,17,-13,266,243055,17,243038
66666,19,-2,575,589454,19,589435
66667,19,9,703,934266,19,934247
66668,14,6,940,843251,14,843237
66669,12,-1,925,623644,12,623632
66670,13,-17,462,118946,13,118933
66671,19,14,489,1089259,19,1089240
66672,18,15,145,1117893,18,1117875
66673,14,-15,823,183942,14,183928
66674,20,-14,150,210455,20,210435
66675,13,16,373,1149829,13,1149816
66676,13,6,177,837083,13,837070
66677,14,9,443,932256,14,932242
66678,15,6,638,840941,15,840926
66679,16,-8,311,400083,16,400067
66680,6,-7,233,410771,6,410765
66681,19,-20,583,27249,19,27230
66682,19,-3,509,557739,19,557720
66683,15,13,75,1053786,15,1053771
66684,5,-9,412,352591,5,352586
66685,18,-9,7,366695,18,366677
66686,17,0,373,650906,17,650889
66687,16,-4,63,522527,16,522511
66688,13,1,796,686066,13,686053
66689,9,-14,725,202521,9,202512
66690,12,1,447,683357,12,683345
66691,5,-13,946,238847,5,238842
66692,12,16,77,1147626,12,1147614
66693,18,-3,807,560268,18,560250
66694,6,-15,612,168597,6,168591
66695,8,-1,168,597361,8,597353
66696,16,12,429,1025191,16,1025175
66697,9,-12,22,250076,9,250067
66698,10,-17,330,100601,10,100591
66699,12,-11,257,305721,12,305709
66700,13,-9,630,371525,13,371512
66701,17,-19,317,56422,17,56405
66702,20,10,91,960562,20,960542
66703,13,3,235,743657,13,743644
66704,8,-14,91,188591,8,188583
66705,5,3,613,731860,5,731855
66706,7,11,402,977169,7,977162
66707,6,12,67,1000553,6,1000547
66708,6,10,639,951353,6,951347
66709,19,16,42,1147371,19,1147352
66710,7,-16,989,145365,7,145358
66711,10,3,963,739862,10,739852
66712,14,19,822,1247401,14,1247387
66713,19,0,368,650846,19,650827
66714,7,19,817,1235582,7,1235575
66715,10,3,690,733831,10,733821
66716,10,8,931,895415,10,895405
66717,16,-14,90,210051,16,210035
66718,7,7,451,854479,7,854472
66719,9,4,187,754603,9,754594
66720,12,12,330,1024548,12,1024536
66721,13,-18,220,86982,13,86969
66722,12,-2,999,592694,12,592682
66723,5,5,232,786514,5,786509
66724,6,-10,320,319488,6,319482
66725,9,17,823,1172992,9,1172983
66726,16,18,632,1213519,16,1213503
66727,11,2,45,710846,11,710835
66728,7,16,535,1136563,7,1136556
66729,14,-10,121,336006,14,335992
66730,9,18,318,1193647,9,1193638
66731,12,18,452,1212337,12,1212325
66732,16,19,102,1241583,16,1241567
66733,18,-15,921,184784,18,184766
66734,10,7,735,860395,10,860385
66735,6,12,444,1008593,6,1008587
66736,9,-2,31,563449,9,563440
66737,20,-6,89,459751,20,459731
66738,19,-17,913,122281,19,122262
66739,8,17,335,1162574,8,1162566
66740,13,-5,724,496324,13,496311
66741,19,3,21,741946,19,741927
66742,11,-20,274,24891,11,24880
66743,15,-16,94,147593,15,147578
66744,18,5,280,805886,18,805868
66745,10,-7,973,426665,10,426655
66746,6,-5,310,474903,6,474897
66747,9,6,352,820237,9,820228
66748,16,17,843,1184343,16,1184327
66749,9,19,652,1231997,9,1231988
66750,13,-5,355,493717,13,493704
66751,16,-1,179,617886,16,617870
66752,8,-15,467,165574,8,165566
66753,5,-9,859,362796,5,362791
66754,10,-7,257,411246,10,411236
66755,5,-8,461,384861,5,384856
66756,8,3,90,720777,8,720769
66757,9,19,984,1239232,9,1239223
66758,6,-2,141,565861,6,565855
66759,19,-2,343,587683,19,587664
66760,16,14,629,1090342,16,1090326
66761,20,-8,891,404213,20,404193
66762,8,12,207,1003615,8,1003607
66763,12,19,105,1241621,12,1241609
66764,5,-20,684,15159,5,15154
66765,17,7,875,873328,17,873311
66766,7,-20,901,19994,7,19987
66767,17,5,575,807986,17,807969
66768,9,8,119,877648,9,877639
66769,15,-15,548,181838,15,181823
66770,6,-4,335,506819,6,506813
66771,10,6,791,830109,10,830099
66772,15,-17,275,117509,15,117494
66773,20,1,943,687219,20,687199
66774,20,-11,973,311340,20,311320
66775,16,-8,44,398249,16,398233
66776,8,-9,819,361837,8,361829
66777,7,-19,24,32020,7,32013
66778,8,-4,15,499630,8,499622
66779,17,7,350,869575,17,869558
66780,11,6,366,838590,11,838579
66781,18,-10,218,336695,18,336677
66782,5,-6,159,440201,5,440196
66783,20,-7,996,435734,20,435714
66784,19,2,289,712777,19,712758
66785,7,12,802,1016509,7,1016502
66786,7,3,208,723377,7,723370
66787,15,18,691,1213947,15,1213932
66788,6,4,220,755435,6,755429
66789,14,13,455,1056637,14,1056623
66790,17,5,758,809296,17,809279
66791,13,3,788,747774,13,747761
66792,6,2,968,708913,6,708907
66793,13,9,817,935116,13,935103
66794,17,2,94,711302,17,711285
66795,8,-4,117,501891,8,501883
66796,11,8,699,903540,11,903529
66797,10,-17,553,105392,10,105382
66798,9,8,965,896131,9,896122
66799,12,-20,62,23257,12,23245
66800,9,-1,846,612034,9,612025
66801,15,13,945,1060243,15,1060228
66802,9,-10,260,318233,9,318224
66803,15,2,513,714504,15,714489
66804,20,-9,500,370626,20,370606
66805,7,2,190,692754,7,692747
66806,16,0,444,651463,16,651447
66807,11,17,838,1184251,11,1184240
66808,8,3,142,721920,8,721912
66809,9,10,329,944503,9,944494
66810,6,-8,615,388445,6,388439
66811,8,-11,190,285265,8,285257
66812,7,19,842,1236253,7,1236246
66813,19,-14,553,213749,19,213730
66814,12,18,790,1214746,12,1214734
66815,16,-4,829,528133,16,528117
66816,9,2,165,692155,9,692146
66817,15,7,585,871339,15,871324
66818,9,4,876,769887,9,769878
66819,17,-20,102,23535,17,23518
66820,14,6,257,837718,14,837704
66821,17,-13,273,243118,17,243101
66822,17,17,892,1184656,17,1184639
66823,18,19,256,1242781,18,1242763
66824,6,-10,570,325010,6,325004
66825,19,13,285,1055289,19,1055270
66826,11,-13,683,245979,11,245968
66827,19,19,236,1242582,19,1242563
66828,13,-9,480,370467,13,370454
66829,16,19,384,1243895,16,1243879
66830,13,0,85,648854,13,648841
66831,16,-12,276,274579,16,274563
66832,11,11,98,991575,11,991564
66833,6,-8,126,378023,6,378017
66834,14,-8,631,402304,14,402290
66835,13,16,737,1152344,13,1152331
66836,12,-6,903,465971,12,465959
66837,6,16,699,1139697,6,1139691
66838,16,1,841,686354,16,686338
66839,13,-6,424,462415,13,462402
66840,20,11,197,992250,20,992230
66841,5,-14,474,196933,5,196928
66842,18,3,496,745537,18,745519
66843,20,-15,906,184638,20,184618
66844,19,5,170,805017,19,804998
66845,9,6,607,826030,9,826021
66846,19,1,807,686132,19,686113
66847,15,8,319,900465,15,900450
66848,16,-18,478,88847,16,88831
66849,12,8,658,903141,12,903129
66850,7,-10,899,331811,7,331804
66851,18,-10,14,335232,18,335214
66852,5,-1,49,594856,5,594851
66853,5,-16,673,138529,5,138524
66854,13,-12,338,275025,13,275012
66855,13,10,486,963535,13,963522
66856,6,-15,468,165604,6,165598
66857,19,7,996,874093,19,874074
66858,10,8,983,896560,10,896550
66859,17,-15,164,178983,17,178966
66860,17,12,722,1027464,17,1027447
66861,6,-17,263,99088,6,99082
66862,12,-15,517,181573,12,181561
66863,15,-1,769,622460,15,622445
66864,15,14,479,1089185,15,1089170
66865,15,-3,676,559189,15,559174
66866,20,-1,200,618061,20,618041
66867,7,-15,490,166128,7,166121
66868,15,10,364,962596,15,962581
66869,15,19,591,1245585,15,1245570
66870,20,15,551,1120772,20,1120752
66871,16,19,70,1241328,16,1241312
66872,18,16,366,1149793,18,1149775
66873,11,-19,380,56974,11,56963
66874,19,-4,220,523836,19,523817
66875,10,-12,194,253634,10,253624
66876,10,-6,703,451917,10,451907
66877,20,-16,435,150202,20,150182
66878,16,1,1,679747,16,679731
66879,9,-4,134,502353,9,502344
66880,17,-19,348,56714,17,56697
66881,13,8,228,899809,13,899796
66882,14,-11,53,304072,14,304058
66883,16,2,157,711781,16,711765
66884,18,14,153,1086658,18,1086640
66885,7,7,86,846690,7,846683
66886,17,-13,158,242184,17,242167
66887,18,3,737,747424,18,747406
66888,19,16,818,1152968,19,1152949
66889,14,10,671,965097,14,965083
66890,6,13,718,1046140,6,1046134
66891,5,12,810,1016663,5,1016658
66892,14,-13,277,243137,14,243123
66893,13,6,692,841354,13,841341
66894,8,4,903,770475,8,770467
66895,20,3,563,745995,20,745975
66896,11,9,837,935278,11,935267
66897,12,14,455,1089026,12,1089014
66898,16,-19,297,56317,16,56301
66899,20,15,503,1120386,20,1120366
66900,18,-16,319,149328,18,149310
66901,20,4,487,776751,20,776731
66902,15,4,452,776502,15,776487
66903,9,3,597,731572,9,731563
66904,8,4,159,754002,8,753994
66905,10,14,586,1074837,10,1074827
66906,16,9,965,936322,16,936306
66907,19,6,122,836708,19,836689
66908,17,-6,547,463410,17,463393
66909,20,12,82,1022680,20,1022660
66910,7,-18,556,74389,7,74382
66911,18,-20,691,28152,18,28134
66912,9,10,705,952753,9,952744
66913,18,-8,716,402960,18,402942
66914,20,1,357,682715,20,682695
66915,9,-9,553,356173,9,356164
66916,14,16,846,1153163,14,1153149
66917,10,-16,46,124783,10,124773
66918,9,17,271,1161131,9,1161122
66919,9,19,768,1234556,9,1234547
66920,15,19,897,1248049,15,1248034
66921,13,18,635,1213526,13,1213513
66922,5,-15,552,167354,5,167349
66923,17,-7,897,434961,17,434944
66924,5,13,296,1037086,5,1037081
66925,9,12,622,1012580,9,1012571
66926,13,14,315,1087869,13,1087856
66927,7,7,771,861087,7,861080
66928,16,3,972,749311,16,749295
66929,9,17,982,1176447,9,1176438
66930,7,-9,432,353118,7,353111
66931,15,-13,481,244519,15,244504
66932,13,13,728,1058662,13,1058649
66933,15,0,698,653638,15,653623
66934,20,-15,115,178666,20,178646
66935,12,-20,637,27635,12,27623
66936,11,10,792,965997,11,965986
66937,17,-19,941,61087,17,61070
66938,7,19,199,1221901,7,1221894
66939,17,-4,701,527360,17,527343
66940,14,-11,564,308219,14,308205
66941,5,-1,830,611694,5,611689
66942,10,-13,699,233138,10,233128
66943,20,15,252,1118668,20,1118648
66944,11,13,729,1058666,11,1058655
66945,20,-6,817,465392,20,465372
66946,8,-16,404,132741,8,132733
66947,18,-16,942,153859,18,153841
66948,14,-11,583,308398,14,308384
66949,12,-7,714,433516,12,433504
66950,19,6,798,842158,19,842139
66951,14,-1,357,619486,14,619472
66952,11,17,333,1180481,11,1180470
66953,7,8,668,889817,7,889810
66954,15,-12,930,279507,15,279492
66955,19,13,236,1054968,19,1054949
66956,12,19,382,1243858,12,1243846
66957,5,-14,57,187792,5,187787
66958,8,6,23,812776,8,812768
66959,9,-19,988,52649,9,52640
66960,17,5,543,807749,17,807732
66961,6,-8,136,378339,6,378333
66962,17,-18,369,88070,17,88053
66963,20,-18,670,90153,20,90133
66964,18,15,775,1122497,18,1122479
66965,13,-15,417,180842,13,180829
66966,17,0,547,652376,17,652359
66967,7,2,838,706111,7,706104
66968,9,-17,890,112382,9,112373
66969,8,-8,71,377045,8,377037
66970,13,1,92,680509,13,680496
66971,10,-18,66,63845,10,63835
66972,10,9,970,927503,10,927493
66973,15,-18,181,86706,15,86691
66974,18,-8,303,400003,18,399985
66975,5,-11,706,296452,5,296447
66976,8,-11,988,302489,8,302481
66977,11,9,502,932719,11,932708
66978,8,-2,430,571933,8,571925
66979,18,-5,458,494421,18,494403
66980,20,-13,890,247695,20,247675
66981,6,12,29,999727,6,999721
66982,20,18,357,1211685,20,1211665
66983,17,-8,396,400720,17,400703
66984,19,4,716,778527,19,778508
66985,13,-14,231,211234,13,211221
66986,17,-2,974,592572,17,592555
66987,5,-18,580,74923,5,74918
66988,15,17,788,1183771,15,1183756
66989,8,-12,645,263492,8,263484
66990,9,-7,400,414623,9,414614
66991,15,2,435,713882,15,713867
66992,5,-8,158,378858,5,378853
66993,13,7,459,870455,13,870442
66994,5,4,629,764237,5,764232
66995,12,17,773,1183596,12,1183584
66996,15,14,644,1090464,15,1090449
66997,11,7,320,869348,11,869337
66998,17,15,268,1118803,17,1118786
66999,18,14,825,1091920,18,1091902
67000,14,-19,283,56224,14,56210
67001,19,-14,814,215901,19,215882
67002,8,4,126,753281,8,753273
67003,20,15,990,1124056,20,1124036
67004,7,-5,503,478897,7,478890
67005,17,-2,808,591195,17,591178
67006,11,4,252,775065,11,775054
67007,6,-1,760,610135,6,610129
67008,7,-8,173,379224,7,379217
67009,19,-5,322,493513,19,493494
67010,20,-11,894,310695,20,310675
67011,14,-4,122,522964,14,522950
67012,18,-16,991,154255,18,154237
67013,15,2,462,714130,15,714115
67014,17,-7,497,432041,17,432024
67015,12,12,880,1028682,12,1028670
67016,20,-19,437,57377,20,57357
67017,11,17,235,1179596,11,1179585
67018,14,-12,523,276432,14,276418
67019,20,2,184,711962,20,711942
67020,11,-3,690,559280,11,559269
67021,6,0,204,629938,6,629932
67022,11,8,439,901503,11,901492
67023,8,13,543,1042350,8,1042342
67024,11,-10,762,340827,11,340816
67025,5,-6,652,450778,5,450773
67026,18,-8,958,404699,18,404681
67027,15,-14,797,215773,15,215758
67028,18,-11,430,307224,18,307206
67029,19,-19,37,54150,19,54131
67030,7,-11,240,286259,7,286252
67031,5,5,100,783688,5,783683
67032,15,-5,668,495848,15,495833
67033,9,-17,206,97766,9,97757
67034,13,-3,944,561348,13,561335
67035,8,5,972,802160,8,802152
67036,11,-4,10,522124,11,522113
67037,15,12,762,1027697,15,1027682
67038,15,-14,967,217003,15,216988
67039,14,17,58,1178327,14,1178313
67040,18,-12,547,276580,18,276562
67041,17,10,83,960478,17,960461
67042,20,19,884,1247944,20,1247924
67043,10,13,803,1048090,10,1048080
67044,20,-14,675,214822,20,214802
67045,10,-12,502,260514,10,260504
67046,5,1,707,672336,5,672331
67047,14,11,590,995125,14,995111
67048,11,-2,874,591800,11,591789
67049,19,-17,136,116486,19,116467
67050,7,3,323,725985,7,725978
67051,19,-17,514,119374,19,119355
67052,11,8,309,900396,11,900385
67053,16,-13,188,242447,16,242431
67054,14,-14,608,214315,14,214301
67055,13,-7,22,428468,13,428455
67056,5,-7,394,414481,5,414476
67057,9,-18,50,63448,9,63439
67058,14,-1,959,623842,14,623828
67059,11,11,681,995688,11,995677
67060,16,11,277,992880,16,992864
67061,14,-16,849,153146,14,153132
67062,11,0,412,651225,11,651214
67063,19,10,172,961195,19,961176
67064,18,13,132,1054194,18,1054176
67065,11,17,580,1182122,11,1182111
67066,18,9,154,930194,18,930176
67067,11,-15,94,178487,11,178476
67068,13,0,737,653956,13,653943
67069,20,9,847,935356,20,935336
67070,8,-20,296,6635,8,6627
67071,17,-13,931,248080,17,248063
67072,7,-19,236,36769,7,36762
67073,17,-4,877,528644,17,528627
67074,6,-1,635,607581,6,607575
67075,16,-7,541,432425,16,432409
67076,16,-12,564,276691,16,276675
67077,9,14,689,1077560,9,1077551
67078,14,-2,659,590079,14,590065
67079,16,2,952,717584,16,717568
67080,16,-18,472,88809,16,88793
67081,17,12,724,1027502,17,1027485
67082,20,13,28,1053415,20,1053395
67083,14,-17,966,122573,14,122559
67084,18,-2,370,587830,18,587812
67085,6,-5,532,479585,6,479579
67086,11,12,263,1024047,11,1024036
67087,8,11,975,989393,8,989385
67088,5,-8,423,384068,5,384063
67089,11,1,204,681510,11,681499
67090,18,-19,84,54589,18,54571
67091,12,7,911,873526,12,873514
67092,16,15,929,1123565,16,1123549
67093,12,-1,522,620744,12,620732
67094,5,-10,113,314983,5,314978
67095,8,-10,113,314991,8,314983
67096,16,-2,363,587797,16,587781
67097,8,9,482,916879,8,916871
67098,7,2,765,704705,7,704698
67099,10,0,185,629560,10,629550
67100,6,-20,499,10724,6,10718
67101,18,0,901,655124,18,655106
67102,15,-20,306,25215,15,25200
67103,12,-18,534,89159,12,89147
67104,17,0,311,650385,17,650368
67105,19,17,316,1180348,19,1180329
67106,6,3,794,735945,6,735939
67107,20,-3,286,555817,20,555797
67108,11,-14,227,211174,11,211163
67109,11,-11,438,307273,11,307262
67110,10,-20,523,11239,10,11229
67111,12,-8,914,404390,12,404378
67112,17,4,757,778853,17,778836
67113,5,-16,477,134488,5,134483
67114,14,-19,291,56259,14,56245
67115,9,2,614,701558,9,701549
67116,10,6,896,832384,10,832374
67117,11,16,812,1152947,11,1152936
67118,8,6,95,814261,8,814253
67119,17,-14,41,209633,17,209616
67120,14,13,52,1053620,14,1053606
67121,14,-13,879,247612,14,247598
67122,6,0,825,643287,6,643281
67123,15,6,142,836829,15,836814
67124,7,-19,933,51569,7,51562
67125,8,18,174,1190650,8,1190642
67126,18,-14,508,213442,18,213424
67127,19,-9,115,367448,19,367429
67128,20,0,378,650951,20,650931
67129,20,16,950,1153849,20,1153829
67130,14,2,551,714759,14,714745
67131,11,-12,17,272626,11,272615
67132,19,16,674,1151946,19,1151927
67133,17,-13,177,242348,17,242331
67134,15,-18,152,86417,15,86402
67135,8,-14,956,207331,8,207323
67136,18,4,324,775544,18,775526
67137,10,8,893,894533,10,894523
67138,8,-13,923,238311,8,238303
67139,12,-5,210,492509,12,492497
67140,6,13,926,1050575,6,1050569
67141,7,-5,592,480886,7,480879
67142,6,-18,473,72587,6,72581
67143,9,18,889,1205619,9,1205610
67144,15,0,556,652434,15,652419
67145,12,1,967,687392,12,687380
67146,11,5,183,805169,11,805158
67147,18,5,899,810334,18,810316
67148,16,6,636,840915,16,840899
67149,14,-7,517,432249,14,432235
67150,7,-4,806,516591,7,516584
67151,5,-2,275,568716,5,568711
67152,20,8,602,902697,20,902677
67153,5,8,269,881025,5,881020
67154,20,7,324,869388,20,869368
67155,14,-7,116,429135,14,429121
67156,12,0,912,655221,12,655209
67157,5,-18,51,63471,5,63466
67158,13,0,157,649409,13,649396
67159,18,16,869,1153277,18,1153259
67160,20,-2,651,590044,20,590024
67161,18,13,60,1053665,18,1053647
67162,16,0,762,654144,16,654128
67163,10,18,391,1195105,10,1195095
67164,20,1,21,679947,20,679927
67165,15,-16,438,150242,15,150227
67166,11,-2,623,589828,11,589817
67167,5,-8,90,377327,5,377322
67168,14,-19,455,57469,14,57455
67169,19,-14,240,211288,19,211269
67170,6,2,821,705711,6,705705
67171,5,16,215,1129779,5,1129774
67172,10,-19,833,49671,10,49661
67173,12,-18,537,89167,12,89155
67174,15,17,438,1181194,15,1181179
67175,13,9,514,932829,13,932816
67176,5,7,339,852169,5,852164
67177,16,-11,745,309519,16,309503
67178,14,-12,368,275266,14,275252
67179,19,15,451,1119981,19,1119962
67180,15,-7,852,434534,15,434519
67181,8,-9,244,348921,8,348913
67182,17,19,939,1248326,17,1248309
67183,11,19,952,1248449,11,1248438
67184,20,12,843,1028422,20,1028402
67185,10,-18,71,63994,10,63984
67186,10,8,856,893777,10,893767
67187,10,3,132,721669,10,721659
67188,19,-16,249,148806,19,148787
67189,8,15,332,1101596,8,1101588
67190,17,9,591,933459,17,933442
67191,10,-5,97,470218,10,470208
67192,8,9,275,912429,8,912421
67193,11,-14,957,216921,11,216910
67194,19,-14,981,217129,19,217110
67195,20,2,473,714209,20,714189
67196,11,15,120,1117706,11,1117695
67197,5,-18,678,76894,5,76889
67198,7,13,255,1036019,7,1036012
67199,10,0,763,642162,10,642152
67200,6,5,330,788408,6,788402
67201,19,17,120,1178746,19,1178727
67202,10,-17,652,107564,10,107554
67203,10,18,120,1189451,10,1189441
67204,6,-4,800,516485,6,516479
67205,11,17,955,1185036,11,1185025
67206,11,15,109,1117606,11,1117595
67207,18,-19,131,55060,18,55042
67208,11,-19,733,59773,11,59762
67209,9,6,162,815677,9,815668
67210,20,-14,189,210744,20,210724
67211,11,-14,67,209807,11,209796
67212,13,-4,796,527971,13,527958
67213,6,7,995,865876,6,865870
67214,19,-1,204,618128,19,618109
67215,13,7,230,868631,13,868618
67216,8,-9,105,345821,8,345813
67217,14,19,252,1242740,14,1242726
67218,13,1,205,681514,13,681501
67219,17,-16,411,149942,17,149925
67220,12,-13,780,246853,12,246841
67221,11,16,854,1153197,11,1153186
67222,9,-18,850,80744,9,80735
67223,6,-9,275,349606,6,349600
67224,8,-5,681,482708,8,482700
67225,8,6,449,822574,8,822566
67226,18,17,597,1182288,18,1182270
67227,14,12,235,1023780,14,1023766
67228,16,0,426,651349,16,651333
67229,10,2,746,704380,10,704370
67230,10,-3,902,550629,10,550619
67231,5,1,787,674096,5,674091
67232,14,-13,712,246260,14,246246
67233,17,-12,606,276910,17,276893
67234,20,-18,91,85940,20,85920
67235,12,9,200,930528,12,930516
67236,19,9,913,935862,19,935843
67237,17,-7,978,435561,17,435544
67238,7,4,656,764786,7,764779
67239,6,-10,633,326254,6,326248
67240,6,5,820,798774,6,798768
67241,16,13,396,1056182,16,1056166
67242,17,-13,910,247864,17,247847
67243,7,-4,611,512586,7,512579
67244,8,-16,876,142872,8,142864
67245,6,19,645,1231912,6,1231906
67246,12,17,886,1184579,12,1184567
67247,14,-19,676,59247,14,59233
67248,14,-5,863,497313,14,497299
67249,7,-6,599,449712,7,449705
67250,8,17,942,1175476,8,1175468
67251,9,10,849,955816,9,955807
67252,19,-18,626,89789,19,89770
67253,5,11,999,989794,5,989789
67254,13,-8,236,399574,13,399561
67255,14,-6,349,461852,14,461838
67256,19,14,305,1087819,19,1087800
67257,8,-14,986,208015,8,208007
67258,8,-4,919,519112,8,519104
67259,7,-14,710,202261,7,202254
67260,9,3,263,724571,9,724562
67261,9,9,703,921568,9,921559
67262,10,6,115,814695,10,814685
67263,16,-20,853,29384,16,29368
67264,18,-18,654,90029,18,90011
67265,11,5,704,808923,11,808912
67266,8,-4,832,517027,8,517019
67267,19,-18,541,89220,19,89201
67268,7,-19,569,43991,7,43984
67269,14,-2,333,587600,14,587586
67270,10,0,377,633477,10,633467
67271,15,-5,932,497896,15,497881
67272,7,-3,329,537635,7,537628
67273,14,9,790,934903,14,934889
67274,5,-13,990,239781,5,239776
67275,16,1,982,687471,16,687455
67276,17,-16,189,148314,17,148297
67277,15,-18,702,90335,15,90320
67278,12,-7,90,428913,12,428901
67279,19,16,796,1152810,19,1152791
67280,14,-8,976,404862,14,404848
67281,8,1,336,664601,8,664593
67282,17,3,386,744794,17,744777
67283,12,5,334,806241,12,806229
67284,11,2,601,715084,11,715073
67285,14,0,581,652667,14,652653
67286,11,-12,220,274137,11,274126
67287,18,12,260,1024027,18,1024009
67288,18,17,811,1184033,18,1184015
67289,6,18,327,1193818,6,1193812
67290,6,-16,800,141180,6,141174
67291,18,7,494,870701,18,870683
67292,5,-20,171,3838,5,3833
67293,18,11,20,991013,18,990995
67294,13,4,53,773636,13,773623
67295,13,1,190,681378,13,681365
67296,8,6,29,812879,8,812871
67297,12,-3,29,554015,12,554003
67298,16,18,736,1214234,16,1214218
67299,20,18,682,1213894,20,1213874
67300,6,15,112,1096908,6,1096902
67301,8,3,448,728475,8,728467
67302,9,-9,91,345551,9,345542
67303,9,6,725,828755,9,828746
67304,19,13,275,1055219,19,1055200
67305,16,-14,721,215138,16,215122
67306,11,14,411,1088664,11,1088653
67307,19,-16,389,149746,19,149727
67308,18,11,377,993621,18,993603
67309,15,-2,183,586417,15,586402
67310,14,10,800,966107,14,966093
67311,12,14,646,1090486,12,1090474
67312,9,-10,132,315565,9,315556
67313,5,-3,630,544627,5,544622
67314,20,-14,673,214807,20,214787
67315,12,0,443,651452,12,651440
67316,19,-19,686,59350,19,59331
67317,12,-19,625,58942,12,58930
67318,8,9,721,921951,8,921943
67319,18,18,398,1211992,18,1211974
67320,12,13,8,1053312,12,1053300
67321,20,18,395,1211955,20,1211935
67322,8,13,490,1041230,8,1041222
67323,14,-8,889,404180,14,404166
67324,20,10,781,965899,20,965879
67325,18,5,358,806398,18,806380
67326,12,13,440,1056539,12,1056527
67327,9,7,19,845161,9,845152
67328,14,-12,413,275545,14,275531
67329,8,16,972,1145523,8,1145515
67330,20,2,37,710798,20,710778
67331,9,-17,92,95447,9,95438
67332,8,1,108,659466,8,659458
67333,9,8,343,882752,9,882743
67334,8,18,767,1202919,8,1202911
67335,15,-3,539,558091,15,558076
67336,20,5,32,803978,20,803958
67337,5,12,961,1020340,5,1020335
67338,15,4,973,780380,15,780365
67339,17,6,215,837336,17,837319
67340,20,-1,981,624001,20,623981
67341,17,-7,815,434229,17,434212
67342,12,16,482,1150574,12,1150562
67343,12,-12,775,278205,12,278193
67344,11,9,308,931250,11,931239
67345,20,-10,466,338536,20,338516
67346,16,13,537,1057243,16,1057227
67347,7,2,657,702515,7,702508
67348,11,4,401,776098,11,776087
67349,13,17,801,1183923,13,1183910
67350,6,-3,909,550812,6,550806
67351,16,15,683,1121792,16,1121776
67352,9,14,85,1063690,9,1063681
67353,9,3,618,732046,9,732037
67354,11,19,298,1243154,11,1243143
67355,15,-9,335,369110,15,369095
67356,12,-10,942,342186,12,342174
67357,10,-1,424,603244,10,603234
67358,18,7,342,869516,18,869498
67359,18,1,213,681579,18,681561
67360,17,-2,511,589012,17,588995
67361,15,5,665,808641,15,808626
67362,10,-13,431,227428,10,227418
67363,17,8,756,903911,17,903894
67364,18,13,765,1058976,18,1058958
67365,11,11,861,997100,11,997089
67366,10,-13,15,218630,10,218620
67367,9,-13,805,235840,9,235831
67368,15,-7,212,429905,15,429890
67369,18,14,49,1085809,18,1085791
67370,13,12,734,1027544,13,1027531
67371,18,-6,330,461725,18,461707
67372,12,10,535,963943,12,963931
67373,11,-7,549,432477,11,432466
67374,20,0,214,649856,20,649836
67375,15,7,884,873368,15,873353
67376,8,-3,192,534505,8,534497
67377,7,-20,658,14471,7,14464
67378,12,15,988,1124048,12,1124036
67379,6,-9,79,345330,6,345324
67380,9,-14,711,202307,9,202298
67381,7,19,803,1235280,7,1235273
67382,16,17,599,1182312,16,1182296
67383,19,13,811,1059324,19,1059305
67384,5,16,840,1142589,5,1142584
67385,17,-9,318,368930,17,368913
67386,14,5,439,806952,14,806938
67387,10,18,254,1192432,10,1192422
67388,11,-7,418,431480,11,431469
67389,20,-9,29,366824,20,366804
67390,8,15,66,1095866,8,1095858
67391,16,14,516,1089485,16,1089469
67392,8,-6,292,443189,8,443181
67393,15,0,26,648431,15,648416
67394,12,-10,256,336969,12,336957
67395,19,17,252,1179790,19,1179771
67396,16,-14,985,217168,16,217152
67397,18,-14,24,209513,18,209495
67398,6,14,279,1068055,6,1068049
67399,19,-1,176,617875,19,617856
67400,15,1,380,682899,15,682884
67401,10,14,779,1079429,10,1079419
67402,10,7,808,861950,10,861940
67403,8,-15,768,171822,8,171814
67404,11,-18,749,90742,11,90731
67405,8,-4,962,520113,8,520105
67406,14,14,511,1089441,14,1089427
67407,13,-8,972,404816,13,404803
67408,14,-19,770,60005,14,59991
67409,15,-4,103,522812,15,522797
67410,15,-9,486,370512,15,370497
67411,19,16,818,1152977,19,1152958
67412,17,9,609,933573,17,933556
67413,20,-12,464,275911,20,275891
67414,14,0,472,651706,14,651692
67415,8,-13,458,227913,8,227905
67416,5,19,191,1221754,5,1221749
67417,14,1,288,682142,14,682128
67418,10,17,283,1161444,10,1161434
67419,13,-4,227,523886,13,523873
67420,16,0,720,653818,16,653802
67421,20,9,282,931009,20,930989
67422,9,-12,988,271156,9,271147
67423,10,-10,453,322462,10,322452
67424,17,-3,365,556478,17,556461
67425,10,-8,402,383810,10,383800
67426,12,1,890,686741,12,686729
67427,15,-1,344,619360,15,619345
67428,18,-12,372,275286,18,275268
67429,14,10,427,963104,14,963090
67430,5,-2,275,568721,5,568716
67431,7,-6,507,447788,7,447781
67432,10,17,894,1174581,10,1174571
67433,10,-4,2,499390,10,499380
67434,16,14,380,1088389,16,1088373
67435,12,11,423,993967,12,993955
67436,6,-1,889,613024,6,613018
67437,9,-11,928,301013,9,301004
67438,12,-13,469,244442,12,244430
67439,14,13,367,1055937,14,1055923
67440,8,-18,402,71045,8,71037
67441,15,-13,424,244088,15,244073
67442,19,0,103,649075,19,649056
67443,19,7,964,873836,19,873817
67444,15,6,764,841912,15,841897
67445,16,-16,212,148521,16,148505
67446,9,8,306,881942,9,881933
67447,17,-7,927,435171,17,435154
67448,10,-10,199,316971,10,316961
67449,12,-20,903,29762,12,29750
67450,15,-16,215,148551,15,148536
67451,13,11,451,994130,13,994117
67452,6,14,654,1076631,6,1076625
67453,18,14,243,1087320,18,1087302
67454,10,7,567,856849,10,856839
67455,19,-1,127,617519,19,617500
67456,18,9,201,930535,18,930517
67457,5,12,36,999878,5,999873
67458,12,3,320,744345,12,744333
67459,9,-6,206,441379,9,441370
67460,8,-5,639,481860,8,481852
67461,7,6,159,815601,7,815594
67462,12,-12,215,274070,12,274058
67463,17,13,68,1053744,17,1053727
67464,10,-16,995,145548,10,145538
67465,7,-12,773,266226,7,266219
67466,6,-15,290,161637,6,161631
67467,15,-2,121,586026,15,586011
67468,17,-15,319,180094,17,180077
67469,20,6,761,841882,20,841862
67470,9,6,439,822369,9,822360
67471,13,6,953,843337,13,843324
67472,11,-2,124,586038,11,586027
67473,20,9,960,936250,20,936230
67474,11,5,514,807534,11,807523
67475,5,7,231,849733,5,849728
67476,14,8,723,903717,14,903703
67477,12,-18,199,86838,12,86826
67478,10,-3,24,531080,10,531070
67479,10,-18,504,73301,10,73291
67480,13,-13,54,241490,13,241477
67481,15,8,8,897970,15,897955
67482,10,14,227,1066849,10,1066839
67483,14,-6,414,462312,14,462298
67484,8,-7,38,406929,8,406921
67485,16,9,197,930512,16,930496
67486,10,-15,769,171887,10,171877
67487,20,1,248,681857,20,681837
67488,14,-1,391,619682,14,619668
67489,17,-12,176,273802,17,273785
67490,10,-3,376,538662,10,538652
67491,13,-13,794,246932,13,246919
67492,7,6,458,822740,7,822733
67493,8,9,731,922110,8,922102
67494,5,-16,385,132253,5,132248
67495,5,-7,758,421895,5,421890
67496,8,-10,960,333067,8,333059
67497,5,4,859,769583,5,769578
67498,7,16,422,1134261,7,1134254
67499,20,8,80,898526,20,898506
67500,12,3,972,749313,12,749301
67501,8,-14,614,200164,8,200156
67502,6,13,163,1034127,6,1034121
67503,7,16,821,1142238,7,1142231
67504,19,-17,540,119543,19,119524
67505,10,-14,6,186543,10,186533
67506,9,-4,389,508078,9,508069
67507,10,4,309,757195,10,757185
67508,14,12,795,1027974,14,1027960
67509,10,-11,21,281528,10,281518
67510,8,-18,835,80453,8,80445
67511,10,13,476,1040941,10,1040931
67512,12,11,241,992573,12,992561
67513,12,-4,519,526033,12,526021
67514,19,13,920,1060029,19,1060010
67515,5,-9,439,353356,5,353351
67516,12,-10,665,340129,12,340117
67517,14,-7,913,435051,14,435037
67518,17,-6,692,464464,17,464447
67519,5,-18,219,67174,5,67169
67520,20,15,225,1118513,20,1118493
67521,15,1,171,681220,15,681205
67522,5,9,743,922326,5,922321
67523,5,-8,924,395069,5,395064
67524,11,-3,520,557817,11,557806
67525,18,-7,891,434899,18,434881
67526,6,-20,953,20978,6,20972
67527,15,-6,949,466330,15,466315
67528,5,-2,192,566860,5,566855
67529,19,-15,639,182538,19,182519
67530,5,1,790,674170,5,674165
67531,12,10,666,965064,12,965052
67532,11,9,509,932793,11,932782
67533,11,-7,331,430848,11,430837
67534,5,-5,775,484638,5,484633
67535,15,18,964,1216064,15,1216049
67536,9,9,162,910231,9,910222
67537,8,5,616,794470,8,794462
67538,7,-14,910,206336,7,206329
67539,13,-17,316,117838,13,117825
67540,15,-18,292,87514,15,87499
67541,10,9,741,922290,10,922280
67542,13,-9,867,373450,13,373437
67543,8,-20,496,10638,8,10630
67544,15,6,168,837002,15,836987
67545,20,-8,28,398112,20,398092
67546,11,-12,879,279066,11,279055
67547,5,1,3,657074,5,657069
67548,8,6,170,815904,8,815896
67549,20,-3,638,558902,20,558882
67550,15,-15,198,179176,15,179161
67551,8,5,819,798744,8,798736
67552,9,2,180,692592,9,692583
67553,9,10,705,952762,9,952753
67554,12,7,326,869410,12,869398
67555,15,-17,338,118030,15,118015
67556,12,-1,133,617585,12,617573
67557,16,17,214,1179473,16,1179457
67558,13,-12,90,273196,13,273183
67559,11,2,533,714633,11,714622
67560,6,2,443,698110,6,698104
67561,5,17,544,1166937,5,1166932
67562,5,-14,458,196584,5,196579
67563,19,-12,998,280103,19,280084
67564,5,-3,257,535987,5,535982
67565,19,16,829,1153093,19,1153074
67566,7,-7,471,415929,7,415922
67567,7,19,231,1222629,7,1222622
67568,17,-4,839,528194,17,528177
67569,11,-1,754,622351,11,622340
67570,19,19,666,1246184,19,1246165
67571,18,3,224,743553,18,743535
67572,19,17,251,1179774,19,1179755
67573,16,8,645,903106,16,903090
67574,12,-18,655,90047,12,90035
67575,10,-15,172,159092,10,159082
67576,14,-19,629,58969,14,58955
67577,16,-15,885,184467,16,184451
67578,14,-2,323,587539,14,587525
67579,12,-15,198,179178,12,179166
67580,7,-16,643,137969,7,137962
67581,14,-5,870,497378,14,497364
67582,20,-13,385,243861,20,243841
67583,15,-3,585,558402,15,558387
67584,16,-8,624,402245,16,402229
67585,15,-4,228,523892,15,523877
67586,12,-10,590,339461,12,339449
67587,5,8,475,885583,5,885578
67588,11,6,762,841891,11,841880
67589,5,-5,597,480998,5,480993
67590,12,-2,443,588458,12,588446
67591,8,4,717,766110,8,766102
67592,9,-13,733,234023,9,234014
67593,10,11,90,970361,10,970351
67594,5,-8,555,387062,5,387057
67595,10,-14,779,203694,10,203684
67596,14,7,956,873778,14,873764
67597,16,-11,855,310422,16,310406
67598,17,-7,779,433966,17,433949
67599,18,-3,330,556204,18,556186
67600,10,9,464,916393,10,916383
67601,17,19,420,1244322,17,1244305
67602,17,0,612,652878,17,652861
67603,18,-16,275,149006,18,148988
67604,16,18,978,1216176,16,1216160
67605,8,-19,250,37066,8,37058
67606,10,-4,506,510416,10,510406
67607,9,-9,892,363677,9,363668
67608,13,11,6,990898,13,990885
67609,7,11,798,985542,7,985535
67610,11,0,142,649291,11,649280
67611,14,-2,873,591792,14,591778
67612,15,1,389,682971,15,682956
67613,17,15,629,1121415,17,1121398
67614,18,10,871,966521,18,966503
67615,11,-1,960,623842,11,623831
67616,9,-11,92,283049,9,283040
67617,16,-15,842,184089,16,184073
67618,20,15,479,1120173,20,1120153
67619,16,-4,620,526760,16,526744
67620,13,7,402,870033,13,870020
67621,19,-19,731,59741,19,59722
67622,15,11,119,991693,15,991678
67623,6,-10,524,323922,6,323916
67624,10,5,250,786849,10,786839
67625,19,-19,501,57844,19,57825
67626,17,-20,293,25096,17,25079
67627,10,-10,641,326497,10,326487
67628,13,-10,74,335767,13,335754
67629,14,19,849,1247625,14,1247611
67630,11,-19,1,53893,11,53882
67631,16,-13,813,247083,16,247067
67632,19,-18,105,86046,19,86027
67633,14,6,197,837209,14,837195
67634,17,3,545,745834,17,745817
67635,17,-10,973,342440,17,342423
67636,16,6,30,836048,16,836032
67637,17,17,288,1180095,17,1180078
67638,20,3,624,746516,20,746496
67639,7,-11,770,297711,7,297704
67640,15,-11,594,308449,15,308434
67641,5,-11,720,296730,5,296725
67642,16,-16,214,148540,16,148524
67643,5,-7,788,422482,5,422477
67644,13,7,158,868196,13,868183
67645,11,17,232,1179579,11,1179568
67646,14,-9,364,369373,14,369359
67647,8,-14,124,189157,8,189149
67648,19,-11,529,307983,19,307964
67649,17,6,815,842328,17,842311
67650,5,-12,578,262070,5,262065
67651,5,-8,830,393117,5,393112
67652,15,-12,464,275916,15,275901
67653,8,-20,111,2432,8,2424
67654,17,3,169,743112,17,743095
67655,13,-9,485,370505,13,370492
67656,10,17,922,1175102,10,1175092
67657,5,-14,919,206525,5,206520
67658,16,-9,779,372708,16,372692
67659,16,-6,930,466185,16,466169
67660,6,-2,596,575409,6,575403
67661,12,1,368,682808,12,682796
67662,13,18,972,1216130,13,1216117
67663,8,7,540,856281,8,856273
67664,14,-14,753,215361,14,215347
67665,19,-14,448,212999,19,212980
67666,11,7,869,873301,11,873290
67667,13,12,745,1027621,13,1027608
67668,5,11,386,976784,5,976779
67669,7,-17,740,109367,7,109360
67670,13,-3,5,553894,13,553881
67671,5,3,13,719125,5,719120
67672,13,-7,803,434130,13,434117
67673,19,-17,410,118480,19,118461
67674,20,-7,943,435289,20,435269
67675,10,7,952,864895,10,864885
67676,15,15,594,1121100,15,1121085
67677,8,-10,718,328060,8,328052
67678,15,-1,746,622306,15,622291
67679,9,-20,848,18866,9,18857
67680,10,19,264,1223320,10,1223310
67681,16,-17,4,115586,16,115570
67682,14,5,982,810997,14,810983
67683,18,0,794,654313,18,654295
67684,19,3,378,744717,19,744698
67685,17,-7,620,432855,17,432838
67686,15,13,204,1054742,15,1054727
67687,15,-2,599,589619,15,589604
67688,12,-1,896,623412,12,623400
67689,18,-20,772,28770,18,28752
67690,12,-20,891,29669,12,29657
67691,13,-20,299,25140,13,25127
67692,19,2,281,712657,19,712638
67693,15,15,349,1119356,15,1119341
67694,6,-10,966,333181,6,333175
67695,20,-17,29,115758,20,115738
67696,12,8,791,904219,12,904207
67697,14,4,436,776407,14,776393
67698,11,-5,670,495877,11,495866
67699,7,14,221,1066628,7,1066621
67700,11,7,482,870629,11,870618
67701,8,-5,336,475556,8,475548
67702,9,15,447,1103933,9,1103924
67703,9,-7,259,411292,9,411283
67704,18,7,406,870048,18,870030
67705,9,2,778,704865,9,704856
67706,16,10,643,964874,16,964858
67707,11,9,322,931361,11,931350
67708,18,12,604,1026502,18,1026484
67709,11,-20,912,29794,11,29783
67710,6,-6,493,447441,6,447435
67711,19,-11,745,309528,19,309509
67712,11,-18,111,86060,11,86049
67713,11,-8,689,402779,11,402768
67714,14,1,930,687143,14,687129
67715,12,-18,359,88008,12,87996
67716,13,-9,782,372742,13,372729
67717,20,-14,847,216125,20,216105
67718,12,17,930,1184867,12,1184855
67719,15,-15,63,178230,15,178215
67720,7,4,436,760028,7,760021
67721,10,-6,208,441427,10,441417
67722,19,4,707,778439,19,778420
67723,10,-11,415,290384,10,290374
67724,18,3,313,744310,18,744292
67725,6,6,675,827539,6,827533
67726,13,-10,95,335840,13,335827
67727,19,18,883,1215378,19,1215359
67728,16,2,516,714537,16,714521
67729,17,17,502,1181656,17,1181639
67730,12,-15,222,179337,12,179325
67731,6,6,271,818319,6,818313
67732,15,-10,350,337612,15,337597
67733,13,-7,245,430106,13,430093
67734,9,10,32,938239,9,938230
67735,19,6,605,840641,19,840622
67736,13,12,671,1027105,13,1027092
67737,15,-20,283,24998,15,24983
67738,15,9,400,931964,15,931949
67739,19,3,806,747921,19,747902
67740,16,19,410,1244170,16,1244154
67741,13,-6,954,466357,13,466344
67742,13,-11,777,309817,13,309804
67743,9,11,678,982910,9,982901
67744,13,-16,537,150944,13,150931
67745,17,16,541,1150933,17,1150916
67746,18,17,970,1185214,18,1185196
67747,19,-19,543,58221,19,58202
67748,5,13,617,1044108,5,1044103
67749,10,6,217,816982,10,816972
67750,6,4,329,757646,6,757640
67751,9,9,485,916984,9,916975
67752,8,-20,836,18569,8,18561
67753,17,-10,526,338932,17,338915
67754,13,-8,20,398035,13,398022
67755,14,-14,41,209637,14,209623
67756,7,-2,484,573127,7,573120
67757,9,14,172,1065622,9,1065613
67758,14,4,640,777918,14,777904
67759,13,0,628,652986,13,652973
67760,5,-15,296,161786,5,161781
67761,6,-19,972,52353,6,52347
67762,18,-13,50,241429,18,241411
67763,6,-1,967,614719,6,614713
67764,16,-2,644,589956,16,589940
67765,11,-1,821,622858,11,622847
67766,14,-10,629,339745,14,339731
67767,12,-3,952,561425,12,561413
67768,13,11,425,993976,13,993963
67769,18,-3,445,557197,18,557179
67770,16,4,413,776221,16,776205
67771,10,3,6,718977,10,718967
67772,9,-14,920,206543,9,206534
67773,15,-12,429,275607,15,275592
67774,17,18,307,1211303,17,1211286
67775,12,-16,494,150645,12,150633
67776,17,-9,809,372958,17,372941
67777,18,-14,547,213707,18,213689
67778,7,-11,894,300294,7,300287
67779,9,-9,726,359568,9,359559
67780,20,1,426,683195,20,683175
67781,16,-15,726,183195,16,183179
67782,15,17,23,1178030,15,1178015
67783,19,14,686,1090877,19,1090858
67784,13,2,732,716097,13,716084
67785,5,-17,529,104850,5,104845
67786,8,2,855,706380,8,706372
67787,8,-11,354,289003,8,288995
67788,6,14,978,1083755,6,1083749
67789,5,14,461,1072089,5,1072084
67790,13,-4,119,522915,13,522902
67791,13,1,15,679861,13,679848
67792,5,4,555,762510,5,762505
67793,7,-6,464,446722,7,446715
67794,19,6,592,840556,19,840537
67795,8,-10,956,332952,8,332944
67796,13,5,260,805748,13,805735
67797,19,4,631,777861,19,777842
67798,18,-12,814,278482,18,278464
67799,6,0,262,631066,6,631060
67800,9,1,461,667267,9,667258
67801,14,-12,350,275157,14,275143
67802,8,18,421,1195749,8,1195741
67803,8,-8,147,378627,8,378619
67804,14,4,885,779841,14,779827
67805,5,17,560,1167190,5,1167185
67806,17,-2,177,586347,17,586330
67807,16,19,521,1245101,16,1245085
67808,11,-11,137,304815,11,304804
67809,14,-15,461,181162,14,181148
67810,17,-10,404,337977,17,337960
67811,19,1,965,687362,19,687343
67812,18,-19,550,58317,18,58299
67813,17,10,716,965386,17,965369
67814,15,-12,538,276535,15,276520
67815,19,-13,798,246978,19,246959
67816,11,-2,101,585884,11,585873
67817,9,0,421,634516,9,634507
67818,12,3,649,746747,12,746735
67819,12,5,864,810064,12,810052
67820,10,-15,457,165279,10,165269
67821,20,5,782,809480,20,809460
67822,6,-7,308,412550,6,412544
67823,15,-20,682,28051,15,28036
67824,19,9,678,934047,19,934028
67825,20,-19,692,59392,20,59372
67826,13,10,399,962834,13,962821
67827,20,-16,875,153429,20,153409
67828,8,14,60,1063159,8,1063151
67829,9,-6,563,448957,9,448948
67830,16,-19,274,56124,16,56108
67831,20,13,180,1054548,20,1054528
67832,7,-19,983,52571,7,52564
67833,20,-17,205,116964,20,116944
67834,17,5,924,810567,17,810550
67835,16,15,999,1124116,16,1124100
67836,14,-19,730,59711,14,59697
67837,9,-9,480,354437,9,354428
67838,10,6,401,821420,10,821410
67839,6,16,254,1130626,6,1130620
67840,17,5,798,809581,17,809564
67841,9,-3,871,549885,9,549876
67842,7,-4,126,502131,7,502124
67843,19,-14,409,212748,19,212729
67844,6,19,519,1229334,6,1229328
67845,19,-16,110,147741,19,147722
67846,17,6,635,840896,17,840879
67847,20,-15,278,179791,20,179771
67848,12,-5,963,498104,12,498092
67849,16,18,362,1211726,16,1211710
67850,10,-20,483,10332,10,10322
67851,19,-14,385,212564,19,212545
67852,9,18,579,1199064,9,1199055
67853,15,4,838,779493,15,779478
67854,12,19,786,1247173,12,1247161
67855,6,6,176,816032,6,816026
67856,17,-8,553,401767,17,401750
67857,19,3,375,744687,19,744668
67858,17,14,990,1093225,17,1093208
67859,19,-14,36,209600,19,209581
67860,15,13,806,1059310,15,1059295
67861,15,1,318,682385,15,682370
67862,7,-8,946,395559,7,395552
67863,16,0,157,649415,16,649399
67864,9,-19,566,43930,9,43921
67865,14,12,572,1026234,14,1026220
67866,19,-5,24,491001,19,490982
67867,18,15,119,1117690,18,1117672
67868,20,-13,42,241372,20,241352
67869,6,-16,246,129411,6,129405
67870,5,-3,762,547525,5,547520
67871,8,11,200,972530,8,972522
67872,7,19,696,1232970,7,1232963
67873,6,-6,485,447212,6,447206
67874,12,-16,712,152130,12,152118
67875,6,-10,416,321677,6,321671
67876,18,19,907,1248149,18,1248131
67877,15,-20,217,24467,15,24452
67878,15,-20,799,29010,15,28995
67879,20,-17,932,122374,20,122354
67880,11,13,61,1053671,11,1053660
67881,14,1,64,680254,14,680240
67882,7,1,521,668725,7,668718
67883,10,7,65,846230,10,846220
67884,15,10,333,962359,15,962344
67885,8,-16,370,131947,8,131939
67886,6,-15,470,165628,6,165622
67887,7,1,247,662589,7,662582
67888,7,-18,948,83024,7,83017
67889,7,-2,758,578939,7,578932
67890,18,-1,881,623352,18,623334
67891,16,-13,305,243344,16,243328
67892,10,-13,807,235882,10,235872
67893,6,19,205,1222053,6,1222047
67894,7,-18,835,80460,7,80453
67895,12,-13,387,243876,12,243864
67896,6,-13,392,226575,6,226569
67897,6,14,370,1069981,6,1069975
67898,9,-9,80,345366,9,345357
67899,8,-20,542,11828,8,11820
67900,5,-10,398,321188,5,321183
67901,7,-20,681,15097,7,15090
67902,5,-5,199,472343,5,472338
67903,8,-4,569,511718,8,511710
67904,16,14,628,1090321,16,1090305
67905,17,-18,804,91116,17,91099
67906,14,7,972,873893,14,873879
67907,20,-19,895,60822,20,60802
67908,16,-4,599,526590,16,526574
67909,16,15,436,1119869,16,1119853
67910,6,14,781,1079481,6,1079475
67911,20,-12,937,279566,20,279546
67912,14,4,308,775413,14,775399
67913,20,-20,553,27045,20,27025
67914,15,-2,911,592088,15,592073
67915,17,6,276,837899,17,837882
67916,13,1,107,680660,13,680647
67917,19,15,139,1117852,19,1117833
67918,12,3,301,744183,12,744171
67919,7,16,342,1132429,7,1132422
67920,20,-3,408,556822,20,556802
67921,7,10,808,955059,7,955052
67922,13,-5,212,492533,13,492520
67923,16,18,224,1210776,16,1210760
67924,13,-16,820,152921,13,152908
67925,5,3,582,731223,5,731218
67926,20,-14,972,217078,20,217058
67927,17,6,891,842881,17,842864
67928,12,2,783,716351,12,716339
67929,11,-11,270,305858,11,305847
67930,19,-4,988,529553,19,529534
67931,13,12,619,1026643,13,1026630
67932,12,-17,677,120594,12,120582
67933,20,7,321,869360,20,869340
67934,18,-9,418,369842,18,369824
67935,10,13,936,1050782,10,1050772
67936,17,10,731,965518,17,965501
67937,19,6,257,837727,19,837708
67938,18,-9,478,370436,18,370418
67939,13,1,178,681297,13,681284
67940,18,-8,24,398077,18,398059
67941,16,2,127,711570,16,711554
67942,14,-12,949,279680,14,279666
67943,6,15,324,1101420,6,1101414
67944,19,-4,776,527829,19,527810
67945,8,-4,481,509794,8,509786
67946,7,-14,962,207447,7,207440
67947,13,-1,494,620524,13,620511
67948,15,9,27,929261,15,929246
67949,15,16,916,1153690,15,1153675
67950,9,17,614,1168360,9,1168351
67951,7,-11,22,281551,7,281544
67952,17,16,76,1147625,17,1147608
67953,5,10,934,957628,5,957623
67954,17,14,53,1085828,17,1085811
67955,17,7,942,873711,17,873694
67956,7,6,597,825834,7,825827
67957,17,-15,879,184416,17,184399
67958,18,3,65,742305,18,742287
67959,13,-14,955,216914,13,216901
67960,6,-5,296,474605,6,474599
67961,20,-1,329,619180,20,619160
67962,12,-17,490,119136,12,119124
67963,12,11,682,995706,12,995694
67964,5,17,184,1159196,5,1159191
67965,19,-1,491,620497,19,620478
67966,13,-5,477,494582,13,494569
67967,8,19,543,1229810,8,1229802
67968,7,10,188,941560,7,941553
67969,15,10,501,963660,15,963645
67970,7,8,192,879290,7,879283
67971,20,17,329,1180461,20,1180441
67972,12,-4,416,525349,12,525337
67973,5,-20,865,19228,5,19223
67974,8,16,191,1129246,8,1129238
67975,20,19,411,1244185,20,1244165
67976,17,-16,844,153090,17,153073
67977,20,8,810,904327,20,904307
67978,16,-11,974,311346,16,311330
67979,20,-11,160,305024,20,305004
67980,15,-2,689,590348,15,590333
67981,5,-18,565,74541,5,74536
67982,7,-2,891,581904,7,581897
67983,20,17,41,1178189,20,1178169
67984,5,-4,964,520153,5,520148
67985,13,1,741,685638,13,685625
67986,16,8,123,898915,16,898899
67987,15,17,750,1183470,15,1183455
67988,18,1,68,680297,18,680279
67989,6,-20,567,12403,6,12397
67990,13,16,398,1150006,13,1149993
67991,16,-5,147,492086,16,492070
67992,20,-2,642,589949,20,589929
67993,12,19,809,1247345,12,1247333
67994,14,4,155,774378,14,774364
67995,11,10,754,965627,11,965616
67996,5,-10,756,328843,5,328838
67997,10,-11,946,301451,10,301441
67998,12,14,893,1092465,12,1092453
67999,5,13,279,1036674,5,1036669
68000,7,5,498,791934,7,791927
68001,14,19,201,1242368,14,1242354
68002,15,-14,886,216408,15,216393
68003,19,12,301,1024357,19,1024338
68004,18,-13,2,241069,18,241051
68005,19,-14,970,217052,19,217033
68006,17,-6,340,461815,17,461798
68007,14,18,460,1212383,14,1212369
68008,19,6,696,841412,19,841393
68009,20,-3,995,561723,20,561703
68010,20,-7,314,430719,20,430699
68011,13,-17,369,118226,13,118213
68012,19,9,281,930996,19,930977
68013,9,-12,591,262283,9,262274
68014,5,13,278,1036660,5,1036655
68015,11,-3,536,558067,11,558056
68016,14,-4,957,529277,14,529263
68017,13,18,753,1214433,13,1214420
68018,13,-8,853,403915,13,403902
68019,7,-7,533,417284,7,417277
68020,5,-6,486,447221,5,447216
68021,19,-3,978,561620,19,561601
68022,8,-7,212,410386,8,410378
68023,13,5,427,806871,13,806858
68024,16,19,246,1242683,16,1242667
68025,8,-8,742,391260,8,391252
68026,17,13,118,1054098,17,1054081
68027,9,6,480,823273,9,823264
68028,20,13,788,1059160,20,1059140
68029,5,-4,544,511269,5,511264
68030,12,-14,661,214663,12,214651
68031,5,3,45,719795,5,719790
68032,14,3,756,747542,14,747528
68033,5,6,83,813953,5,813948
68034,7,-9,901,363894,7,363887
68035,8,-9,682,358544,8,358536
68036,11,15,4,1116774,11,1116763
68037,15,16,211,1148638,15,1148623
68038,10,0,141,628542,10,628532
68039,16,3,103,742627,16,742611
68040,20,12,265,1024085,20,1024065
68041,7,-11,725,296880,7,296873
68042,10,10,621,950910,10,950900
68043,7,9,1000,928053,7,928046
68044,20,5,434,806929,20,806909
68045,18,-18,633,89844,18,89826
68046,20,17,609,1182402,20,1182382
68047,8,11,186,972231,8,972223
68048,18,-19,408,57172,18,57154
68049,15,-17,399,118414,15,118399
68050,12,-1,992,624115,12,624103
68051,14,-18,267,87369,14,87355
68052,9,-13,254,223749,9,223740
68053,20,-9,198,367968,20,367948
68054,17,-20,175,24116,17,24099
68055,19,10,508,963763,19,963744
68056,18,18,513,1212758,18,1212740
68057,15,-3,626,558770,15,558755
68058,8,-17,561,105599,8,105591
68059,17,-5,822,496970,17,496953
68060,18,-6,715,464601,18,464583
68061,18,-3,263,555639,18,555621
68062,20,5,322,806118,20,806098
68063,10,-2,331,569859,10,569849
68064,20,14,121,1086419,20,1086399
68065,11,2,442,713984,11,713973
68066,20,14,117,1086402,20,1086382
68067,17,6,766,841917,17,841900
68068,18,-9,0,366625,18,366607
68069,20,16,252,1148917,20,1148897
68070,12,15,775,1122499,12,1122487
68071,8,2,646,702255,8,702247
68072,14,-1,189,617948,14,617934
68073,18,5,99,804520,18,804502
68074,8,-20,593,12957,8,12949
68075,17,2,702,715916,17,715899
68076,5,12,224,1004035,5,1004030
68077,6,13,729,1046417,6,1046411
68078,11,-5,925,497814,11,497803
68079,16,8,164,899253,16,899237
68080,12,4,836,779472,12,779460
68081,14,-9,433,370004,14,369990
68082,16,6,12,835867,16,835851
68083,6,-16,562,136259,6,136253
68084,12,12,197,1023457,12,1023445
68085,7,-14,920,206550,7,206543
68086,8,16,963,1145309,8,1145301
68087,20,-13,214,242598,20,242578
68088,7,6,102,814401,7,814394
68089,11,-9,75,367202,11,367191
68090,12,15,628,1121402,12,1121390
68091,6,-7,979,426778,6,426772
68092,18,1,946,687240,18,687222
68093,6,-14,43,187498,6,187492
68094,13,3,422,745038,13,745025
68095,5,9,781,923226,5,923221
68096,5,-18,215,67069,5,67064
68097,8,9,945,926819,8,926811
68098,13,-2,773,590908,13,590895
68099,14,-6,160,460353,14,460339
68100,19,11,351,993436,19,993417
68101,16,-4,5,522092,16,522076
68102,12,9,525,932908,12,932896
68103,9,-15,797,172362,9,172353
68104,10,-7,690,420424,10,420414
68105,9,5,857,799507,9,799498
68106,13,-6,747,464880,13,464867
68107,7,-13,368,226057,7,226050
68108,13,-13,263,243009,13,242996
68109,17,-12,860,278935,17,278918
68110,6,-10,119,315158,6,315152
68111,7,-18,949,83068,7,83061
68112,19,12,257,1024003,19,1023984
68113,11,12,120,1022917,11,1022906
68114,16,11,328,993250,16,993234
68115,7,18,440,1196150,7,1196143
68116,18,-18,757,90803,18,90785
68117,19,13,504,1056973,19,1056954
68118,9,16,410,1134023,9,1134014
68119,5,-1,500,604954,5,604949
68120,7,-11,399,289987,7,289980
68121,9,-14,197,190766,9,190757
68122,17,12,757,1027659,17,1027642
68123,10,11,404,977204,10,977194
68124,12,14,307,1087828,12,1087816
68125,5,11,865,987022,5,987017
68126,13,15,815,1122764,13,1122751
68127,9,12,1,999062,9,999053
68128,16,-18,511,89022,16,89006
68129,12,6,968,843487,12,843475
68130,13,-3,725,559545,13,559532
68131,7,0,610,638584,7,638577
68132,10,3,748,735031,10,735021
68133,20,15,48,1117164,20,1117144
68134,5,2,377,696842,5,696837
68135,20,-20,831,29251,20,29231
68136,11,-12,716,277780,11,277769
68137,9,18,995,1207798,9,1207789
68138,20,11,1,990844,20,990824
68139,12,-2,109,585957,12,585945
68140,14,13,381,1056034,14,1056020
68141,17,-11,35,303911,17,303894
68142,16,-13,599,245447,16,245431
68143,6,-16,223,128921,6,128915
68144,7,3,636,732458,7,732451
68145,15,3,111,742688,15,742673
68146,11,17,98,1178544,11,1178533
68147,5,4,491,761101,5,761096
68148,7,-6,997,458054,7,458047
68149,11,2,604,715094,11,715083
68150,10,16,206,1129556,10,1129546
68151,17,10,999,967430,17,967413
68152,12,-4,552,526272,12,526260
68153,8,-10,666,327143,8,327135
68154,19,17,987,1185378,19,1185359
68155,12,4,272,775166,12,775154
68156,8,6,441,822415,8,822407
68157,6,18,296,1193248,6,1193242
68158,6,19,466,1228160,6,1228154
68159,7,1,189,661308,7,661301
68160,15,-20,286,25023,15,25008
68161,5,7,169,848344,5,848339
68162,17,-18,284,87454,17,87437
68163,18,-4,777,527837,18,527819
68164,6,0,21,625725,6,625719
68165,18,-15,509,181506,18,181488
68166,17,-7,506,432125,17,432108
68167,13,-20,902,29761,13,29748
68168,11,12,713,1027399,11,1027388
68169,9,11,128,971181,9,971172
68170,19,-7,459,431788,19,431769
68171,8,-2,492,573300,8,573292
68172,15,-16,597,151392,15,151377
68173,8,5,725,796750,8,796742
68174,12,-17,527,119419,12,119407
68175,18,0,503,651997,18,651979
68176,14,-14,843,216074,14,216060
68177,14,8,698,903528,14,903514
68178,8,18,133,1189703,8,1189695
68179,5,-16,120,126682,5,126677
68180,13,18,549,1212997,13,1212984
68181,18,-17,447,118798,18,118780
68182,11,1,313,682331,11,682320
68183,11,3,958,749185,11,749174
68184,6,0,549,637236,6,637230
68185,12,-19,287,56235,12,56223
68186,15,-13,149,242114,15,242099
68187,11,-18,907,91794,11,91783
68188,10,-11,719,296678,10,296668
68189,16,-12,461,275844,16,275828
68190,17,-19,938,61056,17,61039
68191,9,10,521,948660,9,948651
68192,12,-15,394,180645,12,180633
68193,7,2,480,698903,7,698896
68194,8,-3,990,552627,8,552619
68195,7,19,81,1219290,7,1219283
68196,20,8,394,901098,20,901078
68197,8,3,412,727662,8,727654
68198,20,9,865,935475,20,935455
68199,10,9,435,915829,10,915819
68200,6,0,745,641745,6,641739
68201,17,-16,755,152488,17,152471
68202,15,-16,630,151659,15,151644
68203,10,-15,872,174025,10,174015
68204,10,2,596,701159,10,701149
68205,14,-19,228,55845,14,55831
68206,11,4,888,779840,11,779829
68207,10,-6,529,448237,10,448227
68208,8,9,562,918622,8,918614
68209,9,-9,971,365180,9,365171
68210,6,-1,750,609927,6,609921
68211,10,11,615,981643,10,981633
68212,17,-19,797,60173,17,60156
68213,8,-5,56,469086,8,469078
68214,12,17,982,1185325,12,1185313
68215,7,17,779,1171903,7,1171896
68216,13,19,766,1247000,13,1246987
68217,14,-20,445,26183,14,26169
68218,12,0,288,650231,12,650219
68219,15,19,905,1248143,15,1248128
68220,7,15,293,1100820,7,1100813
68221,10,17,432,1164507,10,1164497
68222,18,16,311,1149388,18,1149370
68223,6,-11,645,295373,6,295367
68224,8,1,809,674631,8,674623
68225,19,-8,991,404942,19,404923
68226,9,-10,32,313347,9,313338
68227,7,-14,615,200210,7,200203
68228,20,-15,507,181500,20,181480
68229,17,1,101,680635,17,680618
68230,16,0,31,648481,16,648465
68231,17,-19,110,54857,17,54840
68232,13,5,654,808538,13,808525
68233,15,-3,988,561678,15,561663
68234,16,11,547,994778,16,994762
68235,12,-13,112,241870,12,241858
68236,13,-14,932,216724,13,216711
68237,16,14,921,1092615,16,1092599
68238,18,-8,165,399073,18,399055
68239,6,-11,543,293284,6,293278
68240,19,0,911,655203,19,655184
68241,6,-15,933,175271,6,175265
68242,17,-12,934,279537,17,279520
68243,16,-14,4,209388,16,209372
68244,9,-2,819,580315,9,580306
68245,7,13,890,1049863,7,1049856
68246,14,7,400,870006,14,869992
68247,8,-14,401,195622,8,195614
68248,8,0,174,629296,8,629288
68249,7,18,491,1197228,7,1197221
68250,15,14,935,1092749,15,1092734
68251,6,-17,672,107923,6,107917
68252,8,-16,754,140311,8,140303
68253,17,16,539,1150918,17,1150901
68254,14,9,298,931130,14,931116
68255,9,16,518,1136219,9,1136210
68256,5,4,516,761679,5,761674
68257,8,-7,283,411925,8,411917
68258,20,17,284,1180057,20,1180037
68259,11,0,675,653405,11,653394
68260,16,12,493,1025691,16,1025675
68261,20,-19,321,56489,20,56469
68262,18,-15,939,184930,18,184912
68263,18,8,473,901676,18,901658
68264,7,14,731,1078458,7,1078451
68265,20,-19,806,60221,20,60201
68266,8,-2,461,572580,8,572572
68267,14,-7,553,432493,14,432479
68268,7,-16,440,133707,7,133700
68269,14,15,279,1118847,14,1118833
68270,7,-13,418,227046,7,227039
68271,6,4,610,763842,6,763836
68272,7,-16,278,130104,7,130097
68273,18,-4,454,525528,18,525510
68274,18,-1,88,617241,18,617223
68275,12,-4,846,528271,12,528259
68276,10,-20,106,2335,10,2325
68277,16,3,69,742348,16,742332
68278,6,10,488,947888,6,947882
68279,20,-11,132,304756,20,304736
68280,10,-11,477,291753,10,291743
68281,17,-19,339,56671,17,56654
68282,14,-4,805,528033,14,528019
68283,10,-20,5,144,10,134
68284,19,3,228,743617,19,743598
68285,18,-2,711,590507,18,590489
68286,15,-9,481,370477,15,370462
68287,8,-7,665,419833,8,419825
68288,6,-13,828,236281,6,236275
68289,16,2,701,715910,16,715894
68290,12,1,0,679736,12,679724
68291,19,-18,523,89112,19,89093
68292,5,12,974,1020541,5,1020536
68293,13,-7,640,432985,13,432972
68294,12,2,158,711796,12,711784
68295,8,-20,808,17984,8,17976
68296,19,10,903,966724,19,966705
68297,18,5,561,807864,18,807846
68298,16,16,230,1148751,16,1148735
68299,8,7,218,849399,8,849391
68300,17,-4,450,525512,17,525495
68301,17,15,502,1120367,17,1120350
68302,12,14,553,1089770,12,1089758
68303,11,15,405,1119679,11,1119668
68304,14,1,697,685263,14,685249
68305,13,-18,72,85760,13,85747
68306,15,1,792,686017,15,686002
68307,5,-20,5,149,5,144
68308,12,2,140,711672,12,711660
68309,11,2,742,716159,11,716148
68310,20,-12,105,273300,20,273280
68311,20,-4,503,525910,20,525890
68312,12,-14,342,212061,12,212049
68313,16,12,578,1026306,16,1026290
68314,12,18,703,1214034,12,1214022
68315,14,5,675,808693,14,808679
68316,14,12,862,1028562,14,1028548
68317,11,2,850,716842,11,716831
68318,20,-9,436,370032,20,370012
68319,5,-5,331,475449,5,475444
68320,5,-7,261,411358,5,411353
68321,17,-17,156,116640,17,116623
68322,20,-8,160,399043,20,399023
68323,12,15,108,1117596,12,1117584
68324,16,12,785,1027900,16,1027884
68325,11,11,450,994106,11,994095
68326,18,1,298,682216,18,682198
68327,9,-8,875,394036,9,394027
68328,12,3,81,742426,12,742414
68329,8,-17,150,96589,8,96581
68330,14,19,157,1242044,14,1242030
68331,19,-16,566,151174,19,151155
68332,19,19,422,1244333,19,1244314
68333,10,8,145,878206,10,878196
68334,10,-7,925,425625,10,425615
68335,16,-7,909,435019,16,435003
68336,20,-17,656,120442,20,120422
68337,6,-9,760,360551,6,360545
68338,17,-1,999,624151,17,624134
68339,17,-13,396,243937,17,243920
68340,16,6,116,836661,16,836645
68341,14,7,542,871048,14,871034
68342,7,-16,810,141387,7,141380
68343,8,9,755,922541,8,922533
68344,10,2,941,708230,10,708220
68345,12,17,100,1178554,12,1178542
68346,13,-9,800,372887,13,372874
68347,19,7,254,868880,19,868861
68348,18,-12,584,276802,18,276784
68349,6,-13,663,232388,6,232382
68350,17,-19,333,56591,17,56574
68351,8,-10,816,330087,8,330079
68352,20,-5,89,491603,20,491583
68353,18,1,843,686378,18,686360
68354,11,16,279,1149156,11,1149145
68355,8,3,591,731385,8,731377
68356,20,-18,459,88731,20,88711
68357,7,-15,197,159509,7,159502
68358,12,-18,603,89616,12,89604
68359,7,9,506,917427,7,917420
68360,19,0,416,651288,19,651269
68361,15,-10,997,342705,15,342690
68362,7,8,193,879306,7,879299
68363,6,11,513,979435,6,979429
68364,14,15,500,1120325,14,1120311
68365,6,-7,803,422788,6,422782
68366,10,7,488,855324,10,855314
68367,15,-8,153,398999,15,398984
68368,8,13,732,1046472,8,1046464
68369,18,9,297,931120,18,931102
68370,6,9,731,922116,6,922110
68371,12,15,289,1118939,12,1118927
68372,18,4,540,777173,18,777155
68373,6,19,877,1237047,6,1237041
68374,18,-6,834,465455,18,465437
68375,18,13,418,1056361,18,1056343
68376,11,-16,843,153066,11,153055
68377,5,1,430,666508,5,666503
68378,13,9,851,935374,13,935361
68379,15,-11,740,309465,15,309450
68380,5,-15,31,156013,5,156008
68381,11,13,814,1059360,11,1059349
68382,13,-9,7,366698,13,366685
68383,15,-1,335,619256,15,619241
68384,9,6,551,824728,9,824719
68385,9,-13,536,229730,9,229721
68386,14,-18,810,91160,14,91146
68387,18,19,896,1248037,18,1248019
68388,9,-19,927,51438,9,51429
68389,19,-11,754,309582,19,309563
68390,19,-2,821,591353,19,591334
68391,16,-13,236,242777,16,242761
68392,19,-6,348,461849,19,461830
68393,7,12,596,1011852,7,1011845
68394,13,14,241,1087304,13,1087291
68395,12,-1,985,624075,12,624063
68396,5,-2,371,570544,5,570539
68397,18,-11,848,310334,18,310316
68398,10,13,313,1037440,10,1037430
68399,16,-18,507,88988,16,88972
68400,18,-11,682,309141,18,309123
68401,7,5,618,794510,7,794503
68402,18,-13,959,248287,18,248269
68403,15,11,887,997299,15,997284
68404,7,-18,80,64241,7,64234
68405,17,-2,468,588661,17,588644
68406,15,-2,408,588167,15,588152
68407,12,-15,994,185289,12,185277
68408,11,12,180,1023363,11,1023352
68409,18,-8,126,398766,18,398748
68410,18,-19,830,60384,18,60366
68411,16,5,253,805687,16,805671
68412,8,-7,508,416719,8,416711
68413,18,-18,476,88833,18,88815
68414,13,-11,478,307549,13,307536
68415,16,18,560,1213036,16,1213020
68416,8,-4,570,511755,8,511747
68417,6,-9,677,358429,6,358423
68418,18,8,784,904159,18,904141
68419,6,15,577,1106716,6,1106710
68420,20,8,106,898762,20,898742
68421,6,-10,195,316858,6,316852
68422,5,18,645,1200381,5,1200376
68423,20,-19,456,57495,20,57475
68424,19,0,80,648809,19,648790
68425,9,-2,32,563475,9,563466
68426,8,-6,449,446340,8,446332
68427,8,0,594,638237,8,638229
68428,9,-4,511,510558,9,510549
68429,7,16,432,1134545,7,1134538
68430,17,-20,417,25927,17,25910
68431,18,-4,968,529382,18,529364
68432,19,8,732,903770,19,903751
68433,8,-8,262,381032,8,381024
68434,18,-11,861,310475,18,310457
68435,20,0,287,650230,20,650210
68436,16,7,238,868685,16,868669
68437,6,-18,457,72295,6,72289
68438,16,-5,566,495207,16,495191
68439,13,15,967,1123886,13,1123873
68440,12,6,874,842733,12,842721
68441,6,10,473,947614,6,947608
68442,15,-15,248,179584,15,179569
68443,7,1,881,676111,7,676104
68444,5,3,69,720292,5,720287
68445,5,-16,616,137448,5,137443
68446,13,12,29,1022309,13,1022296
68447,19,17,437,1181175,19,1181156
68448,14,-17,165,116697,14,116683
68449,10,-20,939,20670,10,20660
68450,9,11,796,985517,9,985508
68451,11,17,850,1184384,11,1184373
68452,19,18,150,1210207,19,1210188
68453,5,7,306,851371,5,851366
68454,8,-1,914,613702,8,613694
68455,9,17,169,1158848,9,1158839
68456,9,15,3,1094466,9,1094457
68457,16,18,865,1215257,16,1215241
68458,17,4,594,777597,17,777580
68459,13,13,365,1055909,13,1055896
68460,19,18,447,1212318,19,1212299
68461,7,19,637,1231706,7,1231699
68462,13,6,20,835977,13,835964
68463,10,4,92,752626,10,752616
68464,15,-3,746,559715,15,559700
68465,11,-9,685,371829,11,371818
68466,11,15,740,1122295,11,1122284
68467,8,14,43,1062799,8,1062791
68468,18,-13,589,245393,18,245375
68469,6,-7,931,425696,6,425690
68470,16,4,172,774535,16,774519
68471,11,-4,725,527502,11,527491
68472,17,-14,858,216212,17,216195
68473,6,-3,221,535138,6,535132
68474,11,-20,535,26850,11,26839
68475,10,17,749,1171239,10,1171229
68476,6,-12,536,261268,6,261262
68477,8,3,17,719201,8,719193
68478,18,6,780,842007,18,841989
68479,6,-9,254,349148,6,349142
68480,20,3,402,744895,20,744875
68481,7,11,752,984534,7,984527
68482,12,10,582,964385,12,964373
68483,10,0,876,644319,10,644309
68484,20,-3,442,557149,20,557129
68485,19,10,898,966675,19,966656
68486,9,14,570,1074504,9,1074495
68487,9,2,400,697266,9,697257
68488,18,-11,97,304464,18,304446
68489,7,0,732,641476,7,641469
68490,14,9,68,929555,14,929541
68491,14,-13,608,245554,14,245540
68492,11,6,827,842404,11,842393
68493,16,7,508,870796,16,870780
68494,14,1,486,683699,14,683685
68495,15,19,800,1247261,15,1247246
68496,18,-5,35,491082,18,491064
68497,11,7,985,874021,11,874010
68498,15,6,681,841224,15,841209
68499,7,-11,636,295206,7,295199
68500,18,12,671,1027113,18,1027095
68501,18,-12,963,279802,18,279784
68502,5,-15,321,162380,5,162375
68503,13,13,606,1057869,13,1057856
68504,11,17,139,1178913,11,1178902
68505,18,18,575,1213123,18,1213105
68506,6,10,963,958144,6,958138
68507,14,6,830,842453,14,842439
68508,13,-15,996,185361,13,185348
68509,15,-18,725,90546,15,90531
68510,19,16,332,1149518,19,1149499
68511,7,6,216,816953,7,816946
68512,18,-2,905,592028,18,592010
68513,7,-1,939,614242,7,614235
68514,8,-13,743,234241,8,234233
68515,12,3,868,748379,12,748367
68516,14,-10,950,342228,14,342214
68517,18,15,690,1121825,18,1121807
68518,15,15,445,1119963,15,1119948
68519,19,-16,148,148041,19,148022
68520,8,-2,586,575198,8,575190
68521,19,19,938,1248305,19,1248286
68522,9,-13,541,229811,9,229802
68523,19,9,812,935051,19,935032
68524,20,-14,829,215966,20,215946
68525,8,13,922,1050440,8,1050432
68526,18,-5,326,493564,18,493546
68527,12,12,246,1023859,12,1023847
68528,11,-7,954,435389,11,435378
68529,7,16,738,1140457,7,1140450
68530,9,18,62,1188145,9,1188136
68531,10,-4,217,504273,10,504263
68532,13,17,408,1180937,13,1180924
68533,18,17,289,1180110,18,1180092
68534,11,-8,802,403621,11,403610
68535,15,-8,674,402688,15,402673
68536,19,15,486,1120238,19,1120219
68537,17,13,332,1055681,17,1055664
68538,16,-19,638,59032,16,59016
68539,14,1,757,685747,14,685733
68540,12,8,509,901995,12,901983
68541,13,-3,392,556678,13,556665
68542,7,-18,397,70962,7,70955
68543,10,9,99,908862,10,908852
68544,10,-5,532,479595,10,479585
68545,12,6,354,838515,12,838503
68546,18,14,645,1090475,18,1090457
68547,9,-9,662,358209,9,358200
68548,9,10,340,944728,9,944719
68549,20,-3,693,559293,20,559273
68550,15,1,756,685744,15,685729
68551,17,-11,437,307273,17,307256
68552,5,7,354,852467,5,852462
68553,18,7,452,870414,18,870396
68554,9,-15,156,158779,9,158770
68555,9,15,536,1105919,9,1105910
68556,19,-7,679,433233,19,433214
68557,13,-18,519,89078,13,89065
68558,10,-4,171,503140,10,503130
68559,12,4,40,773552,12,773540
68560,15,17,106,1178608,15,1178593
68561,8,0,215,630149,8,630141
68562,19,-5,876,497464,19,497445
68563,19,-3,357,556410,19,556391
68564,15,9,444,932266,15,932251
68565,16,5,943,810711,16,810695
68566,13,-9,668,371736,13,371723
68567,15,-12,145,273596,15,273581
68568,5,-17,341,100816,5,100811
68569,9,-13,565,230396,9,230387
68570,10,-6,170,440481,10,440471
68571,15,-16,457,150421,15,150406
68572,8,-8,814,392836,8,392828
68573,5,2,797,705223,5,705218
68574,15,-11,9,303779,15,303764
68575,13,-16,472,150527,13,150514
68576,14,-9,463,370231,14,370217
68577,20,-16,748,152373,20,152353
68578,8,-8,931,395229,8,395221
68579,11,12,754,1027648,11,1027637
68580,14,4,829,779414,14,779400
68581,7,17,38,1156148,7,1156141
68582,8,-5,339,475609,8,475601
68583,14,-5,215,492563,14,492549
68584,17,-19,391,57055,17,57038
68585,19,-16,687,151955,19,151936
68586,19,8,229,899837,19,899818
68587,20,5,365,806474,20,806454
68588,14,6,65,836246,14,836232
68589,14,10,202,961363,14,961349
68590,17,-16,367,149601,17,149584
68591,7,7,693,859506,7,859499
68592,13,6,879,842775,13,842762
68593,20,6,108,836593,20,836573
68594,9,-13,922,238304,9,238295
68595,18,-6,366,461961,18,461943
68596,14,11,467,994267,14,994253
68597,17,-12,953,279726,17,279709
68598,10,-15,227,160239,10,160229
68599,9,2,766,704713,9,704704
68600,20,-17,667,120547,20,120527
68601,19,-11,64,304194,19,304175
68602,6,2,931,707990,6,707984
68603,7,12,984,1020814,7,1020807
68604,14,17,970,1185218,14,1185204
68605,18,7,510,870810,18,870792
68606,20,3,864,748362,20,748342
68607,13,-9,687,371864,13,371851
68608,10,14,169,1065546,10,1065536
68609,14,-12,76,273088,14,273074
68610,13,15,772,1122484,13,1122471
68611,10,5,926,801164,10,801154
68612,5,5,180,785374,5,785369
68613,12,8,395,901099,12,901087
68614,19,2,774,716331,19,716312
68615,5,0,584,638001,5,637996
68616,15,4,759,778858,15,778843
68617,10,-1,574,606425,10,606415
68618,9,9,324,913581,9,913572
68619,16,-6,230,460975,16,460959
68620,18,-10,858,341546,18,341528
68621,5,-1,862,612384,5,612379
68622,12,-1,807,622754,12,622742
68623,19,-8,492,401261,19,401242
68624,15,11,114,991659,15,991644
68625,13,-1,492,620508,13,620495
68626,9,8,39,875908,9,875899
68627,17,-3,857,560642,17,560625
68628,16,-14,227,211180,16,211164
68629,10,-17,541,105126,10,105116
68630,12,0,653,653266,12,653254
68631,10,-14,765,203421,10,203411
68632,16,-15,952,185039,16,185023
68633,19,10,800,966116,19,966097
68634,14,-6,42,459444,14,459430
68635,7,-1,638,607678,7,607671
68636,20,-2,876,591820,20,591800
68637,15,-1,857,623115,15,623100
68638,5,-19,454,41260,5,41255
68639,16,-19,591,58672,16,58656
68640,9,-9,578,356692,9,356683
68641,19,2,669,715624,19,715605
68642,20,-13,948,248209,20,248189
68643,12,-14,927,216706,12,216694
68644,16,-20,73,23336,16,23320
68645,12,15,813,1122745,12,1122733
68646,18,18,174,1210342,18,1210324
68647,18,-3,523,557905,18,557887
68648,10,-8,490,385529,10,385519
68649,9,-17,887,112311,9,112302
68650,17,-16,563,151143,17,151126
68651,6,-11,390,289760,6,289754
68652,9,9,656,920556,9,920547
68653,15,-6,395,462138,15,462123
68654,13,13,388,1056112,13,1056099
68655,17,17,185,1179284,17,1179267
68656,6,4,731,766518,6,766512
68657,10,-15,996,176743,10,176733
68658,15,-18,892,91700,15,91685
68659,15,0,25,648418,15,648403
68660,20,-20,534,26849,20,26829
68661,17,10,915,966896,17,966879
68662,15,15,2,1116739,15,1116724
68663,16,13,893,1059907,16,1059891
68664,19,-1,312,619078,19,619059
68665,6,-8,710,390641,6,390635
68666,12,12,237,1023782,12,1023770
68667,13,-11,134,304773,13,304760
68668,17,-7,873,434680,17,434663
68669,9,2,231,693541,9,693532
68670,8,-8,680,389989,8,389981
68671,19,-20,766,28685,19,28666
68672,15,-16,467,150484,15,150469
68673,9,18,851,1204800,9,1204791
68674,18,-14,575,214050,18,214032
68675,13,-1,704,621987,13,621974
68676,10,1,921,677080,10,677070
68677,13,17,773,1183599,13,1183586
68678,19,-17,394,118388,19,118369
68679,5,7,847,862761,5,862756
68680,17,8,30,898105,17,898088
68681,16,2,228,712302,16,712286
68682,6,-7,796,422607,6,422601
68683,18,5,573,807966,18,807948
68684,12,-16,345,149437,12,149425
68685,17,12,360,1024723,17,1024706
68686,15,18,937,1215810,15,1215795
68687,10,-8,528,386486,10,386476
68688,11,10,311,962166,11,962155
68689,10,15,920,1114030,10,1114020
68690,20,4,772,778942,20,778922
68691,15,-17,783,121434,15,121419
68692,8,10,205,941872,8,941864
68693,6,-3,750,547242,6,547236
68694,5,-5,310,474908,5,474903
68695,15,6,312,838148,15,838133
68696,8,-14,464,196724,8,196716
68697,8,-12,358,257427,8,257419
68698,13,2,572,714867,13,714854
68699,16,-1,901,623444,16,623428
68700,8,13,18,1031203,8,1031195
68701,6,3,359,726612,6,726606
68702,6,-7,430,415102,6,415096
68703,13,7,430,870245,13,870232
68704,13,-8,534,401617,13,401604
68705,13,-2,479,588769,13,588756
68706,10,17,570,1167385,10,1167375
68707,9,1,202,661616,9,661607
68708,6,2,669,702738,6,702732
68709,20,-17,439,118728,20,118708
68710,18,19,694,1246423,18,1246405
68711,14,-11,160,305028,14,305014
68712,15,-13,173,242294,15,242279
68713,6,17,306,1161939,6,1161933
68714,13,-12,132,273513,13,273500
68715,9,-2,73,564418,9,564409
68716,12,1,826,686248,12,686236
68717,9,9,923,926393,9,926384
68718,6,18,620,1199825,6,1199819
68719,6,19,534,1229600,6,1229594
68720,12,-12,741,277939,12,277927
68721,17,9,23,929215,17,929198
68722,15,-18,641,89905,15,89890
68723,10,-11,379,289587,10,289577
68724,18,8,738,903815,18,903797
68725,7,13,831,1048628,7,1048621
68726,16,8,618,902842,16,902826
68727,10,-2,244,567985,10,567975
68728,18,8,843,904503,18,904485
68729,14,12,748,1027641,14,1027627
68730,8,-17,446,102943,8,102935
68731,13,-5,916,497763,13,497750
68732,18,18,692,1213982,18,1213964
68733,6,-5,585,480740,6,480734
68734,10,4,776,767565,10,767555
68735,10,-4,592,512190,10,512180
68736,13,-6,693,464482,13,464469
68737,18,14,600,1090075,18,1090057
68738,16,-9,27,366799,16,366783
68739,10,14,222,1066663,10,1066653
68740,18,-2,354,587766,18,587748
68741,9,4,925,770922,9,770913
68742,15,8,287,900251,15,900236
68743,14,-20,461,26266,14,26252
68744,15,12,899,1028884,15,1028869
68745,9,-18,567,74558,9,74549
68746,5,-5,332,475468,5,475463
68747,13,16,740,1152374,13,1152361
68748,5,6,187,816285,5,816280
68749,6,8,968,896237,6,896231
68750,15,-16,861,153268,15,153253
68751,20,-15,696,182904,20,182884
68752,9,-17,163,96885,9,96876
68753,16,16,250,1148893,16,1148877
68754,5,-17,835,111214,5,111209
68755,10,-4,400,508352,10,508342
68756,19,14,756,1091372,19,1091353
68757,17,-3,440,557139,17,557122
68758,5,15,713,1109644,5,1109639
68759,10,-7,840,423626,10,423616
68760,12,-18,797,91043,12,91031
68761,8,-1,446,603758,8,603750
68762,10,7,185,848694,10,848684
68763,19,-2,663,590134,19,590115
68764,17,2,60,710986,17,710969
68765,8,15,299,1100976,8,1100968
68766,10,-2,987,583932,10,583922
68767,16,19,325,1243391,16,1243375
68768,6,8,116,877542,6,877536
68769,7,4,37,751365,7,751358
68770,6,-19,309,38214,6,38208
68771,14,-19,674,59221,14,59207
68772,11,-9,844,373235,11,373224
68773,12,5,764,809338,12,809326
68774,16,-5,300,493318,16,493302
68775,15,16,447,1150373,15,1150358
68776,18,18,919,1215640,18,1215622
68777,18,-18,303,87587,18,87569
68778,18,5,698,808893,18,808875
68779,12,8,638,903050,12,903038
68780,20,11,274,992827,20,992807
68781,13,7,969,873870,13,873857
68782,9,-3,30,531199,9,531190
68783,5,11,630,981892,5,981887
68784,9,5,863,799707,9,799698
68785,20,4,706,778413,20,778393
68786,9,-13,576,230649,9,230640
68787,16,17,231,1179579,16,1179563
68788,5,-13,83,220126,5,220121
68789,9,2,876,706825,9,706816
68790,20,6,463,839489,20,839469
68791,6,1,711,672416,6,672410
68792,16,14,433,1088864,16,1088848
68793,7,-14,568,198971,7,198964
68794,12,11,559,994872,12,994860
68795,14,-6,986,466650,14,466636
68796,7,1,1000,678726,7,678719
68797,11,-6,157,460330,11,460319
68798,13,9,340,931496,13,931483
68799,5,19,198,1221889,5,1221884
68800,10,17,282,1161406,10,1161396
68801,15,17,980,1185308,15,1185293
68802,14,-18,10,85299,14,85285
68803,5,-8,787,392198,5,392193
68804,16,11,840,996933,16,996917
68805,17,-20,310,25267,17,25250
68806,9,7,888,863596,9,863587
68807,19,0,930,655331,19,655312
68808,9,-4,842,517282,9,517273
68809,19,11,526,994676,19,994657
68810,7,7,193,848859,7,848852
68811,10,14,16,1062129,10,1062119
68812,16,-4,519,526039,16,526023
68813,17,8,558,902330,17,902313
68814,6,10,970,958255,6,958249
68815,19,2,349,713227,19,713208
68816,9,5,250,786858,9,786849
68817,9,-13,369,226088,9,226079
68818,6,12,340,1006615,6,1006609
68819,8,4,605,763754,8,763746
68820,15,-2,33,585373,15,585358
68821,14,4,575,777437,14,777423
68822,8,-9,731,359715,8,359707
68823,8,-19,138,34650,8,34642
68824,13,5,192,805267,13,805254
68825,11,-5,217,492574,11,492563
68826,7,-14,265,192588,7,192581
68827,15,3,640,746673,15,746658
68828,18,13,545,1057339,18,1057321
68829,17,3,429,745080,17,745063
68830,11,-7,684,433266,11,433255
68831,10,-12,603,262545,10,262535
68832,13,12,220,1023683,13,1023670
68833,15,-5,189,492368,15,492353
68834,18,-18,300,87569,18,87551
68835,8,-14,963,207512,8,207504
68836,14,-15,317,180070,14,180056
68837,11,17,78,1178462,11,1178451
68838,19,-10,685,340261,19,340242
68839,6,-13,111,220801,6,220795
68840,6,6,595,825788,6,825782
68841,5,-17,214,98041,5,98036
68842,19,1,792,686026,19,686007
68843,5,19,498,1228855,5,1228850
68844,13,-14,629,214451,13,214438
68845,5,1,761,673555,5,673550
68846,16,6,260,837760,16,837744
68847,6,-17,157,96759,6,96753
68848,8,9,488,917033,8,917025
68849,20,18,308,1211313,20,1211293
68850,10,-11,832,298936,10,298926
68851,20,-15,338,180245,20,180225
68852,6,-3,626,544475,6,544469
68853,17,-5,917,497769,17,497752
68854,14,3,647,746734,14,746720
68855,15,-17,825,121668,15,121653
68856,11,-3,378,556592,11,556581
68857,11,-15,596,182155,11,182144
68858,8,-1,751,609961,8,609953
68859,18,-4,440,525476,18,525458
68860,14,15,507,1120436,14,1120422
68861,15,1,262,682000,15,681985
68862,19,17,118,1178728,19,1178709
68863,5,11,96,970577,5,970572
68864,18,17,621,1182472,18,1182454
68865,11,6,224,837441,11,837430
68866,9,12,860,1017915,9,1017906
68867,19,6,110,836608,19,836589
68868,7,-5,901,487617,7,487610
68869,17,6,319,838250,17,838233
68870,5,5,182,785435,5,785430
68871,6,-4,368,507619,6,507613
68872,18,2,957,717642,18,717624
68873,20,11,215,992325,20,992305
68874,20,-10,13,335215,20,335195
68875,11,-11,865,310501,11,310490
68876,12,11,839,996928,12,996916
68877,10,2,474,698774,10,698764
68878,14,-15,801,183719,14,183705
68879,10,-14,305,193341,10,193331
68880,19,12,208,1023552,19,1023533
68881,11,-8,145,398938,11,398927
68882,8,-3,492,541590,8,541582
68883,5,1,408,666123,5,666118
68884,9,8,650,889421,9,889412
68885,5,-18,422,71491,5,71486
68886,20,-13,961,248319,20,248299
68887,20,16,170,1148299,20,1148279
68888,13,-14,742,215259,13,215246
68889,18,-19,635,59003,18,58985
68890,13,-8,856,403940,13,403927
68891,18,10,159,961098,18,961080
68892,8,-15,54,156485,8,156477
68893,5,-7,864,424202,5,424197
68894,7,15,730,1110061,7,1110054
68895,5,-15,934,175295,5,175290
68896,18,-20,606,27413,18,27395
68897,16,-3,955,561451,16,561435
68898,17,13,848,1059581,17,1059564
68899,12,-6,647,464097,12,464085
68900,8,-2,435,572065,8,572057
68901,12,15,131,1117789,12,1117777
68902,16,10,922,966945,16,966929
68903,17,3,48,742177,17,742160
68904,6,14,80,1063587,6,1063581
68905,11,-7,252,430140,11,430129
68906,19,7,982,874002,19,873983
68907,17,1,714,685380,17,685363
68908,14,7,617,871545,14,871531
68909,18,3,123,742790,18,742772
68910,19,-12,513,276347,19,276328
68911,7,-8,641,389090,7,389083
68912,6,8,668,889823,6,889817
68913,15,4,747,778763,15,778748
68914,19,-5,853,497255,19,497236
68915,13,-12,844,278757,13,278744
68916,5,14,115,1064428,5,1064423
68917,14,-15,554,181876,14,181862
68918,15,19,830,1247497,15,1247482
68919,6,12,993,1020981,6,1020975
68920,6,9,339,913854,6,913848
68921,20,12,909,1029020,20,1029000
68922,20,-16,644,151740,20,151720
68923,17,15,830,1122868,17,1122851
68924,18,2,197,712100,18,712082
68925,12,-12,848,278798,12,278786
68926,20,9,612,933599,20,933579
68927,14,8,923,905140,14,905126
68928,10,-10,847,330740,10,330730
68929,15,-19,443,57402,15,57387
68930,12,-10,862,341570,12,341558
68931,10,-12,510,260731,10,260721
68932,19,-11,466,307489,19,307470
68933,10,-5,522,479362,10,479352
68934,5,-8,806,392589,5,392584
68935,5,11,33,969205,5,969200
68936,12,12,817,1028116,12,1028104
68937,7,-11,500,292359,7,292352
68938,16,8,40,898173,16,898157
68939,20,-11,134,304783,20,304763
68940,12,0,17,648332,12,648320
68941,14,-14,158,210523,14,210509
68942,5,-16,688,138770,5,138765
68943,18,-18,33,85453,18,85435
68944,17,-19,278,56189,17,56172
68945,19,3,600,746325,19,746306
68946,20,-5,872,497416,20,497396
68947,16,-5,528,494965,16,494949
68948,8,-16,870,142775,8,142767
68949,7,-5,28,468466,7,468459
68950,11,-20,449,26213,11,26202
68951,8,19,286,1223830,8,1223822
68952,8,-5,145,471230,8,471222
68953,6,-10,823,330239,6,330233
68954,20,4,973,780390,20,780370
68955,11,-9,985,374175,11,374164
68956,10,0,703,640755,10,640745
68957,11,-20,186,24270,11,24259
68958,17,-3,532,558046,17,558029
68959,13,17,894,1184674,13,1184661
68960,15,19,312,1243297,15,1243282
68961,9,-3,471,541044,9,541035
68962,11,18,358,1211694,11,1211683
68963,14,5,861,810038,14,810024
68964,16,14,238,1087282,16,1087266
68965,7,-2,892,581920,7,581913
68966,19,-2,286,587274,19,587255
68967,9,-9,375,351821,9,351812
68968,10,-19,224,36493,10,36483
68969,14,-10,489,338715,14,338701
68970,10,-10,867,331136,10,331126
68971,12,-8,351,400359,12,400347
68972,12,3,562,745969,12,745957
68973,6,17,87,1157125,6,1157119
68974,13,6,383,838776,13,838763
68975,7,-7,665,419840,7,419833
68976,5,17,621,1168565,5,1168560
68977,8,-11,480,291843,8,291835
68978,12,15,46,1117134,12,1117122
68979,6,18,976,1207476,6,1207470
68980,13,-2,690,590356,13,590343
68981,14,-9,465,370266,14,370252
68982,8,-12,860,268325,8,268317
68983,7,-17,127,96088,7,96081
68984,9,-1,446,603767,9,603758
68985,15,-17,969,122593,15,122578
68986,18,-3,319,556109,18,556091
68987,10,-18,71,64004,10,63994
68988,6,14,795,1079741,6,1079735
68989,19,-6,457,462652,19,462633
68990,7,9,591,919335,7,919328
68991,16,-6,107,459856,16,459840
68992,12,9,956,936204,12,936192
68993,13,11,574,995000,13,994987
68994,8,-16,669,138434,8,138426
68995,15,-15,678,182825,15,182810
68996,18,0,715,653788,18,653770
68997,20,-5,14,490862,20,490842
68998,8,4,912,770665,8,770657
68999,14,9,954,936185,14,936171
69000,6,-20,401,8714,6,8708
69001,18,16,131,1148010,18,1147992
69002,15,7,587,871355,15,871340
69003,15,-6,620,463906,15,463891
69004,9,12,476,1009312,9,1009303
69005,13,14,787,1091661,13,1091648
69006,17,-20,823,29193,17,29176
69007,7,16,706,1139824,7,1139817
69008,18,-14,505,213396,18,213378
69009,19,-18,16,85329,19,85310
69010,20,13,31,1053440,20,1053420
69011,15,-3,257,555583,15,555568
69012,14,-5,422,494126,14,494112
69013,7,2,173,692392,7,692385
69014,8,1,38,657883,8,657875
69015,18,-3,159,554891,18,554873
69016,13,-8,176,399169,13,399156
69017,8,10,502,948174,8,948166
69018,11,-17,962,122562,11,122551
69019,20,2,212,712194,20,712174
69020,11,2,522,714579,11,714568
69021,12,0,328,650515,12,650503
69022,11,-5,533,494992,11,494981
69023,9,-5,273,474067,9,474058
69024,5,14,379,1070159,5,1070154
69025,9,15,697,1109276,9,1109267
69026,18,-3,861,560676,18,560658
69027,7,-3,284,536519,7,536512
69028,17,14,663,1090630,17,1090613
69029,5,-8,198,379713,5,379708
69030,9,18,358,1194447,9,1194438
69031,8,19,71,1219082,8,1219074
69032,11,10,370,962622,11,962611
69033,9,-5,544,479795,9,479786
69034,17,-12,715,277773,17,277756
69035,10,0,686,640383,10,640373
69036,10,-13,632,231887,10,231877
69037,17,14,989,1093211,17,1093194
69038,14,15,941,1123670,14,1123656
69039,17,5,273,805832,17,805815
69040,16,-11,821,310112,16,310096
69041,6,18,973,1207365,6,1207359
69042,6,-10,184,316634,6,316628
69043,12,-3,801,560222,12,560210
69044,20,10,943,967079,20,967059
69045,19,-14,376,212446,19,212427
69046,20,-12,549,276593,20,276573
69047,5,4,98,752773,5,752768
69048,18,-16,382,149710,18,149692
69049,15,6,57,836198,15,836183
69050,5,8,966,896179,5,896174
69051,9,18,747,1202454,9,1202445
69052,8,-13,265,224081,8,224073
69053,14,17,627,1182510,14,1182496
69054,5,2,959,708731,5,708726
69055,11,-19,54,54267,11,54256
69056,8,-5,101,470324,8,470316
69057,11,4,858,779685,11,779674
69058,19,-2,820,591340,19,591321
69059,5,-3,869,549832,5,549827
69060,10,9,973,927569,10,927559
69061,16,2,711,715959,16,715943
69062,7,-8,211,379989,7,379982
69063,20,18,132,1209984,20,1209964
69064,5,4,409,759488,5,759483
69065,18,-11,534,308036,18,308018
69066,7,9,299,912986,7,912979
69067,20,13,803,1059293,20,1059273
69068,12,-15,130,178770,12,178758
69069,10,-11,564,293637,10,293627
69070,6,-14,136,189491,6,189485
69071,8,-2,280,568782,8,568774
69072,14,1,635,684875,14,684861
69073,11,-3,905,561042,11,561031
69074,11,2,219,712232,11,712221
69075,16,14,581,1089922,16,1089906
69076,5,9,98,908793,5,908788
69077,11,-10,472,338615,11,338604
69078,5,14,943,1082967,5,1082962
69079,8,-20,841,18731,8,18723
69080,8,8,676,890081,8,890073
69081,5,-15,161,158865,5,158860
69082,20,-19,13,53981,20,53961
69083,11,15,247,1118630,11,1118619
69084,15,3,607,746367,15,746352
69085,7,-7,133,408595,7,408588
69086,12,-1,131,617548,12,617536
69087,20,18,276,1211176,20,1211156
69088,17,-7,909,435026,17,435009
69089,19,-16,460,150454,19,150435
69090,20,-1,703,621980,20,621960
69091,15,10,618,964697,15,964682
69092,5,14,810,1080170,5,1080165
69093,10,19,108,1219863,10,1219853
69094,18,1,962,687347,18,687329
69095,17,-11,69,304234,17,304217
69096,13,-1,94,617292,13,617279
69097,11,14,879,1092309,11,1092298
69098,18,-19,417,57212,18,57194
69099,11,-19,191,55561,11,55550
69100,12,-9,524,370838,12,370826
69101,5,-4,836,517141,5,517136
69102,10,-6,753,453003,10,452993
69103,20,15,640,1121471,20,1121451
69104,19,-14,411,212790,19,212771
69105,18,-19,137,55112,18,55094
69106,9,-3,202,534755,9,534746
69107,9,-19,1000,52883,9,52874
69108,8,-11,777,297904,8,297896
69109,7,-1,658,608083,7,608076
69110,20,-2,350,587720,20,587700
69111,19,7,269,868955,19,868936
69112,11,12,752,1027646,11,1027635
69113,12,3,621,746494,12,746482
69114,13,7,308,869251,13,869238
69115,5,16,728,1140229,5,1140224
69116,7,-16,924,143829,7,143822
69117,18,10,518,963836,18,963818
69118,14,-2,536,589140,14,589126
69119,16,9,530,932942,16,932926
69120,19,-5,595,495447,19,495428
69121,9,4,55,751767,9,751758
69122,20,9,347,931555,20,931535
69123,13,2,106,711392,13,711379
69124,10,8,107,877373,10,877363
69125,14,-7,621,432867,14,432853
69126,10,15,245,1099780,10,1099770
69127,14,-9,78,367243,14,367229
69128,17,15,501,1120338,17,1120321
69129,7,-8,691,390298,7,390291
69130,10,-1,408,602932,10,602922
69131,10,-18,917,82387,10,82377
69132,8,19,3,1217493,8,1217485
69133,6,12,762,1015613,6,1015607
69134,6,-20,234,5237,6,5231
69135,10,8,820,893019,10,893009
69136,7,0,913,645132,7,645125
69137,19,14,287,1087626,19,1087607
69138,10,-13,546,229939,10,229929
69139,13,-20,2,2318,13,2305
69140,20,9,196,930495,20,930475
69141,20,14,470,1089103,20,1089083
69142,15,12,334,1024583,15,1024568
69143,7,14,379,1070166,7,1070159
69144,5,-18,270,68389,5,68384
69145,9,-4,980,520511,9,520502
69146,9,-8,899,394622,9,394613
69147,8,-11,1,281153,8,281145
69148,11,18,516,1212761,11,1212750
69149,9,0,572,637736,9,637727
69150,8,5,945,801666,8,801658
69151,15,-3,450,557247,15,557232
69152,18,2,907,717234,18,717216
69153,16,-5,120,491869,16,491853
69154,18,18,380,1211849,18,1211831
69155,8,18,302,1193324,8,1193316
69156,11,-12,626,277062,11,277051
69157,10,-2,756,578844,10,578834
69158,6,7,819,862183,6,862177
69159,15,16,231,1148755,15,1148740
69160,19,-13,909,247841,19,247822
69161,20,19,873,1247853,20,1247833
69162,20,19,386,1243918,20,1243898
69163,14,-16,959,154003,14,153989
69164,19,18,989,1216225,19,1216206
69165,18,12,360,1024731,18,1024713
69166,6,4,884,770068,6,770062
69167,16,-7,169,429584,16,429568
69168,9,-4,877,518244,9,518235
69169,20,15,465,1120081,20,1120061
69170,14,4,598,777627,14,777613
69171,13,7,735,872398,13,872385
69172,6,-11,488,292063,6,292057
69173,15,-14,103,210122,15,210107
69174,10,-5,27,468427,10,468417
69175,9,8,454,885126,9,885117
69176,8,-3,264,536127,8,536119
69177,14,4,876,779791,14,779777
69178,15,13,824,1059414,15,1059399
69179,7,0,467,635530,7,635523
69180,6,15,948,1114714,6,1114708
69181,11,-16,916,153670,11,153659
69182,16,11,417,993915,16,993899
69183,11,-13,556,245121,11,245110
69184,15,-20,642,27679,15,27664
69185,20,12,264,1024066,20,1024046
69186,16,13,399,1056196,16,1056180
69187,14,3,918,748760,14,748746
69188,19,-14,967,217012,19,216993
69189,10,13,802,1048052,10,1048042
69190,12,-9,491,370557,12,370545
69191,9,-14,50,187626,9,187617
69192,13,-12,101,273259,13,273246
69193,8,11,967,989157,8,989149
69194,8,-9,241,348833,8,348825
69195,11,18,193,1210581,11,1210570
69196,5,19,260,1223215,5,1223210
69197,5,3,739,734859,5,734854
69198,6,-8,898,394604,6,394598
69199,14,18,45,1209261,14,1209247
69200,6,-12,419,258736,6,258730
69201,15,-13,75,241608,15,241593
69202,19,11,635,995373,19,995354
69203,6,-2,771,579186,6,579180
69204,11,10,801,966125,11,966114
69205,16,-19,330,56546,16,56530
69206,11,5,438,806946,11,806935
69207,16,18,434,1212255,16,1212239
69208,9,14,957,1083250,9,1083241
69209,11,6,547,840182,11,840171
69210,8,-19,662,46041,8,46033
69211,12,13,680,1058350,12,1058338
69212,5,-8,659,389527,5,389522
69213,19,10,419,963055,19,963036
69214,20,-3,760,559879,20,559859
69215,18,12,134,1023019,18,1023001
69216,15,8,460,901611,15,901596
69217,9,-14,32,187192,9,187183
69218,20,8,914,905102,20,905082
69219,18,-4,611,526695,18,526677
69220,14,14,641,1090425,14,1090411
69221,19,-15,48,178145,19,178126
69222,11,-12,337,275016,11,275005
69223,16,-20,376,25713,16,25697
69224,14,-15,339,180251,14,180237
69225,16,-7,243,430097,16,430081
69226,11,-15,519,181575,11,181564
69227,18,-7,313,430687,18,430669
69228,13,-6,544,463382,13,463369
69229,14,-1,656,621651,14,621637
69230,17,-17,656,120449,17,120432
69231,20,9,794,934954,20,934934
69232,10,3,384,727135,10,727125
69233,13,17,904,1184748,13,1184735
69234,9,-10,727,328284,9,328275
69235,20,-5,55,491254,20,491234
69236,11,13,560,1057462,11,1057451
69237,18,12,901,1028934,18,1028916
69238,6,-11,893,300250,6,300244
69239,20,19,732,1246740,20,1246720
69240,5,-12,71,251163,5,251158
69241,6,8,161,878594,6,878588
69242,20,12,816,1028109,20,1028089
69243,13,1,890,686744,13,686731
69244,15,12,615,1026578,15,1026563
69245,11,9,754,934544,11,934533
69246,10,-20,956,21074,10,21064
69247,16,-12,318,274890,16,274874
69248,12,19,326,1243399,12,1243387
69249,14,-15,391,180621,14,180607
69250,17,11,569,994971,17,994954
69251,16,-2,162,586257,16,586241
69252,14,-6,18,459270,14,459256
69253,8,-11,109,283483,8,283475
69254,20,8,550,902281,20,902261
69255,12,9,419,932088,12,932076
69256,15,4,196,774658,15,774643
69257,9,-6,759,453139,9,453130
69258,10,-8,317,382125,10,382115
69259,7,15,34,1095185,7,1095178
69260,6,15,191,1098557,6,1098551
69261,17,13,469,1056706,17,1056689
69262,12,-12,569,276715,12,276703
69263,18,-9,211,368043,18,368025
69264,8,8,885,894350,8,894342
69265,7,-7,459,415661,7,415654
69266,19,18,768,1214513,19,1214494
69267,10,15,961,1114982,10,1114972
69268,6,17,480,1165619,6,1165613
69269,8,-13,73,219953,8,219945
69270,13,3,270,743930,13,743917
69271,9,-20,664,14646,9,14637
69272,16,12,267,1024104,16,1024088
69273,8,-2,914,582407,8,582399
69274,14,-20,695,28167,14,28153
69275,17,-16,220,148617,17,148600
69276,17,-14,757,215397,17,215380
69277,13,11,94,991545,13,991532
69278,9,15,579,1106753,9,1106744
69279,19,11,752,996266,19,996247
69280,16,11,894,997377,16,997361
69281,11,-1,130,617545,11,617534
69282,6,-14,797,204028,6,204022
69283,9,11,195,972464,9,972455
69284,20,-8,702,402857,20,402837
69285,11,-19,227,55826,11,55815
69286,18,-14,2,209368,18,209350
69287,16,-16,42,147052,16,147036
69288,6,1,891,676379,6,676373
69289,5,-8,4,375353,5,375348
69290,20,14,401,1088580,20,1088560
69291,9,-9,655,358034,9,358025
69292,11,4,261,775084,11,775073
69293,9,-3,192,534514,9,534505
69294,14,-20,352,25555,14,25541
69295,15,12,451,1025355,15,1025340
69296,10,-14,148,189696,10,189686
69297,7,6,450,822590,7,822583
69298,19,13,460,1056650,19,1056631
69299,12,10,320,962265,12,962253
69300,7,0,376,633449,7,633442
69301,13,15,843,1122940,13,1122927
69302,13,19,874,1247861,13,1247848
69303,17,-4,487,525718,17,525701
69304,8,-7,134,408638,8,408630
69305,9,-5,430,477297,9,477288
69306,11,-19,808,60222,11,60211
69307,18,-1,101,617349,18,617331
69308,13,-3,598,558503,13,558490
69309,15,19,303,1243188,15,1243173
69310,17,16,433,1150258,17,1150241
69311,14,13,122,1054134,14,1054120
69312,18,4,830,779422,18,779404
69313,7,9,909,926075,7,926068
69314,7,3,546,730303,7,730296
69315,19,2,209,712166,19,712147
69316,17,1,865,686551,17,686534
69317,15,13,547,1057361,15,1057346
69318,13,14,334,1088070,13,1088057
69319,10,3,42,719726,10,719716
69320,12,5,137,804772,12,804760
69321,14,-10,978,342466,14,342452
69322,10,-2,254,568234,10,568224
69323,12,-20,678,28018,12,28006
69324,11,-11,441,307283,11,307272
69325,15,-19,144,55152,15,55137
69326,13,-15,414,180825,13,180812
69327,6,-13,51,219483,6,219477
69328,6,-10,443,322228,6,322222
69329,10,-20,490,10497,10,10487
69330,13,4,162,774445,13,774432
69331,20,2,449,714003,20,713983
69332,7,15,55,1095664,7,1095657
69333,9,-16,839,141983,9,141974
69334,10,8,994,896800,10,896790
69335,9,-18,979,83753,9,83744
69336,16,-20,441,26160,16,26144
69337,14,-10,688,340306,14,340292
69338,10,16,55,1126313,10,1126303
69339,9,-9,772,360848,9,360839
69340,5,-3,847,549340,5,549335
69341,13,-14,797,215776,13,215763
69342,11,-7,826,434288,11,434277
69343,6,-13,701,233200,6,233194
69344,7,-10,455,322500,7,322493
69345,6,12,678,1014028,6,1014022
69346,13,-15,109,178588,13,178575
69347,5,-10,795,329597,5,329592
69348,5,2,639,702125,5,702120
69349,9,-6,472,446899,9,446890
69350,10,-16,599,137075,10,137065
69351,16,-15,984,185252,16,185236
69352,14,-9,177,367795,14,367781
69353,10,-10,793,329527,10,329517
69354,7,16,156,1128389,7,1128382
69355,16,3,862,748346,16,748330
69356,19,9,859,935444,19,935425
69357,6,-7,408,414747,6,414741
69358,20,-11,958,311226,20,311206
69359,18,-16,426,150073,18,150055
69360,8,-7,276,411720,8,411712
69361,9,8,339,882644,9,882635
69362,9,-8,423,384077,9,384068
69363,10,-15,957,175899,10,175889
69364,11,-5,719,496292,11,496281
69365,17,12,686,1027244,17,1027227
69366,11,-9,182,367844,11,367833
69367,17,-2,75,585704,17,585687
69368,19,-8,411,400799,19,400780
69369,6,17,540,1166867,6,1166861
69370,8,14,449,1071805,8,1071797
69371,6,13,141,1033673,6,1033667
69372,12,-17,755,121241,12,121229
69373,16,-5,97,491673,16,491657
69374,12,14,594,1090021,12,1090009
69375,19,-13,695,246063,19,246044
69376,8,5,751,797325,8,797317
69377,11,-18,554,89299,11,89288
69378,18,5,330,806207,18,806189
69379,17,0,651,653233,17,653216
69380,17,-7,976,435551,17,435534
69381,13,5,860,810026,13,810013
69382,16,-13,557,245143,16,245127
69383,12,-4,818,528096,12,528084
69384,9,6,590,825632,9,825623
69385,9,-16,641,137918,9,137909
69386,16,-9,465,370272,16,370256
69387,12,-19,144,55154,12,55142
69388,14,1,668,685115,14,685101
69389,19,-16,863,153297,19,153278
69390,11,14,177,1086833,11,1086822
69391,18,-12,339,275032,18,275014
69392,7,-2,800,579817,7,579810
69393,18,-19,826,60327,18,60309
69394,11,-18,927,91964,11,91953
69395,11,-13,740,246493,11,246482
69396,9,-2,561,574697,9,574688
69397,11,-13,827,247145,11,247134
69398,16,-18,459,88737,16,88721
69399,5,4,189,754656,5,754651
69400,16,15,521,1120561,16,1120545
69401,11,-20,587,27263,11,27252
69402,5,-11,584,294156,5,294151
69403,6,13,550,1042556,6,1042550
69404,16,16,570,1151136,16,1151120
69405,12,-19,103,54740,12,54728
69406,7,8,858,893802,7,893795
69407,13,-1,171,617835,13,617822
69408,7,-4,910,518979,7,518972
69409,10,0,998,647165,10,647155
69410,11,-18,543,89244,11,89233
69411,9,17,460,1165194,9,1165185
69412,14,13,637,1058070,14,1058056
69413,18,-20,280,24972,18,24954
69414,14,-20,621,27504,14,27490
69415,6,-19,18,31888,6,31882
69416,11,-1,826,622888,11,622877
69417,15,4,633,777885,15,777870
69418,20,-11,635,308771,20,308751
69419,8,5,10,781830,8,781822
69420,8,6,229,817360,8,817352
69421,14,-10,659,340036,14,340022
69422,12,-11,624,308702,12,308690
69423,10,-9,926,364408,10,364398
69424,16,-18,322,87757,16,87741
69425,13,-20,402,25878,13,25865
69426,8,3,726,734619,8,734611
69427,19,10,394,962793,19,962774
69428,15,-9,454,370185,15,370170
69429,13,12,570,1026217,13,1026204
69430,15,1,63,680235,15,680220
69431,15,-20,972,30181,15,30166
69432,16,5,556,807818,16,807802
69433,12,-17,889,122112,12,122100
69434,6,-5,818,485610,6,485604
69435,19,6,520,840022,19,840003
69436,17,0,964,655653,17,655636
69437,11,-8,687,402770,11,402759
69438,6,1,703,672305,6,672299
69439,10,-10,824,330282,10,330272
69440,5,11,754,984602,5,984597
69441,18,8,735,903801,18,903783
69442,17,8,989,905627,17,905610
69443,8,16,322,1132016,8,1132008
69444,11,-19,547,58248,11,58237
69445,6,6,169,815853,6,815847
69446,20,19,257,1242797,20,1242777
69447,10,15,27,1095086,10,1095076
69448,5,-16,811,141431,5,141426
69449,18,6,714,841572,18,841554
69450,10,-15,73,156912,10,156902
69451,13,-18,117,86090,13,86077
69452,16,-1,12,616580,16,616564
69453,10,4,30,751189,10,751179
69454,17,8,156,899197,17,899180
69455,10,12,140,1002172,10,1002162
69456,17,-15,764,183462,17,183445
69457,16,-19,362,56815,16,56799
69458,19,-9,849,373270,19,373251
69459,10,-2,545,574297,10,574287
69460,20,-11,352,306564,20,306544
69461,18,-2,973,592563,18,592545
69462,5,11,977,989404,5,989399
69463,20,17,599,1182322,20,1182302
69464,19,16,906,1153581,19,1153562
69465,19,-17,389,118369,19,118350
69466,8,-7,503,416611,8,416603
69467,5,10,797,954834,5,954829
69468,19,11,722,996030,19,996011
69469,6,10,3,937572,6,937566
69470,20,13,929,1060136,20,1060116
69471,14,3,58,742284,14,742270
69472,6,5,751,797331,6,797325
69473,20,2,111,711407,20,711387
69474,8,13,841,1048875,8,1048867
69475,19,12,875,1028652,19,1028633
69476,16,-6,649,464101,16,464085
69477,14,3,99,742536,14,742522
69478,15,-5,671,495888,15,495873
69479,20,9,933,936032,20,936012
69480,17,6,351,838501,17,838484
69481,16,-16,42,147058,16,147042
69482,17,19,849,1247632,17,1247615
69483,9,3,755,735178,9,735169
69484,18,17,341,1180537,18,1180519
69485,18,-6,718,464634,18,464616
69486,16,13,786,1059121,16,1059105
69487,5,-4,615,512694,5,512689
69488,12,-7,289,430507,12,430495
69489,14,-13,494,244650,14,244636
69490,6,13,660,1045023,6,1045017
69491,5,-11,600,294443,5,294438
69492,15,-13,210,242566,15,242551
69493,5,4,408,759466,5,759461
69494,16,-13,54,241496,16,241480
69495,19,19,705,1246501,19,1246482
69496,20,13,771,1059025,20,1059005
69497,20,11,483,994391,20,994371
69498,8,17,792,1172282,8,1172274
69499,17,-8,525,401535,17,401518
69500,7,19,88,1219480,7,1219473
69501,13,-10,365,337666,13,337653
69502,16,-9,819,373035,16,373019
69503,5,6,841,831267,5,831262
69504,7,8,33,875798,7,875791
69505,7,2,101,690826,7,690819
69506,13,-1,751,622350,13,622337
69507,15,-7,431,431564,15,431549
69508,16,7,646,871755,16,871739
69509,13,-17,795,121503,13,121490
69510,19,-10,664,340126,19,340107
69511,16,-5,391,493891,16,493875
69512,14,19,50,1241112,14,1241098
69513,20,16,167,1148289,20,1148269
69514,15,-11,906,310835,15,310820
69515,20,-5,717,496284,20,496264
69516,15,-1,71,617128,15,617113
69517,5,-6,79,438392,5,438387
69518,13,14,635,1090381,13,1090368
69519,13,12,473,1025526,13,1025513
69520,12,-7,293,430546,12,430534
69521,19,1,797,686083,19,686064
69522,11,-16,967,154056,11,154045
69523,12,-5,655,495791,12,495779
69524,7,9,303,913086,7,913079
69525,16,15,895,1123319,16,1123303
69526,13,-8,466,401080,13,401067
69527,9,-16,941,144248,9,144239
69528,12,0,392,651058,12,651046
69529,10,8,569,887702,10,887692
69530,18,-1,854,623089,18,623071
69531,8,4,714,766036,8,766028
69532,8,-18,770,79134,8,79126
69533,7,11,84,970260,7,970253
69534,20,-5,522,494920,20,494900
69535,6,-9,640,357764,6,357758
69536,8,-7,129,408540,8,408532
69537,13,15,601,1121180,13,1121167
69538,20,8,869,904699,20,904679
69539,19,-5,661,495829,19,495810
69540,10,-9,140,346575,10,346565
69541,8,-17,649,107466,8,107458
69542,12,-17,68,116004,12,115992
69543,6,19,821,1235640,6,1235634
69544,16,-17,6,115602,16,115586
69545,18,-3,43,554115,18,554097
69546,11,8,110,898798,11,898787
69547,12,13,174,1054481,12,1054469
69548,20,-14,901,216522,20,216502
69549,7,3,417,727751,7,727744
69550,18,0,70,648759,18,648741
69551,9,-13,959,239161,9,239152
69552,19,9,367,931738,19,931719
69553,17,15,804,1122655,17,1122638
69554,10,-13,577,230678,10,230668
69555,6,14,795,1079747,6,1079741
69556,16,17,821,1184111,16,1184095
69557,8,4,586,763220,8,763212
69558,11,12,333,1024574,11,1024563
69559,5,-8,270,381166,5,381161
69560,18,16,17,1147218,18,1147200
69561,11,-10,978,342467,11,342456
69562,17,4,697,778342,17,778325
69563,16,-7,964,435451,16,435435
69564,9,-13,680,232677,9,232668
69565,15,-5,154,492162,15,492147
69566,15,7,837,873069,15,873054
69567,19,18,401,1212018,19,1211999
69568,10,7,950,864851,10,864841
69569,12,13,642,1058098,12,1058086
69570,10,-18,221,67240,10,67230
69571,16,-20,479,26387,16,26371
69572,9,3,423,727892,9,727883
69573,14,4,282,775212,14,775198
69574,6,-11,934,301149,6,301143
69575,11,-14,576,214073,11,214062
69576,9,3,738,734845,9,734836
69577,11,-8,997,405013,11,405002
69578,7,18,944,1206702,7,1206695
69579,20,-9,955,374096,20,374076
69580,20,19,414,1244248,20,1244228
69581,15,18,515,1212761,15,1212746
69582,15,-12,492,276142,15,276127
69583,11,-9,241,368336,11,368325
69584,17,-1,119,617471,17,617454
69585,11,-9,14,366729,11,366718
69586,17,10,681,965189,17,965172
69587,13,19,420,1244325,13,1244312
69588,9,10,318,944314,9,944305
69589,7,-7,909,425315,7,425308
69590,14,11,485,994405,14,994391
69591,10,-4,375,507790,10,507780
69592,20,18,135,1210040,20,1210020
69593,16,-1,352,619409,16,619393
69594,7,8,935,895536,7,895529
69595,8,13,531,1042027,8,1042019
69596,5,8,40,875950,5,875945
69597,8,-18,961,83360,8,83352
69598,12,9,128,930034,12,930022
69599,15,19,503,1244926,15,1244911
69600,19,8,697,903517,19,903498
69601,7,0,115,627947,7,627940
69602,16,-7,513,432199,16,432183
69603,18,8,882,904786,18,904768
69604,9,10,905,956935,9,956926
69605,16,-16,176,148201,16,148185
69606,20,4,560,777314,20,777294
69607,8,-16,899,143258,8,143250
69608,18,-2,184,586436,18,586418
69609,15,15,110,1117610,15,1117595
69610,13,-2,76,585706,13,585693
69611,13,-10,861,341546,13,341533
69612,10,-14,155,189870,10,189860
69613,15,-12,377,275315,15,275300
69614,7,3,536,730036,7,730029
69615,19,-13,854,247403,19,247384
69616,8,-14,786,203822,8,203814
69617,5,3,146,721987,5,721982
69618,11,-14,322,211896,11,211885
69619,6,-5,47,468899,6,468893
69620,5,15,934,1114354,5,1114349
69621,9,16,885,1143491,9,1143482
69622,6,-3,498,541657,6,541651
69623,14,15,633,1121432,14,1121418
69624,16,16,121,1147909,16,1147893
69625,20,2,66,711035,20,711015
69626,17,-12,535,276525,17,276508
69627,16,-14,229,211202,16,211186
69628,6,3,473,728956,6,728950
69629,14,-18,277,87401,14,87387
69630,15,4,457,776533,15,776518
69631,13,-18,878,91582,13,91569
69632,9,18,498,1197360,9,1197351
69633,19,-12,658,277381,19,277362
69634,19,11,849,997034,19,997015
69635,20,-9,380,369503,20,369483
69636,15,0,369,650853,15,650838
69637,9,-14,211,191227,9,191218
69638,13,0,336,650556,13,650543
69639,7,4,852,769479,7,769472
69640,6,8,287,881497,6,881491
69641,5,-5,558,480115,5,480110
69642,14,0,380,650981,14,650967
69643,18,-1,350,619381,18,619363
69644,19,18,869,1215295,19,1215276
69645,17,13,285,1055296,17,1055279
69646,15,-15,918,184762,15,184747
69647,11,18,184,1210471,11,1210460
69648,20,12,323,1024495,20,1024475
69649,18,9,33,929309,18,929291
69650,12,19,564,1245386,12,1245374
69651,18,-18,100,85995,18,85977
69652,5,0,175,629335,5,629330
69653,18,-17,58,115958,18,115940
69654,17,4,745,778751,17,778734
69655,5,-18,431,71682,5,71677
69656,6,16,260,1130745,6,1130739
69657,5,-14,75,188218,5,188213
69658,10,-9,775,360887,10,360877
69659,17,-17,696,120726,17,120709
69660,6,3,329,726067,6,726061
69661,8,-20,994,22004,8,21996
69662,13,2,472,714187,13,714174
69663,18,2,20,710625,18,710607
69664,20,-12,206,273958,20,273938
69665,8,12,574,1011355,8,1011347
69666,20,-19,428,57284,20,57264
69667,19,6,412,839096,19,839077
69668,19,7,502,870728,19,870709
69669,17,1,781,685935,17,685918
69670,11,9,790,934904,11,934893
69671,10,-11,132,284012,10,284002
69672,6,18,630,1200080,6,1200074
69673,13,14,545,1089738,13,1089725
69674,11,13,17,1053368,11,1053357
69675,20,-6,660,464170,20,464150
69676,14,-16,807,152835,14,152821
69677,20,-19,748,59891,20,59871
69678,6,-16,422,133131,6,133125
69679,20,16,266,1149032,20,1149012
69680,18,7,836,873061,18,873043
69681,9,18,534,1198278,9,1198269
69682,10,-11,319,288176,10,288166
69683,18,-3,701,559364,18,559346
69684,14,2,669,715628,14,715614
69685,16,19,509,1244987,16,1244971
69686,6,-3,552,542913,6,542907
69687,6,-6,907,456165,6,456159
69688,11,-18,51,85581,11,85570
69689,14,-11,945,311087,14,311073
69690,5,-1,25,594234,5,594229
69691,16,-11,247,305641,16,305625
69692,15,12,922,1029160,15,1029145
69693,18,14,323,1087977,18,1087959
69694,11,7,864,873263,11,873252
69695,5,-20,311,7019,5,7014
69696,11,14,319,1087928,11,1087917
69697,18,-8,617,402201,18,402183
69698,6,3,560,730616,6,730610
69699,9,-15,583,168007,9,167998
69700,12,-5,180,492320,12,492308
69701,10,-16,456,134043,10,134033
69702,5,-16,51,124909,5,124904
69703,5,-9,687,358695,5,358690
69704,17,-2,581,589517,17,589500
69705,20,-19,685,59338,20,59318
69706,15,8,382,900963,15,900948
69707,15,18,399,1212001,15,1211986
69708,11,-10,341,337527,11,337516
69709,7,14,109,1064297,7,1064290
69710,12,13,923,1060073,12,1060061
69711,7,13,473,1040860,7,1040853
69712,10,10,174,941316,10,941306
69713,12,-17,318,117855,12,117843
69714,15,-4,14,522149,15,522134
69715,17,2,499,714398,17,714381
69716,15,3,651,746765,15,746750
69717,20,-16,873,153409,20,153389
69718,6,18,163,1190372,6,1190366
69719,12,-5,310,493369,12,493357
69720,8,19,297,1224124,8,1224116
69721,12,7,72,867540,12,867528
69722,9,-15,314,162174,9,162165
69723,18,-19,476,57633,18,57615
69724,9,-1,319,601004,9,600995
69725,5,-16,911,143631,5,143626
69726,15,-20,586,27257,15,27242
69727,6,7,756,860740,6,860734
69728,9,16,0,1125159,9,1125150
69729,12,2,913,717275,12,717263
69730,5,-9,253,349137,5,349132
69731,10,10,367,945353,10,945343
69732,20,-6,289,461436,20,461416
69733,12,-12,567,276708,12,276696
69734,8,3,724,734583,8,734575
69735,6,19,167,1221186,6,1221180
69736,18,1,379,682895,18,682877
69737,7,13,809,1048222,7,1048215
69738,11,-4,939,529095,11,529084
69739,17,-11,983,311399,17,311382
69740,10,-20,273,6048,10,6038
69741,19,3,96,742525,19,742506
69742,10,-4,169,503102,10,503092
69743,6,-9,975,365237,6,365231
69744,15,-17,518,119403,15,119388
69745,5,14,931,1082661,5,1082656
69746,18,8,675,903323,18,903305
69747,6,12,314,1006077,6,1006071
69748,19,6,474,839569,19,839550
69749,13,14,428,1088823,13,1088810
69750,6,-5,44,468826,6,468820
69751,17,-16,960,154019,17,154002
69752,14,8,93,898639,14,898625
69753,9,-13,115,220886,9,220877
69754,14,-14,42,209640,14,209626
69755,8,17,631,1168806,8,1168798
69756,7,3,536,730043,7,730036
69757,20,-1,223,618322,20,618302
69758,19,-9,353,369287,19,369268
69759,9,-11,439,290938,9,290929
69760,19,-3,23,553981,19,553962
69761,14,9,768,934680,14,934666
69762,14,-4,376,525032,14,525018
69763,17,0,3,648203,17,648186
69764,5,-15,437,164891,5,164886
69765,5,14,771,1079230,5,1079225
69766,13,-9,162,367735,13,367722
69767,10,4,921,770841,10,770831
69768,19,-12,24,272687,19,272668
69769,11,11,426,993976,11,993965
69770,6,0,973,646511,6,646505
69771,6,8,213,879815,6,879809
69772,18,14,873,1092267,18,1092249
69773,14,-16,146,147999,14,147985
69774,11,0,170,649526,11,649515
69775,10,6,649,826947,10,826937
69776,15,11,250,992630,15,992615
69777,19,-9,758,372529,19,372510
69778,6,13,759,1047027,6,1047021
69779,6,11,764,984845,6,984839
69780,19,4,708,778461,19,778442
69781,12,-16,224,148625,12,148613
69782,16,14,481,1089210,16,1089194
69783,11,6,782,842020,11,842009
69784,18,-17,275,117517,18,117499
69785,7,3,994,740654,7,740647
69786,15,-7,360,431106,15,431091
69787,10,5,365,789138,10,789128
69788,8,16,242,1130343,8,1130335
69789,18,15,917,1123494,18,1123476
69790,14,19,669,1246194,14,1246180
69791,10,-6,252,442345,10,442335
69792,13,-4,754,527671,13,527658
69793,12,13,968,1060412,12,1060400
69794,6,-12,266,255277,6,255271
69795,6,-20,153,3390,6,3384
69796,6,-18,379,70575,6,70569
69797,20,7,45,867386,20,867366
69798,5,15,602,1107258,5,1107253
69799,7,-5,208,472549,7,472542
69800,15,-8,732,403072,15,403057
69801,17,8,91,898624,17,898607
69802,8,7,759,860854,8,860846
69803,20,9,803,935025,20,935005
69804,5,-10,644,326535,5,326530
69805,19,-13,137,241998,19,241979
69806,11,11,491,994435,11,994424
69807,10,-5,793,485048,10,485038
69808,10,9,55,907952,10,907942
69809,20,-17,756,121259,20,121239
69810,8,-9,482,354493,8,354485
69811,13,17,600,1182336,13,1182323
69812,12,10,775,965826,12,965814
69813,12,10,565,964227,12,964215
69814,16,-11,994,311462,16,311446
69815,9,-18,227,67418,9,67409
69816,5,-1,398,602710,5,602705
69817,17,11,869,997183,17,997166
69818,10,-6,708,452056,10,452046
69819,10,-4,124,502088,10,502078
69820,12,11,965,997787,12,997775
69821,16,-15,675,182800,16,182784
69822,7,5,871,799934,7,799927
69823,20,-15,526,181618,20,181598
69824,15,2,871,717000,15,716985
69825,15,10,628,964770,15,964755
69826,20,-7,38,428619,20,428599
69827,9,19,49,1218457,9,1218448
69828,20,12,770,1027773,20,1027753
69829,16,5,416,806785,16,806769
69830,20,-8,812,403706,20,403686
69831,9,-17,36,94350,9,94341
69832,8,-18,43,63275,8,63267
69833,8,-9,492,354809,8,354801
69834,16,-7,322,430805,16,430789
69835,17,-12,829,278616,17,278599
69836,8,-15,870,173970,8,173962
69837,19,4,749,778785,19,778766
69838,13,19,433,1244418,13,1244405
69839,9,11,536,979927,9,979918
69840,20,-8,477,401152,20,401132
69841,8,1,693,672147,8,672139
69842,17,6,956,843356,17,843339
69843,14,-17,683,120642,14,120628
69844,8,-15,590,168125,8,168117
69845,15,3,327,744370,15,744355
69846,13,-13,369,243740,13,243727
69847,19,-2,89,585811,19,585792
69848,14,17,77,1178452,14,1178438
69849,12,6,256,837706,12,837694
69850,17,-8,475,401137,17,401120
69851,18,13,582,1057696,18,1057678
69852,14,-14,797,215780,14,215766
69853,13,3,69,742351,13,742338
69854,9,16,318,1131907,9,1131898
69855,11,12,792,1027955,11,1027944
69856,13,-9,250,368422,13,368409
69857,7,9,190,910739,7,910732
69858,18,1,111,680694,18,680676
69859,10,8,659,889553,10,889543
69860,14,19,572,1245455,14,1245441
69861,6,14,831,1080531,6,1080525
69862,20,-17,899,122176,20,122156
69863,11,9,570,933248,11,933237
69864,5,0,531,636813,5,636808
69865,16,-17,206,116979,16,116963
69866,5,-13,533,229630,5,229625
69867,17,8,956,905376,17,905359
69868,8,-10,692,327611,8,327603
69869,13,19,119,1241750,13,1241737
69870,10,-11,285,287260,10,287250
69871,7,12,51,1000217,7,1000210
69872,18,-2,947,592368,18,592350
69873,6,7,714,859877,6,859871
69874,15,19,79,1241432,15,1241417
69875,19,-5,235,492728,19,492709
69876,16,17,158,1179035,16,1179019
69877,6,-11,488,292069,6,292063
69878,17,-5,292,493238,17,493221
69879,17,-2,118,586013,17,585996
69880,15,15,86,1117434,15,1117419
69881,9,19,825,1235765,9,1235756
69882,17,-11,682,309148,17,309131
69883,15,-7,582,432713,15,432698
69884,6,-8,126,378039,6,378033
69885,12,10,765,965740,12,965728
69886,6,-19,127,34418,6,34412
69887,15,9,204,930562,15,930547
69888,7,-8,531,386545,7,386538
69889,10,-14,675,201530,10,201520
69890,10,-15,22,155823,10,155813
69891,11,-17,23,115733,11,115722
69892,6,-1,281,600035,6,600029
69893,7,0,345,632681,7,632674
69894,16,12,816,1028115,16,1028099
69895,12,19,551,1245292,12,1245280
69896,12,-14,844,216084,12,216072
69897,16,-8,322,400173,16,400157
69898,18,7,103,867766,18,867748
69899,19,-5,391,493900,19,493881
69900,7,1,999,678700,7,678693
69901,11,14,964,1092966,11,1092955
69902,12,-3,12,553935,12,553923
69903,7,-3,229,535308,7,535301
69904,8,-3,423,539835,8,539827
69905,10,3,81,720556,10,720546
69906,5,-3,107,532716,5,532711
69907,5,16,168,1128681,5,1128676
69908,19,-11,705,309251,19,309232
69909,7,13,751,1046863,7,1046856
69910,16,-17,261,117401,16,117385
69911,19,17,584,1182177,19,1182158
69912,5,8,543,887085,5,887080
69913,9,15,722,1109834,9,1109825
69914,6,15,843,1112410,6,1112404
69915,17,-1,647,621556,17,621539
69916,16,-13,490,244631,16,244615
69917,7,10,696,952521,7,952514
69918,16,2,340,713176,16,713160
69919,15,-3,958,561476,15,561461
69920,14,17,587,1182212,14,1182198
69921,13,-4,579,526461,13,526448
69922,6,-13,12,218534,6,218528
69923,12,6,872,842725,12,842713
69924,6,9,281,912544,6,912538
69925,13,-5,799,496786,13,496773
69926,19,8,550,902290,19,902271
69927,16,15,633,1121438,16,1121422
69928,7,14,231,1066936,7,1066929
69929,18,-20,209,24437,18,24419
69930,13,-1,437,620011,13,619998
69931,19,-6,402,462186,19,462167
69932,6,-11,103,283360,6,283354
69933,6,12,130,1001958,6,1001952
69934,16,16,177,1148387,16,1148371
69935,10,-1,15,594039,10,594029
69936,5,-19,195,35898,5,35893
69937,15,-4,61,522508,15,522493
69938,10,1,228,662189,10,662179
69939,12,-17,12,115654,12,115642
69940,11,-13,174,242299,11,242288
69941,7,2,563,700512,7,700505
69942,6,2,35,689363,6,689357
69943,18,-5,439,494255,18,494237
69944,16,-7,535,432395,16,432379
69945,7,-3,343,537970,7,537963
69946,5,8,805,892843,5,892838
69947,10,1,149,660470,10,660460
69948,12,3,924,748836,12,748824
69949,12,10,739,965554,12,965542
69950,17,-19,52,54263,17,54246
69951,13,0,921,655265,13,655252
69952,16,11,114,991665,16,991649
69953,13,9,525,932911,13,932898
69954,11,0,20,648363,11,648352
69955,7,-5,628,481618,7,481611
69956,5,19,541,1229758,5,1229753
69957,6,-1,694,608845,6,608839
69958,20,-11,635,308781,20,308761
69959,6,-14,977,207828,6,207822
69960,10,-4,509,510501,10,510491
69961,13,3,141,742897,13,742884
69962,15,14,353,1088172,15,1088157
69963,7,-7,548,417659,7,417652
69964,15,-14,944,216822,15,216807
69965,11,12,325,1024500,11,1024489
69966,15,-8,773,403374,15,403359
69967,18,-2,5,585152,18,585134
69968,13,-18,568,89359,13,89346
69969,17,-5,444,494289,17,494272
69970,12,-5,779,496643,12,496631
69971,12,1,142,680975,12,680963
69972,7,13,416,1039757,7,1039750
69973,16,17,714,1183222,16,1183206
69974,7,-13,702,233248,7,233241
69975,17,-7,849,434515,17,434498
69976,9,14,379,1070175,9,1070166
69977,12,19,669,1246196,12,1246184
69978,13,-10,679,340209,13,340196
69979,7,12,844,1017552,7,1017545
69980,7,-2,837,580735,7,580728
69981,12,4,168,774491,12,774479
69982,20,2,510,714482,20,714462
69983,16,17,153,1178976,16,1178960
69984,5,-12,767,266133,5,266128
69985,7,-11,20,281503,7,281496
69986,16,14,493,1089303,16,1089287
69987,14,-9,708,372013,14,371999
69988,9,0,99,627603,9,627594
69989,9,2,979,709120,9,709111
69990,18,4,646,777977,18,777959
69991,10,5,443,790786,10,790776
69992,8,-19,95,33520,8,33512
69993,9,16,261,1130763,9,1130754
69994,5,11,293,974628,5,974623
69995,12,3,517,745647,12,745635
69996,11,4,247,775050,11,775039
69997,14,-5,932,497900,14,497886
69998,10,-4,391,508144,10,508134
69999,11,13,396,1056183,11,1056172
70000,19,-8,8,397931,19,397912
70001,17,-16,767,152546,17,152529
70002,10,0,59,626549,10,626539
70003,9,-4,387,508011,9,508002
70004,14,-17,113,116406,14,116392
70005,12,5,864,810066,12,810054
70006,6,-10,211,317214,6,317208
70007,15,6,595,840601,15,840586
70008,9,-1,161,597167,9,597158
70009,10,-6,885,455695,10,455685
70010,15,12,912,1029037,15,1029022
70011,14,16,774,1152573,14,1152559
70012,19,14,582,1089941,19,1089922
70013,16,-16,210,148491,16,148475
70014,14,-19,889,60788,14,60774
70015,16,12,997,1029804,16,1029788
70016,18,-4,869,528531,18,528513
70017,5,10,797,954839,5,954834
70018,7,-6,988,457898,7,457891
70019,16,15,177,1118132,16,1118116
70020,14,-3,672,559159,14,559145
70021,18,-20,627,27541,18,27523
70022,5,16,178,1128921,5,1128916
70023,9,-11,577,293952,9,293943
70024,16,-3,452,557265,16,557249
70025,10,16,788,1141467,10,1141457
70026,20,18,516,1212771,20,1212751
70027,8,9,568,918739,8,918731
70028,16,3,928,748894,16,748878
70029,7,-20,669,14771,7,14764
70030,13,-12,809,278418,13,278405
70031,5,-19,338,38856,5,38851
70032,18,1,698,685277,18,685259
70033,16,4,329,775596,16,775580
70034,5,18,256,1192454,5,1192449
70035,13,-5,654,495790,13,495777
70036,17,0,687,653532,17,653515
70037,19,-7,680,433243,19,433224
70038,17,4,284,775241,17,775224
70039,13,2,279,712628,13,712615
70040,17,-10,943,342192,17,342175
70041,9,8,190,879219,9,879210
70042,16,-17,53,115939,16,115923
70043,16,-16,622,151622,16,151606
70044,9,-19,513,42594,9,42585
70045,11,-14,878,216358,11,216347
70046,18,12,639,1026804,18,1026786
70047,5,18,626,1199988,5,1199983
70048,19,1,88,680458,19,680439
70049,17,19,678,1246252,17,1246235
70050,13,-1,402,619760,13,619747
70051,6,3,935,739133,6,739127
70052,18,15,670,1121712,18,1121694
70053,10,-7,539,417426,10,417416
70054,20,-19,283,56234,20,56214
70055,17,-18,341,87870,17,87853
70056,18,19,829,1247470,18,1247452
70057,15,-6,91,459758,15,459743
70058,20,13,377,1056009,20,1055989
70059,19,-1,381,619613,19,619594
70060,20,19,156,1242029,20,1242009
70061,10,7,679,859220,10,859210
70062,8,-3,181,534308,8,534300
70063,9,-18,923,82480,9,82471
70064,7,18,917,1206107,7,1206100
70065,9,15,829,1112038,9,1112029
70066,8,-9,110,345904,8,345896
70067,6,-3,812,548597,6,548591
70068,5,-2,285,568894,5,568889
70069,18,8,854,904625,18,904607
70070,10,9,633,920235,10,920225
70071,13,-18,433,88509,13,88496
70072,8,-3,392,539035,8,539027
70073,11,-11,404,306953,11,306942
70074,16,16,971,1154083,16,1154067
70075,5,-4,732,515122,5,515117
70076,8,16,206,1129564,8,1129556
70077,16,-18,952,92131,16,92115
70078,9,10,868,956184,9,956175
70079,6,-10,451,322438,6,322432
70080,9,-13,215,222895,9,222886
70081,18,-11,219,305429,18,305411
70082,16,-9,569,371228,16,371212
70083,5,-17,841,111292,5,111287
70084,14,-2,43,585477,14,585463
70085,17,-19,278,56196,17,56179
70086,9,-19,827,49522,9,49513
70087,9,-11,650,295457,9,295448
70088,15,-8,223,399502,15,399487
70089,13,-18,854,91403,13,91390
70090,9,-10,145,315837,9,315828
70091,17,7,787,872721,17,872704
70092,20,10,812,966179,20,966159
70093,18,2,698,715894,18,715876
70094,19,-1,628,621425,19,621406
70095,15,3,410,744950,15,744935
70096,10,-15,335,162697,10,162687
70097,13,-11,829,310182,13,310169
70098,19,9,266,930874,19,930855
70099,19,2,226,712298,19,712279
70100,12,9,217,930673,12,930661
70101,10,17,264,1160894,10,1160884
70102,6,11,736,984162,6,984156
70103,12,16,428,1150225,12,1150213
70104,7,-18,296,68957,7,68950
70105,14,-9,543,371004,14,370990
70106,9,2,887,707124,9,707115
70107,7,-2,850,580987,7,580980
70108,19,-7,367,431132,19,431113
70109,6,-11,676,296049,6,296043
70110,20,-16,312,149245,20,149225
70111,9,-5,494,478693,9,478684
70112,15,9,830,935218,15,935203
70113,8,13,701,1045812,8,1045804
70114,10,19,367,1225803,10,1225793
70115,9,-6,703,451926,9,451917
70116,5,3,658,732984,5,732979
70117,19,8,193,899458,19,899439
70118,11,15,139,1117853,11,1117842
70119,10,0,373,633407,10,633397
70120,16,-2,330,587585,16,587569
70121,7,17,172,1158905,7,1158898
70122,5,15,921,1114054,5,1114049
70123,5,-18,372,70372,5,70367
70124,15,-3,231,555390,15,555375
70125,11,10,414,963008,11,962997
70126,19,3,927,748864,19,748845
70127,11,-10,531,338997,11,338986
70128,8,11,240,973324,8,973316
70129,11,18,430,1212205,11,1212194
70130,11,-14,275,211578,11,211567
70131,17,-1,769,622467,17,622450
70132,11,17,83,1178470,11,1178459
70133,8,-4,880,518295,8,518287
70134,7,-12,915,269547,7,269540
70135,8,5,543,792924,8,792916
70136,11,-14,618,214371,11,214360
70137,6,-2,904,582162,6,582156
70138,20,1,336,682579,20,682559
70139,15,-6,569,463530,15,463515
70140,14,-4,616,526733,14,526719
70141,7,-15,305,162017,7,162010
70142,8,4,59,751813,8,751805
70143,15,-8,522,401513,15,401498
70144,16,-7,227,429998,16,429982
70145,15,-4,193,523556,15,523541
70146,15,16,187,1148460,15,1148445
70147,18,1,582,684493,18,684475
70148,17,-17,429,118628,17,118611
70149,15,16,571,1151140,15,1151125
70150,11,16,743,1152382,11,1152371
70151,17,-10,562,339286,17,339269
70152,12,-15,109,178590,12,178578
70153,13,-5,947,497997,13,497984
70154,7,6,879,832061,7,832054
70155,6,-4,704,514556,6,514550
70156,9,-4,4,499431,9,499422
70157,14,-2,488,588825,14,588811
70158,8,-4,143,502492,8,502484
70159,19,-15,612,182264,19,182245
70160,17,-14,986,217174,17,217157
70161,12,-9,857,373358,12,373346
70162,11,11,968,997789,11,997778
70163,9,9,126,909472,9,909463
70164,12,3,497,745545,12,745533
70165,13,-10,110,335912,13,335899
70166,6,-16,350,131476,6,131470
70167,9,8,706,890749,9,890740
70168,18,9,111,929859,18,929841
70169,19,-16,46,147103,19,147084
70170,15,-12,442,275715,15,275700
70171,14,6,633,840873,14,840859
70172,9,-13,335,225444,9,225435
70173,17,-2,318,587518,17,587501
70174,7,-16,905,143439,7,143432
70175,10,10,76,939147,10,939137
70176,16,-20,869,29492,16,29476
70177,7,-18,301,69086,7,69079
70178,10,19,808,1235431,10,1235421
70179,5,-1,478,604507,5,604502
70180,14,1,216,681591,14,681577
70181,19,17,306,1180296,19,1180277
70182,19,11,479,994354,19,994335
70183,14,-1,323,619119,14,619105
70184,18,8,509,902003,18,901985
70185,18,-20,763,28663,18,28645
70186,18,-15,207,179233,18,179215
70187,14,1,725,685508,14,685494
70188,14,3,167,743079,14,743065
70189,12,10,614,964648,12,964636
70190,13,15,638,1121455,13,1121442
70191,9,-8,917,394948,9,394939
70192,12,-2,11,585187,12,585175
70193,14,17,508,1181728,14,1181714
70194,15,15,647,1121522,15,1121507
70195,13,18,86,1209604,13,1209591
70196,12,0,114,649135,12,649123
70197,20,13,536,1057229,20,1057209
70198,14,13,646,1058108,14,1058094
70199,16,-2,809,591205,16,591189
70200,5,-12,276,255512,5,255507
70201,15,10,903,966729,15,966714
70202,9,10,937,957683,9,957674
70203,11,-2,879,591859,11,591848
70204,16,-16,672,151862,16,151846
70205,8,-7,733,421374,8,421366
70206,5,0,653,639671,5,639666
70207,9,-5,814,485547,9,485538
70208,7,-20,728,16029,7,16022
70209,8,-10,949,332842,8,332834
70210,16,1,310,682283,16,682267
70211,11,-19,697,59438,11,59427
70212,18,18,55,1209370,18,1209352
70213,20,1,295,682197,20,682177
70214,14,11,96,991576,14,991562
70215,12,7,431,870249,12,870237
70216,14,5,615,808344,14,808330
70217,7,-20,932,20541,7,20534
70218,5,8,854,893731,5,893726
70219,14,10,116,960800,14,960786
70220,19,-11,517,307867,19,307848
70221,6,13,524,1041911,6,1041905
70222,10,-14,152,189776,10,189766
70223,14,-5,374,493802,14,493788
70224,10,-15,570,167695,10,167685
70225,13,18,544,1212946,13,1212933
70226,15,13,99,1053954,15,1053939
70227,17,-14,775,215602,17,215585
70228,10,7,759,860864,10,860854
70229,7,-11,667,295846,7,295839
70230,12,-12,326,274979,12,274967
70231,15,6,340,838433,15,838418
70232,8,-1,552,606016,8,606008
70233,14,18,50,1209292,14,1209278
70234,5,1,855,675611,5,675606
70235,14,1,635,684879,14,684865
70236,17,12,809,1028047,17,1028030
70237,8,-13,561,230255,8,230247
70238,9,-10,637,326428,9,326419
70239,5,10,101,939822,5,939817
70240,19,-10,696,340352,19,340333
70241,12,-18,366,88053,12,88041
70242,8,7,186,848711,8,848703
70243,18,-18,623,89749,18,89731
70244,18,6,543,840151,18,840133
70245,12,-11,212,305375,12,305363
70246,10,-5,595,480959,10,480949
70247,10,-14,942,206953,10,206943
70248,6,-19,98,33638,6,33632
70249,17,-5,594,495435,17,495418
70250,18,16,556,1151045,18,1151027
70251,9,0,650,639583,9,639574
70252,6,9,741,922296,6,922290
70253,10,-13,585,230868,10,230858
70254,17,-1,683,621819,17,621802
70255,20,5,586,808058,20,808038
70256,14,-13,281,243197,14,243183
70257,8,15,428,1103478,8,1103470
70258,8,12,152,1002395,8,1002387
70259,12,-9,248,368413,12,368401
70260,13,-7,855,434550,13,434537
70261,14,-11,771,309771,14,309757
70262,16,17,360,1180669,16,1180653
70263,6,-1,577,606514,6,606508
70264,10,-11,340,288608,10,288598
70265,14,14,967,1092987,14,1092973
70266,9,5,815,798637,9,798628
70267,11,-1,338,619286,11,619275
70268,19,10,722,965424,19,965405
70269,5,0,401,634031,5,634026
70270,17,-16,801,152783,17,152766
70271,15,-10,940,342180,15,342165
70272,6,4,750,766943,6,766937
70273,19,18,966,1216088,19,1216069
70274,15,6,11,835848,15,835833
70275,6,-12,265,255252,6,255246
70276,17,18,419,1212150,17,1212133
70277,17,-2,206,586653,17,586636
70278,15,12,449,1025332,15,1025317
70279,14,10,86,960503,14,960489
70280,5,-2,278,568756,5,568751
70281,15,-16,274,148994,15,148979
70282,6,11,47,969472,6,969466
70283,6,-10,652,326689,6,326683
70284,17,9,166,930301,17,930284
70285,9,9,803,923829,9,923820
70286,5,-4,915,519070,5,519065
70287,8,7,893,863756,8,863748
70288,12,5,595,808117,12,808105
70289,5,7,213,849305,5,849300
70290,15,-15,45,178120,15,178105
70291,16,-20,364,25619,16,25603
70292,14,-18,601,89592,14,89578
70293,6,8,785,892480,6,892474
70294,13,-10,587,339445,13,339432
70295,11,-14,413,212793,11,212782
70296,7,14,177,1065717,7,1065710
70297,17,7,409,870068,17,870051
70298,20,-15,376,180571,20,180551
70299,20,-12,160,273727,20,273707
70300,5,9,137,909696,5,909691
70301,13,-10,398,337921,13,337908
70302,20,16,192,1148514,20,1148494
70303,6,-12,320,256591,6,256585
70304,9,17,245,1160493,9,1160484
70305,14,-6,30,459408,14,459394
70306,7,6,33,812940,7,812933
70307,19,-11,855,310431,19,310412
70308,17,-4,647,526938,17,526921
70309,20,1,534,684131,20,684111
70310,9,1,767,673710,9,673701
70311,9,-17,446,102952,9,102943
70312,15,2,545,714716,15,714701
70313,5,19,313,1224579,5,1224574
70314,6,13,511,1041728,6,1041722
70315,8,-3,704,546325,8,546317
70316,8,3,813,736321,8,736313
70317,9,19,297,1224133,9,1224124
70318,20,2,665,715569,20,715549
70319,7,18,762,1202805,7,1202798
70320,9,-14,975,207801,9,207792
70321,8,1,215,661932,8,661924
70322,16,-18,173,86639,16,86623
70323,10,3,858,737403,10,737393
70324,11,11,567,994914,11,994903
70325,14,10,363,962565,14,962551
70326,20,0,485,651827,20,651807
70327,13,0,884,654996,13,654983
70328,9,8,168,878775,9,878766
70329,16,-16,367,149607,16,149591
70330,18,1,70,680310,18,680292
70331,20,12,779,1027841,20,1027821
70332,14,-4,36,522308,14,522294
70333,12,13,440,1056541,12,1056529
70334,17,5,318,806083,17,806066
70335,5,7,803,861790,5,861785
70336,20,14,747,1091299,20,1091279
70337,6,0,847,643738,6,643732
70338,12,-13,826,247140,12,247128
70339,16,12,650,1026891,16,1026875
70340,19,9,477,932486,19,932467
70341,9,-8,62,376779,9,376770
70342,13,-20,839,29319,13,29306
70343,10,7,462,854711,10,854701
70344,8,16,798,1141735,8,1141727
70345,10,7,341,852202,10,852192
70346,17,3,367,744633,17,744616
70347,13,-14,350,212132,13,212119
70348,12,17,284,1180059,12,1180047
70349,5,-9,535,355788,5,355783
70350,18,6,300,838070,18,838052
70351,10,10,162,941086,10,941076
70352,19,-8,503,401352,19,401333
70353,19,-12,555,276627,19,276608
70354,6,11,328,975452,6,975446
70355,18,2,547,714732,18,714714
70356,6,11,871,987226,6,987220
70357,18,-2,266,587134,18,587116
70358,13,2,614,715151,13,715138
70359,11,-12,182,273816,11,273805
70360,7,6,926,833044,7,833037
70361,11,-10,978,342468,11,342457
70362,8,10,876,956344,8,956336
70363,10,15,314,1101238,10,1101228
70364,15,-5,724,496329,15,496314
70365,15,12,893,1028809,15,1028794
70366,14,12,2,1022125,14,1022111
70367,8,15,619,1107613,8,1107605
70368,11,13,963,1060371,11,1060360
70369,16,5,475,807305,16,807289
70370,9,-7,214,410434,9,410425
70371,16,18,238,1210890,16,1210874
70372,20,7,312,869283,20,869263
70373,8,-13,756,234566,8,234558
70374,18,8,585,902546,18,902528
70375,8,5,663,795326,8,795318
70376,15,2,199,712106,15,712091
70377,8,-12,978,270954,8,270946
70378,15,-19,963,61230,15,61215
70379,15,-18,425,88487,15,88472
70380,19,-16,236,148724,19,148705
70381,10,-7,262,411377,10,411367
70382,13,-10,805,341187,13,341174
70383,14,-20,424,25968,14,25954
70384,17,2,471,714177,17,714160
70385,14,0,415,651277,14,651263
70386,16,-12,849,278819,16,278803
70387,16,0,975,655748,16,655732
70388,13,10,118,960816,13,960803
70389,6,3,698,734033,6,734027
70390,16,-18,1,85203,16,85187
70391,13,-5,368,493782,13,493769
70392,17,-11,209,305361,17,305344
70393,15,-14,680,214848,15,214833
70394,17,19,755,1246905,17,1246888
70395,16,-16,390,149753,16,149737
70396,15,-12,241,274293,15,274278
70397,16,5,904,810391,16,810375
70398,7,15,626,1107745,7,1107738
70399,5,7,533,856146,5,856141
70400,16,6,977,843561,16,843545
70401,19,13,375,1055989,19,1055970
70402,12,5,924,810569,12,810557
70403,20,10,28,960060,20,960040
70404,14,-18,761,90817,14,90803
70405,18,4,503,776884,18,776866
70406,13,12,58,1022497,13,1022484
70407,8,-13,462,227977,8,227969
70408,18,14,539,1089654,18,1089636
70409,19,-6,974,466515,19,466496
70410,13,1,302,682240,13,682227
70411,20,11,840,996943,20,996923
70412,13,13,467,1056672,13,1056659
70413,14,-19,966,61257,14,61243
70414,19,3,520,745668,19,745649
70415,12,-8,538,401655,12,401643
70416,10,11,18,968840,10,968830
70417,9,-8,517,386213,9,386204
70418,8,-7,637,419367,8,419359
70419,9,17,333,1162552,9,1162543
70420,5,4,168,754248,5,754243
70421,10,17,372,1163309,10,1163299
70422,5,13,943,1050907,5,1050902
70423,12,-13,775,246829,12,246817
70424,11,19,576,1245515,11,1245504
70425,17,-19,6,53937,17,53920
70426,18,1,333,682553,18,682535
70427,18,-1,151,617692,18,617674
70428,19,-1,691,621886,19,621867
70429,15,18,413,1212108,15,1212093
70430,5,-20,201,4723,5,4718
70431,17,-12,341,275080,17,275063
70432,7,-1,605,607035,7,607028
70433,12,5,465,807210,12,807198
70434,11,19,85,1241494,11,1241483
70435,17,7,39,867321,17,867304
70436,13,-6,811,465361,13,465348
70437,19,7,733,872368,19,872349
70438,5,1,859,675673,5,675668
70439,13,8,371,900864,13,900851
70440,20,12,900,1028916,20,1028896
70441,7,-2,97,564913,7,564906
70442,12,7,756,872474,12,872462
70443,7,-20,531,11493,7,11486
70444,14,12,852,1028493,14,1028479
70445,15,-16,217,148585,15,148570
70446,14,6,744,841760,14,841746
70447,20,-13,799,246987,20,246967
70448,11,8,179,899342,11,899331
70449,9,-15,175,159179,9,159170
70450,17,-11,461,307442,17,307425
70451,10,15,707,1109471,10,1109461
70452,16,-17,437,118712,16,118696
70453,15,-17,306,117804,15,117789
70454,15,-4,939,529100,15,529085
70455,11,-20,162,23998,11,23987
70456,17,-12,224,274171,17,274154
70457,8,17,1000,1176838,8,1176830
70458,8,-20,221,5017,8,5009
70459,11,-16,492,150627,11,150616
70460,14,11,399,993829,14,993815
70461,6,-4,247,505065,6,505059
70462,18,11,878,997236,18,997218
70463,9,5,502,791988,9,791979
70464,19,13,53,1053643,19,1053624
70465,13,9,855,935410,13,935397
70466,6,-2,530,573998,6,573992
70467,9,19,670,1232352,9,1232343
70468,18,-11,88,304380,18,304362
70469,17,-12,907,279382,17,279365
70470,10,-15,952,175763,10,175753
70471,6,-13,542,229836,6,229830
70472,15,-9,559,371131,15,371116
70473,10,-8,877,394100,10,394090
70474,10,3,431,728096,10,728086
70475,15,13,333,1055699,15,1055684
70476,7,-5,964,489057,7,489050
70477,12,3,269,743928,12,743916
70478,16,11,73,991420,16,991404
70479,5,-3,463,540841,5,540836
70480,14,19,874,1247865,14,1247851
70481,9,-17,118,95927,9,95918
70482,15,18,778,1214614,15,1214599
70483,18,-3,662,559064,18,559046
70484,15,-20,306,25220,15,25205
70485,17,17,315,1180332,17,1180315
70486,8,-12,739,265459,8,265451
70487,6,6,950,833587,6,833581
70488,6,4,630,764262,6,764256
70489,9,-10,7,312677,9,312668
70490,5,5,167,785009,5,785004
70491,10,15,530,1105757,10,1105747
70492,17,-14,530,213596,17,213579
70493,11,3,236,743657,11,743646
70494,8,16,536,1136580,8,1136572
70495,5,-17,149,96562,5,96557
70496,11,0,738,653963,11,653952
70497,17,17,322,1180381,17,1180364
70498,14,1,1,679751,14,679737
70499,16,-20,645,27697,16,27681
70500,12,13,24,1053394,12,1053382
70501,9,19,494,1228730,9,1228721
70502,7,-8,23,375855,7,375848
70503,8,3,856,737309,8,737301
70504,8,-15,393,163878,8,163870
70505,20,4,339,775662,20,775642
70506,15,-9,328,369029,15,369014
70507,19,-16,906,153606,19,153587
70508,5,-4,945,519714,5,519709
70509,10,-10,339,319950,10,319940
70510,14,11,626,995317,14,995303
70511,19,17,506,1181706,19,1181687
70512,18,-11,177,305176,18,305158
70513,13,-2,179,586373,13,586360
70514,10,-18,102,64773,10,64763
70515,8,-20,969,21311,8,21303
70516,14,5,173,805048,14,805034
70517,10,2,908,707506,10,707496
70518,20,2,651,715468,20,715448
70519,9,6,524,824245,9,824236
70520,18,15,206,1118357,18,1118339
70521,14,-17,990,122718,14,122704
70522,13,4,288,775270,13,775257
70523,19,-6,982,466603,19,466584
70524,20,-6,350,461888,20,461868
70525,5,-5,641,481916,5,481911
70526,17,9,905,935798,17,935781
70527,19,5,529,807632,19,807613
70528,6,10,628,951081,6,951075
70529,7,-18,785,79470,7,79463
70530,10,-20,847,18832,10,18822
70531,15,-6,907,466008,15,465993
70532,5,-5,974,489234,5,489229
70533,13,-16,348,149479,13,149466
70534,9,-18,553,74326,9,74317
70535,12,18,157,1210238,12,1210226
70536,11,12,754,1027649,11,1027638
70537,6,-10,746,328668,6,328662
70538,14,-1,252,618507,14,618493
70539,5,-1,616,607278,5,607273
70540,15,-12,576,276767,15,276752
70541,20,-2,489,588846,20,588826
70542,7,3,121,721485,7,721478
70543,14,9,386,931834,14,931820
70544,20,-14,229,211212,20,211192
70545,17,3,336,744435,17,744418
70546,18,12,80,1022628,18,1022610
70547,9,-17,787,110320,9,110311
70548,12,17,961,1185131,12,1185119
70549,7,-2,682,577321,7,577314
70550,7,16,113,1127441,7,1127434
70551,10,-14,894,205901,10,205891
70552,10,-12,182,253354,10,253344
70553,12,11,545,994772,12,994760
70554,14,6,281,837933,14,837919
70555,8,-20,601,13157,8,13149
70556,7,-11,86,282932,7,282925
70557,18,18,13,1209018,18,1209000
70558,5,-17,976,114051,5,114046
70559,11,-11,696,309200,11,309189
70560,11,10,581,964376,11,964365
70561,12,10,434,963128,12,963116
70562,20,-4,87,522692,20,522672
70563,20,-20,866,29471,20,29451
70564,8,-19,915,51200,8,51192
70565,20,-18,679,90190,20,90170
70566,17,6,223,837435,17,837418
70567,9,3,806,736212,9,736203
70568,20,3,588,746231,20,746211
70569,11,9,268,930883,11,930872
70570,7,7,325,851828,7,851821
70571,6,-11,167,284771,6,284765
70572,11,-1,231,618401,11,618390
70573,19,-18,24,85401,19,85382
70574,18,-10,994,342672,18,342654
70575,15,-2,881,591882,15,591867
70576,16,-1,931,623687,16,623671
70577,10,-7,838,423601,10,423591
70578,17,17,500,1181641,17,1181624
70579,20,-18,217,86965,20,86945
70580,10,-2,130,565679,10,565669
70581,19,-5,747,496520,19,496501
70582,7,3,451,728534,7,728527
70583,17,-12,171,273776,17,273759
70584,11,18,703,1214035,11,1214024
70585,14,-1,850,623072,14,623058
70586,9,11,223,972930,9,972921
70587,18,-4,196,523594,18,523576
70588,9,-12,237,254630,9,254621
70589,7,-10,74,314311,7,314304
70590,6,-5,650,482073,6,482067
70591,17,0,337,650566,17,650549
70592,10,1,958,677829,10,677819
70593,13,13,830,1059450,13,1059437
70594,13,-20,187,24285,13,24272
70595,18,-7,202,429817,18,429799
70596,10,-12,176,253290,10,253280
70597,14,-5,816,496909,14,496895
70598,20,-17,343,118050,20,118030
70599,14,-20,600,27363,14,27349
70600,18,19,939,1248334,18,1248316
70601,8,-17,10,93759,8,93751
70602,6,1,348,664809,6,664803
70603,9,13,400,1039382,9,1039373
70604,14,-19,917,60905,14,60891
70605,5,0,51,626384,5,626379
70606,20,5,712,808986,20,808966
70607,8,-5,90,470055,8,470047
70608,9,19,839,1236176,9,1236167
70609,13,15,133,1117790,13,1117777
70610,13,-6,251,461119,13,461106
70611,10,-15,298,161830,10,161820
70612,15,19,291,1243074,15,1243059
70613,12,18,50,1209294,12,1209282
70614,13,2,657,715520,13,715507
70615,17,10,602,964572,17,964555
70616,6,-12,268,255311,6,255305
70617,17,0,405,651143,17,651126
70618,8,-3,867,549793,8,549785
70619,13,10,542,964003,13,963990
70620,8,-15,88,157291,8,157283
70621,20,-14,500,213350,20,213330
70622,10,-11,824,298799,10,298789
70623,11,11,614,995268,11,995257
70624,9,-7,543,417563,9,417554
70625,11,-13,781,246876,11,246865
70626,13,6,102,836514,13,836501
70627,6,17,923,1175127,6,1175121
70628,11,19,31,1240973,11,1240962
70629,13,3,618,746493,13,746480
70630,10,-3,326,537509,10,537499
70631,17,-10,167,336344,17,336327
70632,11,-2,126,586068,11,586057
70633,15,-15,692,182888,15,182873
70634,18,-11,121,304677,18,304659
70635,12,1,192,681385,12,681373
70636,10,-17,890,112392,10,112382
70637,14,12,603,1026480,14,1026466
70638,11,2,916,717293,11,717282
70639,9,-3,387,538931,9,538922
70640,9,-17,308,100174,9,100165
70641,13,-5,558,495168,13,495155
70642,12,14,794,1091677,12,1091665
70643,12,-1,741,622282,12,622270
70644,5,0,538,636982,5,636977
70645,6,-4,184,503458,6,503452
70646,12,18,974,1216151,12,1216139
70647,14,10,659,964992,14,964978
70648,17,0,616,652922,17,652905
70649,11,7,891,873406,11,873395
70650,19,12,351,1024661,19,1024642
70651,12,2,183,711953,12,711941
70652,20,7,367,869660,20,869640
70653,11,-16,988,154191,11,154180
70654,9,-9,571,356556,9,356547
70655,11,-2,334,587600,11,587589
70656,10,8,637,889202,10,889192
70657,13,19,664,1246145,13,1246132
70658,19,5,923,810553,19,810534
70659,20,-8,30,398137,20,398117
70660,14,-17,919,122316,14,122302
70661,11,6,330,838340,11,838329
70662,7,-17,8,93725,7,93718
70663,12,16,511,1150730,12,1150718
70664,12,10,953,967152,12,967140
70665,13,-10,657,340017,13,340004
70666,5,16,499,1135804,5,1135799
70667,12,-1,841,623015,12,623003
70668,18,10,409,962945,18,962927
70669,14,0,625,652945,14,652931
70670,11,-2,600,589622,11,589611
70671,20,11,785,996518,20,996498
70672,11,-15,394,180646,11,180635
70673,16,3,82,742442,16,742426
70674,16,14,333,1088058,16,1088042
70675,17,0,836,654620,17,654603
70676,15,-3,120,554668,15,554653
70677,8,12,138,1002125,8,1002117
70678,18,-20,199,24395,18,24377
70679,10,19,918,1237864,10,1237854
70680,17,-20,929,29881,17,29864
70681,19,-13,713,246269,19,246250
70682,14,-10,12,335206,14,335192
70683,8,-2,669,577057,8,577049
70684,8,7,133,847665,8,847657
70685,18,19,959,1248495,18,1248477
70686,19,-4,477,525666,19,525647
70687,6,10,824,955354,6,955348
70688,5,-20,368,8066,5,8061
70689,17,18,840,1215072,17,1215055
70690,10,-19,634,45474,10,45464
70691,5,-10,472,323008,5,323003
70692,17,17,646,1182655,17,1182638
70693,13,-3,266,555650,13,555637
70694,6,2,95,690710,6,690704
70695,11,-10,374,337770,11,337759
70696,8,6,852,831496,8,831488
70697,15,-19,204,55693,15,55678
70698,9,-10,967,333219,9,333210
70699,9,4,676,765226,9,765217
70700,6,-20,163,3604,6,3598
70701,12,14,430,1088843,12,1088831
70702,16,8,230,899851,16,899835
70703,14,6,617,840739,14,840725
70704,10,-11,150,284441,10,284431
70705,11,-20,10,6071,11,6060
70706,6,-10,42,313544,6,313538
70707,19,-12,608,276925,19,276906
70708,18,-8,327,400206,18,400188
70709,17,-14,337,212045,17,212028
70710,14,-4,994,529567,14,529553
70711,20,17,304,1180275,20,1180255
70712,14,8,146,899088,14,899074
70713,18,-10,257,336989,18,336971
70714,5,15,632,1107883,5,1107878
70715,7,0,330,632322,7,632315
70716,14,-9,472,370358,14,370344
70717,14,-15,238,179476,14,179462
70718,10,19,633,1231570,10,1231560
70719,11,-5,655,495792,11,495781
70720,14,8,934,905218,14,905204
70721,5,-3,476,541146,5,541141
70722,10,15,485,1104744,10,1104734
70723,6,19,14,1217732,6,1217726
70724,10,4,208,755120,10,755110
70725,9,-16,56,125057,9,125048
70726,14,2,710,715944,14,715930
70727,20,17,796,1183900,20,1183880
70728,6,1,860,675698,6,675692
70729,16,-16,746,152338,16,152322
70730,18,15,693,1121876,18,1121858
70731,20,-4,943,529148,20,529128
70732,16,-4,491,525780,16,525764
70733,13,1,421,683137,13,683124
70734,8,2,972,708967,8,708959
70735,8,6,669,827415,8,827407
70736,9,1,663,671654,9,671645
70737,20,-14,202,210884,20,210864
70738,18,2,256,712519,18,712501
70739,6,7,196,848927,6,848921
70740,17,-11,565,308235,17,308218
70741,18,19,614,1245766,18,1245748
70742,7,7,120,847368,7,847361
70743,14,-7,1000,435774,14,435760
70744,9,-17,260,99025,9,99016
70745,18,16,88,1147716,18,1147698
70746,13,0,732,653930,13,653917
70747,10,-3,410,539476,10,539466
70748,19,14,33,1085672,19,1085653
70749,19,13,741,1058746,19,1058727
70750,20,3,561,745950,20,745930
70751,13,-19,760,59943,13,59930
70752,12,-8,643,402370,12,402358
70753,8,-14,443,196370,8,196362
70754,11,-15,310,180011,11,180000
70755,7,-16,872,142808,7,142801
70756,12,3,729,747366,12,747354
70757,13,-11,353,306597,13,306584
70758,13,13,438,1056531,13,1056518
70759,13,-8,637,402349,13,402336
70760,11,-1,995,624118,11,624107
70761,11,-17,506,119287,11,119276
70762,9,2,94,690685,9,690676
70763,6,-4,298,505985,6,505979
70764,16,15,810,1122699,16,1122683
70765,15,10,645,964920,15,964905
70766,6,11,759,984693,6,984687
70767,17,-20,344,25525,17,25508
70768,18,13,770,1059008,18,1058990
70769,11,7,451,870407,11,870396
70770,18,6,991,843693,18,843675
70771,17,-17,860,121898,17,121881
70772,8,6,306,819134,8,819126
70773,19,-13,971,248375,19,248356
70774,10,3,149,722069,10,722059
70775,15,-13,496,244669,15,244654
70776,12,-1,367,619550,12,619538
70777,12,-9,459,370204,12,370192
70778,13,0,111,649116,13,649103
70779,15,-3,126,554702,15,554687
70780,11,-5,799,496787,11,496776
70781,11,0,252,650071,11,650060
70782,11,10,505,963718,11,963707
70783,13,-12,533,276495,13,276482
70784,8,-11,39,281915,8,281907
70785,20,8,53,898281,20,898261
70786,11,-17,566,119778,11,119767
70787,17,-4,692,527306,17,527289
70788,18,-17,328,117912,18,117894
70789,9,18,525,1198075,9,1198066
70790,12,-12,111,273359,12,273347
70791,14,-16,33,146978,14,146964
70792,20,-7,155,429444,20,429424
70793,14,17,640,1182620,14,1182606
70794,9,4,129,753329,9,753320
70795,11,-11,67,304208,11,304197
70796,17,-8,828,403806,17,403789
70797,15,10,452,963257,15,963242
70798,5,-12,587,262220,5,262215
70799,17,16,623,1151507,17,1151490
70800,13,11,26,991070,13,991057
70801,19,9,561,933206,19,933187
70802,17,-18,112,86070,17,86053
70803,13,-8,837,403842,13,403829
70804,6,8,48,876094,6,876088
70805,14,18,343,1211596,14,1211582
70806,6,-19,857,50266,6,50260
70807,5,18,928,1206383,5,1206378
70808,18,5,975,810962,18,810944
70809,10,-14,838,204720,10,204710
70810,9,11,807,985762,9,985753
70811,14,18,700,1214007,14,1213993
70812,5,-4,42,500198,5,500193
70813,20,1,754,685725,20,685705
70814,9,12,610,1012293,9,1012284
70815,13,2,176,711919,13,711906
70816,14,-17,305,117796,14,117782
70817,13,0,506,652015,13,652002
70818,19,-9,388,369601,19,369582
70819,14,-2,783,591029,14,591015
70820,6,16,11,1125444,6,1125438
70821,16,2,248,712445,16,712429
70822,10,12,480,1009405,10,1009395
70823,13,8,490,901845,13,901832
70824,18,-13,726,246381,18,246363
70825,10,19,920,1237911,10,1237901
70826,17,-1,649,621590,17,621573
70827,7,1,183,661186,7,661179
70828,14,15,130,1117788,14,1117774
70829,6,18,222,1191653,6,1191647
70830,16,1,491,683732,16,683716
70831,17,-20,766,28692,17,28675
70832,5,-17,355,101076,5,101071
70833,6,-16,983,145148,6,145142
70834,15,-15,951,185025,15,185010
70835,17,13,515,1057063,17,1057046
70836,16,1,248,681863,16,681847
70837,15,7,859,873199,15,873184
70838,7,17,744,1171125,7,1171118
70839,16,18,133,1210016,16,1210000
70840,8,11,695,983209,8,983201
70841,13,18,738,1214251,13,1214238
70842,11,-19,920,60937,11,60926
70843,19,4,354,775793,19,775774
70844,12,-7,393,431332,12,431320
70845,10,15,653,1108306,10,1108296
70846,8,-11,806,298384,8,298376
70847,5,-17,412,102216,5,102211
70848,10,-4,188,503542,10,503532
70849,14,2,926,717349,14,717335
70850,9,-13,757,234638,9,234629
70851,13,14,121,1086422,13,1086409
70852,19,3,663,746856,19,746837
70853,9,18,962,1207143,9,1207134
70854,18,6,637,840934,18,840916
70855,12,6,603,840611,12,840599
70856,11,-7,529,432340,11,432329
70857,18,10,668,965070,18,965052
70858,8,7,992,865801,8,865793
70859,5,-1,891,613082,5,613077
70860,20,-7,214,429918,20,429898
70861,19,18,752,1214428,19,1214409
70862,16,-17,510,119314,16,119298
70863,15,-10,792,341044,15,341029
70864,12,-16,32,146972,12,146960
70865,12,11,443,994079,12,994067
70866,10,5,176,785250,10,785240
70867,13,-8,26,398088,13,398075
70868,16,-19,135,55099,16,55083
70869,18,5,949,810783,18,810765
70870,19,-1,636,621467,19,621448
70871,14,1,280,682098,14,682084
70872,16,-4,252,524087,16,524071
70873,15,-2,504,588943,15,588928
70874,12,-10,574,339358,12,339346
70875,8,0,835,643486,8,643478
70876,6,-19,805,49049,6,49043
70877,12,0,140,649292,12,649280
70878,16,4,367,775876,16,775860
70879,10,-2,957,583308,10,583298
70880,13,13,7,1053311,13,1053298
70881,13,0,150,649333,13,649320
70882,16,8,770,904061,16,904045
70883,12,-16,639,151709,12,151697
70884,17,-16,637,151681,17,151664
70885,13,-12,954,279738,13,279725
70886,9,18,730,1201966,9,1201957
70887,15,4,209,774741,15,774726
70888,8,14,895,1081908,8,1081900
70889,9,14,143,1065067,9,1065058
70890,7,16,561,1137037,7,1137030
70891,20,4,283,775235,20,775215
70892,12,15,786,1122542,12,1122530
70893,13,-12,280,274593,13,274580
70894,16,6,9,835810,16,835794
70895,17,-4,958,529298,17,529281
70896,10,2,241,693794,10,693784
70897,5,-3,865,549731,5,549726
70898,10,9,487,917026,10,917016
70899,6,-5,386,476474,6,476468
70900,5,-6,584,449367,5,449362
70901,19,-2,431,588398,19,588379
70902,18,-17,696,120734,18,120716
70903,8,3,481,729147,8,729139
70904,7,-6,327,443856,7,443849
70905,9,8,710,890880,9,890871
70906,6,-12,890,268944,6,268938
70907,8,18,761,1202785,8,1202777
70908,16,-15,471,181258,16,181242
70909,20,10,966,967227,20,967207
70910,15,-11,644,308866,15,308851
70911,12,3,28,741993,12,741981
70912,16,-2,220,586803,16,586787
70913,13,17,136,1178879,13,1178866
70914,6,18,607,1199526,6,1199520
70915,19,-11,142,304847,19,304828
70916,13,11,973,997856,13,997843
70917,16,5,625,808376,16,808360
70918,12,-10,260,337004,12,336992
70919,19,15,645,1121504,19,1121485
70920,20,14,678,1090754,20,1090734
70921,9,-17,757,109753,9,109744
70922,6,-3,668,545511,6,545505
70923,19,19,823,1247418,19,1247399
70924,7,-4,841,517265,7,517258
70925,14,17,441,1181233,14,1181219
70926,20,-7,497,432051,20,432031
70927,9,-6,824,454503,9,454494
70928,13,-5,213,492543,13,492530
70929,11,-11,827,310170,11,310159
70930,19,-8,536,401649,19,401630
70931,13,-6,892,465877,13,465864
70932,17,-9,437,370046,17,370029
70933,12,-6,217,460839,12,460827
70934,11,14,883,1092359,11,1092348
70935,20,0,857,654752,20,654732
70936,19,14,183,1086856,19,1086837
70937,5,6,11,812383,5,812378
70938,18,-6,541,463350,18,463332
70939,12,-15,366,180449,12,180437
70940,7,14,755,1078896,7,1078889
70941,10,2,878,706880,10,706870
70942,5,15,283,1100611,5,1100606
70943,20,-19,999,61447,20,61427
70944,18,18,780,1214638,18,1214620
70945,15,-15,54,178183,15,178168
70946,18,-4,935,529068,18,529050
70947,20,-10,528,338946,20,338926
70948,20,-6,376,462047,20,462027
70949,11,8,831,904416,11,904405
70950,5,14,253,1067440,5,1067435
70951,17,-15,552,181869,17,181852
70952,18,-7,192,429735,18,429717
70953,10,19,938,1238253,10,1238243
70954,17,8,789,904195,17,904178
70955,16,-10,939,342176,16,342160
70956,19,-5,915,497757,19,497738
70957,12,-15,780,183583,12,183571
70958,7,17,610,1168310,7,1168303
70959,8,-5,605,481204,8,481196
70960,9,-2,104,565060,9,565051
70961,15,-7,741,433677,15,433662
70962,17,16,707,1152142,17,1152125
70963,19,11,128,991760,19,991741
70964,12,-7,265,430284,12,430272
70965,16,-14,368,212333,16,212317
70966,15,-18,253,87297,15,87282
70967,12,-11,179,305189,12,305177
70968,20,4,540,777183,20,777163
70969,18,15,6,1116802,18,1116784
70970,12,-17,927,122338,12,122326
70971,6,-10,704,327820,6,327814
70972,10,-16,753,140249,10,140239
70973,13,-1,860,623153,13,623140
70974,12,11,9,990933,12,990921
70975,19,-2,576,589462,19,589443
70976,6,-9,796,361409,6,361403
70977,20,-2,86,585785,20,585765
70978,8,8,805,892851,8,892843
70979,5,-2,812,580128,5,580123
70980,14,3,504,745597,14,745583
70981,17,12,408,1025015,17,1024998
70982,18,3,329,744391,18,744373
70983,12,-11,391,306867,12,306855
70984,10,-18,828,80358,10,80348
70985,18,-11,649,308909,18,308891
70986,15,-7,215,429928,15,429913
70987,11,-4,929,529020,11,529009
70988,14,4,519,777030,14,777016
70989,18,-19,773,60029,18,60011
70990,7,10,163,941110,7,941103
70991,12,-2,589,589551,12,589539
70992,5,16,935,1144686,5,1144681
70993,18,12,861,1028544,18,1028526
70994,6,0,793,642675,6,642669
70995,14,7,102,867756,14,867742
70996,19,-20,343,25509,19,25490
70997,20,3,878,748427,20,748407
70998,16,-19,920,60943,16,60927
70999,12,6,579,840470,12,840458
71000,9,6,525,824309,9,824300
71001,8,17,728,1170852,8,1170844
71002,18,-4,984,529525,18,529507
71003,13,0,685,653507,13,653494
71004,12,11,615,995274,12,995262
71005,20,-11,366,306695,20,306675
71006,15,-2,349,587704,15,587689
71007,12,3,888,748497,12,748485
71008,19,8,741,903829,19,903810
71009,20,1,259,681961,20,681941
71010,12,-14,519,213554,12,213542
71011,12,-19,978,61320,12,61308
71012,16,-1,722,622174,16,622158
71013,17,-15,525,181605,17,181588
71014,16,-1,750,622340,16,622324
71015,16,13,798,1059232,16,1059216
71016,6,-1,334,601399,6,601393
71017,17,0,132,649225,17,649208
71018,5,2,771,704792,5,704787
71019,18,13,85,1053874,18,1053856
71020,10,-15,668,169748,10,169738
71021,14,4,648,777995,14,777981
71022,14,-5,63,491309,14,491295
71023,9,-15,377,163646,9,163637
71024,12,-14,497,213337,12,213325
71025,13,0,614,652907,13,652894
71026,6,-7,729,421296,6,421290
71027,13,18,992,1216257,13,1216244
71028,12,19,58,1241193,12,1241181
71029,7,-14,441,196344,7,196337
71030,20,0,510,652035,20,652015
71031,18,-17,295,117695,18,117677
71032,17,2,388,713535,17,713518
71033,18,8,191,899448,18,899430
71034,17,9,599,933512,17,933495
71035,16,-16,318,149303,16,149287
71036,5,-16,626,137618,5,137613
71037,14,-11,470,307507,14,307493
71038,8,-4,911,519005,8,518997
71039,14,-3,201,555200,14,555186
71040,19,-14,454,213022,19,213003
71041,15,-18,160,86489,15,86474
71042,17,-10,671,340164,17,340147
71043,10,15,653,1108316,10,1108306
71044,20,-11,963,311277,20,311257
71045,16,-20,680,28037,16,28021
71046,13,-15,84,178429,13,178416
71047,7,-12,647,263534,7,263527
71048,7,12,799,1016408,7,1016401
71049,12,14,13,1085479,12,1085467
71050,5,10,149,940802,5,940797
71051,20,1,377,682888,20,682868
71052,8,8,359,883053,8,883045
71053,16,19,139,1241890,16,1241874
71054,17,12,915,1029056,17,1029039
71055,15,-2,320,587527,15,587512
71056,5,16,172,1128751,5,1128746
71057,11,15,668,1121700,11,1121689
71058,11,-7,253,430160,11,430149
71059,5,-12,205,253866,5,253861
71060,7,-13,383,226367,7,226360
71061,12,14,663,1090632,12,1090620
71062,15,-14,437,212918,15,212903
71063,18,-9,60,367106,18,367088
71064,10,18,757,1202671,10,1202661
71065,17,14,344,1088111,17,1088094
71066,9,-3,336,537815,9,537806
71067,18,-11,6,303744,18,303726
71068,16,0,150,649339,16,649323
71069,5,9,609,919683,5,919678
71070,7,9,262,912128,7,912121
71071,8,-4,676,513991,8,513983
71072,15,-11,344,306478,15,306463
71073,19,17,685,1182937,19,1182918
71074,16,-19,432,57334,16,57318
71075,19,-18,289,87478,19,87459
71076,16,4,947,780232,16,780216
71077,15,11,712,995925,15,995910
71078,7,19,725,1233626,7,1233619
71079,14,-6,249,461094,14,461080
71080,15,-6,149,460260,15,460245
71081,19,-4,522,526079,19,526060
71082,6,1,116,659653,6,659647
71083,20,-18,769,90858,20,90838
71084,6,4,518,761750,6,761744
71085,20,19,521,1245111,20,1245091
71086,15,-11,136,304805,15,304790
71087,18,-9,289,368710,18,368692
71088,8,7,207,849187,8,849179
71089,5,-14,356,194418,5,194413
71090,19,-10,274,337073,19,337054
71091,9,-11,993,302553,9,302544
71092,17,18,919,1215647,17,1215630
71093,7,-14,885,205716,7,205709
71094,9,15,863,1112840,9,1112831
71095,5,18,1,1186553,5,1186548
71096,15,11,505,994519,15,994504
71097,12,-18,265,87360,12,87348
71098,11,-11,924,310914,11,310903
71099,16,0,697,653624,16,653608
71100,20,11,969,997813,20,997793
71101,14,-9,53,367039,14,367025
71102,8,-9,153,346892,8,346884
71103,6,-3,554,542978,6,542972
71104,11,4,880,779813,11,779802
71105,6,-18,224,67309,6,67303
71106,15,-11,940,311050,15,311035
71107,12,14,16,1085502,12,1085490
71108,12,-20,555,27046,12,27034
71109,10,-16,988,145315,10,145305
71110,8,-11,887,300170,8,300162
71111,8,-18,753,78769,8,78761
71112,17,-9,636,371582,17,371565
71113,10,-4,991,520794,10,520784
71114,9,19,282,1223739,9,1223730
71115,13,-12,450,275752,13,275739
71116,8,-18,934,82764,8,82756
71117,17,9,273,930940,17,930923
71118,14,-3,14,553945,14,553931
71119,14,-13,541,245013,14,244999
71120,17,6,839,842517,17,842500
71121,11,-7,361,431113,11,431102
71122,19,-2,796,591121,19,591102
71123,16,1,64,680260,16,680244
71124,8,14,598,1075139,8,1075131
71125,11,1,812,686172,11,686161
71126,18,6,407,839053,18,839035
71127,18,-17,430,118646,18,118628
71128,19,-7,10,428344,19,428325
71129,14,16,339,1149569,14,1149555
71130,12,-7,306,430630,12,430618
71131,17,0,167,649503,17,649486
71132,8,-3,773,547770,8,547762
71133,13,5,989,811049,13,811036
71134,7,-14,737,202732,7,202725
71135,13,14,690,1090908,13,1090895
71136,11,-3,644,558921,11,558910
71137,6,-9,178,347369,6,347363
71138,20,-15,420,180872,20,180852
71139,5,-9,268,349456,5,349451
71140,17,8,613,902781,17,902764
71141,6,-15,860,173773,6,173767
71142,16,1,425,683177,16,683161
71143,16,-5,224,492618,16,492602
71144,5,19,341,1225176,5,1225171
71145,7,2,165,692162,7,692155
71146,9,7,653,858597,9,858588
71147,19,-3,826,560395,19,560376
71148,9,-3,664,545435,9,545426
71149,7,0,779,642431,7,642424
71150,6,-1,290,600298,6,600292
71151,16,-11,262,305802,16,305786
71152,17,-16,120,147818,17,147801
71153,16,-1,541,620855,16,620839
71154,11,0,789,654265,11,654254
71155,13,-10,559,339246,13,339233
71156,7,-15,562,167508,7,167501
71157,9,-7,849,423897,9,423888
71158,10,13,596,1043598,10,1043588
71159,12,-5,313,493389,12,493377
71160,12,14,656,1090588,12,1090576
71161,12,18,457,1212370,12,1212358
71162,6,15,667,1108585,6,1108579
71163,19,-2,424,588310,19,588291
71164,8,3,163,722301,8,722293
71165,18,12,197,1023465,18,1023447
71166,5,-19,943,51800,5,51795
71167,7,19,329,1224971,7,1224964
71168,12,-17,927,122340,12,122328
71169,8,-6,624,450209,8,450201
71170,6,-7,643,419491,6,419485
71171,17,-9,146,367626,17,367609
71172,10,-7,910,425324,10,425314
71173,15,-4,32,522271,15,522256
71174,7,-8,124,377992,7,377985
71175,17,-20,373,25683,17,25666
71176,15,-6,546,463402,15,463387
71177,8,11,979,989440,8,989432
71178,14,16,920,1153714,14,1153700
71179,7,17,741,1171091,7,1171084
71180,17,6,690,841332,17,841315
71181,9,9,969,927465,9,927456
71182,19,-14,609,214337,19,214318
71183,6,-15,310,162119,6,162113
71184,13,-16,864,153315,13,153302
71185,10,9,131,909570,10,909560
71186,14,8,820,904358,14,904344
71187,18,-12,204,273941,18,273923
71188,18,-14,78,209932,18,209914
71189,20,-8,896,404282,20,404262
71190,18,-1,78,617181,18,617163
71191,20,-13,101,241831,20,241811
71192,6,-1,100,595995,6,595989
71193,9,-12,812,267141,9,267132
71194,15,3,406,744931,15,744916
71195,9,-12,560,261671,9,261662
71196,6,16,256,1130685,6,1130679
71197,14,-14,832,216003,14,215989
71198,15,5,510,807507,15,807492
71199,8,18,739,1202201,8,1202193
71200,20,-18,866,91500,20,91480
71201,11,-12,221,274138,11,274127
71202,14,-20,393,25793,14,25779
71203,16,-19,505,57870,16,57854
71204,9,17,395,1163751,9,1163742
71205,15,-6,450,462573,15,462558
71206,13,-4,963,529340,13,529327
71207,7,17,763,1171507,7,1171500
71208,6,13,454,1040533,6,1040527
71209,14,-5,462,494470,14,494456
71210,14,-7,381,431247,14,431233
71211,10,-8,608,388275,10,388265
71212,6,-6,591,449513,6,449507
71213,12,-5,590,495390,12,495378
71214,5,-6,960,457240,5,457235
71215,15,18,511,1212737,15,1212722
71216,9,2,22,689073,9,689064
71217,7,19,356,1225506,7,1225499
71218,7,-11,779,297929,7,297922
71219,7,-12,932,269836,7,269829
71220,20,18,200,1210630,20,1210610
71221,9,6,366,820475,9,820466
71222,16,-2,536,589146,16,589130
71223,10,-16,350,131486,10,131476
71224,13,11,571,994980,13,994967
71225,16,-2,8,585175,16,585159
71226,10,0,500,636226,10,636216
71227,16,14,449,1088963,16,1088947
71228,18,19,502,1244899,18,1244881
71229,15,5,905,810395,15,810380
71230,10,17,35,1156050,10,1156040
71231,13,-16,800,152769,13,152756
71232,7,19,278,1223664,7,1223657
71233,15,-9,1,366639,15,366624
71234,15,-6,536,463305,15,463290
71235,11,1,603,684587,11,684576
71236,10,1,192,661375,10,661365
71237,18,15,803,1122647,18,1122629
71238,16,-11,943,311071,16,311055
71239,18,-12,489,276108,18,276090
71240,20,3,300,744173,20,744153
71241,16,-18,664,90131,16,90115
71242,13,-12,65,273009,13,272996
71243,11,-10,500,338791,11,338780
71244,9,11,225,972976,9,972967
71245,12,3,475,745379,12,745367
71246,5,4,184,754538,5,754533
71247,13,1,307,682270,13,682257
71248,12,4,584,777488,12,777476
71249,9,15,508,1105257,9,1105248
71250,20,1,659,685067,20,685047
71251,8,7,770,861054,8,861046
71252,10,-7,119,408330,10,408320
71253,9,-15,36,156092,9,156083
71254,7,11,44,969383,7,969376
71255,9,-20,798,17680,9,17671
71256,7,4,244,756008,7,756001
71257,18,10,944,967094,18,967076
71258,7,-15,70,156829,7,156822
71259,13,-5,305,493339,13,493326
71260,11,10,930,967013,11,967002
71261,19,9,775,934782,19,934763
71262,15,10,796,966057,15,966042
71263,18,4,827,779391,18,779373
71264,15,-9,998,374242,15,374227
71265,20,19,2,1240651,20,1240631
71266,8,12,250,1004605,8,1004597
71267,18,18,802,1214802,18,1214784
71268,9,-14,355,194404,9,194395
71269,14,-4,165,523336,14,523322
71270,16,1,476,683600,16,683584
71271,13,-17,175,116748,13,116735
71272,19,-20,114,23618,19,23599
71273,5,11,210,972682,5,972677
71274,13,-17,770,121362,13,121349
71275,19,-2,447,588500,19,588481
71276,5,-9,113,345950,5,345945
71277,5,12,921,1019413,5,1019408
71278,19,10,521,963878,19,963859
71279,11,-11,529,307984,11,307973
71280,14,14,935,1092753,14,1092739
71281,18,-15,9,177894,18,177876
71282,8,-17,187,97334,8,97326
71283,19,-3,934,561275,19,561256
71284,8,10,574,949870,8,949862
71285,13,-17,279,117544,13,117531
71286,17,1,722,685478,17,685461
71287,14,19,389,1243954,14,1243940
71288,6,4,287,756738,6,756732
71289,17,-10,629,339752,17,339735
71290,9,-16,38,124613,9,124604
71291,19,18,946,1215918,19,1215899
71292,19,-20,823,29202,19,29183
71293,10,-15,225,160163,10,160153
71294,20,-3,911,561105,20,561085
71295,12,-19,59,54291,12,54279
71296,17,-16,727,152234,17,152217
71297,7,18,757,1202678,7,1202671
71298,12,2,571,714865,12,714853
71299,15,9,305,931225,15,931210
71300,13,13,848,1059584,13,1059571
71301,9,-13,713,233575,9,233566
71302,14,10,117,960803,14,960789
71303,8,7,397,853376,8,853368
71304,18,-17,942,122426,18,122408
71305,9,-19,404,40312,9,40303
71306,12,-6,97,459796,12,459784
71307,20,-3,25,553998,20,553978
71308,10,14,329,1069105,10,1069095
71309,10,4,437,760045,10,760035
71310,19,-16,161,148114,19,148095
71311,7,-12,988,271163,7,271156
71312,13,15,840,1122916,13,1122903
71313,8,12,11,999240,8,999232
71314,9,-10,76,314384,9,314375
71315,12,-5,790,496725,12,496713
71316,6,13,496,1041403,6,1041397
71317,5,6,100,814346,5,814341
71318,8,-6,986,457845,8,457837
71319,11,18,874,1215323,11,1215312
71320,12,6,293,838017,12,838005
71321,14,-2,678,590225,14,590211
71322,10,19,637,1231716,10,1231706
71323,12,1,35,680081,12,680069
71324,17,-10,304,337262,17,337245
71325,17,-5,66,491346,17,491329
71326,7,-15,375,163571,7,163564
71327,7,4,710,765949,7,765942
71328,7,8,462,885327,7,885320
71329,16,-17,644,120298,16,120282
71330,7,5,527,792578,7,792571
71331,5,7,108,847171,5,847166
71332,5,-15,59,156616,5,156611
71333,20,10,603,964589,20,964569
71334,11,11,712,995926,11,995915
71335,9,19,731,1233722,9,1233713
71336,11,-6,43,459447,11,459436
71337,9,18,252,1192352,9,1192343
71338,16,-5,86,491573,16,491557
71339,17,-15,418,180850,17,180833
71340,13,13,1,1053259,13,1053246
71341,17,11,722,996037,17,996020
71342,6,2,701,703454,6,703448
71343,8,1,186,661249,8,661241
71344,7,-16,819,141574,7,141567
71345,19,-10,88,335834,19,335815
71346,5,17,90,1157200,5,1157195
71347,13,-2,116,585993,13,585980
71348,10,2,3,688612,10,688602
71349,9,4,484,760966,9,760957
71350,12,-10,693,340314,12,340302
71351,17,13,883,1059853,17,1059836
71352,9,-6,862,455193,9,455184
71353,17,-11,666,309033,17,309016
71354,19,2,382,713476,19,713457
71355,14,4,376,775923,14,775909
71356,6,-11,372,289418,6,289412
71357,20,-7,282,430442,20,430422
71358,6,7,18,845113,6,845107
71359,14,10,438,963171,14,963157
71360,19,2,499,714407,19,714388
71361,13,6,419,839127,13,839114
71362,19,5,97,804503,19,804484
71363,9,-5,158,471512,9,471503
71364,6,19,850,1236395,6,1236389
71365,10,3,658,732994,10,732984
71366,15,-2,505,588950,15,588935
71367,9,-19,741,47902,9,47893
71368,13,-10,986,342536,13,342523
71369,15,5,854,809967,15,809952
71370,11,-20,605,27406,11,27395
71371,20,-18,770,90879,20,90859
71372,8,-16,550,135998,8,135990
71373,6,6,325,819609,6,819603
71374,8,13,584,1043375,8,1043367
71375,14,8,788,904166,14,904152
71376,12,-4,494,525797,12,525785
71377,16,-13,204,242553,16,242537
71378,6,-1,706,609094,6,609088
71379,9,-5,639,481869,9,481860
71380,7,8,629,889015,7,889008
71381,18,-6,173,460464,18,460446
71382,15,9,793,934934,15,934919
71383,13,8,294,900286,13,900273
71384,5,-4,814,516751,5,516746
71385,16,-15,361,180408,16,180392
71386,13,8,342,900680,13,900667
71387,19,5,837,809894,19,809875
71388,7,1,89,658950,7,658943
71389,20,1,98,680583,20,680563
71390,18,13,401,1056236,18,1056218
71391,16,15,667,1121689,16,1121673
71392,7,5,161,784900,7,784893
71393,6,3,932,739069,6,739063
71394,9,-17,856,111552,9,111543
71395,15,1,630,684814,15,684799
71396,12,10,736,965534,12,965522
71397,14,-16,780,152639,14,152625
71398,14,-9,413,369780,14,369766
71399,6,-9,621,357386,6,357380
71400,12,12,803,1028009,12,1027997
71401,13,11,753,996296,13,996283
71402,10,-9,744,360091,10,360081
71403,8,4,585,763203,8,763195
71404,20,-1,205,618155,20,618135
71405,5,-11,836,299021,5,299016
71406,10,9,77,908359,10,908349
71407,17,-20,1,1413,17,1396
71408,20,-10,969,342375,20,342355
71409,15,-3,627,558784,15,558769
71410,15,1,867,686561,15,686546
71411,11,2,615,715160,11,715149
71412,13,-18,718,90478,13,90465
71413,6,-14,968,207649,6,207643
71414,17,-16,497,150668,17,150651
71415,16,-9,269,368548,16,368532
71416,15,-11,49,304016,15,304001
71417,9,-16,626,137627,9,137618
71418,10,-4,46,500265,10,500255
71419,5,16,426,1134370,5,1134365
71420,12,-4,191,523531,12,523519
71421,19,-15,205,179217,19,179198
71422,12,15,719,1122128,12,1122116
71423,20,-6,855,465610,20,465590
71424,8,9,465,916440,8,916432
71425,18,-7,973,435534,18,435516
71426,13,-20,535,26853,13,26840
71427,10,-6,684,451519,10,451509
71428,9,-2,244,567994,9,567985
71429,11,17,294,1180180,11,1180169
71430,5,13,803,1048105,5,1048100
71431,5,-10,821,330159,5,330154
71432,18,6,146,836867,18,836849
71433,10,19,428,1227462,10,1227452
71434,10,-9,63,344991,10,344981
71435,19,-11,579,308359,19,308340
71436,18,9,342,931528,18,931510
71437,18,12,937,1029270,18,1029252
71438,5,-19,234,36709,5,36704
71439,10,10,259,942942,10,942932
71440,12,-4,320,524587,12,524575
71441,12,-1,355,619461,12,619449
71442,13,-12,973,279889,13,279876
71443,11,-9,133,367539,11,367528
71444,9,13,624,1044211,9,1044202
71445,19,9,294,931078,19,931059
71446,11,-15,556,181875,11,181864
71447,5,-10,272,318417,5,318412
71448,9,-7,196,409998,9,409989
71449,8,-5,135,471012,8,471004
71450,11,-15,46,178121,11,178110
71451,16,18,180,1210418,16,1210402
71452,11,-14,205,210916,11,210905
71453,20,7,767,872567,20,872547
71454,17,1,46,680152,17,680135
71455,16,19,973,1248613,16,1248597
71456,13,16,962,1153986,13,1153973
71457,19,11,346,993392,19,993373
71458,8,-19,453,41248,8,41240
71459,15,-18,382,88163,15,88148
71460,10,-6,312,443555,10,443545
71461,7,14,209,1066329,7,1066322
71462,17,-1,49,616935,17,616918
71463,15,8,974,905514,15,905499
71464,19,14,477,1089152,19,1089133
71465,15,15,89,1117455,15,1117440
71466,9,-14,814,204357,9,204348
71467,12,-11,355,306607,12,306595
71468,5,-6,799,454037,5,454032
71469,6,7,949,864817,6,864811
71470,7,-5,808,485399,7,485392
71471,19,10,346,962436,19,962417
71472,17,9,570,933255,17,933238
71473,11,16,603,1151355,11,1151344
71474,7,3,268,724661,7,724654
71475,9,7,123,847500,9,847491
71476,16,-16,956,153955,16,153939
71477,5,16,804,1141922,5,1141917
71478,12,13,728,1058664,12,1058652
71479,11,-16,208,148467,11,148456
71480,6,1,396,665827,6,665821
71481,18,16,963,1154011,18,1153993
71482,12,11,19,990996,12,990984
71483,20,3,155,742986,20,742966
71484,7,0,130,628316,7,628309
71485,7,-17,777,110131,7,110124
71486,9,-18,853,80819,9,80810
71487,11,16,210,1148632,11,1148621
71488,15,14,744,1091272,15,1091257
71489,10,-3,416,539627,10,539617
71490,5,7,530,856091,5,856086
71491,11,7,784,872671,11,872660
71492,11,13,770,1059009,11,1058998
71493,17,-7,779,433973,17,433956
71494,18,-7,611,432822,18,432804
71495,13,12,738,1027557,13,1027544
71496,6,0,750,641822,6,641816
71497,15,17,469,1181448,15,1181433
71498,15,-18,875,91577,15,91562
71499,16,13,871,1059742,16,1059726
71500,20,13,390,1056129,20,1056109
71501,8,17,547,1166979,8,1166971
71502,12,4,979,780423,12,780411
71503,8,-9,516,355298,8,355290
71504,10,-10,584,325252,10,325242
71505,18,-12,937,279574,18,279556
71506,8,-19,496,42203,8,42195
71507,18,-17,511,119351,18,119333
71508,7,14,924,1082412,7,1082405
71509,19,-5,145,492053,19,492034
71510,11,8,103,898738,11,898727
71511,14,1,182,681304,14,681290
71512,12,18,103,1209769,12,1209757
71513,13,16,955,1153900,13,1153887
71514,13,-1,405,619800,13,619787
71515,16,-12,195,273883,16,273867
71516,17,-20,731,28416,17,28399
71517,17,-9,878,373535,17,373518
71518,18,-16,2,146730,18,146712
71519,9,-15,120,158099,9,158090
71520,16,-17,550,119626,16,119610
71521,6,0,845,643695,6,643689
71522,15,-5,362,493745,15,493730
71523,10,-1,14,594000,10,593990
71524,7,-19,149,34974,7,34967
71525,6,-10,676,327322,6,327316
71526,14,3,358,744576,14,744562
71527,20,8,379,900948,20,900928
71528,20,-1,286,618851,20,618831
71529,17,-19,319,56466,17,56449
71530,7,12,897,1018832,7,1018825
71531,20,-4,131,523061,20,523041
71532,18,15,403,1119665,18,1119647
71533,5,2,908,707511,5,707506
71534,19,-2,11,585196,19,585177
71535,12,-1,903,623495,12,623483
71536,10,-9,389,352179,10,352169
71537,9,15,622,1107674,9,1107665
71538,20,2,911,717268,20,717248
71539,7,-2,388,570921,7,570914
71540,19,-20,171,24066,19,24047
71541,10,7,523,856017,10,856007
71542,11,17,509,1181740,11,1181729
71543,17,-1,151,617699,17,617682
71544,6,-7,366,413842,6,413836
71545,9,-3,945,551675,9,551666
71546,11,18,519,1212794,11,1212783
71547,13,-18,776,90893,13,90880
71548,20,6,829,842418,20,842398
71549,20,11,917,997563,20,997543
71550,15,-10,473,338634,15,338619
71551,15,6,216,837346,15,837331
71552,19,19,356,1243658,19,1243639
71553,17,15,340,1119284,17,1119267
71554,13,-20,417,25930,13,25917
71555,17,-2,750,590729,17,590712
71556,15,19,188,1242240,15,1242225
71557,9,-8,433,384283,9,384274
71558,15,2,421,713821,15,713806
71559,14,14,374,1088351,14,1088337
71560,6,13,954,1051187,6,1051181
71561,5,17,161,1158643,5,1158638
71562,19,14,986,1093194,19,1093175
71563,10,-15,329,162525,10,162515
71564,11,-12,7,272565,11,272554
71565,18,-1,832,622944,18,622926
71566,19,16,464,1150444,19,1150425
71567,15,18,858,1215213,15,1215198
71568,14,16,215,1148683,14,1148669
71569,7,-12,996,271359,7,271352
71570,8,-7,93,407815,8,407807
71571,11,6,255,837696,11,837685
71572,16,19,592,1245594,16,1245578
71573,8,-18,330,69667,8,69659
71574,19,-3,444,557162,19,557143
71575,17,-2,374,587869,17,587852
71576,6,-6,346,444241,6,444235
71577,15,-18,264,87349,15,87334
71578,7,-2,679,577267,7,577260
71579,8,-1,669,608249,8,608241
71580,14,8,582,902519,14,902505
71581,17,-20,138,23806,17,23789
71582,13,-4,448,525499,13,525486
71583,19,-20,103,23543,19,23524
71584,18,-14,57,209765,18,209747
71585,12,7,517,870882,12,870870
71586,5,6,330,819727,5,819722
71587,15,5,398,806705,15,806690
71588,9,9,438,915912,9,915903
71589,12,-10,338,337521,12,337509
71590,6,-9,270,349510,6,349504
71591,7,-7,682,420251,7,420244
71592,12,19,0,1240600,12,1240588
71593,5,10,610,950664,5,950659
71594,18,-18,713,90446,18,90428
71595,16,10,69,960361,16,960345
71596,15,-1,512,620644,15,620629
71597,14,-18,554,89303,14,89289
71598,17,-12,633,277116,17,277099
71599,16,-10,409,338046,16,338030
71600,10,-3,990,552637,10,552627
71601,7,-1,5,593834,7,593827
71602,19,16,446,1150347,19,1150328
71603,7,-5,741,484036,7,484029
71604,18,-13,851,247369,18,247351
71605,11,18,555,1213024,11,1213013
71606,17,-4,724,527502,17,527485
71607,17,11,747,996203,17,996186
71608,11,-12,598,276872,11,276861
71609,19,-20,179,24178,19,24159
71610,12,-8,610,402154,12,402142
71611,6,14,482,1072579,6,1072573
71612,13,19,787,1247177,13,1247164
71613,9,8,453,885098,9,885089
71614,18,-19,995,61407,18,61389
71615,7,12,226,1004074,7,1004067
71616,16,5,719,809039,16,809023
71617,12,-14,764,215461,12,215449
71618,15,18,202,1210634,15,1210619
71619,7,-7,771,422224,7,422217
71620,14,-18,554,89307,14,89293
71621,9,-14,573,199097,9,199088
71622,18,-12,175,273796,18,273778
71623,20,6,180,837110,20,837090
71624,17,-17,199,116932,17,116915
71625,6,-1,698,608896,6,608890
71626,11,10,305,962092,11,962081
71627,20,19,375,1243811,20,1243791
71628,18,-16,815,152893,18,152875
71629,7,4,841,769113,7,769106
71630,16,-19,616,58843,16,58827
71631,20,9,930,936009,20,935989
71632,6,16,423,1134309,6,1134303
71633,17,18,428,1212194,17,1212177
71634,13,-12,704,277679,13,277666
71635,17,7,64,867489,17,867472
71636,12,-17,122,116440,12,116428
71637,10,14,210,1066354,10,1066344
71638,16,-15,991,185266,16,185250
71639,5,-7,813,423036,5,423031
71640,17,6,724,841656,17,841639
71641,18,16,131,1148018,18,1148000
71642,11,-18,908,91817,11,91806
71643,7,-15,309,162096,7,162089
71644,15,8,545,902236,15,902221
71645,14,-10,146,336205,14,336191
71646,20,-13,9,241102,20,241082
71647,10,0,568,637591,10,637581
71648,15,-19,726,59645,15,59630
71649,10,4,360,758341,10,758331
71650,12,-6,297,461494,12,461482
71651,16,-15,949,185019,16,185003
71652,6,-6,25,437441,6,437435
71653,7,11,307,974920,7,974913
71654,11,3,704,747194,11,747183
71655,16,8,96,898693,16,898677
71656,16,-4,593,526550,16,526534
71657,10,17,564,1167288,10,1167278
71658,15,-5,29,491038,15,491023
71659,17,4,226,774923,17,774906
71660,8,18,739,1202209,8,1202201
71661,11,6,253,837666,11,837655
71662,14,16,235,1148781,14,1148767
71663,18,4,384,776006,18,775988
71664,7,13,405,1039506,7,1039499
71665,9,15,925,1114143,9,1114134
71666,13,15,287,1118914,13,1118901
71667,10,-2,781,579399,10,579389
71668,18,16,187,1148468,18,1148450
71669,15,-12,732,277849,15,277834
71670,15,6,579,840475,15,840460
71671,16,13,737,1058726,16,1058710
71672,10,-5,676,482636,10,482626
71673,13,-8,609,402138,13,402125
71674,18,8,347,900739,18,900721
71675,19,19,405,1244124,19,1244105
71676,6,10,515,948516,6,948510
71677,14,-9,706,372008,14,371994
71678,9,-19,477,41803,9,41794
71679,18,14,592,1089988,18,1089970
71680,15,-16,980,154142,15,154127
71681,13,-13,921,247967,13,247954
71682,18,-11,607,308590,18,308572
71683,6,0,907,645061,6,645055
71684,13,-20,996,30418,13,30405
71685,18,5,48,804153,18,804135
71686,10,-9,200,347845,10,347835
71687,16,-13,222,242684,16,242668
71688,8,2,12,688779,8,688771
71689,17,19,740,1246806,17,1246789
71690,11,-8,749,403191,11,403180
71691,6,-8,88,377288,6,377282
71692,13,4,599,777634,13,777621
71693,5,-10,159,316104,5,316099
71694,9,-15,984,176440,9,176431
71695,12,7,536,870965,12,870953
71696,6,-8,940,395437,6,395431
71697,13,3,771,747652,13,747639
71698,11,16,836,1153139,11,1153128
71699,9,-3,950,551784,9,551775
71700,15,-9,589,371312,15,371297
71701,7,-6,823,454485,7,454478
71702,11,-7,333,430858,11,430847
71703,11,6,573,840416,11,840405
71704,8,8,212,879800,8,879792
71705,19,4,582,777480,19,777461
71706,6,-7,81,407592,6,407586
71707,10,-10,663,327079,10,327069
71708,13,15,663,1121664,13,1121651
71709,14,10,739,965558,14,965544
71710,20,14,220,1087122,20,1087102
71711,15,7,500,870711,15,870696
71712,8,12,306,1005934,8,1005926
71713,18,11,825,996815,18,996797
71714,18,-19,114,54898,18,54880
71715,5,2,821,705716,5,705711
71716,6,10,922,957364,6,957358
71717,10,3,575,731094,10,731084
71718,15,17,855,1184423,15,1184408
71719,14,-4,226,523874,14,523860
71720,9,15,340,1101769,9,1101760
71721,6,19,850,1236401,6,1236395
71722,16,-3,896,560973,16,560957
71723,18,-10,751,340747,18,340729
71724,20,0,564,652504,20,652484
71725,6,13,693,1045632,6,1045626
71726,14,17,822,1184117,14,1184103
71727,14,-2,784,591032,14,591018
71728,9,5,841,799210,9,799201
71729,6,12,169,1002864,6,1002858
71730,13,15,555,1120805,13,1120792
71731,6,4,56,751782,6,751776
71732,20,-8,692,402793,20,402773
71733,12,0,180,649628,12,649616
71734,13,-2,290,587324,13,587311
71735,13,3,229,743619,13,743606
71736,19,15,852,1122984,19,1122965
71737,8,-20,645,14134,8,14126
71738,19,19,65,1241268,19,1241249
71739,10,3,460,728685,10,728675
71740,15,-8,631,402309,15,402294
71741,10,15,552,1106195,10,1106185
71742,7,11,159,971745,7,971738
71743,17,6,874,842740,17,842723
71744,15,-12,738,277886,15,277871
71745,20,-1,875,623263,20,623243
71746,5,18,684,1201120,5,1201115
71747,17,18,959,1216031,17,1216014
71748,9,19,441,1227775,9,1227766
71749,19,12,758,1027675,19,1027656
71750,6,-13,662,232383,6,232377
71751,12,3,661,746838,12,746826
71752,12,-13,778,246841,12,246829
71753,9,17,600,1168094,9,1168085
71754,11,3,193,743350,11,743339
71755,5,12,350,1006785,5,1006780
71756,18,8,615,902800,18,902782
71757,15,3,213,743494,15,743479
71758,19,6,9,835819,19,835800
71759,10,-6,322,443739,10,443729
71760,20,11,66,991378,20,991358
71761,7,-2,399,571151,7,571144
71762,10,-15,618,168698,10,168688
71763,8,-9,450,353586,8,353578
71764,12,-5,160,492194,12,492182
71765,14,-13,261,243008,14,242994
71766,7,6,191,816362,7,816355
71767,20,-9,472,370368,20,370348
71768,5,17,978,1176362,5,1176357
71769,6,8,60,876356,6,876350
71770,16,-3,831,560439,16,560423
71771,13,-12,688,277571,13,277558
71772,6,14,79,1063582,6,1063576
71773,6,-13,220,223031,6,223025
71774,6,18,96,1188841,6,1188835
71775,17,-1,803,622745,17,622728
71776,17,0,927,655325,17,655308
71777,18,-14,40,209624,18,209606
71778,8,-1,807,611187,8,611179
71779,20,1,748,685696,20,685676
71780,14,-12,107,273314,14,273300
71781,7,-6,207,441410,7,441403
71782,8,2,629,701948,8,701940
71783,15,-15,958,185099,15,185084
71784,9,-6,670,451159,9,451150
71785,20,16,205,1148607,20,1148587
71786,18,-19,822,60297,18,60279
71787,13,8,627,902931,13,902918
71788,14,-2,481,588771,14,588757
71789,18,-6,782,465126,18,465108
71790,7,-10,797,329660,7,329653
71791,5,-12,406,258468,5,258463
71792,15,1,625,684772,15,684757
71793,15,3,391,744828,15,744813
71794,9,-19,537,43167,9,43158
71795,10,-1,394,602620,10,602610
71796,18,12,658,1026933,18,1026915
71797,11,3,759,747590,11,747579
71798,8,-3,56,531720,8,531712
71799,15,-9,854,373335,15,373320
71800,10,13,860,1049266,10,1049256
71801,10,-8,555,387072,10,387062
71802,17,-7,40,428642,17,428625
71803,7,14,723,1078294,7,1078287
71804,11,-18,989,92416,11,92405
71805,20,-16,770,152561,20,152541
71806,12,-11,414,307055,12,307043
71807,17,7,18,867150,17,867133
71808,11,-13,182,242399,11,242388
71809,9,-8,133,378249,9,378240
71810,11,16,41,1147349,11,1147338
71811,20,-2,614,589775,20,589755
71812,8,14,730,1078442,8,1078434
71813,9,-9,614,357310,9,357301
71814,19,10,621,964712,19,964693
71815,15,-2,492,588861,15,588846
71816,15,-1,692,621896,15,621881
71817,14,-12,555,276631,14,276617
71818,16,-17,613,120094,16,120078
71819,8,-14,181,190380,8,190372
71820,20,-11,523,307898,20,307878
71821,17,-18,183,86725,17,86708
71822,5,-5,858,486605,5,486600
71823,18,-20,535,26861,18,26843
71824,10,16,337,1132286,10,1132276
71825,20,16,563,1151105,20,1151085
71826,14,-1,856,623111,14,623097
71827,19,0,531,652239,19,652220
71828,12,-12,93,273215,12,273203
71829,9,0,484,635885,9,635876
71830,9,7,961,865067,9,865058
71831,15,-5,917,497774,15,497759
71832,5,4,798,767966,5,767961
71833,19,-2,42,585471,19,585452
71834,11,3,816,747980,11,747969
71835,13,17,863,1184500,13,1184487
71836,10,-11,532,292989,10,292979
71837,17,10,598,964545,17,964528
71838,11,-12,59,272947,11,272936
71839,8,14,596,1075090,8,1075082
71840,20,-7,993,435677,20,435657
71841,13,11,628,995325,13,995312
71842,16,-8,328,400211,16,400195
71843,17,19,669,1246203,17,1246186
71844,17,-15,42,178102,17,178085
71845,5,-17,784,110226,5,110221
71846,8,10,610,950672,8,950664
71847,7,6,337,819964,7,819957
71848,19,-18,651,90008,19,89989
71849,5,-10,212,317273,5,317268
71850,11,-1,80,617204,11,617193
71851,16,-3,828,560407,16,560391
71852,19,15,101,1117552,19,1117533
71853,14,-5,29,491042,14,491028
71854,20,-1,26,616735,20,616715
71855,7,19,925,1237998,7,1237991
71856,12,7,462,870465,12,870453
71857,8,2,677,702929,8,702921
71858,16,17,474,1181470,16,1181454
71859,11,0,407,651155,11,651144
71860,6,-13,309,224964,6,224958
71861,19,-1,976,623971,19,623952
71862,20,-6,27,459381,20,459361
71863,9,-10,486,323220,9,323211
71864,13,2,609,715123,13,715110
71865,15,-10,408,338023,15,338008
71866,15,15,481,1120210,15,1120195
71867,17,13,984,1060498,17,1060481
71868,13,-16,599,151426,13,151413
71869,17,13,691,1058411,17,1058394
71870,18,-17,560,119696,18,119678
71871,14,16,50,1147448,14,1147434
71872,12,-16,656,151787,12,151775
71873,8,-5,359,475983,8,475975
71874,19,2,498,714392,19,714373
71875,5,19,221,1222457,5,1222452
71876,10,-5,637,481799,10,481789
71877,10,-18,997,84135,10,84125
71878,16,7,471,870526,16,870510
71879,19,19,435,1244436,19,1244417
71880,19,12,394,1024940,19,1024921
71881,17,5,882,810202,17,810185
71882,9,1,762,673593,9,673584
71883,9,14,476,1072389,9,1072380
71884,19,-15,339,180260,19,180241
71885,19,-19,307,56373,19,56354
71886,16,-16,248,148790,16,148774
71887,19,-10,724,340529,19,340510
71888,12,-15,914,184740,12,184728
71889,19,-5,549,495071,19,495052
71890,5,11,885,987584,5,987579
71891,12,13,424,1056400,12,1056388
71892,17,-5,653,495783,17,495766
71893,13,10,171,961187,13,961174
71894,7,18,295,1193224,7,1193217
71895,17,7,127,867929,17,867912
71896,7,5,764,797598,7,797591
71897,8,16,121,1127578,8,1127570
71898,14,1,918,687024,14,687010
71899,10,1,926,677194,10,677184
71900,7,-7,28,406715,7,406708
71901,17,-10,561,339265,17,339248
71902,7,-17,406,102080,7,102073
71903,17,-11,759,309635,17,309618
71904,11,-10,257,336990,11,336979
71905,7,5,641,794887,7,794880
71906,11,2,166,711853,11,711842
71907,19,17,997,1185471,19,1185452
71908,6,8,439,884855,6,884849
71909,7,9,12,906987,7,906980
71910,11,0,270,650165,11,650154
71911,15,-9,523,370837,15,370822
71912,8,-15,605,168409,8,168401
71913,7,11,667,982646,7,982639
71914,6,13,909,1050183,6,1050177
71915,7,-6,327,443863,7,443856
71916,12,8,66,898380,12,898368
71917,5,-1,54,594949,5,594944
71918,6,17,661,1169503,6,1169497
71919,14,17,599,1182326,14,1182312
71920,7,10,403,946167,7,946160
71921,10,-9,759,360516,10,360506
71922,16,19,644,1246022,16,1246006
71923,19,10,616,964664,19,964645
71924,17,19,942,1248367,17,1248350
71925,8,11,845,986578,8,986570
71926,11,-15,376,180572,11,180561
71927,17,-5,81,491499,17,491482
71928,12,7,858,873192,12,873180
71929,12,4,236,774996,12,774984
71930,5,-7,802,422763,5,422758
71931,20,4,205,774717,20,774697
71932,13,-8,618,402216,13,402203
71933,9,0,492,636101,9,636092
71934,19,1,649,684972,19,684953
71935,11,-16,433,150184,11,150173
71936,7,4,246,756033,7,756026
71937,13,-14,377,212463,13,212450
71938,15,-2,957,592431,15,592416
71939,10,17,438,1164668,10,1164658
71940,6,12,340,1006621,6,1006615
71941,16,-11,844,310293,16,310277
71942,17,-1,282,618781,17,618764
71943,10,5,8,781789,10,781779
71944,6,7,488,855330,6,855324
71945,17,10,208,961418,17,961401
71946,9,18,23,1187066,9,1187057
71947,6,19,806,1235335,6,1235329
71948,10,6,586,825519,10,825509
71949,15,13,717,1058579,15,1058564
71950,9,19,122,1220165,9,1220156
71951,10,-4,217,504283,10,504273
71952,7,7,13,845060,7,845053
71953,12,-3,516,557788,12,557776
71954,19,-15,184,179101,19,179082
71955,6,4,623,764134,6,764128
71956,15,-16,614,151557,15,151542
71957,20,8,398,901135,20,901115
71958,13,10,860,966422,13,966409
71959,11,-4,250,524066,11,524055
71960,9,19,952,1238625,9,1238616
71961,17,-19,277,56168,17,56151
71962,20,-8,180,399202,20,399182
71963,5,16,573,1137247,5,1137242
71964,11,18,113,1209883,11,1209872
71965,8,12,98,1001239,8,1001231
71966,16,-13,401,243941,16,243925
71967,16,1,353,682695,16,682679
71968,8,8,226,880096,8,880088
71969,6,-2,902,582120,6,582114
71970,7,18,101,1188958,7,1188951
71971,9,-12,778,266327,9,266318
71972,12,-5,210,492511,12,492499
71973,7,-7,931,425703,7,425696
71974,11,7,110,867823,11,867812
71975,15,-6,797,465253,15,465238
71976,8,9,930,926526,8,926518
71977,13,-19,468,57578,13,57565
71978,10,16,125,1127660,10,1127650
71979,8,-3,908,550772,8,550764
71980,11,-10,595,339503,11,339492
71981,12,10,293,962020,12,962008
71982,5,-9,144,346664,5,346659
71983,9,15,174,1098220,9,1098211
71984,15,-15,261,179641,15,179626
71985,10,4,850,769431,10,769421
71986,9,4,931,771016,9,771007
71987,6,3,532,729980,6,729974
71988,12,-5,275,493062,12,493050
71989,18,-8,315,400106,18,400088
71990,15,-1,480,620426,15,620411
71991,11,-3,644,558922,11,558911
71992,7,-13,548,230015,7,230008
71993,15,-5,751,496522,15,496507
71994,19,17,30,1178093,19,1178074
71995,17,8,31,898111,17,898094
71996,5,-5,656,482232,5,482227
71997,7,5,5,781703,7,781696
71998,17,6,500,839802,17,839785
71999,10,-1,438,603550,10,603540
72000,10,-17,909,112761,10,112751
72001,17,4,215,774828,17,774811
72002,9,5,443,790795,9,790786
72003,15,-6,414,462317,15,462302
72004,14,10,711,965340,14,965326
72005,16,-19,3,53904,16,53888
72006,12,-10,73,335749,12,335737
72007,18,6,264,837775,18,837757
72008,6,7,86,846696,6,846690
72009,7,14,278,1068030,7,1068023
72010,15,4,24,773429,15,773414
72011,18,1,641,684907,18,684889
72012,17,14,58,1085866,17,1085849
72013,12,-14,922,216695,12,216683
72014,16,12,835,1028290,16,1028274
72015,11,5,91,804477,11,804466
72016,17,17,215,1179483,17,1179466
72017,11,-18,719,90497,11,90486
72018,14,-20,663,27906,14,27892
72019,9,5,697,796107,9,796098
72020,12,1,364,682792,12,682780
72021,9,-5,359,475992,9,475983
72022,13,13,139,1054213,13,1054200
72023,17,-12,949,279687,17,279670
72024,7,6,349,820191,7,820184
72025,8,-17,755,109706,8,109698
72026,9,-12,960,270489,9,270480
72027,7,14,243,1067225,7,1067218
72028,15,10,757,965659,15,965644
72029,13,-14,878,216361,13,216348
72030,13,-9,690,371897,13,371884
72031,16,12,637,1026764,16,1026748
72032,7,-20,281,6313,7,6306
72033,19,13,340,1055735,19,1055716
72034,11,-8,889,404181,11,404170
72035,15,10,897,966667,15,966652
72036,20,1,2,679769,20,679749
72037,11,-2,136,586116,11,586105
72038,12,0,614,652909,12,652897
72039,11,9,477,932487,11,932476
72040,15,-12,900,279281,15,279266
72041,15,9,581,933344,15,933329
72042,18,-18,635,89874,18,89856
72043,19,-14,409,212757,19,212738
72044,6,16,629,1138382,6,1138376
72045,11,-13,522,244903,11,244892
72046,6,12,81,1000872,6,1000866
72047,20,-6,176,460508,20,460488
72048,16,6,398,838985,16,838969
72049,5,0,110,627867,5,627862
72050,6,-11,85,282876,6,282870
72051,15,-3,657,559033,15,559018
72052,5,8,591,888119,5,888114
72053,6,17,789,1172146,6,1172140
72054,15,8,126,898925,15,898910
72055,11,-14,8,209404,11,209393
72056,11,-12,968,279853,11,279842
72057,8,8,862,893903,8,893895
72058,17,-2,881,591889,17,591872
72059,13,-2,531,589128,13,589115
72060,7,18,676,1200914,7,1200907
72061,9,-1,105,596080,9,596071
72062,18,-2,394,588027,18,588009
72063,16,-9,304,368807,16,368791
72064,13,-9,783,372744,13,372731
72065,5,-1,910,613590,5,613585
72066,16,3,691,747142,16,747126
72067,12,16,523,1150827,12,1150815
72068,20,17,531,1181841,20,1181821
72069,6,5,582,793699,6,793693
72070,13,-4,213,523756,13,523743
72071,9,14,340,1069343,9,1069334
72072,12,-2,914,592105,12,592093
72073,13,17,270,1179945,13,1179932
72074,10,6,431,822106,10,822096
72075,17,-1,995,624125,17,624108
72076,18,-10,423,338173,18,338155
72077,6,-8,75,377141,6,377135
72078,18,3,992,749468,18,749450
72079,11,-17,817,121628,11,121617
72080,20,8,207,899618,20,899598
72081,15,6,863,842659,15,842644
72082,7,-3,97,532488,7,532481
72083,8,-13,593,231024,8,231016
72084,18,19,972,1248587,18,1248569
72085,10,8,307,881971,10,881961
72086,8,8,39,875916,8,875908
72087,19,-5,281,493108,19,493089
72088,10,-5,247,473459,10,473449
72089,11,-6,270,461295,11,461284
72090,19,-15,661,182732,19,182713
72091,14,-5,107,491759,14,491745
72092,14,7,835,873039,14,873025
72093,6,19,750,1234122,6,1234116
72094,19,-18,654,90038,19,90019
72095,13,15,128,1117774,13,1117761
72096,10,2,126,691330,10,691320
72097,11,5,16,803894,11,803883
72098,10,7,895,863805,10,863795
72099,8,-8,733,391088,8,391080
72100,19,-16,250,148824,19,148805
72101,11,-18,291,87492,11,87481
72102,5,12,744,1015317,5,1015312
72103,10,-10,835,330550,10,330540
72104,9,-11,349,288806,9,288797
72105,7,-3,656,545236,7,545229
72106,17,-11,294,306026,17,306009
72107,19,-4,186,523516,19,523497
72108,13,2,121,711505,13,711492
72109,12,-6,760,464951,12,464939
72110,11,-2,235,586911,11,586900
72111,11,-10,249,336908,11,336897
72112,5,17,127,1157938,5,1157933
72113,15,8,158,899206,15,899191
72114,9,7,894,863764,9,863755
72115,15,-5,646,495754,15,495739
72116,10,-7,969,426549,10,426539
72117,10,5,819,798754,10,798744
72118,15,-11,394,306875,15,306860
72119,15,0,19,648357,15,648342
72120,15,-5,830,497053,15,497038
72121,12,-2,469,588672,12,588660
72122,8,13,629,1044348,8,1044340
72123,11,-7,726,433583,11,433572
72124,11,-18,372,88079,11,88068
72125,17,-13,768,246742,17,246725
72126,18,7,237,868665,18,868647
72127,5,-1,929,614041,5,614036
72128,6,-6,796,453876,6,453870
72129,10,-12,248,254857,10,254847
72130,16,6,590,840542,16,840526
72131,19,18,484,1212528,19,1212509
72132,15,17,248,1179732,15,1179717
72133,7,-13,657,232289,7,232282
72134,18,-10,751,340755,18,340737
72135,16,3,258,743804,16,743788
72136,13,-3,753,559807,13,559794
72137,20,-5,859,497282,20,497262
72138,16,-7,228,430006,16,429990
72139,12,13,156,1054349,12,1054337
72140,15,18,786,1214674,15,1214659
72141,17,-10,878,341703,17,341686
72142,6,16,782,1141330,6,1141324
72143,10,3,131,721640,10,721630
72144,17,11,193,992210,17,992193
72145,14,-7,194,429743,14,429729
72146,14,9,724,934377,14,934363
72147,17,-15,241,179502,17,179485
72148,14,-19,344,56696,14,56682
72149,15,15,342,1119309,15,1119294
72150,8,-7,590,418526,8,418518
72151,10,1,795,674307,10,674297
72152,7,11,425,977584,7,977577
72153,16,-15,8,177877,16,177861
72154,7,-13,539,229787,7,229780
72155,15,17,315,1180337,15,1180322
72156,7,-14,729,202600,7,202593
72157,7,6,180,816111,7,816104
72158,16,17,625,1182497,16,1182481
72159,13,-19,677,59260,13,59247
72160,17,-10,493,338722,17,338705
72161,13,1,43,680122,13,680109
72162,20,19,985,1248684,20,1248664
72163,14,-15,237,179453,14,179439
72164,13,17,661,1182782,13,1182769
72165,16,-6,285,461409,16,461393
72166,10,-9,481,354476,10,354466
72167,8,4,823,768588,8,768580
72168,8,-14,961,207424,8,207416
72169,5,-13,43,219312,5,219307
72170,12,-20,963,30076,12,30064
72171,19,8,662,903188,19,903169
72172,5,-17,57,94634,5,94629
72173,5,10,138,940666,5,940661
72174,10,15,837,1112259,10,1112249
72175,7,4,616,763985,7,763978
72176,16,-9,211,368049,16,368033
72177,18,-18,302,87580,18,87562
72178,9,-17,924,113013,9,113004
72179,6,-4,898,518716,6,518710
72180,20,-13,869,247517,20,247497
72181,16,1,77,680353,16,680337
72182,20,15,900,1123356,20,1123336
72183,18,-9,799,372876,18,372858
72184,17,-1,382,619619,17,619602
72185,7,-17,707,108632,7,108625
72186,20,15,474,1120129,20,1120109
72187,13,-15,409,180785,13,180772
72188,13,-18,438,88535,13,88522
72189,16,7,475,870596,16,870580
72190,6,3,516,729763,6,729757
72191,16,-12,9,272572,16,272556
72192,14,6,869,842705,14,842691
72193,10,-11,441,290989,10,290979
72194,11,-5,962,498091,11,498080
72195,13,-16,119,147808,13,147795
72196,8,7,605,857660,8,857652
72197,13,-6,780,465111,13,465098
72198,12,17,897,1184695,12,1184683
72199,19,-18,335,87814,19,87795
72200,17,9,269,930901,17,930884
72201,6,-9,556,356204,6,356198
72202,17,-2,781,591009,17,590992
72203,5,-5,639,481874,5,481869
72204,10,17,108,1157564,10,1157554
72205,7,13,404,1039460,7,1039453
72206,16,15,603,1121208,16,1121192
72207,6,0,560,637439,6,637433
72208,7,2,143,691660,7,691653
72209,8,-2,944,583104,8,583096
72210,18,-9,897,373676,18,373658
72211,18,-18,459,88745,18,88727
72212,14,-4,416,525353,14,525339
72213,8,-1,190,597790,8,597782
72214,14,-18,824,91258,14,91244
72215,5,-7,977,426764,5,426759
72216,13,3,567,746056,13,746043
72217,14,-9,343,369217,14,369203
72218,20,10,243,961634,20,961614
72219,17,-20,652,27774,17,27757
72220,6,-6,810,454236,6,454230
72221,11,12,347,1024628,11,1024617
72222,12,-6,226,460890,12,460878
72223,11,-1,504,620575,11,620564
72224,16,17,17,1177982,16,1177966
72225,10,-13,691,232908,10,232898
72226,18,1,754,685733,18,685715
72227,6,8,90,876963,6,876957
72228,6,-5,379,476351,6,476345
72229,6,-16,784,140890,6,140884
72230,18,-11,316,306302,18,306284
72231,8,-10,508,323718,8,323710
72232,20,-13,259,242989,20,242969
72233,17,-8,145,398945,17,398928
72234,7,0,874,644263,7,644256
72235,16,8,641,903077,16,903061
72236,12,0,915,655234,12,655222
72237,19,-18,943,92074,19,92055
72238,18,-14,540,213640,18,213622
72239,17,14,365,1088288,17,1088271
72240,6,0,318,631984,6,631978
72241,9,18,263,1192598,9,1192589
72242,20,-12,451,275770,20,275750
72243,15,-2,822,591358,15,591343
72244,20,-8,179,399186,20,399166
72245,17,-12,294,274687,17,274670
72246,19,7,515,870848,19,870829
72247,9,-10,109,314916,9,314907
72248,8,11,448,977966,8,977958
72249,16,-8,539,401663,16,401647
72250,16,12,849,1028476,16,1028460
72251,14,-20,995,30412,14,30398
72252,8,0,820,643200,8,643192
72253,15,-5,563,495194,15,495179
72254,13,-2,396,588056,13,588043
72255,15,17,634,1182561,15,1182546
72256,20,9,504,932752,20,932732
72257,19,7,558,871126,19,871107
72258,9,16,830,1142458,9,1142449
72259,20,10,556,964123,20,964103
72260,9,16,620,1138176,9,1138167
72261,15,-20,400,25849,15,25834
72262,18,-14,263,211481,18,211463
72263,20,4,122,774123,20,774103
72264,14,8,967,905476,14,905462
72265,20,12,820,1028145,20,1028125
72266,8,-19,280,37666,8,37658
72267,11,-5,939,497927,11,497916
72268,17,2,72,711115,17,711098
72269,12,8,648,903110,12,903098
72270,10,4,631,764313,10,764303
72271,11,-7,557,432509,11,432498
72272,16,3,644,746698,16,746682
72273,10,-9,58,344885,10,344875
72274,5,-16,695,138923,5,138918
72275,5,15,146,1097662,5,1097657
72276,16,-18,308,87637,16,87621
72277,10,-14,549,198393,10,198383
72278,19,-14,561,213861,19,213842
72279,13,2,106,711395,13,711382
72280,19,15,15,1116877,19,1116858
72281,12,-7,283,430454,12,430442
72282,12,-7,998,435758,12,435746
72283,20,4,1000,780576,20,780556
72284,5,-16,259,129664,5,129659
72285,15,17,194,1179351,15,1179336
72286,19,-11,709,309273,19,309254
72287,12,12,106,1022821,12,1022809
72288,13,-10,782,340946,13,340933
72289,9,7,620,857945,9,857936
72290,5,11,15,968770,5,968765
72291,8,-20,939,20678,8,20670
72292,20,-5,338,493657,20,493637
72293,11,3,947,749067,11,749056
72294,20,-4,729,527542,20,527522
72295,9,-3,562,543131,9,543122
72296,15,-2,722,590583,15,590568
72297,9,-20,581,12683,9,12674
72298,20,10,799,966104,20,966084
72299,17,-10,301,337237,17,337220
72300,5,-3,73,532082,5,532077
72301,15,-18,74,85798,15,85783
72302,9,-15,668,169757,9,169748
72303,15,-3,338,556284,15,556269
72304,6,15,59,1095764,6,1095758
72305,20,6,609,840674,20,840654
72306,10,6,199,816556,10,816546
72307,19,16,828,1153070,19,1153051
72308,7,-11,838,299087,7,299080
72309,15,0,34,648533,15,648518
72310,17,-5,709,496213,17,496196
72311,9,14,718,1078191,9,1078182
72312,16,-1,326,619160,16,619144
72313,16,13,655,1058194,16,1058178
72314,15,1,522,683991,15,683976
72315,6,2,595,701117,6,701111
72316,13,12,402,1024997,13,1024984
72317,19,3,81,742435,19,742416
72318,20,1,794,686041,20,686021
72319,16,0,672,653386,16,653370
72320,8,-8,109,377654,8,377646
72321,7,8,624,888833,7,888826
72322,15,-17,924,122325,15,122310
72323,14,8,342,900684,14,900670
72324,19,-4,483,525713,19,525694
72325,19,17,204,1179419,19,1179400
72326,6,4,508,761497,6,761491
72327,15,-11,11,303783,15,303768
72328,18,8,60,898338,18,898320
72329,6,-11,930,301077,6,301071
72330,20,-17,421,118549,20,118529
72331,13,-1,567,621027,13,621014
72332,13,16,802,1152893,13,1152880
72333,6,1,290,663472,6,663466
72334,13,-8,324,400180,13,400167
72335,7,-14,944,207028,7,207021
72336,7,-8,485,385395,7,385388
72337,5,-18,637,76088,5,76083
72338,10,6,768,829560,10,829550
72339,10,8,628,888963,10,888953
72340,18,12,209,1023588,18,1023570
72341,19,10,131,960913,19,960894
72342,20,14,976,1093106,20,1093086
72343,13,12,719,1027437,13,1027424
72344,11,-9,625,371488,11,371477
72345,8,4,723,766295,8,766287
72346,12,5,177,805100,12,805088
72347,11,-7,433,431572,11,431561
72348,17,-14,691,214947,17,214930
72349,9,2,223,693395,9,693386
72350,11,1,907,686917,11,686906
72351,19,-5,887,497552,19,497533
72352,5,-18,812,79976,5,79971
72353,16,11,608,995213,16,995197
72354,5,-1,637,607619,5,607614
72355,14,5,364,806452,14,806438
72356,13,18,471,1212440,13,1212427
72357,12,12,158,1023193,12,1023181
72358,19,19,306,1243236,19,1243217
72359,11,6,298,838058,11,838047
72360,16,-15,372,180516,16,180500
72361,14,13,172,1054474,14,1054460
72362,15,-8,62,398413,15,398398
72363,18,-17,432,118673,18,118655
72364,8,15,198,1098716,8,1098708
72365,11,11,319,993189,11,993178
72366,18,1,483,683683,18,683665
72367,12,-9,398,369680,12,369668
72368,10,7,934,864559,10,864549
72369,18,14,408,1088643,18,1088625
72370,13,1,156,681122,13,681109
72371,12,19,566,1245396,12,1245384
72372,15,-4,880,528673,15,528658
72373,18,-1,155,617726,18,617708
72374,9,-17,238,98528,9,98519
72375,9,-5,758,484333,9,484324
72376,13,-13,212,242587,13,242574
72377,17,6,213,837311,17,837294
72378,7,-15,839,173250,7,173243
72379,17,6,626,840814,17,840797
72380,20,8,281,900215,20,900195
72381,15,-19,942,61100,15,61085
72382,15,-17,328,117917,15,117902
72383,20,-18,407,88343,20,88323
72384,16,-16,340,149396,16,149380
72385,11,-20,145,23875,11,23864
72386,8,-6,481,447113,8,447105
72387,18,12,376,1024845,18,1024827
72388,13,-6,133,460104,13,460091
72389,15,-11,866,310517,15,310502
72390,20,-12,176,273812,20,273792
72391,14,1,623,684756,14,684742
72392,14,-5,270,493034,14,493020
72393,8,-18,613,75558,8,75550
72394,12,-9,462,370219,12,370207
72395,15,-8,590,401970,15,401955
72396,13,9,379,931813,13,931800
72397,7,17,842,1173499,7,1173492
72398,13,7,102,867759,13,867746
72399,10,2,972,708977,10,708967
72400,13,-15,288,179877,13,179864
72401,16,-8,616,402194,16,402178
72402,15,-7,717,433538,15,433523
72403,7,2,477,698847,7,698840
72404,6,2,310,695301,6,695295
72405,6,-3,351,538088,6,538082
72406,9,8,910,894987,9,894978
72407,9,0,111,627885,9,627876
72408,20,4,344,775706,20,775686
72409,13,14,238,1087285,13,1087272
72410,15,16,583,1151207,15,1151192
72411,12,-5,448,494303,12,494291
72412,7,17,97,1157310,7,1157303
72413,9,-3,46,531551,9,531542
72414,19,1,400,683036,19,683017
72415,19,-8,563,401816,19,401797
72416,10,-9,268,349466,10,349456
72417,6,-10,959,333035,6,333029
72418,15,-17,996,122743,15,122728
72419,13,9,648,933834,13,933821
72420,19,-6,842,465520,19,465501
72421,9,-17,286,99613,9,99604
72422,12,17,429,1181125,12,1181113
72423,20,-13,325,243471,20,243451
72424,9,16,290,1131308,9,1131299
72425,18,17,271,1179964,18,1179946
72426,15,19,163,1242069,15,1242054
72427,14,19,589,1245582,14,1245568
72428,8,-7,940,425898,8,425890
72429,12,8,7,897958,12,897946
72430,5,-14,165,190035,5,190030
72431,7,-16,985,145173,7,145166
72432,18,-4,459,525552,18,525534
72433,17,16,530,1150864,17,1150847
72434,15,-9,113,367414,15,367399
72435,6,19,38,1218239,6,1218233
72436,9,6,622,826373,9,826364
72437,9,4,955,771484,9,771475
72438,12,2,260,712527,12,712515
72439,11,-14,876,216337,11,216326
72440,17,-7,870,434673,17,434656
72441,5,-11,203,285523,5,285518
72442,13,17,866,1184501,13,1184488
72443,20,10,328,962318,20,962298
72444,12,6,433,839220,12,839208
72445,8,-9,64,345008,8,345000
72446,8,-3,172,534094,8,534086
72447,17,-1,329,619187,17,619170
72448,14,10,214,961473,14,961459
72449,7,-6,425,445890,7,445883
72450,9,-19,627,45333,9,45324
72451,10,-13,67,219787,10,219777
72452,5,8,548,887229,5,887224
72453,17,0,745,654030,17,654013
72454,20,2,490,714303,20,714283
72455,13,3,371,744659,13,744646
72456,19,10,28,960069,19,960050
72457,15,-4,145,523137,15,523122
72458,16,1,277,682077,16,682061
72459,18,8,895,904922,18,904904
72460,9,-12,322,256658,9,256649
72461,11,10,430,963114,11,963103
72462,10,13,117,1033240,10,1033230
72463,17,7,859,873206,17,873189
72464,16,-16,788,152710,16,152694
72465,13,-15,697,182922,13,182909
72466,16,9,817,935122,16,935106
72467,10,13,902,1050064,10,1050054
72468,13,13,852,1059612,13,1059599
72469,17,-11,598,308500,17,308483
72470,19,18,532,1212882,19,1212863
72471,19,-14,994,217234,19,217215
72472,10,15,99,1096600,10,1096590
72473,20,18,187,1210504,20,1210484
72474,14,-3,928,561216,14,561202
72475,16,-5,461,494467,16,494451
72476,7,-20,30,695,7,688
72477,5,5,431,790481,5,790476
72478,20,-15,774,183553,20,183533
72479,16,-17,114,116422,16,116406
72480,15,-12,648,277280,15,277265
72481,18,14,808,1091810,18,1091792
72482,19,-20,551,27009,19,26990
72483,5,11,643,982180,5,982175
72484,12,-18,895,91701,12,91689
72485,10,-7,959,426350,10,426340
72486,16,1,997,687538,16,687522
72487,17,6,370,838662,17,838645
72488,18,-10,446,338350,18,338332
72489,16,-5,572,495247,16,495231
72490,18,-17,410,118488,18,118470
72491,12,9,905,935800,12,935788
72492,8,7,455,854559,8,854551
72493,16,-16,905,153594,16,153578
72494,13,-19,767,59985,13,59972
72495,18,-19,436,57368,18,57350
72496,7,-10,847,330747,7,330740
72497,18,5,689,808826,18,808808
72498,15,-18,246,87249,15,87234
72499,20,4,530,777119,20,777099
72500,6,0,882,644507,6,644501
72501,18,17,647,1182662,18,1182644
72502,6,12,988,1020892,6,1020886
72503,7,-15,54,156502,7,156495
72504,11,3,241,743701,11,743690
72505,6,6,740,829037,6,829031
72506,6,10,740,953421,6,953415
72507,7,-18,155,65885,7,65878
72508,18,-18,442,88562,18,88544
72509,7,-7,687,420350,7,420343
72510,17,8,117,898851,17,898834
72511,7,-4,678,514114,7,514107
72512,18,10,801,966133,18,966115
72513,6,17,162,1158648,6,1158642
72514,10,-5,997,489656,10,489646
72515,13,4,428,776351,13,776338
72516,18,-11,127,304690,18,304672
72517,12,-9,247,368399,12,368387
72518,15,17,65,1178364,15,1178349
72519,14,17,237,1179665,14,1179651
72520,12,-16,269,148959,12,148947
72521,18,7,346,869548,18,869530
72522,15,-6,48,459486,15,459471
72523,8,2,691,703212,8,703204
72524,12,-20,948,29978,12,29966
72525,16,0,790,654283,16,654267
72526,16,-4,722,527474,16,527458
72527,20,-12,249,274336,20,274316
72528,16,-5,363,493758,16,493742
72529,9,-4,207,504068,9,504059
72530,17,1,522,683998,17,683981
72531,13,5,9,803855,13,803842
72532,7,14,681,1077310,7,1077303
72533,7,-16,110,126452,7,126445
72534,10,8,331,882534,10,882524
72535,20,-3,950,561412,20,561392
72536,9,9,893,925650,9,925641
72537,7,19,506,1229036,7,1229029
72538,20,16,710,1152179,20,1152159
72539,18,-9,354,369312,18,369294
72540,17,6,770,841930,17,841913
72541,6,4,148,753782,6,753776
72542,18,14,972,1093054,18,1093036
72543,7,-13,285,224556,7,224549
72544,5,6,806,830506,5,830501
72545,12,-12,765,278146,12,278134
72546,17,1,452,683414,17,683397
72547,18,15,285,1118912,18,1118894
72548,8,8,978,896484,8,896476
72549,10,19,142,1220606,10,1220596
72550,19,-17,112,116380,19,116361
72551,10,9,995,928011,10,928001
72552,10,-4,267,505418,10,505408
72553,6,4,492,761116,6,761110
72554,15,-6,744,464855,15,464840
72555,17,-4,451,525520,17,525503
72556,18,-16,766,152534,18,152516
72557,6,17,488,1165776,6,1165770
72558,19,-19,415,57196,19,57177
72559,8,-19,36,32271,8,32263
72560,13,-18,621,89718,13,89705
72561,16,-3,275,555725,16,555709
72562,16,-7,709,433466,16,433450
72563,18,13,515,1057071,18,1057053
72564,8,-20,75,1705,8,1697
72565,20,-7,152,429419,20,429399
72566,5,-6,494,447465,5,447460
72567,9,-8,298,381694,9,381685
72568,9,18,50,1187772,9,1187763
72569,6,-2,490,573258,6,573252
72570,13,-11,686,309168,13,309155
72571,11,-2,451,588549,11,588538
72572,16,-2,510,588996,16,588980
72573,13,10,184,961270,13,961257
72574,14,-3,682,559231,14,559217
72575,11,-14,619,214380,11,214369
72576,6,-6,967,457373,6,457367
72577,20,-11,806,309994,20,309974
72578,9,18,907,1205933,9,1205924
72579,13,-3,264,555641,13,555628
72580,18,4,611,777745,18,777727
72581,7,10,890,956637,7,956630
72582,6,5,636,794813,6,794807
72583,10,0,50,626362,10,626352
72584,19,15,517,1120532,19,1120513
72585,9,-17,687,108197,9,108188
72586,8,7,333,852030,8,852022
72587,7,16,348,1132551,7,1132544
72588,14,9,353,931610,14,931596
72589,13,-3,468,557376,13,557363
72590,8,-19,751,48069,8,48061
72591,13,-20,185,24248,13,24235
72592,20,7,132,867987,20,867967
72593,19,12,809,1028056,19,1028037
72594,11,-12,509,276334,11,276323
72595,14,7,182,868332,14,868318
72596,16,-7,21,428466,16,428450
72597,16,-10,206,336583,16,336567
72598,10,-10,931,332442,10,332432
72599,8,-12,680,264243,8,264235
72600,6,9,670,920788,6,920782
72601,9,19,919,1237888,9,1237879
72602,11,-3,180,555074,11,555063
72603,11,11,707,995867,11,995856
72604,10,11,680,982948,10,982938
72605,19,-8,758,403266,19,403247
72606,18,-5,427,494146,18,494128
72607,17,-6,63,459562,17,459545
72608,5,-11,676,296054,5,296049
72609,13,-10,201,336541,13,336528
72610,18,14,326,1088001,18,1087983
72611,9,-12,916,269572,9,269563
72612,20,-6,709,464559,20,464539
72613,12,-17,935,122395,12,122383
72614,20,13,130,1054180,20,1054160
72615,17,17,452,1181326,17,1181309
72616,19,8,669,903260,19,903241
72617,10,-20,165,3685,10,3675
72618,16,14,601,1090094,16,1090078
72619,12,-15,632,182447,12,182435
72620,17,-7,650,433041,17,433024
72621,13,-6,132,460091,13,460078
72622,18,-19,704,59469,18,59451
72623,13,-11,143,304855,13,304842
72624,18,4,651,778010,18,777992
72625,15,6,251,837659,15,837644
72626,16,-8,992,404947,16,404931
72627,18,13,786,1059129,18,1059111
72628,8,-17,704,108584,8,108576
72629,11,-2,103,585897,11,585886
72630,13,0,996,655918,13,655905
72631,18,-2,819,591323,18,591305
72632,8,3,577,731156,8,731148
72633,14,19,147,1241948,14,1241934
72634,17,9,900,935748,17,935731
72635,19,17,242,1179707,19,1179688
72636,12,5,140,804822,12,804810
72637,18,9,480,932541,18,932523
72638,10,-3,877,550037,10,550027
72639,13,-16,490,150616,13,150603
72640,14,15,983,1124014,14,1124000
72641,17,12,760,1027682,17,1027665
72642,13,6,648,840996,13,840983
72643,18,-17,599,120027,18,120009
72644,13,-3,636,558876,13,558863
72645,7,-15,775,171997,7,171990
72646,20,-1,605,621279,20,621259
72647,17,18,820,1214883,17,1214866
72648,11,-8,200,399330,11,399319
72649,6,-2,637,576264,6,576258
72650,10,17,369,1163238,10,1163228
72651,18,-5,221,492605,18,492587
72652,10,15,375,1102426,10,1102416
72653,15,11,455,994165,15,994150
72654,8,-18,897,81872,8,81864
72655,9,9,892,925636,9,925627
72656,20,-1,20,616664,20,616644
72657,6,9,518,917746,6,917740
72658,14,-14,661,214667,14,214653
72659,11,11,292,993027,11,993016
72660,16,6,215,837342,16,837326
72661,9,19,715,1233366,9,1233357
72662,5,17,29,1155900,5,1155895
72663,13,13,175,1054483,13,1054470
72664,20,15,520,1120552,20,1120532
72665,8,-16,999,145647,8,145639
72666,7,-20,77,1766,7,1759
72667,7,14,988,1083984,7,1083977
72668,10,13,268,1036361,10,1036351
72669,5,-18,420,71431,5,71426
72670,5,13,102,1032905,5,1032900
72671,6,-3,208,534865,6,534859
72672,6,-7,365,413837,6,413831
72673,17,-9,761,372550,17,372533
72674,15,-6,664,464208,15,464193
72675,19,10,384,962707,19,962688
72676,12,-15,410,180786,12,180774
72677,12,-8,321,400168,12,400156
72678,20,-15,614,182280,20,182260
72679,19,12,158,1023202,19,1023183
72680,7,3,510,729691,7,729684
72681,8,13,279,1036682,8,1036674
72682,9,-13,284,224550,9,224541
72683,12,-11,278,305901,12,305889
72684,12,19,652,1246068,12,1246056
72685,19,18,262,1211086,19,1211067
72686,6,18,554,1198622,6,1198616
72687,15,14,134,1086533,15,1086518
72688,17,-2,478,588765,17,588748
72689,13,13,695,1058440,13,1058427
72690,12,-18,911,91845,12,91833
72691,17,2,504,714420,17,714403
72692,6,-10,650,326625,6,326619
72693,6,0,288,631509,6,631503
72694,6,19,913,1237823,6,1237817
72695,6,14,404,1070770,6,1070764
72696,16,-18,735,90626,16,90610
72697,6,-7,806,422848,6,422842
72698,6,19,613,1231194,6,1231188
72699,16,-13,732,246437,16,246421
72700,12,13,477,1056759,12,1056747
72701,11,-13,742,246516,11,246505
72702,11,-19,71,54421,11,54410
72703,12,0,711,653721,12,653709
72704,8,15,888,1113316,8,1113308
72705,17,-14,943,216799,17,216782
72706,16,19,460,1244605,16,1244589
72707,7,-7,306,412468,7,412461
72708,10,-5,414,476986,10,476976
72709,15,6,943,843277,15,843262
72710,12,-19,140,55129,12,55117
72711,14,-3,522,557888,14,557874
72712,18,11,665,995572,18,995554
72713,11,1,171,681221,11,681210
72714,13,1,10,679806,13,679793
72715,13,4,194,774637,13,774624
72716,20,4,199,774681,20,774661
72717,8,-19,521,42832,8,42824
72718,12,18,612,1213343,12,1213331
72719,14,13,715,1058565,14,1058551
72720,14,1,444,683317,14,683303
72721,13,8,36,898142,13,898129
72722,5,-10,332,319752,5,319747
72723,8,3,303,725529,8,725521
72724,19,-20,175,24125,19,24106
72725,13,15,505,1120417,13,1120404
72726,20,13,51,1053612,20,1053592
72727,10,6,896,832394,10,832384
72728,5,11,523,979662,5,979657
72729,9,7,931,864488,9,864479
72730,10,10,134,940565,10,940555
72731,15,4,512,776959,15,776944
72732,14,2,605,715097,14,715083
72733,18,9,152,930166,18,930148
72734,12,-20,672,27966,12,27954
72735,20,-15,167,178998,20,178978
72736,7,18,753,1202599,7,1202592
72737,18,4,73,773783,18,773765
72738,11,-16,378,149667,11,149656
72739,6,-15,307,162076,6,162070
72740,5,-1,823,611540,5,611535
72741,11,3,154,742977,11,742966
72742,11,-13,82,241624,11,241613
72743,11,4,561,777314,11,777303
72744,19,11,397,993819,19,993800
72745,5,18,425,1195826,5,1195821
72746,16,-16,188,148297,16,148281
72747,14,-15,525,181609,14,181595
72748,10,5,646,794980,10,794970
72749,14,17,491,1181574,14,1181560
72750,10,-4,278,505651,10,505641
72751,6,12,508,1009952,6,1009946
72752,14,-16,156,148085,14,148071
72753,10,-15,843,173356,10,173346
72754,15,15,398,1119653,15,1119638
72755,8,-6,864,455227,8,455219
72756,6,5,343,788693,6,788687
72757,16,-11,450,307389,16,307373
72758,20,-10,651,339946,20,339926
72759,14,-16,52,147172,14,147158
72760,19,2,841,716798,19,716779
72761,11,-7,895,434946,11,434935
72762,17,11,27,991076,17,991059
72763,14,-1,81,617209,14,617195
72764,13,-14,542,213659,13,213646
72765,17,15,55,1117214,17,1117197
72766,6,-1,955,614530,6,614524
72767,5,-8,196,379679,5,379674
72768,5,-10,656,326816,5,326811
72769,9,-8,71,377054,9,377045
72770,20,3,93,742516,20,742496
72771,11,15,878,1123173,11,1123162
72772,12,-12,988,280007,12,279995
72773,6,-17,92,95453,6,95447
72774,18,0,597,652759,18,652741
72775,8,-15,238,160458,8,160450
72776,18,0,768,654165,18,654147
72777,9,-16,458,134100,9,134091
72778,9,-4,939,519556,9,519547
72779,10,1,872,675992,10,675982
72780,9,-12,893,269030,9,269021
72781,10,-1,79,595532,10,595522
72782,8,17,962,1175996,8,1175988
72783,15,11,867,997157,15,997142
72784,8,8,131,877899,8,877891
72785,7,-11,448,291112,7,291105
72786,12,-14,97,210084,12,210072
72787,18,-18,187,86736,18,86718
72788,11,-20,341,25462,11,25451
72789,6,15,554,1106234,6,1106228
72790,5,-11,201,285493,5,285488
72791,15,0,974,655734,15,655719
72792,9,-13,802,235784,9,235775
72793,9,8,860,893849,9,893840
72794,13,5,886,810221,13,810208
72795,11,-3,900,561018,11,561007
72796,15,-20,847,29363,15,29348
72797,20,-8,393,400701,20,400681
72798,8,-3,544,542757,8,542749
72799,11,-13,176,242325,11,242314
72800,13,-3,954,561446,13,561433
72801,9,-14,431,196111,9,196102
72802,10,14,462,1072107,10,1072097
72803,18,13,330,1055658,18,1055640
72804,15,9,602,933524,15,933509
72805,5,3,313,725810,5,725805
72806,8,3,132,721677,8,721669
72807,12,-5,415,494087,12,494075
72808,9,-5,423,477145,9,477136
72809,5,-16,684,138684,5,138679
72810,5,5,379,789446,5,789441
72811,19,-11,728,309411,19,309392
72812,17,6,80,836313,17,836296
72813,13,-20,941,29939,13,29926
72814,16,15,70,1117290,16,1117274
72815,13,13,528,1057118,13,1057105
72816,11,-9,234,368270,11,368259
72817,14,-9,426,369934,14,369920
72818,16,-19,562,58428,16,58412
72819,5,10,960,958106,5,958101
72820,5,-16,235,129226,5,129221
72821,10,-4,627,512975,10,512965
72822,20,-7,130,429242,20,429222
72823,6,-7,744,421586,6,421580
72824,17,-20,604,27392,17,27375
72825,8,-18,469,72521,8,72513
72826,10,-8,596,387963,10,387953
72827,12,-7,151,429400,12,429388
72828,18,-13,266,243063,18,243045
72829,7,10,526,948770,7,948763
72830,20,-15,444,181063,20,181043
72831,20,4,871,779759,20,779739
72832,13,-3,235,555422,13,555409
72833,18,17,340,1180530,18,1180512
72834,7,1,851,675508,7,675501
72835,20,9,938,936087,20,936067
72836,9,7,277,850722,9,850713
72837,7,14,260,1067627,7,1067620
72838,14,18,522,1212823,14,1212809
72839,9,-19,368,39450,9,39441
72840,14,3,554,745911,14,745897
72841,10,10,350,944917,10,944907
72842,17,4,729,778639,17,778622
72843,15,14,713,1091093,15,1091078
72844,11,-4,984,529526,11,529515
72845,12,-20,597,27329,12,27317
72846,11,-4,867,528486,11,528475
72847,5,-11,365,289220,5,289215
72848,9,5,425,790327,9,790318
72849,13,-8,150,398986,13,398973
72850,7,8,719,891106,7,891099
72851,7,5,532,792693,7,792686
72852,9,-2,589,575269,9,575260
72853,11,-16,354,149515,11,149504
72854,13,-14,708,215051,13,215038
72855,15,-11,231,305504,15,305489
72856,10,0,25,625830,10,625820
72857,7,11,128,971198,7,971191
72858,15,-19,260,56040,15,56025
72859,14,-12,629,277081,14,277067
72860,6,-18,67,63921,6,63915
72861,17,13,508,1057029,17,1057012
72862,6,6,476,823212,6,823206
72863,12,6,908,842994,12,842982
72864,9,-18,182,66477,9,66468
72865,7,-14,957,207357,7,207350
72866,11,1,513,683920,11,683909
72867,20,-4,777,527847,20,527827
72868,19,-17,2,115562,19,115543
72869,10,3,285,725076,10,725066
72870,15,3,539,745771,15,745756
72871,16,13,931,1060149,16,1060133
72872,7,10,848,955743,7,955736
72873,7,8,806,892867,7,892860
72874,8,-4,729,515083,8,515075
72875,10,-7,875,424472,10,424462
72876,17,8,62,898361,17,898344
72877,11,4,772,778943,11,778932
72878,14,15,185,1118211,14,1118197
72879,10,19,708,1233183,10,1233173
72880,10,-15,396,163972,10,163962
72881,9,7,217,849374,9,849365
72882,19,6,36,836098,19,836079
72883,15,12,870,1028641,15,1028626
72884,8,-12,58,250829,8,250821
72885,14,-14,131,210312,14,210298
72886,16,18,63,1209467,16,1209451
72887,11,-18,98,85972,11,85961
72888,9,2,553,700301,9,700292
72889,12,-14,505,213398,12,213386
72890,16,-18,839,91299,16,91283
72891,6,15,335,1101666,6,1101660
72892,9,-7,971,426606,9,426597
72893,6,10,237,942530,6,942524
72894,18,7,1000,874136,18,874118
72895,19,-16,42,147067,19,147048
72896,20,-8,653,402485,20,402465
72897,9,3,642,732617,9,732608
72898,11,-15,470,181253,11,181242
72899,19,12,203,1023515,19,1023496
72900,11,13,858,1059655,11,1059644
72901,18,13,584,1057706,18,1057688
72902,6,-20,720,15842,6,15836
72903,16,-7,758,433801,16,433785
72904,18,0,29,648447,18,648429
72905,11,10,672,965097,11,965086
72906,5,10,370,945391,5,945386
72907,12,-13,968,248350,12,248338
72908,19,14,659,1090598,19,1090579
72909,8,-11,797,298245,8,298237
72910,8,19,205,1222061,8,1222053
72911,12,-16,261,148872,12,148860
72912,6,-1,325,601098,6,601092
72913,9,-19,283,37762,9,37753
72914,19,18,325,1211472,19,1211453
72915,11,18,341,1211587,11,1211576
72916,7,-1,303,600617,7,600610
72917,18,13,418,1056369,18,1056351
72918,18,1,926,687118,18,687100
72919,14,15,366,1119448,14,1119434
72920,15,-15,458,181142,15,181127
72921,5,-16,298,130475,5,130470
72922,12,-8,655,402502,12,402490
72923,8,-20,831,18445,8,18437
72924,17,-11,309,306257,17,306240
72925,13,-6,217,460842,13,460829
72926,20,-13,257,242965,20,242945
72927,6,-13,997,239952,6,239946
72928,6,-14,601,199839,6,199833
72929,13,-6,997,466706,13,466693
72930,17,-19,653,59126,17,59109
72931,6,-11,257,286655,6,286649
72932,6,15,631,1107849,6,1107843
72933,15,7,7,867079,15,867064
72934,6,-16,188,128133,6,128127
72935,18,-19,485,57680,18,57662
72936,14,-17,278,117536,14,117522
72937,16,1,979,687450,16,687434
72938,18,-18,114,86076,18,86058
72939,20,12,582,1026332,20,1026312
72940,16,10,192,961322,16,961306
72941,5,13,263,1036276,5,1036271
72942,12,17,715,1183230,12,1183218
72943,10,-16,850,142242,10,142232
72944,10,-13,469,228211,10,228201
72945,18,18,495,1212586,18,1212568
72946,20,-8,934,404484,20,404464
72947,15,6,94,836459,15,836444
72948,12,-4,658,527072,12,527060
72949,10,-1,873,612642,10,612632
72950,12,3,940,749002,12,748990
72951,10,-14,503,197501,10,197491
72952,12,-11,857,310443,12,310431
72953,18,-10,821,341268,18,341250
72954,8,9,740,922261,8,922253
72955,5,-6,682,451391,5,451386
72956,12,12,758,1027677,12,1027665
72957,6,-15,298,161836,6,161830
72958,12,-13,27,241293,12,241281
72959,9,-18,56,63624,9,63615
72960,17,2,800,716456,17,716439
72961,20,-16,935,153826,20,153806
72962,7,19,561,1230192,7,1230185
72963,9,14,365,1069920,9,1069911
72964,9,12,763,1015679,9,1015670
72965,18,3,790,747817,18,747799
72966,20,19,541,1245256,20,1245236
72967,11,3,932,748911,11,748900
72968,16,-20,681,28046,16,28030
72969,14,11,250,992634,14,992620
72970,20,16,175,1148374,20,1148354
72971,20,-5,64,491318,20,491298
72972,18,-17,874,121984,18,121966
72973,9,4,908,770546,9,770537
72974,11,-11,937,310998,11,310987
72975,8,-19,241,36878,8,36870
72976,14,10,856,966390,14,966376
72977,10,13,242,1035845,10,1035835
72978,19,1,517,683942,19,683923
72979,9,-6,205,441344,9,441335
72980,7,-17,450,103025,7,103018
72981,12,-14,254,211437,12,211425
72982,9,13,341,1038182,9,1038173
72983,15,7,299,869171,15,869156
72984,9,15,983,1115402,9,1115393
72985,6,-12,161,253060,6,253054
72986,7,7,87,846714,7,846707
72987,11,8,174,899320,11,899309
72988,7,9,677,920965,7,920958
72989,10,4,181,754480,10,754470
72990,6,-17,387,101767,6,101761
72991,5,-4,133,502318,5,502313
72992,17,-19,355,56779,17,56762
72993,9,16,931,1144595,9,1144586
72994,5,17,872,1174149,5,1174144
72995,16,2,657,715526,16,715510
72996,8,2,972,708985,8,708977
72997,9,-13,828,236290,9,236281
72998,20,19,538,1245217,20,1245197
72999,6,9,593,919387,6,919381
73000,8,-20,145,3218,8,3210
73001,5,4,874,769841,5,769836
73002,5,-11,772,297774,5,297769
73003,18,-7,112,429099,18,429081
73004,10,-8,40,376231,10,376221
73005,16,-3,869,560750,16,560734
73006,16,-4,307,524466,16,524450
73007,18,8,989,905635,18,905617
73008,13,5,810,809688,13,809675
73009,5,-2,439,572133,5,572128
73010,19,8,487,901821,19,901802
73011,14,-13,467,244422,14,244408
73012,9,15,768,1110759,9,1110750
73013,6,0,274,631242,6,631236
73014,17,-15,736,183293,17,183276
73015,19,4,682,778263,19,778244
73016,12,-16,430,150159,12,150147
73017,15,-3,907,561050,15,561035
73018,10,-17,952,113552,10,113542
73019,12,-1,722,622176,12,622164
73020,8,5,764,797606,8,797598
73021,12,3,830,748052,12,748040
73022,17,-2,795,591113,17,591096
73023,9,-17,575,105955,9,105946
73024,12,15,134,1117801,12,1117789
73025,5,-8,761,391655,5,391650
73026,17,14,13,1085486,17,1085469
73027,20,-16,58,147241,20,147221
73028,5,-12,327,256795,5,256790
73029,18,18,691,1213955,18,1213937
73030,5,9,185,910670,5,910665
73031,11,-17,260,117396,11,117385
73032,6,-18,268,68348,6,68342
73033,9,-12,63,250945,9,250936
73034,6,2,439,698002,6,697996
73035,17,0,41,648566,17,648549
73036,18,14,827,1091947,18,1091929
73037,6,-1,854,612129,6,612123
73038,11,-8,617,402202,11,402191
73039,13,-3,992,561692,13,561679
73040,5,-9,92,345610,5,345605
73041,18,4,719,778562,18,778544
73042,7,2,490,699064,7,699057
73043,14,19,763,1246947,14,1246933
73044,14,-4,317,524575,14,524561
73045,6,4,430,759932,6,759926
73046,5,6,207,816734,5,816729
73047,6,-20,353,7791,6,7785
73048,15,7,321,869365,15,869350
73049,10,-17,89,95386,10,95376
73050,15,-20,755,28627,15,28612
73051,18,1,300,682222,18,682204
73052,10,-2,608,575693,10,575683
73053,16,18,840,1215078,16,1215062
73054,19,-17,745,121192,19,121173
73055,7,4,747,766878,7,766871
73056,13,-7,256,430187,13,430174
73057,20,7,378,869786,20,869766
73058,14,12,410,1025026,14,1025012
73059,17,17,296,1180195,17,1180178
73060,6,-15,985,176459,6,176453
73061,17,8,505,901985,17,901968
73062,14,-13,769,246766,14,246752
73063,6,12,595,1011821,6,1011815
73064,13,-8,454,401032,13,401019
73065,15,16,66,1147554,15,1147539
73066,17,10,114,960781,17,960764
73067,9,18,373,1194760,9,1194751
73068,13,-12,928,279504,13,279491
73069,14,-9,141,367614,14,367600
73070,12,-8,755,403250,12,403238
73071,5,-11,763,297534,5,297529
73072,12,0,246,650053,12,650041
73073,6,10,898,956783,6,956777
73074,12,8,155,899183,12,899171
73075,14,13,397,1056186,14,1056172
73076,13,-14,611,214338,13,214325
73077,20,18,431,1212219,20,1212199
73078,14,4,161,774428,14,774414
73079,12,18,481,1212516,12,1212504
73080,17,-10,31,335400,17,335383
73081,17,-6,599,463720,17,463703
73082,18,0,282,650210,18,650192
73083,15,-6,152,460298,15,460283
73084,16,-17,177,116769,16,116753
73085,8,9,769,922928,8,922920
73086,11,3,545,745835,11,745824
73087,14,-18,60,85650,14,85636
73088,20,7,729,872316,20,872296
73089,13,12,568,1026204,13,1026191
73090,19,-3,707,559427,19,559408
73091,5,-18,864,81061,5,81056
73092,19,-8,178,399176,19,399157
73093,11,-14,318,211853,11,211842
73094,8,-3,874,549946,8,549938
73095,10,13,652,1044809,10,1044799
73096,18,14,740,1091257,18,1091239
73097,19,-3,87,554382,19,554363
73098,6,-15,688,170077,6,170071
73099,13,-3,382,556644,13,556631
73100,10,-2,32,563485,10,563475
73101,17,10,774,965815,17,965798
73102,18,11,1000,998020,18,998002
73103,13,1,973,687426,13,687413
73104,19,17,153,1178985,19,1178966
73105,6,-19,96,33565,6,33559
73106,19,13,382,1056042,19,1056023
73107,18,-8,492,401269,18,401251
73108,5,-10,396,321160,5,321155
73109,16,11,422,993944,16,993928
73110,14,5,616,808354,14,808340
73111,17,7,972,873900,17,873883
73112,8,-5,848,486371,8,486363
73113,5,-3,947,551732,5,551727
73114,9,-5,39,468698,9,468689
73115,7,-15,13,155601,7,155594
73116,18,0,132,649233,18,649215
73117,14,10,21,959986,14,959972
73118,15,-1,923,623631,15,623616
73119,8,19,354,1225436,8,1225428
73120,15,9,517,932861,15,932846
73121,7,19,301,1224258,7,1224251
73122,15,4,555,777266,15,777251
73123,12,-10,20,335275,12,335263
73124,16,10,837,966274,16,966258
73125,18,8,215,899656,18,899638
73126,16,7,244,868766,16,868750
73127,17,12,155,1023173,17,1023156
73128,18,-1,79,617197,18,617179
73129,15,-20,745,28522,15,28507
73130,17,-5,148,492092,17,492075
73131,12,-13,344,243603,12,243591
73132,18,2,897,717168,18,717150
73133,11,5,854,809968,11,809957
73134,8,9,964,927302,8,927294
73135,11,8,457,901573,11,901562
73136,10,19,575,1230529,10,1230519
73137,19,-9,915,373850,19,373831
73138,17,-7,542,432444,17,432427
73139,14,12,686,1027248,14,1027234
73140,16,5,58,804263,16,804247
73141,20,5,240,805610,20,805590
73142,8,-4,985,520687,8,520679
73143,18,13,675,1058309,18,1058291
73144,19,18,830,1214972,19,1214953
73145,9,6,153,815464,9,815455
73146,7,4,595,763482,7,763475
73147,14,16,504,1150678,14,1150664
73148,12,-5,81,491501,12,491489
73149,12,6,217,837347,12,837335
73150,12,-11,778,309819,12,309807
73151,14,1,607,684626,14,684612
73152,14,17,678,1182898,14,1182884
73153,6,17,220,1159844,6,1159838
73154,6,-8,180,379407,6,379401
73155,8,-3,545,542784,8,542776
73156,17,15,34,1117025,17,1117008
73157,9,-7,284,411949,9,411940
73158,11,5,122,804671,11,804660
73159,20,-20,980,30267,20,30247
73160,5,-13,989,239767,5,239762
73161,13,-7,782,433995,13,433982
73162,10,-9,73,345183,10,345173
73163,10,-8,46,376365,10,376355
73164,12,17,359,1180647,12,1180635
73165,15,14,877,1092287,15,1092272
73166,11,16,741,1152381,11,1152370
73167,19,-16,613,151547,19,151528
73168,7,-11,109,283490,7,283483
73169,10,-16,430,133367,10,133357
73170,9,16,717,1140048,9,1140039
73171,11,-15,84,178430,11,178419
73172,6,2,356,696410,6,696404
73173,6,-1,341,601612,6,601606
73174,13,6,664,841120,13,841107
73175,7,-20,445,9525,7,9518
73176,10,-14,34,187252,10,187242
73177,8,2,121,691211,8,691203
73178,14,19,309,1243266,14,1243252
73179,20,-20,889,29647,20,29627
73180,13,8,617,902823,13,902810
73181,11,3,194,743356,11,743345
73182,14,-20,810,29133,14,29119
73183,11,-2,414,588196,11,588185
73184,19,9,302,931164,19,931145
73185,9,16,539,1136629,9,1136620
73186,18,6,181,837124,18,837106
73187,9,-12,97,251644,9,251635
73188,20,-4,249,524062,20,524042
73189,11,10,675,965138,11,965127
73190,11,2,757,716258,11,716247
73191,18,3,325,744367,18,744349
73192,10,4,908,770556,10,770546
73193,6,10,709,952838,6,952832
73194,13,-17,736,121085,13,121072
73195,8,18,96,1188849,8,1188841
73196,17,1,435,683251,17,683234
73197,14,15,126,1117764,14,1117750
73198,15,-5,483,494638,15,494623
73199,14,-14,783,215659,14,215645
73200,14,11,587,995096,14,995082
73201,6,-17,610,106670,6,106664
73202,6,0,906,645036,6,645030
73203,20,-4,924,528995,20,528975
73204,17,-5,921,497794,17,497777
73205,10,16,127,1127728,10,1127718
73206,12,-14,636,214529,12,214517
73207,18,-13,653,245799,18,245781
73208,17,-17,445,118789,17,118772
73209,20,-18,615,89676,20,89656
73210,16,3,818,747992,16,747976
73211,8,14,698,1077731,8,1077723
73212,14,-3,201,555204,14,555190
73213,20,15,601,1121190,20,1121170
73214,19,-9,182,367853,19,367834
73215,5,1,286,663406,5,663401
73216,10,-12,346,257190,10,257180
73217,17,9,413,932030,17,932013
73218,15,8,962,905430,15,905415
73219,9,-9,857,362763,9,362754
73220,17,-3,570,558326,17,558309
73221,9,-8,41,376259,9,376250
73222,12,-2,772,590906,12,590894
73223,16,-17,850,121828,16,121812
73224,12,-15,563,181920,12,181908
73225,14,-15,810,183823,14,183809
73226,9,-18,508,73383,9,73374
73227,5,-6,371,444757,5,444752
73228,14,3,893,748540,14,748526
73229,19,-6,472,462767,19,462748
73230,5,18,343,1194156,5,1194151
73231,6,16,493,1135637,6,1135631
73232,9,-14,316,193564,9,193555
73233,8,17,753,1171345,8,1171337
73234,20,13,858,1059665,20,1059645
73235,15,6,763,841908,15,841893
73236,13,-5,225,492626,13,492613
73237,13,2,953,717595,13,717582
73238,12,-10,4,335155,12,335143
73239,13,-17,764,121297,13,121284
73240,12,5,982,810999,12,810987
73241,9,7,900,863893,9,863884
73242,12,7,354,869595,12,869583
73243,13,1,547,684237,13,684224
73244,11,13,893,1059908,11,1059897
73245,8,8,447,884998,8,884990
73246,10,-19,306,38177,10,38167
73247,12,15,331,1119218,12,1119206
73248,20,16,24,1147274,20,1147254
73249,13,-3,880,560820,13,560807
73250,20,16,581,1151186,20,1151166
73251,16,-19,211,55758,16,55742
73252,16,-7,890,434882,16,434866
73253,17,6,908,843001,17,842984
73254,15,8,965,905460,15,905445
73255,17,-19,548,58268,17,58251
73256,10,-5,846,486307,10,486297
73257,9,-8,317,382134,9,382125
73258,19,-4,333,524682,19,524663
73259,5,15,753,1110566,5,1110561
73260,6,13,608,1043908,6,1043902
73261,8,19,63,1218825,8,1218817
73262,14,4,509,776918,14,776904
73263,8,2,787,705033,8,705025
73264,17,-15,879,184423,17,184406
73265,6,-7,315,412703,6,412697
73266,8,10,373,945432,8,945424
73267,10,9,374,914601,10,914591
73268,8,-10,652,326697,8,326689
73269,19,-18,93,85953,19,85934
73270,13,-6,156,460326,13,460313
73271,11,3,178,743191,11,743180
73272,13,3,179,743203,13,743190
73273,18,19,508,1244981,18,1244963
73274,6,6,408,821632,6,821626
73275,9,-6,746,452875,9,452866
73276,6,8,771,892169,6,892163
73277,9,-18,760,78950,9,78941
73278,10,7,147,847918,10,847908
73279,6,-20,578,12613,6,12607
73280,8,-14,957,207365,8,207357
73281,10,-5,621,481458,10,481448
73282,5,17,288,1161556,5,1161551
73283,18,-11,874,310566,18,310548
73284,7,10,842,955619,7,955612
73285,20,4,513,776976,20,776956
73286,8,-10,456,322533,8,322525
73287,7,-14,13,186749,7,186742
73288,5,-9,42,344503,5,344498
73289,20,10,398,962826,20,962806
73290,15,-4,391,525170,15,525155
73291,10,13,996,1052063,10,1052053
73292,7,-7,883,424735,7,424728
73293,6,5,429,790441,6,790435
73294,13,17,492,1181579,13,1181566
73295,16,-2,469,588678,16,588662
73296,5,-1,380,602306,5,602301
73297,20,-16,611,151526,20,151506
73298,18,0,677,653455,18,653437
73299,15,18,429,1212198,15,1212183
73300,13,-5,84,491528,13,491515
73301,11,-15,142,178877,11,178866
73302,6,-7,95,407858,6,407852
73303,11,18,738,1214252,11,1214241
73304,19,11,462,994227,19,994208
73305,17,6,962,843404,17,843387
73306,11,19,128,1241811,11,1241800
73307,5,-17,152,96632,5,96627
73308,12,15,89,1117457,12,1117445
73309,8,-3,14,530915,8,530907
73310,9,6,12,812431,9,812422
73311,6,-10,808,329932,6,329926
73312,10,12,699,1014474,10,1014464
73313,17,-3,771,559990,17,559973
73314,9,14,832,1080549,9,1080540
73315,19,-5,474,494553,19,494534
73316,7,-14,512,197744,7,197737
73317,17,-4,133,523085,17,523068
73318,6,7,65,846236,6,846230
73319,15,8,528,902165,15,902150
73320,7,-20,702,15505,7,15498
73321,20,-16,676,151885,20,151865
73322,6,11,810,985851,6,985845
73323,16,-15,726,183201,16,183185
73324,8,-18,854,80856,8,80848
73325,5,5,86,783443,5,783438
73326,10,7,597,857487,10,857477
73327,12,-2,481,588773,12,588761
73328,20,4,109,774063,20,774043
73329,20,14,349,1088148,20,1088128
73330,8,3,685,733692,8,733684
73331,14,18,419,1212154,14,1212140
73332,17,19,853,1247660,17,1247643
73333,20,-4,598,526585,20,526565
73334,20,-5,220,492588,20,492568
73335,18,9,453,932322,18,932304
73336,14,5,119,804659,14,804645
73337,13,-20,105,23554,13,23541
73338,20,10,317,962250,20,962230
73339,9,-14,166,190071,9,190062
73340,5,-5,964,489062,5,489057
73341,20,-15,264,179672,20,179652
73342,20,0,494,651946,20,651926
73343,17,-15,573,182026,17,182009
73344,9,-15,512,166499,9,166490
73345,8,6,70,813700,8,813692
73346,18,-12,709,277746,18,277728
73347,14,-5,179,492317,14,492303
73348,17,-4,639,526914,17,526897
73349,6,-9,514,355262,6,355256
73350,19,3,836,748107,19,748088
73351,9,3,981,740368,9,740359
73352,18,8,996,905699,18,905681
73353,17,-9,781,372730,17,372713
73354,12,-4,227,523888,12,523876
73355,14,12,166,1023273,14,1023259
73356,18,14,411,1088672,18,1088654
73357,10,-2,40,563684,10,563674
73358,19,-11,8,303769,19,303750
73359,16,4,278,775202,16,775186
73360,11,7,653,871796,11,871785
73361,12,-3,397,556709,12,556697
73362,7,4,591,763427,7,763420
73363,20,-2,402,588118,20,588098
73364,13,-19,501,57847,13,57834
73365,8,-11,871,299777,8,299769
73366,7,14,867,1081260,7,1081253
73367,10,-8,844,393336,10,393326
73368,9,13,670,1045237,9,1045228
73369,14,-17,841,121783,14,121769
73370,6,10,7,937665,6,937659
73371,19,-14,947,216845,19,216826
73372,7,-19,411,40413,7,40406
73373,12,-6,629,463960,12,463948
73374,15,-1,845,623046,15,623031
73375,7,2,973,708991,7,708984
73376,15,-20,776,28794,15,28779
73377,20,-15,25,177996,20,177976
73378,20,-2,540,589180,20,589160
73379,14,-11,451,307392,14,307378
73380,20,-4,257,524106,20,524086
73381,7,13,313,1037447,7,1037440
73382,14,-9,243,368353,14,368339
73383,13,-16,685,151931,13,151918
73384,6,-5,225,472946,6,472940
73385,16,4,603,777686,16,777670
73386,15,-10,995,342677,15,342662
73387,19,1,254,681930,19,681911
73388,5,-20,482,10313,5,10308
73389,11,-3,833,560439,11,560428
73390,15,12,606,1026513,15,1026498
73391,14,-15,842,184093,14,184079
73392,12,-9,849,373272,12,373260
73393,14,16,812,1152951,14,1152937
73394,5,-14,409,195756,5,195751
73395,12,-16,150,148050,12,148038
73396,12,9,622,933699,12,933687
73397,19,-12,435,275653,19,275634
73398,14,1,114,680708,14,680694
73399,7,-16,499,134934,7,134927
73400,15,-9,331,369056,15,369041
73401,7,8,93,877040,7,877033
73402,17,16,610,1151420,17,1151403
73403,6,-8,47,376410,6,376404
73404,9,13,597,1043632,9,1043623
73405,17,2,56,710947,17,710930
73406,17,-14,908,216589,17,216572
73407,12,-10,879,341719,12,341707
73408,15,2,518,714550,15,714535
73409,10,-16,254,129552,10,129542
73410,9,-18,911,82273,9,82264
73411,18,18,637,1213555,18,1213537
73412,15,-9,477,370427,15,370412
73413,11,10,85,960488,11,960477
73414,12,-18,681,90203,12,90191
73415,6,11,123,971031,6,971025
73416,18,-9,489,370522,18,370504
73417,19,-3,700,559354,19,559335
73418,11,-14,152,210475,11,210464
73419,15,14,515,1089477,15,1089462
73420,9,16,212,1129717,9,1129708
73421,15,-11,939,311036,15,311021
73422,16,1,223,681665,16,681649
73423,11,-12,943,279618,11,279607
73424,16,-11,510,307827,16,307811
73425,17,6,917,843101,17,843084
73426,10,5,613,794398,10,794388
73427,8,-12,810,267057,8,267049
73428,6,14,643,1076300,6,1076294
73429,5,15,672,1108687,5,1108682
73430,9,13,702,1045835,9,1045826
73431,17,15,15,1116884,17,1116867
73432,6,-17,621,106900,6,106894
73433,19,5,804,809638,19,809619
73434,6,-19,477,41809,6,41803
73435,9,-1,88,595710,9,595701
73436,8,-17,609,106638,8,106630
73437,11,-10,94,335838,11,335827
73438,10,-4,838,517195,10,517185
73439,13,13,891,1059885,13,1059872
73440,11,-15,348,180333,11,180322
73441,18,12,433,1025235,18,1025217
73442,14,14,657,1090591,14,1090577
73443,19,19,894,1248022,19,1248003
73444,7,-19,442,41043,7,41036
73445,8,3,63,720156,8,720148
73446,13,11,833,996864,13,996851
73447,9,10,191,941630,9,941621
73448,13,-2,848,591590,13,591577
73449,5,-17,877,112059,5,112054
73450,8,-4,370,507675,8,507667
73451,20,0,862,654776,20,654756
73452,12,15,186,1118212,12,1118200
73453,13,-9,998,374245,13,374232
73454,9,-3,133,533304,9,533295
73455,6,-2,864,581286,6,581280
73456,9,17,625,1168664,9,1168655
73457,10,16,342,1132439,10,1132429
73458,17,13,169,1054453,17,1054436
73459,20,-5,145,492063,20,492043
73460,17,9,579,933337,17,933320
73461,13,6,434,839241,13,839228
73462,20,4,511,776952,20,776932
73463,20,6,756,841863,20,841843
73464,11,-1,268,618662,11,618651
73465,5,0,959,646242,5,646237
73466,17,-10,689,340312,17,340295
73467,16,-2,957,592437,16,592421
73468,18,-13,914,247910,18,247892
73469,13,-9,866,373435,13,373422
73470,19,-5,474,494562,19,494543
73471,9,-20,218,4970,9,4961
73472,13,15,8,1116805,13,1116792
73473,16,-8,9,397944,16,397928
73474,18,-4,356,524903,18,524885
73475,6,4,492,761122,6,761116
73476,7,17,973,1176277,7,1176270
73477,5,-2,748,578654,5,578649
73478,18,18,989,1216233,18,1216215
73479,7,12,370,1007209,7,1007202
73480,14,-4,612,526703,14,526689
73481,10,-6,732,452580,10,452570
73482,20,5,352,806343,20,806323
73483,12,5,502,807446,12,807434
73484,12,-17,833,121731,12,121719
73485,6,-19,346,39043,6,39037
73486,8,9,778,923155,8,923147
73487,19,14,40,1085731,19,1085712
73488,18,-17,264,117426,18,117408
73489,9,-14,406,195683,9,195674
73490,8,5,934,801336,8,801328
73491,15,-16,778,152636,15,152621
73492,13,11,908,997471,13,997458
73493,17,9,938,936094,17,936077
73494,15,8,141,899059,15,899044
73495,17,-2,650,590026,17,590009
73496,6,-10,840,330642,6,330636
73497,12,-14,801,215827,12,215815
73498,17,-9,762,372567,17,372550
73499,18,10,91,960570,18,960552
73500,19,0,692,653577,19,653558
73501,17,-17,66,115989,17,115972
73502,17,-5,625,495611,17,495594
73503,12,-19,15,53991,12,53979
73504,12,9,301,931156,12,931144
73505,14,-17,980,122682,14,122668
73506,18,-20,915,29801,18,29783
73507,18,-6,737,464797,18,464779
73508,8,1,357,665016,8,665008
73509,19,-19,320,56480,19,56461
73510,7,-10,605,325735,7,325728
73511,7,1,409,666129,7,666122
73512,16,14,208,1087023,16,1087007
73513,10,19,306,1224413,10,1224403
73514,10,18,7,1186708,10,1186698
73515,7,6,931,833186,7,833179
73516,18,-20,502,26616,18,26598
73517,9,14,626,1075901,9,1075892
73518,14,16,512,1150743,14,1150729
73519,20,-19,479,57641,20,57621
73520,5,6,7,812286,5,812281
73521,13,-16,927,153742,13,153729
73522,19,10,796,966066,19,966047
73523,15,-20,896,29705,15,29690
73524,17,11,867,997164,17,997147
73525,16,5,786,809502,16,809486
73526,16,-9,147,367643,16,367627
73527,5,-17,714,108768,5,108763
73528,10,-8,441,384466,10,384456
73529,19,-1,482,620445,19,620426
73530,13,13,392,1056140,13,1056127
73531,6,11,995,989729,6,989723
73532,6,-7,709,420894,6,420888
73533,15,-9,688,371868,15,371853
73534,5,1,845,675343,5,675338
73535,11,-5,192,492384,11,492373
73536,17,4,320,775508,17,775491
73537,11,-8,283,399866,11,399855
73538,10,-18,491,72998,10,72988
73539,10,-18,690,77142,10,77132
73540,5,-11,946,301456,5,301451
73541,11,19,169,1242105,11,1242094
73542,13,-7,846,434501,13,434488
73543,20,3,909,748685,20,748665
73544,9,-9,779,360979,9,360970
73545,17,18,629,1213449,17,1213432
73546,5,3,197,723117,5,723112
73547,8,-17,620,106875,8,106867
73548,17,-15,94,178494,17,178477
73549,17,8,634,903003,17,902986
73550,15,12,949,1029409,15,1029394
73551,13,18,847,1215156,13,1215143
73552,9,-14,584,199358,9,199349
73553,15,2,177,711932,15,711917
73554,12,12,562,1026161,12,1026149
73555,7,-7,304,412416,7,412409
73556,13,15,377,1119549,13,1119536
73557,13,-13,249,242885,13,242872
73558,7,6,632,826556,7,826549
73559,12,-20,869,29494,12,29482
73560,18,17,249,1179762,18,1179744
73561,20,0,478,651753,20,651733
73562,5,11,570,980699,5,980694
73563,12,19,348,1243583,12,1243571
73564,7,-17,384,101718,7,101711
73565,13,-7,388,431281,13,431268
73566,17,-1,853,623076,17,623059
73567,13,4,376,775926,13,775913
73568,17,-10,921,342006,17,341989
73569,10,-12,810,267067,10,267057
73570,12,-19,107,54808,12,54796
73571,14,7,58,867453,14,867439
73572,12,-1,477,620401,12,620389
73573,17,-16,599,151433,17,151416
73574,15,2,148,711730,15,711715
73575,13,18,393,1211940,13,1211927
73576,5,-5,372,476227,5,476222
73577,12,-9,853,373331,12,373319
73578,17,2,141,711681,17,711664
73579,11,-14,466,213119,11,213108
73580,17,17,359,1180654,17,1180637
73581,11,-11,378,306782,11,306771
73582,12,3,753,747523,12,747511
73583,15,-15,606,182214,15,182199
73584,5,14,28,1062409,5,1062404
73585,16,-20,562,27102,16,27086
73586,15,6,524,840062,15,840047
73587,15,7,103,867771,15,867756
73588,8,-10,299,318995,8,318987
73589,9,7,171,848373,9,848364
73590,14,-13,496,244673,14,244659
73591,5,15,590,1106947,5,1106942
73592,8,17,804,1172592,8,1172584
73593,8,-15,861,173786,8,173778
73594,19,-17,90,116264,19,116245
73595,20,8,69,898412,20,898392
73596,19,19,849,1247641,19,1247622
73597,11,10,392,962774,11,962763
73598,16,7,415,870115,16,870099
73599,10,15,342,1101827,10,1101817
73600,18,5,387,806649,18,806631
73601,20,-16,878,153445,20,153425
73602,11,-6,219,460847,11,460836
73603,20,1,958,687320,20,687300
73604,8,19,35,1218201,8,1218193
73605,20,-1,518,620710,20,620690
73606,15,19,47,1241099,15,1241084
73607,13,-6,123,459989,13,459976
73608,18,16,373,1149837,18,1149819
73609,18,-7,548,432476,18,432458
73610,17,-7,351,431007,17,430990
73611,19,17,776,1183634,19,1183615
73612,15,17,412,1180992,15,1180977
73613,17,-14,524,213569,17,213552
73614,12,17,276,1179982,12,1179970
73615,7,17,583,1167683,7,1167676
73616,18,-1,861,623160,18,623142
73617,7,10,633,951174,7,951167
73618,15,-14,193,210809,15,210794
73619,18,10,447,963222,18,963204
73620,20,11,419,993926,20,993906
73621,16,-15,408,180783,16,180767
73622,20,9,553,933113,20,933093
73623,7,-18,654,76431,7,76424
73624,9,-11,551,293426,9,293417
73625,8,-2,657,576740,8,576732
73626,15,13,964,1060384,15,1060369
73627,17,2,112,711436,17,711419
73628,17,4,268,775134,17,775117
73629,10,-3,822,548751,10,548741
73630,10,17,194,1159401,10,1159391
73631,18,-9,756,372475,18,372457
73632,16,0,48,648613,16,648597
73633,5,3,821,736526,5,736521
73634,18,-2,459,588598,18,588580
73635,9,-12,167,253110,9,253101
73636,16,-2,849,591595,16,591579
73637,7,-9,120,346170,7,346163
73638,5,13,884,1049765,5,1049760
73639,13,7,616,871526,13,871513
73640,8,19,546,1229859,8,1229851
73641,18,14,520,1089520,18,1089502
73642,6,5,299,787841,6,787835
73643,8,0,373,633415,8,633407
73644,7,8,170,878844,7,878837
73645,18,-4,540,526200,18,526182
73646,19,-15,1000,185411,19,185392
73647,8,9,316,913460,8,913452
73648,8,-20,318,7127,8,7119
73649,7,-5,863,486729,7,486722
73650,16,-6,405,462227,16,462211
73651,9,4,579,763063,9,763054
73652,20,-20,674,27982,20,27962
73653,12,15,945,1123703,12,1123691
73654,16,-1,872,623224,16,623208
73655,11,6,831,842465,11,842454
73656,9,-15,247,160736,9,160727
73657,20,-4,762,527727,20,527707
73658,16,-14,34,209587,16,209571
73659,12,9,110,929852,12,929840
73660,9,-7,421,414941,9,414932
73661,6,13,209,1035182,6,1035176
73662,5,-5,210,472621,5,472616
73663,17,7,689,872066,17,872049
73664,9,-10,655,326773,9,326764
73665,13,13,821,1059392,13,1059379
73666,18,-8,245,399655,18,399637
73667,16,-6,356,461905,16,461889
73668,14,8,714,903659,14,903645
73669,13,14,481,1089213,13,1089200
73670,15,18,432,1212230,15,1212215
73671,9,-13,168,221955,9,221946
73672,19,8,158,899215,19,899196
73673,6,17,136,1158163,6,1158157
73674,17,19,153,1241989,17,1241972
73675,18,19,146,1241945,18,1241927
73676,14,-9,406,369738,14,369724
73677,18,-17,626,120170,18,120152
73678,18,16,191,1148505,18,1148487
73679,16,-12,584,276808,16,276792
73680,20,-7,160,429485,20,429465
73681,10,-11,353,288987,10,288977
73682,16,-4,747,527638,16,527622
73683,13,-9,339,369166,13,369153
73684,18,-4,647,526946,18,526928
73685,9,7,423,853889,9,853880
73686,18,-15,652,182670,18,182652
73687,6,-20,716,15714,6,15708
73688,18,-11,115,304647,18,304629
73689,20,17,669,1182863,20,1182843
73690,14,9,277,930963,14,930949
73691,11,16,454,1150398,11,1150387
73692,20,-2,344,587699,20,587679
73693,19,12,359,1024712,19,1024693
73694,6,-10,134,315646,6,315640
73695,20,12,566,1026203,20,1026183
73696,9,6,845,831344,9,831335
73697,14,-10,978,342472,14,342458
73698,6,18,758,1202689,6,1202683
73699,20,1,202,681496,20,681476
73700,8,1,412,666192,8,666184
73701,11,-9,219,368124,11,368113
73702,5,-19,199,36034,5,36029
73703,16,14,567,1089850,16,1089834
73704,16,3,932,748917,16,748901
73705,9,8,469,885438,9,885429
73706,7,13,214,1035311,7,1035304
73707,12,-4,289,524325,12,524313
73708,15,-13,563,245200,15,245185
73709,18,4,930,780124,18,780106
73710,13,-5,774,496640,13,496627
73711,8,18,878,1205294,8,1205286
73712,20,19,352,1243627,20,1243607
73713,5,16,676,1139365,5,1139360
73714,19,6,666,841136,19,841117
73715,17,-5,210,492518,17,492501
73716,10,14,616,1075595,10,1075585
73717,20,2,209,712176,20,712156
73718,15,-7,956,435411,15,435396
73719,14,-20,188,24303,14,24289
73720,7,-16,853,142346,7,142339
73721,12,19,569,1245423,12,1245411
73722,20,-18,221,86997,20,86977
73723,7,12,520,1010235,7,1010228
73724,16,14,636,1090397,16,1090381
73725,7,-4,57,500537,7,500530
73726,7,7,300,851287,7,851280
73727,14,-13,582,245349,14,245335
73728,18,19,492,1244821,18,1244803
73729,17,-19,651,59110,17,59093
73730,6,-9,146,346713,6,346707
73731,13,3,119,742722,13,742709
73732,17,-11,327,306367,17,306350
73733,13,-12,896,279230,13,279217
73734,6,-11,735,297010,6,297004
73735,9,18,823,1204139,9,1204130
73736,12,-13,391,243898,12,243886
73737,14,-4,323,524626,14,524612
73738,14,-9,678,371788,14,371774
73739,7,-17,192,97476,7,97469
73740,12,12,701,1027334,12,1027322
73741,11,19,332,1243456,11,1243445
73742,13,-20,657,27822,13,27809
73743,15,19,958,1248479,15,1248464
73744,14,1,44,680134,14,680120
73745,11,7,23,867167,11,867156
73746,16,-11,527,307950,16,307934
73747,10,-18,909,82206,10,82196
73748,12,14,245,1087337,12,1087325
73749,5,5,771,797758,5,797753
73750,12,17,973,1185245,12,1185233
73751,15,-7,905,434996,15,434981
73752,20,7,150,868121,20,868101
73753,14,-12,189,273853,14,273839
73754,18,-12,476,276012,18,275994
73755,6,16,392,1133550,6,1133544
73756,17,7,248,868817,17,868800
73757,13,-12,887,279150,13,279137
73758,6,4,119,753116,6,753110
73759,19,10,49,960234,19,960215
73760,9,9,50,907878,9,907869
73761,15,19,357,1243669,15,1243654
73762,16,-20,114,23624,16,23608
73763,6,16,451,1134950,6,1134944
73764,19,-3,277,555738,19,555719
73765,6,19,68,1218977,6,1218971
73766,6,14,832,1080555,6,1080549
73767,20,-15,715,183103,20,183083
73768,14,4,872,779767,14,779753
73769,14,2,400,713670,14,713656
73770,15,-10,987,342552,15,342537
73771,20,-20,971,30142,20,30122
73772,10,19,251,1223030,10,1223020
73773,16,-16,508,150751,16,150735
73774,20,2,139,711662,20,711642
73775,20,-14,658,214653,20,214633
73776,9,16,665,1139171,9,1139162
73777,13,14,2,1085368,13,1085355
73778,9,-18,156,65917,9,65908
73779,9,-5,73,469535,9,469526
73780,18,17,866,1184509,18,1184491
73781,20,16,300,1149306,20,1149286
73782,12,4,485,776731,12,776719
73783,15,14,321,1087944,15,1087929
73784,5,3,273,724765,5,724760
73785,20,11,960,997728,20,997708
73786,5,10,781,954392,5,954387
73787,17,13,576,1057624,17,1057607
73788,5,19,419,1227224,5,1227219
73789,8,9,353,914187,8,914179
73790,9,-13,641,231995,9,231986
73791,6,10,617,950853,6,950847
73792,17,-14,75,209898,17,209881
73793,7,-12,507,260639,7,260632
73794,6,-12,20,250013,6,250007
73795,20,-12,224,274181,20,274161
73796,7,-9,201,347878,7,347871
73797,5,-8,697,390417,5,390412
73798,8,-13,42,219288,8,219280
73799,20,-3,715,559461,20,559441
73800,19,-17,287,117628,19,117609
73801,14,-2,425,588318,14,588304
73802,10,17,768,1171578,10,1171568
73803,16,3,735,747401,16,747385
73804,19,2,424,713843,19,713824
73805,14,7,341,869509,14,869495
73806,12,-14,32,209579,12,209567
73807,20,3,574,746119,20,746099
73808,15,-3,660,559046,15,559031
73809,15,8,944,905315,15,905300
73810,20,-11,398,306922,20,306902
73811,16,13,821,1059398,16,1059382
73812,9,-3,793,548191,9,548182
73813,20,-10,778,340911,20,340891
73814,17,13,531,1057140,17,1057123
73815,12,3,20,741932,12,741920
73816,10,8,682,890215,10,890205
73817,18,7,122,867900,18,867882
73818,12,0,455,651566,12,651554
73819,10,-16,217,128814,10,128804
73820,16,-14,257,211469,16,211453
73821,20,-2,790,591072,20,591052
73822,17,12,930,1029218,17,1029201
73823,18,0,144,649305,18,649287
73824,17,13,202,1054735,17,1054718
73825,11,7,31,867239,11,867228
73826,17,8,10,897978,17,897961
73827,20,-5,187,492350,20,492330
73828,13,-2,745,590708,13,590695
73829,12,-2,995,592673,12,592661
73830,18,11,963,997743,18,997725
73831,12,8,280,900185,12,900173
73832,19,-6,382,462083,19,462064
73833,13,2,697,715874,13,715861
73834,18,15,689,1121812,18,1121794
73835,17,3,946,749053,17,749036
73836,20,-3,251,555568,20,555548
73837,6,1,125,659903,6,659897
73838,5,-6,639,450570,5,450565
73839,6,1,472,667501,6,667495
73840,9,2,349,696167,9,696158
73841,18,-11,856,310438,18,310420
73842,10,-19,458,41358,10,41348
73843,15,18,465,1212404,15,1212389
73844,9,5,116,783959,9,783950
73845,13,-8,732,403075,13,403062
73846,14,14,362,1088238,14,1088224
73847,14,-1,926,623649,14,623635
73848,20,16,126,1147940,20,1147920
73849,12,12,12,1022171,12,1022159
73850,6,10,964,958154,6,958148
73851,15,-15,889,184504,15,184489
73852,8,-18,55,63576,8,63568
73853,15,-2,804,591185,15,591170
73854,12,12,347,1024630,12,1024618
73855,16,9,919,935946,16,935930
73856,6,0,735,641532,6,641526
73857,14,-11,494,307688,14,307674
73858,10,-3,455,540647,10,540637
73859,17,-4,872,528591,17,528574
73860,16,-14,855,216184,16,216168
73861,16,-2,791,591077,16,591061
73862,11,13,933,1060164,11,1060153
73863,14,-14,63,209793,14,209779
73864,10,-9,61,344958,10,344948
73865,19,-11,604,308558,19,308539
73866,18,-11,899,310754,18,310736
73867,20,-17,715,120880,20,120860
73868,7,-12,563,261695,7,261688
73869,7,-2,355,570262,7,570255
73870,16,-20,516,26690,16,26674
73871,13,-10,847,341451,13,341438
73872,16,6,14,835900,16,835884
73873,19,15,650,1121564,19,1121545
73874,10,-6,854,455049,10,455039
73875,18,-11,477,307542,18,307524
73876,19,16,290,1149227,19,1149208
73877,10,7,293,851089,10,851079
73878,9,-19,223,36474,9,36465
73879,8,15,803,1111426,8,1111418
73880,11,9,81,929634,11,929623
73881,12,-16,595,151381,12,151369
73882,16,-9,879,373552,16,373536
73883,11,-20,583,27250,11,27239
73884,5,4,694,765544,5,765539
73885,6,15,94,1096440,6,1096434
73886,19,12,804,1028017,19,1027998
73887,19,3,606,746363,19,746344
73888,8,1,137,660225,8,660217
73889,6,17,109,1157582,6,1157576
73890,19,-3,541,558107,19,558088
73891,16,6,266,837797,16,837781
73892,8,0,588,638136,8,638128
73893,7,10,767,953998,7,953991
73894,12,2,866,716968,12,716956
73895,20,1,140,680975,20,680955
73896,13,15,240,1118563,13,1118550
73897,17,15,266,1118768,17,1118751
73898,18,-10,366,337688,18,337670
73899,16,-4,861,528448,16,528432
73900,13,1,476,683603,13,683590
73901,7,-8,503,385852,7,385845
73902,8,-4,514,510623,8,510615
73903,13,-8,275,399824,13,399811
73904,15,-13,538,245008,15,244993
73905,10,5,227,786427,10,786417
73906,13,-12,462,275882,13,275869
73907,15,-18,813,91171,15,91156
73908,6,5,865,799781,6,799775
73909,16,-7,892,434913,16,434897
73910,9,10,627,951039,9,951030
73911,12,-4,246,524046,12,524034
73912,15,-6,275,461327,15,461312
73913,15,-1,186,617937,15,617922
73914,20,-11,497,307738,20,307718
73915,6,14,710,1077968,6,1077962
73916,12,-8,602,402065,12,402053
73917,13,15,556,1120814,13,1120801
73918,9,-1,180,597576,9,597567
73919,16,-10,650,339935,16,339919
73920,13,-11,800,309946,13,309933
73921,16,-12,302,274780,16,274764
73922,16,15,623,1121360,16,1121344
73923,12,-18,759,90808,12,90796
73924,10,-15,916,174957,10,174947
73925,18,-17,317,117845,18,117827
73926,15,-4,178,523436,15,523421
73927,12,-4,384,525082,12,525070
73928,18,5,572,807952,18,807934
73929,18,13,532,1057176,18,1057158
73930,5,-13,712,233540,5,233535
73931,14,2,919,717311,14,717297
73932,12,8,337,900640,12,900628
73933,8,-6,758,453111,8,453103
73934,15,15,161,1117958,15,1117943
73935,7,-5,725,483666,7,483659
73936,10,-14,479,197054,10,197044
73937,12,17,465,1181424,12,1181412
73938,7,-20,261,5781,7,5774
73939,17,-9,777,372704,17,372687
73940,11,8,849,904586,11,904575
73941,19,-19,855,60591,19,60572
73942,18,-13,995,248549,18,248531
73943,15,-10,10,335187,15,335172
73944,12,10,208,961420,12,961408
73945,6,-2,693,577625,6,577619
73946,5,9,533,918053,5,918048
73947,9,19,469,1228221,9,1228212
73948,7,-13,640,231973,7,231966
73949,20,11,567,994924,20,994904
73950,13,-14,203,210886,13,210873
73951,17,-19,867,60666,17,60649
73952,5,7,440,854298,5,854293
73953,14,13,783,1059092,14,1059078
73954,11,15,432,1119843,11,1119832
73955,5,-5,320,475227,5,475222
73956,17,-20,149,23914,17,23897
73957,5,-3,537,542626,5,542621
73958,9,-10,798,329708,9,329699
73959,7,2,59,689922,7,689915
73960,10,-10,556,324675,10,324665
73961,15,-17,276,117533,15,117518
73962,18,6,113,836638,18,836620
73963,20,9,852,935394,20,935374
73964,19,-7,502,432106,19,432087
73965,16,-4,404,525260,16,525244
73966,5,4,188,754617,5,754612
73967,10,-2,746,578600,10,578590
73968,8,-15,703,170436,8,170428
73969,15,-12,880,279101,15,279086
73970,11,13,705,1058525,11,1058514
73971,13,4,515,776984,13,776971
73972,10,0,861,644057,10,644047
73973,6,-20,669,14777,6,14771
73974,5,-15,827,173064,5,173059
73975,14,0,234,650004,14,649990
73976,19,14,55,1085853,19,1085834
73977,8,-4,959,520056,8,520048
73978,12,4,405,776106,12,776094
73979,8,-20,864,19201,8,19193
73980,13,-6,191,460662,13,460649
73981,13,14,318,1087902,13,1087889
73982,9,-12,234,254559,9,254550
73983,10,11,542,980073,10,980063
73984,9,10,98,939776,9,939767
73985,11,-18,389,88215,11,88204
73986,19,-1,310,619050,19,619031
73987,10,6,687,827797,10,827787
73988,8,-19,234,36717,8,36709
73989,7,-18,924,82526,7,82519
73990,6,-17,133,96205,6,96199
73991,11,-3,830,560426,11,560415
73992,10,-13,827,236238,10,236228
73993,12,-5,557,495148,12,495136
73994,9,-17,40,94415,9,94406
73995,16,0,143,649296,16,649280
73996,11,3,861,748341,11,748330
73997,12,-18,63,85682,12,85670
73998,17,-1,327,619172,17,619155
73999,11,-17,232,117163,11,117152
74000,5,-4,829,516995,5,516990
74001,10,14,576,1074652,10,1074642
74002,6,-13,128,221097,6,221091
74003,18,-11,919,310889,18,310871
74004,7,12,147,1002316,7,1002309
74005,7,-19,955,52011,7,52004
74006,9,-13,973,239443,9,239434
74007,13,16,853,1153191,13,1153178
74008,16,-19,397,57116,16,57100
74009,19,-14,561,213870,19,213851
74010,18,10,341,962407,18,962389
74011,9,-15,336,162705,9,162696
74012,17,18,44,1209239,17,1209222
74013,13,2,80,711149,13,711136
74014,9,-10,211,317223,9,317214
74015,5,-20,164,3664,5,3659
74016,14,0,987,655830,14,655816
74017,10,12,971,1020459,10,1020449
74018,18,3,716,747296,18,747278
74019,16,13,815,1059365,16,1059349
74020,8,6,151,815422,8,815414
74021,5,9,207,911175,5,911170
74022,10,-17,593,106346,10,106336
74023,15,-18,655,90052,15,90037
74024,19,-3,239,555460,19,555441
74025,16,-7,116,429141,16,429125
74026,17,5,220,805499,17,805482
74027,8,-8,199,379750,8,379742
74028,19,15,119,1117699,19,1117680
74029,8,-8,650,389268,8,389260
74030,13,-2,957,592440,13,592427
74031,17,7,224,868581,17,868564
74032,9,-16,380,132158,9,132149
74033,18,-20,788,28890,18,28872
74034,6,-17,286,99619,6,99613
74035,20,-17,337,118001,20,117981
74036,17,15,706,1121992,17,1121975
74037,19,1,636,684887,19,684868
74038,12,5,309,806028,12,806016
74039,14,18,899,1215544,14,1215530
74040,17,6,762,841898,17,841881
74041,10,17,843,1173538,10,1173528
74042,7,7,286,850913,7,850906
74043,5,-6,350,444319,5,444314
74044,11,-2,140,586148,11,586137
74045,18,7,807,872855,18,872837
74046,9,-13,751,234470,9,234461
74047,8,-16,907,143516,8,143508
74048,5,19,888,1237314,5,1237309
74049,12,-1,586,621148,12,621136
74050,17,6,13,835879,17,835862
74051,11,-14,617,214364,11,214353
74052,9,0,117,627990,9,627981
74053,15,-18,750,90746,15,90731
74054,17,-10,790,341006,17,340989
74055,9,11,682,983005,9,982996
74056,7,7,864,863183,7,863176
74057,13,-3,126,554705,13,554692
74058,7,-8,100,377495,7,377488
74059,14,16,181,1148427,14,1148413
74060,20,-17,474,118998,20,118978
74061,9,6,929,833115,9,833106
74062,16,-19,563,58446,16,58430
74063,17,4,162,774452,17,774435
74064,7,-17,546,105271,7,105264
74065,9,11,620,981748,9,981739
74066,12,-4,921,528966,12,528954
74067,14,7,584,871320,14,871306
74068,10,-13,312,224991,10,224981
74069,5,4,953,771459,5,771454
74070,18,18,54,1209356,18,1209338
74071,19,-3,738,559634,19,559615
74072,16,-17,923,122321,16,122305
74073,12,-11,744,309497,12,309485
74074,11,9,286,931022,11,931011
74075,16,-14,358,212200,16,212184
74076,15,-16,368,149611,15,149596
74077,19,9,936,936065,19,936046
74078,16,-12,5,272558,16,272542
74079,17,-2,921,592131,17,592114
74080,8,-2,160,566169,8,566161
74081,13,8,696,903492,13,903479
74082,16,-20,367,25628,16,25612
74083,18,8,339,900659,18,900641
74084,16,1,632,684849,16,684833
74085,12,6,404,839025,12,839013
74086,6,-4,441,509124,6,509118
74087,9,11,874,987311,9,987302
74088,5,3,983,740403,5,740398
74089,20,16,390,1149947,20,1149927
74090,11,13,890,1059883,11,1059872
74091,9,11,996,989737,9,989728
74092,19,-8,15,398005,19,397986
74093,20,-11,394,306885,20,306865
74094,10,-2,851,581016,10,581006
74095,14,6,192,837194,14,837180
74096,17,-14,978,217110,17,217093
74097,5,6,790,830071,5,830066
74098,10,15,356,1102069,10,1102059
74099,19,-3,652,558999,19,558980
74100,5,6,759,829379,5,829374
74101,6,-11,406,290135,6,290129
74102,18,12,471,1025495,18,1025477
74103,5,-16,763,140468,5,140463
74104,19,-8,750,403203,19,403184
74105,17,12,683,1027208,17,1027191
74106,16,6,560,840277,16,840261
74107,14,13,156,1054353,14,1054339
74108,11,2,264,712542,11,712531
74109,18,0,612,652886,18,652868
74110,6,-15,473,165687,6,165681
74111,8,-11,120,283772,8,283764
74112,19,11,567,994933,19,994914
74113,12,-4,413,525312,12,525300
74114,16,-15,321,180109,16,180093
74115,15,11,233,992452,15,992437
74116,15,12,861,1028549,15,1028534
74117,12,-6,871,465674,12,465662
74118,9,-16,728,139660,9,139651
74119,20,19,302,1243179,20,1243159
74120,19,-4,354,524890,19,524871
74121,12,-10,205,336559,12,336547
74122,20,-16,670,151836,20,151816
74123,14,5,876,810152,14,810138
74124,15,16,926,1153750,15,1153735
74125,5,13,42,1031671,5,1031666
74126,10,5,933,801304,10,801294
74127,20,10,736,965544,20,965524
74128,10,-10,403,321353,10,321343
74129,15,-2,313,587489,15,587474
74130,16,-1,732,622232,16,622216
74131,14,-1,6,616549,14,616535
74132,13,-6,46,459473,13,459460
74133,12,-8,779,403430,12,403418
74134,13,8,800,904284,13,904271
74135,11,9,684,934079,11,934068
74136,10,-2,357,570332,10,570322
74137,11,-18,443,88575,11,88564
74138,8,-14,288,193014,8,193006
74139,5,10,568,949705,5,949700
74140,9,4,775,767521,9,767512
74141,5,-8,624,388663,5,388658
74142,16,-20,879,29587,16,29571
74143,9,-8,420,384014,9,384005
74144,5,-20,437,9364,5,9359
74145,18,1,839,686333,18,686315
74146,8,8,486,885827,8,885819
74147,17,19,185,1242222,17,1242205
74148,5,-19,582,44337,5,44332
74149,15,-1,995,624130,15,624115
74150,20,-8,290,399943,20,399923
74151,13,12,256,1023982,13,1023969
74152,12,-20,526,26778,12,26766
74153,14,-18,247,87263,14,87249
74154,11,-3,556,558180,11,558169
74155,17,-20,899,29733,17,29716
74156,20,15,676,1121738,20,1121718
74157,16,-19,956,61206,16,61190
74158,13,18,532,1212885,13,1212872
74159,10,16,194,1129311,10,1129301
74160,9,-11,853,299422,9,299413
74161,11,7,32,867245,11,867234
74162,11,1,81,680395,11,680384
74163,16,19,999,1248794,16,1248778
74164,16,-17,357,118132,16,118116
74165,15,18,475,1212480,15,1212465
74166,19,6,66,836256,19,836237
74167,20,1,946,687250,20,687230
74168,17,-7,282,430449,17,430432
74169,11,-10,460,338451,11,338440
74170,5,-10,982,333625,5,333620
74171,10,19,423,1227334,10,1227324
74172,15,-19,485,57685,15,57670
74173,9,9,761,922690,9,922681
74174,8,6,256,817987,8,817979
74175,16,13,767,1058989,16,1058973
74176,14,-6,455,462630,14,462616
74177,15,7,339,869501,15,869486
74178,11,18,797,1214777,11,1214766
74179,16,-11,926,310923,16,310907
74180,13,3,755,747539,13,747526
74181,6,13,261,1036223,6,1036217
74182,11,0,785,654231,11,654220
74183,8,7,259,850391,8,850383
74184,18,16,214,1148676,18,1148658
74185,10,-18,186,66536,10,66526
74186,15,-16,599,151438,15,151423
74187,9,19,330,1224996,9,1224987
74188,16,-10,713,340438,16,340422
74189,16,-11,984,311423,16,311407
74190,17,-11,445,307327,17,307310
74191,10,14,921,1082348,10,1082338
74192,8,19,494,1228738,8,1228730
74193,5,14,446,1071751,5,1071746
74194,16,-6,758,464944,16,464928
74195,11,17,630,1182536,11,1182525
74196,5,-13,765,234896,5,234891
74197,16,8,607,902744,16,902728
74198,5,13,505,1041586,5,1041581
74199,19,-11,175,305160,19,305141
74200,11,-7,225,429993,11,429982
74201,9,12,355,1006900,9,1006891
74202,9,7,991,865779,9,865770
74203,9,8,446,884971,9,884962
74204,5,1,192,661380,5,661375
74205,6,-2,213,567261,6,567255
74206,11,0,384,651003,11,650992
74207,11,-2,454,588574,11,588563
74208,5,9,836,924567,5,924562
74209,15,-15,421,180892,15,180877
74210,17,8,263,900030,17,900013
74211,18,15,164,1118014,18,1117996
74212,13,-18,772,90882,13,90869
74213,15,-8,400,400755,15,400740
74214,9,-7,133,408604,9,408595
74215,12,-14,850,216152,12,216140
74216,5,-1,969,614772,5,614767
74217,15,19,8,1240715,15,1240700
74218,14,19,333,1243473,14,1243459
74219,13,13,763,1058966,13,1058953
74220,15,-17,649,120358,15,120343
74221,18,9,838,935285,18,935267
74222,12,17,591,1182229,12,1182217
74223,15,-10,641,339884,15,339869
74224,18,-18,232,87145,18,87127
74225,8,-9,409,352523,8,352515
74226,19,-13,686,246003,19,245984
74227,17,1,853,686453,17,686436
74228,12,-11,97,304466,12,304454
74229,18,5,237,805586,18,805568
74230,10,2,311,695340,10,695330
74231,15,3,862,748351,15,748336
74232,19,7,334,869470,19,869451
74233,19,18,363,1211748,19,1211729
74234,5,-13,949,238967,5,238962
74235,11,8,949,905340,11,905329
74236,18,6,108,836601,18,836583
74237,10,2,956,708645,10,708635
74238,5,-4,595,512280,5,512275
74239,20,-11,954,311186,20,311166
74240,6,-8,103,377516,6,377510
74241,8,8,265,880956,8,880948
74242,6,13,171,1034295,6,1034289
74243,13,-12,45,272810,13,272797
74244,12,-2,227,586851,12,586839
74245,14,-9,678,371792,14,371778
74246,9,-20,804,17861,9,17852
74247,17,-20,900,29759,17,29742
74248,15,-12,805,278395,15,278380
74249,14,9,458,932372,14,932358
74250,9,-17,868,111806,9,111797
74251,13,-4,579,526464,13,526451
74252,17,-19,207,55729,17,55712
74253,16,15,611,1121253,16,1121237
74254,9,-17,155,96693,9,96684
74255,9,-20,387,8433,9,8424
74256,13,-16,109,147729,13,147716
74257,8,-14,578,199232,8,199224
74258,9,-2,181,566571,9,566562
74259,16,-15,175,179042,16,179026
74260,14,1,655,685034,14,685020
74261,7,-3,98,532504,7,532497
74262,10,-1,579,606556,10,606546
74263,14,1,3,679772,14,679758
74264,5,-10,666,327148,5,327143
74265,9,12,192,1003309,9,1003300
74266,9,9,621,919992,9,919983
74267,11,4,356,775793,11,775782
74268,6,11,572,980772,6,980766
74269,9,15,1000,1115732,9,1115723
74270,13,-9,814,372998,13,372985
74271,10,-3,392,539045,10,539035
74272,20,3,969,749284,20,749264
74273,19,-15,690,182866,19,182847
74274,6,13,994,1051983,6,1051977
74275,16,-4,610,526688,16,526672
74276,7,1,223,662096,7,662089
74277,17,-18,174,86661,17,86644
74278,5,15,906,1113718,5,1113713
74279,9,-14,149,189714,9,189705
74280,17,5,713,809002,17,808985
74281,15,19,686,1246340,15,1246325
74282,8,-11,642,295331,8,295323
74283,6,-9,302,350195,6,350189
74284,20,-12,905,279337,20,279317
74285,13,2,590,715007,13,714994
74286,10,5,539,792831,10,792821
74287,5,-5,697,483099,5,483094
74288,18,13,579,1057677,18,1057659
74289,12,8,733,903792,12,903780
74290,7,-15,502,166370,7,166363
74291,15,17,920,1184820,15,1184805
74292,10,7,46,845827,10,845817
74293,15,-13,69,241544,15,241529
74294,18,7,631,871638,18,871620
74295,6,9,923,926399,6,926393
74296,9,-10,717,328013,9,328004
74297,11,16,799,1152840,11,1152829
74298,6,14,3,1061748,6,1061742
74299,20,-20,1,1720,20,1700
74300,19,-15,397,180662,19,180643
74301,20,-20,965,30088,20,30068
74302,20,-5,981,498250,20,498230
74303,20,-5,251,492879,20,492859
74304,12,-13,437,244203,12,244191
74305,9,-2,244,568003,9,567994
74306,6,-4,716,514828,6,514822
74307,18,-3,670,559138,18,559120
74308,19,18,656,1213709,19,1213690
74309,10,13,450,1040430,10,1040420
74310,16,15,542,1120708,16,1120692
74311,6,-13,851,236806,6,236800
74312,13,-17,715,120883,13,120870
74313,6,18,828,1204251,6,1204245
74314,18,-15,251,179597,18,179579
74315,18,-15,748,183351,18,183333
74316,5,18,667,1200808,5,1200803
74317,12,-4,785,527907,12,527895
74318,12,-2,608,589695,12,589683
74319,15,19,681,1246295,15,1246280
74320,19,-4,7,522114,19,522095
74321,17,-11,47,303981,17,303964
74322,5,0,450,635147,5,635142
74323,12,19,927,1248237,12,1248225
74324,13,16,258,1148985,13,1148972
74325,20,-19,295,56291,20,56271
74326,15,17,572,1182079,15,1182064
74327,8,19,766,1234503,8,1234495
74328,9,-20,128,2858,9,2849
74329,13,-18,19,85337,13,85324
74330,17,-20,18,10804,17,10787
74331,10,-9,292,350000,10,349990
74332,14,2,325,713048,14,713034
74333,7,-18,914,82352,7,82345
74334,7,9,203,911072,7,911065
74335,14,-3,203,555225,14,555211
74336,14,1,477,683627,14,683613
74337,5,-19,196,35933,5,35928
74338,5,-19,194,35870,5,35865
74339,16,-15,111,178611,16,178595
74340,7,5,497,791908,7,791901
74341,16,-15,108,178583,16,178567
74342,15,-7,932,435212,15,435197
74343,7,-9,585,356803,7,356796
74344,8,-6,192,441115,8,441107
74345,10,12,293,1005652,10,1005642
74346,19,0,42,648578,19,648559
74347,5,19,91,1219538,5,1219533
74348,6,9,110,909119,6,909113
74349,20,19,566,1245406,20,1245386
74350,7,-9,118,346087,7,346080
74351,6,15,76,1096069,6,1096063
74352,15,-4,652,527019,15,527004
74353,17,8,369,900844,17,900827
74354,9,-14,722,202475,9,202466
74355,13,15,997,1124110,13,1124097
74356,16,-8,289,399911,16,399895
74357,15,-8,684,402762,15,402747
74358,18,-16,212,148529,18,148511
74359,19,-14,131,210321,19,210302
74360,13,-2,261,587098,13,587085
74361,7,-8,43,376304,7,376297
74362,13,6,637,840937,13,840924
74363,18,-13,737,246477,18,246459
74364,10,2,551,700294,10,700284
74365,13,-7,477,431913,13,431900
74366,18,-8,859,403976,18,403958
74367,10,14,505,1073097,10,1073087
74368,9,-8,774,391947,9,391938
74369,19,11,773,996452,19,996433
74370,5,9,432,915737,5,915732
74371,20,-15,637,182488,20,182468
74372,8,12,599,1011966,8,1011958
74373,20,-14,710,215070,20,215050
74374,16,6,657,841062,16,841046
74375,13,-20,65,23278,13,23265
74376,11,11,176,992073,11,992062
74377,15,-16,345,149442,15,149427
74378,16,-11,818,310080,16,310064
74379,14,-15,163,178977,14,178963
74380,5,5,877,800071,5,800066
74381,11,-12,871,279021,11,279010
74382,12,0,595,652753,12,652741
74383,6,3,624,732152,6,732146
74384,5,12,409,1007830,5,1007825
74385,7,-20,733,16103,7,16096
74386,14,11,422,993948,14,993934
74387,17,8,85,898571,17,898554
74388,9,-7,180,409698,9,409689
74389,5,1,337,664660,5,664655
74390,5,7,200,849018,5,849013
74391,6,-10,716,327985,6,327979
74392,15,-8,117,398731,15,398716
74393,19,-15,840,184076,19,184057
74394,19,-3,515,557778,19,557759
74395,16,19,725,1246694,16,1246678
74396,6,9,589,919267,6,919261
74397,20,-7,9,428325,20,428305
74398,5,-11,873,299830,5,299825
74399,12,3,156,743003,12,742991
74400,19,4,815,779260,19,779241
74401,19,-12,526,276458,19,276439
74402,14,-14,9,209417,14,209403
74403,11,7,712,872195,11,872184
74404,5,-20,95,2100,5,2095
74405,20,16,642,1151726,20,1151706
74406,12,9,597,933504,12,933492
74407,17,1,618,684704,17,684687
74408,7,14,653,1076606,7,1076599
74409,15,-15,673,182777,15,182762
74410,15,-4,857,528382,15,528367
74411,16,9,956,936210,16,936194
74412,8,10,162,941094,8,941086
74413,15,10,337,962375,15,962360
74414,18,-8,606,402110,18,402092
74415,13,-3,576,558354,13,558341
74416,16,16,881,1153346,16,1153330
74417,19,-6,881,465754,19,465735
74418,15,14,853,1092045,15,1092030
74419,15,-7,20,428451,15,428436
74420,15,3,930,748904,15,748889
74421,18,-12,641,277228,18,277210
74422,14,19,472,1244686,14,1244672
74423,10,-15,410,164336,10,164326
74424,9,-2,374,570643,9,570634
74425,19,-6,620,463915,19,463896
74426,17,16,823,1153007,17,1152990
74427,11,2,235,712336,11,712325
74428,19,14,289,1087668,19,1087649
74429,20,3,609,746382,20,746362
74430,6,-8,758,391610,6,391604
74431,15,-13,375,243783,15,243768
74432,14,-4,48,522397,14,522383
74433,20,-8,532,401580,20,401560
74434,5,-1,614,607225,5,607220
74435,6,-16,372,131977,6,131971
74436,10,-4,249,505118,10,505108
74437,20,-13,969,248359,20,248339
74438,15,18,270,1211148,15,1211133
74439,14,-3,734,559608,14,559594
74440,9,-2,714,578067,9,578058
74441,13,0,553,652406,13,652393
74442,6,9,350,914131,6,914125
74443,11,-6,401,462178,11,462167
74444,11,12,975,1029620,11,1029609
74445,16,-18,23,85382,16,85366
74446,14,-20,736,28448,14,28434
74447,18,12,166,1023281,18,1023263
74448,17,-14,674,214813,17,214796
74449,15,9,6,929091,15,929076
74450,5,17,171,1158889,5,1158884
74451,12,-15,211,179269,12,179257
74452,12,-13,128,241934,12,241922
74453,20,-13,455,244315,20,244295
74454,12,1,432,683235,12,683223
74455,8,-20,832,18462,8,18454
74456,7,0,584,638008,7,638001
74457,18,-2,416,588231,18,588213
74458,5,8,425,884526,5,884521
74459,10,-6,885,455705,10,455695
74460,12,6,958,843372,12,843360
74461,6,-10,899,331817,6,331811
74462,12,-14,894,216455,12,216443
74463,17,1,476,683610,17,683593
74464,15,-8,720,402980,15,402965
74465,18,14,271,1087524,18,1087506
74466,5,16,439,1134651,5,1134646
74467,6,-3,500,541691,6,541685
74468,13,2,166,711856,13,711843
74469,10,-8,994,396662,10,396652
74470,10,-5,54,469055,10,469045
74471,17,-18,146,86365,17,86348
74472,13,-5,146,492068,13,492055
74473,13,-1,307,619018,13,619005
74474,14,16,890,1153429,14,1153415
74475,6,3,306,725592,6,725586
74476,17,-5,450,494320,17,494303
74477,16,5,836,809886,16,809870
74478,9,-17,580,106054,9,106045
74479,9,5,697,796116,9,796107
74480,9,2,868,706682,9,706673
74481,13,10,296,962039,13,962026
74482,16,7,690,872071,16,872055
74483,18,18,516,1212779,18,1212761
74484,9,-8,56,376640,9,376631
74485,12,6,654,841028,12,841016
74486,15,-2,272,587171,15,587156
74487,17,-19,123,55000,17,54983
74488,20,-14,369,212371,20,212351
74489,15,13,816,1059369,15,1059354
74490,18,-19,731,59749,18,59731
74491,18,-14,19,209482,18,209464
74492,18,19,782,1247113,18,1247095
74493,14,-7,761,433824,14,433810
74494,17,11,17,990987,17,990970
74495,10,-13,417,227013,10,227003
74496,15,17,699,1183116,15,1183101
74497,18,-20,85,23429,18,23411
74498,15,-13,814,247087,15,247072
74499,7,0,400,634011,7,634004
74500,18,7,502,870736,18,870718
74501,15,7,501,870715,15,870700
74502,10,-2,414,571518,10,571508
74503,10,15,531,1105813,10,1105803
74504,5,-5,818,485615,5,485610
74505,7,15,813,1111654,7,1111647
74506,18,-7,915,435072,18,435054
74507,18,-9,879,373560,18,373542
74508,5,12,210,1003732,5,1003727
74509,9,2,721,703857,9,703848
74510,6,19,111,1219951,6,1219945
74511,5,-12,988,271178,5,271173
74512,20,6,969,843506,20,843486
74513,10,-12,1,249641,10,249631
74514,16,4,726,778618,16,778602
74515,13,15,611,1121256,13,1121243
74516,20,-18,280,87440,20,87420
74517,10,15,558,1106352,10,1106342
74518,6,1,218,661980,6,661974
74519,8,-15,329,162533,8,162525
74520,5,14,0,1061677,5,1061672
74521,15,1,454,683444,15,683429
74522,16,-12,202,273930,16,273914
74523,14,18,626,1213439,14,1213425
74524,18,-11,94,304427,18,304409
74525,17,-2,850,591616,17,591599
74526,12,-17,132,116464,12,116452
74527,9,11,804,985659,9,985650
74528,16,7,712,872201,16,872185
74529,11,3,668,746882,11,746871
74530,7,-4,392,508170,7,508163
74531,14,-6,67,459576,14,459562
74532,19,3,962,749213,19,749194
74533,13,-16,896,153529,13,153516
74534,12,14,290,1087669,12,1087657
74535,12,5,775,809389,12,809377
74536,5,18,62,1188150,5,1188145
74537,17,13,729,1058673,17,1058656
74538,13,0,938,655378,13,655365
74539,9,-2,95,564854,9,564845
74540,14,-4,998,529592,14,529578
74541,14,11,416,993894,14,993880
74542,8,-10,17,312970,8,312962
74543,5,-13,35,219151,5,219146
74544,18,-1,809,622780,18,622762
74545,8,17,173,1158942,8,1158934
74546,10,-8,304,381834,10,381824
74547,17,-17,707,120807,17,120790
74548,5,-8,128,378082,5,378077
74549,20,6,450,839359,20,839339
74550,19,14,298,1087742,19,1087723
74551,15,11,80,991453,15,991438
74552,15,15,418,1119721,15,1119706
74553,18,8,375,900892,18,900874
74554,16,-12,303,274785,16,274769
74555,12,-15,560,181908,12,181896
74556,20,8,428,901385,20,901365
74557,17,-9,897,373683,17,373666
74558,14,-8,586,401937,14,401923
74559,18,15,725,1122169,18,1122151
74560,13,-19,462,57513,13,57500
74561,16,-11,759,309641,16,309625
74562,20,-7,615,432844,20,432824
74563,8,19,157,1221011,8,1221003
74564,20,1,966,687377,20,687357
74565,9,4,833,768860,9,768851
74566,17,15,508,1120443,17,1120426
74567,7,-5,105,470435,7,470428
74568,7,-6,630,450317,7,450310
74569,13,-7,421,431496,13,431483
74570,19,10,579,964348,19,964329
74571,18,6,402,839001,18,838983
74572,19,-10,185,336448,19,336429
74573,16,19,910,1248152,16,1248136
74574,17,-12,977,279923,17,279906
74575,5,6,609,826077,5,826072
74576,11,16,21,1147241,11,1147230
74577,14,-5,724,496333,14,496319
74578,14,-11,74,304261,14,304247
74579,12,17,7,1177897,12,1177885
74580,10,6,140,815210,10,815200
74581,20,-12,746,277994,20,277974
74582,14,14,125,1086462,14,1086448
74583,9,-12,325,256744,9,256735
74584,13,10,483,963525,13,963512
74585,5,16,410,1134028,5,1134023
74586,20,-16,125,147880,20,147860
74587,12,7,449,870408,12,870396
74588,17,12,157,1023187,17,1023170
74589,16,12,215,1023660,16,1023644
74590,10,8,58,876327,10,876317
74591,10,-14,336,194032,10,194022
74592,10,-19,937,51650,10,51640
74593,7,-7,867,424263,7,424256
74594,16,-12,595,276850,16,276834
74595,9,-3,242,535713,9,535704
74596,5,16,791,1141555,5,1141550
74597,6,-13,988,239723,6,239717
74598,18,-9,506,370652,18,370634
74599,5,2,64,690003,5,689998
74600,8,10,977,958421,8,958413
74601,14,-14,686,214915,14,214901
74602,18,9,727,934386,18,934368
74603,5,9,125,909414,5,909409
74604,5,15,779,1110982,5,1110977
74605,7,2,691,703219,7,703212
74606,12,-17,648,120331,12,120319
74607,5,19,30,1218088,5,1218083
74608,17,13,316,1055512,17,1055495
74609,12,19,238,1242599,12,1242587
74610,13,-1,513,620653,13,620640
74611,11,-4,834,528173,11,528162
74612,5,11,863,986911,5,986906
74613,15,11,141,991850,15,991835
74614,8,3,88,720708,8,720700
74615,17,19,405,1244131,17,1244114
74616,16,16,130,1147996,16,1147980
74617,17,17,446,1181273,17,1181256
74618,6,-8,967,396034,6,396028
74619,7,-12,894,269066,7,269059
74620,16,-1,235,618436,16,618420
74621,19,8,848,904579,19,904560
74622,19,-12,901,279295,19,279276
74623,5,-11,932,301115,5,301110
74624,8,-5,457,477863,8,477855
74625,19,-17,836,121766,19,121747
74626,15,-2,349,587709,15,587694
74627,5,15,653,1108321,5,1108316
74628,19,16,333,1149530,19,1149511
74629,15,2,337,713139,15,713124
74630,12,-4,868,528524,12,528512
74631,19,-7,700,433399,19,433380
74632,9,3,354,726556,9,726547
74633,15,7,949,873753,15,873738
74634,10,-17,152,96642,10,96632
74635,9,-8,485,385404,9,385395
74636,20,13,508,1057039,20,1057019
74637,9,9,144,909817,9,909808
74638,10,2,824,705785,10,705775
74639,12,-7,699,433391,12,433379
74640,18,17,52,1178285,18,1178267
74641,6,-17,754,109679,6,109673
74642,5,-4,992,520825,5,520820
74643,20,16,347,1149654,20,1149634
74644,6,-2,619,575936,6,575930
74645,5,-18,394,70888,5,70883
74646,17,4,862,779707,17,779690
74647,18,5,967,810935,18,810917
74648,5,-5,224,472911,5,472906
74649,17,12,459,1025412,17,1025395
74650,6,-4,443,509144,6,509138
74651,19,18,45,1209270,19,1209251
74652,9,6,788,830016,9,830007
74653,11,3,864,748363,11,748352
74654,10,19,164,1221133,10,1221123
74655,12,3,99,742538,12,742526
74656,9,2,386,696970,9,696961
74657,14,5,658,808588,14,808574
74658,11,-14,710,215071,11,215060
74659,16,5,377,806568,16,806552
74660,10,0,750,641832,10,641822
74661,18,-19,521,58025,18,58007
74662,17,16,55,1147485,17,1147468
74663,17,16,793,1152770,17,1152753
74664,12,-4,582,526484,12,526472
74665,13,8,682,903381,13,903368
74666,10,-13,946,238857,10,238847
74667,15,-11,144,304862,15,304847
74668,7,15,419,1103159,7,1103152
74669,18,-13,800,247001,18,246983
74670,17,-4,342,524749,17,524732
74671,20,2,856,716866,20,716846
74672,20,2,830,716689,20,716669
74673,15,16,162,1148212,15,1148197
74674,20,12,837,1028306,20,1028286
74675,6,4,451,760357,6,760351
74676,14,15,189,1118228,14,1118214
74677,9,-18,719,77926,9,77917
74678,14,9,48,929440,14,929426
74679,17,-20,999,30452,17,30435
74680,10,-4,449,509231,10,509221
74681,20,-4,930,529029,20,529009
74682,8,17,967,1176132,8,1176124
74683,8,14,784,1079545,8,1079537
74684,9,-8,362,382955,9,382946
74685,13,9,246,930806,13,930793
74686,5,-6,192,441120,5,441115
74687,9,-17,126,96059,9,96050
74688,14,16,914,1153668,14,1153654
74689,7,7,967,865177,7,865170
74690,14,8,368,900831,14,900817
74691,10,-9,313,350492,10,350482
74692,17,-20,16,9284,17,9267
74693,11,14,646,1090487,11,1090476
74694,16,17,3,1177881,16,1177865
74695,7,2,730,704042,7,704035
74696,17,-10,343,337551,17,337534
74697,19,-19,202,55681,19,55662
74698,5,9,168,910367,5,910362
74699,13,-8,817,403755,13,403742
74700,8,11,237,973239,8,973231
74701,15,1,622,684746,15,684731
74702,7,-16,580,136601,7,136594
74703,13,13,835,1059494,13,1059481
74704,18,-11,148,304898,18,304880
74705,20,-14,808,215865,20,215845
74706,10,-1,900,613327,10,613317
74707,9,15,254,1099996,9,1099987
74708,15,-3,267,555673,15,555658
74709,5,5,169,785041,5,785036
74710,17,18,91,1209660,17,1209643
74711,10,11,363,976216,10,976206
74712,17,14,405,1088629,17,1088612
74713,6,6,828,830938,6,830932
74714,20,-10,897,341834,20,341814
74715,10,-13,721,233773,10,233763
74716,15,-1,65,617032,15,617017
74717,13,0,45,648600,13,648587
74718,11,12,182,1023372,11,1023361
74719,15,-1,623,621402,15,621387
74720,12,3,118,742720,12,742708
74721,19,18,188,1210535,19,1210516
74722,5,-12,454,259351,5,259346
74723,19,7,880,873367,19,873348
74724,19,-13,83,241632,19,241613
74725,10,17,776,1171797,10,1171787
74726,11,-14,572,214027,11,214016
74727,7,-17,542,105142,7,105135
74728,7,-11,58,282378,7,282371
74729,13,-18,239,87196,13,87183
74730,9,17,325,1162315,9,1162306
74731,16,-11,99,304474,16,304458
74732,14,9,729,934398,14,934384
74733,7,3,551,730438,7,730431
74734,20,6,748,841788,20,841768
74735,11,9,580,933337,11,933326
74736,17,8,448,901544,17,901527
74737,19,-7,397,431357,19,431338
74738,11,-12,317,274877,11,274866
74739,11,10,357,962519,11,962508
74740,12,-2,649,589998,12,589986
74741,5,3,867,737615,5,737610
74742,20,-8,342,400316,20,400296
74743,9,-11,614,294768,9,294759
74744,8,14,679,1077231,8,1077223
74745,18,-3,976,561597,18,561579
74746,8,10,154,940886,8,940878
74747,10,2,956,708655,10,708645
74748,19,-3,768,559959,19,559940
74749,13,19,254,1242748,13,1242735
74750,13,19,937,1248281,13,1248268
74751,13,-3,230,555369,13,555356
74752,8,-8,491,385565,8,385557
74753,11,15,723,1122145,11,1122134
74754,14,-1,133,617589,14,617575
74755,11,-17,415,118502,11,118491
74756,6,-20,736,16173,6,16167
74757,10,0,925,645499,10,645489
74758,12,-4,902,528860,12,528848
74759,12,-18,747,90702,12,90690
74760,14,17,649,1182701,14,1182687
74761,9,19,56,1218659,9,1218650
74762,20,7,895,873430,20,873410
74763,16,-2,217,586785,16,586769
74764,20,11,914,997525,20,997505
74765,16,4,319,775485,16,775469
74766,12,1,39,680103,12,680091
74767,20,-5,151,492123,20,492103
74768,7,-16,39,124649,7,124642
74769,12,11,896,997387,12,997375
74770,6,-20,30,701,6,695
74771,14,18,59,1209395,14,1209381
74772,10,-5,348,475783,10,475773
74773,12,-18,344,87913,12,87901
74774,14,-8,5,397891,14,397877
74775,11,-3,79,554349,11,554338
74776,10,2,537,700022,10,700012
74777,11,-1,998,624145,11,624134
74778,19,-8,61,398409,19,398390
74779,14,-7,97,428959,14,428945
74780,18,12,720,1027454,18,1027436
74781,11,-5,734,496413,11,496402
74782,7,4,956,771490,7,771483
74783,8,-6,245,442222,8,442214
74784,18,5,601,808201,18,808183
74785,11,6,957,843356,11,843345
74786,6,7,986,865689,6,865683
74787,16,3,22,741955,16,741939
74788,15,-3,407,556811,15,556796
74789,17,-4,967,529375,17,529358
74790,8,-12,811,267094,8,267086
74791,18,-9,746,372345,18,372327
74792,14,-8,229,399540,14,399526
74793,7,18,357,1194389,7,1194382
74794,13,18,467,1212418,13,1212405
74795,5,-15,894,174416,5,174411
74796,5,3,620,732084,5,732079
74797,19,-18,700,90295,19,90276
74798,13,12,590,1026401,13,1026388
74799,9,-4,312,506286,9,506277
74800,14,0,391,651046,14,651032
74801,6,-20,514,11068,6,11062
74802,5,10,448,947112,5,947107
74803,12,-11,629,308730,12,308718
74804,5,13,393,1039176,5,1039171
74805,8,19,462,1228105,8,1228097
74806,6,-18,693,77261,6,77255
74807,17,-6,267,461262,17,461245
74808,17,3,798,747861,17,747844
74809,19,-6,254,461164,19,461145
74810,20,-4,899,528834,20,528814
74811,15,3,294,744122,15,744107
74812,11,18,615,1213359,11,1213348
74813,15,-15,552,181874,15,181859
74814,20,8,623,902879,20,902859
74815,13,-5,145,492066,13,492053
74816,15,2,754,716248,15,716233
74817,20,-19,522,58041,20,58021
74818,14,5,688,808819,14,808805
74819,9,-11,776,297867,9,297858
74820,18,8,458,901583,18,901565
74821,5,3,181,722761,5,722756
74822,12,3,309,744275,12,744263
74823,7,4,729,766461,7,766454
74824,7,4,751,766954,7,766947
74825,16,13,923,1060079,16,1060063
74826,8,0,64,626682,8,626674
74827,9,-19,948,51912,9,51903
74828,10,-10,450,322416,10,322406
74829,16,-5,914,497743,16,497727
74830,12,-12,156,273680,12,273668
74831,13,-4,142,523128,13,523115
74832,18,-8,673,402665,18,402647
74833,15,6,0,835741,15,835726
74834,20,12,484,1025651,20,1025631
74835,13,-19,939,61074,13,61061
74836,17,4,307,775410,17,775393
74837,12,8,426,901363,12,901351
74838,19,-20,74,23348,19,23329
74839,12,-17,524,119414,12,119402
74840,19,15,260,1118710,19,1118691
74841,20,19,78,1241421,20,1241401
74842,13,-18,253,87300,13,87287
74843,17,8,110,898805,17,898788
74844,13,1,736,685587,13,685574
74845,18,-13,663,245846,18,245828
74846,8,11,476,978619,8,978611
74847,10,18,61,1188098,10,1188088
74848,19,6,11,835857,19,835838
74849,7,-2,567,574819,7,574812
74850,16,-18,224,87025,16,87009
74851,18,-18,990,92423,18,92405
74852,9,-14,433,196148,9,196139
74853,18,17,554,1182010,18,1181992
74854,11,-11,479,307552,11,307541
74855,6,11,824,986037,6,986031
74856,9,3,962,739826,9,739817
74857,15,9,409,932012,15,931997
74858,19,-3,405,556791,19,556772
74859,17,-8,748,403191,17,403174
74860,20,4,457,776543,20,776523
74861,6,7,966,865146,6,865140
74862,10,4,982,771956,10,771946
74863,17,3,616,746453,17,746436
74864,14,-10,215,336672,14,336658
74865,18,-8,422,400819,18,400801
74866,15,-11,833,310210,15,310195
74867,12,-8,298,399967,12,399955
74868,20,12,779,1027851,20,1027831
74869,14,9,454,932328,14,932314
74870,16,3,906,748647,16,748631
74871,8,-5,498,478776,8,478768
74872,14,-20,423,25965,14,25951
74873,9,18,374,1194778,9,1194769
74874,15,-14,22,209496,15,209481
74875,20,10,400,962867,20,962847
74876,11,17,222,1179503,11,1179492
74877,12,-13,247,242876,12,242864
74878,6,-8,867,393850,6,393844
74879,15,18,889,1215499,15,1215484
74880,12,-2,486,588821,12,588809
74881,11,11,116,991668,11,991657
74882,5,0,286,631441,5,631436
74883,12,16,351,1149685,12,1149673
74884,19,12,209,1023597,19,1023578
74885,19,-11,652,308950,19,308931
74886,13,19,709,1246527,13,1246514
74887,18,12,972,1029580,18,1029562
74888,11,9,21,929190,11,929179
74889,19,16,661,1151859,19,1151840
74890,7,-17,472,103529,7,103522
74891,10,-4,720,514869,10,514859
74892,9,-7,694,420599,9,420590
74893,19,12,364,1024771,19,1024752
74894,17,-3,369,556513,17,556496
74895,12,-10,696,340354,12,340342
74896,6,-12,784,266436,6,266430
74897,5,8,310,882029,5,882024
74898,7,14,317,1068798,7,1068791
74899,20,19,972,1248597,20,1248577
74900,19,4,909,779975,19,779956
74901,9,-19,980,52527,9,52518
74902,6,-18,43,63281,6,63275
74903,19,-1,228,618378,19,618359
74904,11,2,243,712399,11,712388
74905,11,12,37,1022376,11,1022365
74906,14,0,762,654148,14,654134
74907,18,0,496,651954,18,651936
74908,18,19,347,1243561,18,1243543
74909,11,19,333,1243474,11,1243463
74910,19,8,72,898443,19,898424
74911,16,-9,189,367886,16,367870
74912,6,3,960,739771,6,739765
74913,5,-15,573,167831,5,167826
74914,17,-18,452,88670,17,88653
74915,19,-6,738,464807,19,464788
74916,13,-9,723,372087,13,372074
74917,15,14,812,1091838,15,1091823
74918,7,6,356,820303,7,820296
74919,14,-2,56,585580,14,585566
74920,10,5,540,792856,10,792846
74921,20,13,16,1053349,20,1053329
74922,15,-17,345,118066,15,118051
74923,6,1,121,659772,6,659766
74924,10,5,339,788601,10,788591
74925,8,12,48,1000165,8,1000157
74926,8,-14,621,200359,8,200351
74927,17,16,385,1149893,17,1149876
74928,18,16,585,1151233,18,1151215
74929,8,-5,341,475655,8,475647
74930,20,4,188,774596,20,774576
74931,18,-11,94,304435,18,304417
74932,13,14,873,1092270,13,1092257
74933,14,-2,8,585179,14,585165
74934,11,-11,726,309402,11,309391
74935,5,-15,409,164309,5,164304
74936,11,-4,692,527307,11,527296
74937,11,-1,314,619093,11,619082
74938,11,-4,40,522341,11,522330
74939,15,-7,572,432601,15,432586
74940,18,5,130,804704,18,804686
74941,17,-5,585,495372,17,495355
74942,8,-16,28,124435,8,124427
74943,15,12,839,1028357,15,1028342
74944,18,-19,148,55205,18,55187
74945,19,-10,24,335310,19,335291
74946,6,-4,962,520119,6,520113
74947,6,-11,187,285180,6,285174
74948,17,6,5,835771,17,835754
74949,8,-19,865,50418,8,50410
74950,15,3,970,749288,15,749273
74951,15,-10,248,336894,15,336879
74952,13,-16,744,152334,13,152321
74953,14,-3,582,558391,14,558377
74954,20,8,515,902060,20,902040
74955,13,9,355,931643,13,931630
74956,13,16,858,1153232,13,1153219
74957,15,-11,433,307244,15,307229
74958,19,18,860,1215229,19,1215210
74959,6,-19,592,44502,6,44496
74960,13,-2,767,590869,13,590856
74961,15,-4,402,525240,15,525225
74962,9,-6,344,444225,9,444216
74963,12,12,366,1024792,12,1024780
74964,20,18,136,1210064,20,1210044
74965,20,12,581,1026323,20,1026303
74966,6,-1,723,609465,6,609459
74967,16,-9,784,372749,16,372733
74968,7,18,926,1206340,7,1206333
74969,5,-12,258,255070,5,255065
74970,7,-3,648,545055,7,545048
74971,14,6,295,838040,14,838026
74972,6,1,549,669350,6,669344
74973,19,-4,307,524475,19,524456
74974,10,6,113,814669,10,814659
74975,6,-2,588,575226,6,575220
74976,19,-14,545,213691,19,213672
74977,11,-5,388,493864,11,493853
74978,17,-17,295,117702,17,117685
74979,13,8,298,900317,13,900304
74980,17,-14,195,210815,17,210798
74981,12,9,242,930778,12,930766
74982,18,16,133,1148034,18,1148016
74983,6,-2,863,581235,6,581229
74984,7,4,122,753205,7,753198
74985,19,17,967,1185199,19,1185180
74986,19,-15,952,185048,19,185029
74987,16,15,860,1123051,16,1123035
74988,20,-12,521,276408,20,276388
74989,8,11,188,972262,8,972254
74990,6,-5,648,482049,6,482043
74991,14,3,115,742697,14,742683
74992,12,15,258,1118681,12,1118669
74993,19,-5,295,493263,19,493244
74994,18,10,463,963394,18,963376
74995,14,7,153,868143,14,868129
74996,19,1,710,685327,19,685308
74997,11,-10,104,335889,11,335878
74998,8,-7,421,414959,8,414951
74999,17,9,973,936383,17,936366
75000,18,17,336,1180499,18,1180481
75001,15,16,172,1148311,15,1148296
75002,20,-10,905,341900,20,341880
75003,18,1,648,684952,18,684934
75004,9,14,402,1070736,9,1070727
75005,15,-4,998,529597,15,529582
75006,15,9,343,931532,15,931517
75007,17,-4,160,523278,17,523261
75008,6,12,25,999606,6,999600
75009,16,-6,1,459151,16,459135
75010,9,17,492,1165873,9,1165864
75011,20,-2,291,587340,20,587320
75012,14,-13,585,245361,14,245347
75013,16,-13,20,241211,16,241195
75014,12,15,369,1119475,12,1119463
75015,6,15,982,1115375,6,1115369
75016,14,-8,931,404448,14,404434
75017,12,14,430,1088845,12,1088833
75018,17,-1,279,618729,17,618712
75019,20,-11,486,307607,20,307587
75020,12,15,315,1119103,12,1119091
75021,5,1,156,660649,5,660644
75022,14,0,97,649000,14,648986
75023,6,-4,538,511103,6,511097
75024,14,-7,14,428407,14,428393
75025,13,-9,42,366924,13,366911
75026,9,4,63,751971,9,751962
75027,17,-2,566,589385,17,589368
75028,17,-7,336,430898,17,430881
75029,15,1,96,680558,15,680543
75030,8,8,772,892185,8,892177
75031,11,-19,112,54881,11,54870
75032,13,-12,118,273416,13,273403
75033,19,17,685,1182946,19,1182927
75034,12,-5,714,496240,12,496228
75035,8,-4,505,510397,8,510389
75036,18,13,47,1053575,18,1053557
75037,6,15,926,1114171,6,1114165
75038,5,-3,90,532346,5,532341
75039,7,5,942,801523,7,801516
75040,13,-18,456,88712,13,88699
75041,14,-6,296,461484,14,461470
75042,16,3,346,744504,16,744488
75043,10,3,492,729371,10,729361
75044,9,10,919,957297,9,957288
75045,12,3,274,743960,12,743948
75046,17,14,35,1085685,17,1085668
75047,11,-4,9,522121,11,522110
75048,10,-1,857,612240,10,612230
75049,15,-5,867,497341,15,497326
75050,7,-2,421,571705,7,571698
75051,19,1,14,679838,19,679819
75052,6,-1,331,601269,6,601263
75053,13,-17,978,122658,13,122645
75054,8,9,382,914750,8,914742
75055,13,11,585,995076,13,995063
75056,16,-19,553,58367,16,58351
75057,8,-19,995,52749,8,52741
75058,7,-19,108,33876,7,33869
75059,18,-4,114,522909,18,522891
75060,13,-3,986,561656,13,561643
75061,11,17,505,1181695,11,1181684
75062,5,-18,325,69577,5,69572
75063,18,-1,492,620516,18,620498
75064,9,1,550,669368,9,669359
75065,15,-11,761,309656,15,309641
75066,5,13,107,1033045,5,1033040
75067,17,4,666,778106,17,778089
75068,19,-3,104,554517,19,554498
75069,19,4,426,776348,19,776329
75070,10,6,380,820846,10,820836
75071,14,1,754,685737,14,685723
75072,14,-14,927,216710,14,216696
75073,10,-20,452,9694,10,9684
75074,14,-4,393,525184,14,525170
75075,16,-7,292,430545,16,430529
75076,19,-5,672,495897,19,495878
75077,20,-13,923,247975,20,247955
75078,12,5,367,806500,12,806488
75079,13,-2,489,588849,13,588836
75080,12,-14,839,216035,12,216023
75081,12,7,794,872748,12,872736
75082,15,12,634,1026741,15,1026726
75083,20,16,236,1148790,20,1148770
75084,17,-17,540,119550,17,119533
75085,15,-6,759,464948,15,464933
75086,17,4,376,775933,17,775916
75087,8,-20,169,3787,8,3779
75088,6,-19,760,48274,6,48268
75089,16,-19,821,60290,16,60274
75090,5,5,44,782525,5,782520
75091,17,6,466,839517,17,839500
75092,18,15,148,1117920,18,1117902
75093,16,-18,497,88936,16,88920
75094,13,3,383,744755,13,744742
75095,13,-19,208,55740,13,55727
75096,10,19,414,1227057,10,1227047
75097,6,-8,911,394871,6,394865
75098,12,-4,616,526735,12,526723
75099,18,-16,501,150693,18,150675
75100,17,14,660,1090611,17,1090594
75101,17,10,796,966073,17,966056
75102,13,19,211,1242424,13,1242411
75103,10,14,210,1066364,10,1066354
75104,5,-15,625,168871,5,168866
75105,5,14,673,1077107,5,1077102
75106,5,19,425,1227376,5,1227371
75107,10,-5,39,468708,10,468698
75108,12,19,502,1244901,12,1244889
75109,15,-9,863,373400,15,373385
75110,12,1,178,681299,12,681287
75111,12,-3,838,560494,12,560482
75112,16,10,566,964238,16,964222
75113,9,9,643,920376,9,920367
75114,15,0,852,654701,15,654686
75115,13,-10,533,339023,13,339010
75116,19,2,494,714356,19,714337
75117,17,15,100,1117525,17,1117508
75118,13,-7,293,430549,13,430536
75119,9,6,464,822915,9,822906
75120,11,-1,470,620326,11,620315
75121,16,0,137,649277,16,649261
75122,7,4,825,768691,7,768684
75123,17,2,993,717822,17,717805
75124,14,-11,779,309822,14,309808
75125,18,17,437,1181183,18,1181165
75126,5,-12,395,258184,5,258179
75127,19,0,63,648716,19,648697
75128,16,17,686,1182966,16,1182950
75129,16,-13,18,241184,16,241168
75130,7,-10,615,325961,7,325954
75131,6,-5,607,481248,6,481242
75132,19,-16,816,152901,19,152882
75133,15,-8,671,402659,15,402644
75134,19,15,181,1118160,19,1118141
75135,10,-4,856,517675,10,517665
75136,9,-4,941,519649,9,519640
75137,15,-19,86,54598,15,54583
75138,17,5,444,807009,17,806992
75139,20,-19,196,55603,20,55583
75140,9,-4,779,516091,9,516082
75141,10,-2,240,567922,10,567912
75142,5,-20,290,6472,5,6467
75143,12,7,731,872355,12,872343
75144,16,5,732,809119,16,809103
75145,15,19,401,1244072,15,1244057
75146,19,9,560,933198,19,933179
75147,5,-9,772,360853,5,360848
75148,16,-14,912,216637,16,216621
75149,17,1,39,680110,17,680093
75150,13,-3,370,556523,13,556510
75151,15,16,149,1148141,15,1148126
75152,13,-8,217,399437,13,399424
75153,17,17,62,1178353,17,1178336
75154,19,-6,795,465209,19,465190
75155,7,-1,243,599228,7,599221
75156,6,-19,325,38566,6,38560
75157,5,-6,758,453126,5,453121
75158,10,9,947,926867,10,926857
75159,8,-12,218,254246,8,254238
75160,5,10,220,942233,5,942228
75161,19,-16,43,147075,19,147056
75162,5,5,504,792051,5,792046
75163,20,-9,219,368134,20,368114
75164,18,12,772,1027799,18,1027781
75165,11,5,267,805802,11,805791
75166,8,-3,668,545519,8,545511
75167,17,9,435,932198,17,932181
75168,14,0,657,653279,14,653265
75169,14,13,604,1057832,14,1057818
75170,17,-2,214,586721,17,586704
75171,18,0,520,652115,18,652097
75172,6,-17,209,97871,6,97865
75173,8,12,322,1006232,8,1006224
75174,12,-20,465,26296,12,26284
75175,16,18,321,1211413,16,1211397
75176,9,3,384,727144,9,727135
75177,13,9,377,931794,13,931781
75178,14,-5,395,493935,14,493921
75179,7,9,815,924073,7,924066
75180,5,12,737,1015175,5,1015170
75181,20,10,774,965825,20,965805
75182,8,-12,928,269753,8,269745
75183,8,-4,730,515108,8,515100
75184,12,16,233,1148770,12,1148758
75185,5,-8,586,387665,5,387660
75186,6,-15,680,170009,6,170003
75187,9,-20,647,14181,9,14172
75188,6,14,68,1063373,6,1063367
75189,12,-7,736,433663,12,433651
75190,8,-15,734,171200,8,171192
75191,13,-8,886,404156,13,404143
75192,16,-8,669,402641,16,402625
75193,20,-7,100,428993,20,428973
75194,13,-15,398,180670,13,180657
75195,12,-17,135,116468,12,116456
75196,16,-19,32,54126,16,54110
75197,10,-15,314,162184,10,162174
75198,18,0,92,648932,18,648914
75199,18,-5,913,497737,18,497719
75200,14,10,92,960588,14,960574
75201,19,-6,208,460768,19,460749
75202,5,-4,331,506722,5,506717
75203,12,16,610,1151422,12,1151410
75204,13,14,843,1092026,13,1092013
75205,17,-3,206,555246,17,555229
75206,13,3,348,744516,13,744503
75207,6,8,709,890852,6,890846
75208,18,-13,355,243642,18,243624
75209,14,10,571,964283,14,964269
75210,20,-10,56,335586,20,335566
75211,13,17,868,1184517,13,1184504
75212,16,3,139,742888,16,742872
75213,5,-11,8,281322,5,281317
75214,9,-4,521,510766,9,510757
75215,8,-12,47,250530,8,250522
75216,5,-5,820,485672,5,485667
75217,8,-11,449,291129,8,291121
75218,17,-20,97,23499,17,23482
75219,11,-14,627,214448,11,214437
75220,7,-19,854,50191,7,50184
75221,18,-14,302,211754,18,211736
75222,16,-5,799,496793,16,496777
75223,10,16,622,1138250,10,1138240
75224,16,-16,747,152356,16,152340
75225,17,1,654,685022,17,685005
75226,15,9,919,935951,15,935936
75227,16,-17,834,121752,16,121736
75228,17,14,695,1090947,17,1090930
75229,17,-18,670,90160,17,90143
75230,11,-19,664,59162,11,59151
75231,8,5,262,787164,8,787156
75232,8,-15,861,173794,8,173786
75233,8,19,121,1220142,8,1220134
75234,12,10,646,964931,12,964919
75235,6,2,831,705941,6,705935
75236,18,2,989,717812,18,717794
75237,6,-15,327,162477,6,162471
75238,8,-1,75,595427,8,595419
75239,11,-19,748,59892,11,59881
75240,15,15,309,1119064,15,1119049
75241,9,-1,877,612758,9,612749
75242,19,1,641,684916,19,684897
75243,9,6,47,813214,9,813205
75244,20,16,42,1147381,20,1147361
75245,11,-17,481,119058,11,119047
75246,12,-13,387,243878,12,243866
75247,15,-20,114,23629,15,23614
75248,17,-7,353,431024,17,431007
75249,6,-1,946,614358,6,614352
75250,13,-15,46,178124,13,178111
75251,8,-2,607,575674,8,575666
75252,10,-10,908,331966,10,331956
75253,5,-2,116,565375,5,565370
75254,9,-8,112,377718,9,377709
75255,9,8,336,882598,9,882589
75256,13,8,202,899586,13,899573
75257,10,18,954,1206968,10,1206958
75258,13,-10,394,337905,13,337892
75259,7,-6,844,454814,7,454807
75260,5,-20,266,5889,5,5884
75261,6,-19,189,35775,6,35769
75262,12,-11,518,307868,12,307856
75263,8,1,945,677535,8,677527
75264,6,10,394,945928,6,945922
75265,12,10,445,963205,12,963193
75266,6,-2,802,579881,6,579875
75267,10,11,77,970110,10,970100
75268,13,7,430,870248,13,870235
75269,6,11,175,972063,6,972057
75270,8,7,736,860422,8,860414
75271,13,-3,932,561241,13,561228
75272,5,-18,82,64289,5,64284
75273,18,4,211,774765,18,774747
75274,20,-19,193,55578,20,55558
75275,19,3,185,743279,19,743260
75276,13,19,395,1244005,13,1243992
75277,12,12,175,1023315,12,1023303
75278,12,9,368,931753,12,931741
75279,11,-6,674,464282,11,464271
75280,5,-5,715,483462,5,483457
75281,12,-12,933,279531,12,279519
75282,9,-5,561,480188,9,480179
75283,11,19,683,1246307,11,1246296
75284,17,-10,721,340480,17,340463
75285,16,-17,248,117305,16,117289
75286,11,7,859,873207,11,873196
75287,12,-13,706,246204,12,246192
75288,20,19,912,1248177,20,1248157
75289,18,-17,535,119495,18,119477
75290,7,-20,93,2071,7,2064
75291,7,-1,326,601144,7,601137
75292,10,11,953,988874,10,988864
75293,9,-10,457,322584,9,322575
75294,19,-18,61,85677,19,85658
75295,19,-16,15,146894,19,146875
75296,8,17,367,1163172,8,1163164
75297,17,5,317,806072,17,806055
75298,6,-18,284,68680,6,68674
75299,18,-2,654,590064,18,590046
75300,5,17,793,1172303,5,1172298
75301,14,7,946,873735,14,873721
75302,17,1,195,681407,17,681390
75303,7,1,762,673600,7,673593
75304,14,-10,271,337039,14,337025
75305,6,-16,604,137190,6,137184
75306,8,14,532,1073697,8,1073689
75307,11,7,167,868212,11,868201
75308,20,8,86,898587,20,898567
75309,18,7,653,871804,18,871786
75310,8,-4,934,519431,8,519423
75311,8,-11,286,287313,8,287305
75312,19,-8,644,402393,19,402374
75313,16,16,85,1147691,16,1147675
75314,10,-13,935,238641,10,238631
75315,14,3,841,748145,14,748131
75316,14,-12,196,273895,14,273881
75317,13,-19,888,60785,13,60772
75318,7,6,160,815646,7,815639
75319,6,-9,676,358414,6,358408
75320,14,-13,566,245238,14,245224
75321,6,12,287,1005545,6,1005539
75322,15,9,13,929134,15,929119
75323,16,-10,662,340094,16,340078
75324,12,3,476,745391,12,745379
75325,10,-18,566,74550,10,74540
75326,16,8,401,901165,16,901149
75327,16,-7,837,434401,16,434385
75328,12,6,55,836195,12,836183
75329,7,19,754,1234202,7,1234195
75330,19,-14,51,209712,19,209693
75331,9,0,438,634836,9,634827
75332,20,14,418,1088743,20,1088723
75333,19,3,43,742139,19,742120
75334,9,18,332,1193968,9,1193959
75335,7,-13,712,233547,7,233540
75336,10,-14,258,192453,10,192443
75337,13,-15,202,179203,13,179190
75338,8,-16,780,140813,8,140805
75339,11,1,3,679773,11,679762
75340,6,12,930,1019600,6,1019594
75341,13,-15,743,183316,13,183303
75342,19,11,416,993903,19,993884
75343,8,-19,562,43812,8,43804
75344,7,7,573,857012,7,857005
75345,10,-7,735,421428,10,421418
75346,11,18,299,1211273,11,1211262
75347,18,10,456,963299,18,963281
75348,7,19,219,1222401,7,1222394
75349,16,-7,798,434085,16,434069
75350,15,1,498,683813,15,683798
75351,17,-7,82,428869,17,428852
75352,11,8,853,904609,11,904598
75353,8,1,938,677411,8,677403
75354,20,-19,138,55124,20,55104
75355,6,11,101,970660,6,970654
75356,15,-7,13,428394,15,428379
75357,11,0,487,651871,11,651860
75358,5,4,641,764469,5,764464
75359,10,-9,159,346994,10,346984
75360,16,-17,357,118138,16,118122
75361,10,4,972,771761,10,771751
75362,18,-18,557,89313,18,89295
75363,8,15,762,1110683,8,1110675
75364,14,-19,173,55422,14,55408
75365,11,3,886,748483,11,748472
75366,6,15,778,1110938,6,1110932
75367,20,1,346,682655,20,682635
75368,12,-7,440,431625,12,431613
75369,14,8,473,901680,14,901666
75370,13,-4,316,524559,13,524546
75371,18,2,285,712714,18,712696
75372,18,-3,487,557578,18,557560
75373,10,14,468,1072233,10,1072223
75374,19,-2,74,585681,19,585662
75375,8,-5,249,473495,8,473487
75376,6,19,826,1235795,6,1235789
75377,8,2,72,690207,8,690199
75378,15,2,802,716463,15,716448
75379,15,2,590,715012,15,714997
75380,7,-18,796,79604,7,79597
75381,16,15,217,1118447,16,1118431
75382,20,-11,595,308458,20,308438
75383,6,-4,321,506547,6,506541
75384,19,-4,676,527186,19,527167
75385,5,5,599,794099,5,794094
75386,10,10,518,948563,10,948553
75387,13,-7,465,431841,13,431828
75388,13,1,530,684070,13,684057
75389,13,9,599,933515,13,933502
75390,10,-9,519,355419,10,355409
75391,12,14,179,1086842,12,1086830
75392,20,9,17,929167,20,929147
75393,18,-20,508,26653,18,26635
75394,20,-14,134,210361,20,210341
75395,5,-15,94,157459,5,157454
75396,9,-11,216,285761,9,285752
75397,19,7,134,868010,19,867991
75398,19,-11,423,307137,19,307118
75399,12,-5,71,491390,12,491378
75400,17,19,123,1241791,17,1241774
75401,14,6,713,841557,14,841543
75402,7,-6,681,451382,7,451375
75403,5,18,161,1190333,5,1190328
75404,17,19,540,1245226,17,1245209
75405,13,2,534,714638,13,714625
75406,13,-12,284,274617,13,274604
75407,20,14,138,1086563,20,1086543
75408,8,19,802,1235264,8,1235256
75409,5,-13,547,229980,5,229975
75410,11,16,198,1148541,11,1148530
75411,12,6,700,841468,12,841456
75412,18,-3,74,554319,18,554301
75413,16,8,652,903129,16,903113
75414,9,-15,635,169140,9,169131
75415,7,-2,361,570372,7,570365
75416,20,9,426,932123,20,932103
75417,19,-2,567,589408,19,589389
75418,8,19,831,1235923,8,1235915
75419,18,9,176,930371,18,930353
75420,19,-17,608,120075,19,120056
75421,9,-16,619,137490,9,137481
75422,20,-8,215,399423,20,399403
75423,6,-8,901,394663,6,394657
75424,5,15,454,1104070,5,1104065
75425,19,2,746,716186,19,716167
75426,13,12,827,1028199,13,1028186
75427,10,-6,957,457170,10,457160
75428,14,-20,590,27280,14,27266
75429,20,6,396,838960,20,838940
75430,10,1,240,662467,10,662457
75431,17,14,347,1088131,17,1088114
75432,20,-10,164,336318,20,336298
75433,8,-5,331,475457,8,475449
75434,16,-1,25,616705,16,616689
75435,13,9,586,933403,13,933390
75436,7,-18,422,71498,7,71491
75437,8,-5,505,478952,8,478944
75438,12,-1,318,619109,12,619097
75439,16,7,718,872237,16,872221
75440,14,7,791,872739,14,872725
75441,19,-14,551,213732,19,213713
75442,17,3,148,742951,17,742934
75443,20,-14,369,212381,20,212361
75444,17,15,869,1123138,17,1123121
75445,10,4,40,751424,10,751414
75446,5,0,405,634129,5,634124
75447,5,11,809,985816,5,985811
75448,10,-11,944,301414,10,301404
75449,12,-13,515,244843,12,244831
75450,6,7,428,854006,6,854000
75451,16,9,685,934084,16,934068
75452,7,9,402,915170,7,915163
75453,13,-9,950,374075,13,374062
75454,9,-13,517,229353,9,229344
75455,19,1,924,687094,19,687075
75456,15,16,801,1152885,15,1152870
75457,20,16,780,1152650,20,1152630
75458,10,15,781,1111024,10,1111014
75459,14,-20,656,27798,14,27784
75460,16,2,542,714683,16,714667
75461,15,-4,721,527469,15,527454
75462,16,12,943,1029354,16,1029338
75463,20,15,135,1117811,20,1117791
75464,7,-11,603,294526,7,294519
75465,15,-3,234,555402,15,555387
75466,16,-10,499,338772,16,338756
75467,20,15,835,1122908,20,1122888
75468,8,-20,629,13764,8,13756
75469,19,5,138,804780,19,804761
75470,15,-2,227,586856,15,586841
75471,12,15,801,1122635,12,1122623
75472,11,18,280,1211185,11,1211174
75473,12,10,387,962742,12,962730
75474,17,-9,310,368864,17,368847
75475,7,-14,452,196508,7,196501
75476,11,7,3,867051,11,867040
75477,6,-3,688,545985,6,545979
75478,15,6,301,838083,15,838068
75479,14,-1,340,619307,14,619293
75480,14,-16,537,150948,14,150934
75481,17,8,93,898646,17,898629
75482,17,3,597,746300,17,746283
75483,14,9,53,929474,14,929460
75484,9,-7,746,421639,9,421630
75485,15,-17,444,118779,15,118764
75486,20,6,365,838583,20,838563
75487,16,4,78,773809,16,773793
75488,6,8,323,882346,6,882340
75489,11,3,246,743721,11,743710
75490,12,-1,879,623325,12,623313
75491,14,-11,659,308989,14,308975
75492,14,8,263,900034,14,900020
75493,8,1,743,673211,8,673203
75494,10,-3,802,548354,10,548344
75495,11,-20,488,26455,11,26444
75496,14,18,830,1214976,14,1214962
75497,5,-11,266,286884,5,286879
75498,13,-12,161,273730,13,273717
75499,9,15,456,1104105,9,1104096
75500,6,-4,877,518250,6,518244
75501,14,11,49,991216,14,991202
75502,11,6,600,840605,11,840594
75503,9,5,603,794187,9,794178
75504,17,3,608,746373,17,746356
75505,11,-4,47,522382,11,522371
75506,16,-8,714,402940,16,402924
75507,8,-6,856,455097,8,455089
75508,16,18,276,1211182,16,1211166
75509,18,-3,816,560345,18,560327
75510,7,-7,382,414166,7,414159
75511,8,2,532,699905,8,699897
75512,5,4,885,770119,5,770114
75513,5,-11,566,293678,5,293673
75514,19,15,100,1117534,19,1117515
75515,18,-8,9,397952,18,397934
75516,16,-13,265,243041,16,243025
75517,8,1,750,673347,8,673339
75518,14,6,22,835998,14,835984
75519,6,14,128,1064764,6,1064758
75520,10,2,301,695106,10,695096
75521,7,-12,850,268106,7,268099
75522,19,-17,822,121658,19,121639
75523,12,-14,722,215148,12,215136
75524,13,-16,93,147586,13,147573
75525,19,12,383,1024861,19,1024842
75526,17,10,50,960241,17,960224
75527,7,-10,127,315389,7,315382
75528,13,13,255,1055060,13,1055047
75529,5,-9,713,359310,5,359305
75530,5,1,219,662003,5,661998
75531,17,16,36,1147336,17,1147319
75532,20,13,571,1057568,20,1057548
75533,10,18,387,1195027,10,1195017
75534,9,-6,33,437581,9,437572
75535,5,5,948,801727,5,801722
75536,19,-5,755,496548,19,496529
75537,20,-13,837,247256,20,247236
75538,18,2,204,712144,18,712126
75539,14,-1,682,621807,14,621793
75540,17,10,672,965104,17,965087
75541,20,8,680,903365,20,903345
75542,10,-16,73,125418,10,125408
75543,20,-17,563,119769,20,119749
75544,15,16,597,1151310,15,1151295
75545,20,-20,326,25384,20,25364
75546,11,-18,674,90169,11,90158
75547,11,-12,25,272692,11,272681
75548,13,-20,340,25462,13,25449
75549,12,-20,310,25269,12,25257
75550,17,0,299,650333,17,650316
75551,10,14,184,1065855,10,1065845
75552,6,11,349,975895,6,975889
75553,11,-9,606,371405,11,371394
75554,19,-14,623,214412,19,214393
75555,7,10,524,948729,7,948722
75556,14,-11,175,305164,14,305150
75557,13,3,919,748766,13,748753
75558,14,-13,410,243996,14,243982
75559,8,1,724,672736,8,672728
75560,20,-14,69,209845,20,209825
75561,19,-12,559,276661,19,276642
75562,15,1,42,680117,15,680102
75563,6,-5,90,470061,6,470055
75564,17,-8,591,401984,17,401967
75565,15,15,978,1123993,15,1123978
75566,18,-11,454,307414,18,307396
75567,18,4,791,779064,18,779046
75568,19,-14,581,214095,19,214076
75569,7,16,959,1145121,7,1145114
75570,8,-12,836,267697,8,267689
75571,20,12,395,1024955,20,1024935
75572,19,-1,213,618222,19,618203
75573,14,5,220,805503,14,805489
75574,18,-5,226,492647,18,492629
75575,14,-4,454,525532,14,525518
75576,13,-17,898,122155,13,122142
75577,13,-10,91,335834,13,335821
75578,15,4,211,774770,15,774755
75579,17,18,138,1210084,17,1210067
75580,14,9,502,932723,14,932709
75581,9,-5,601,481129,9,481120
75582,9,0,659,639793,9,639784
75583,18,12,91,1022730,18,1022712
75584,15,-2,882,591916,15,591901
75585,16,7,574,871263,16,871247
75586,9,0,926,645517,9,645508
75587,16,-12,9,272578,16,272562
75588,9,-7,745,421604,9,421595
75589,11,2,445,713991,11,713980
75590,6,7,505,855622,6,855616
75591,6,-10,712,327948,6,327942
75592,17,-3,773,560006,17,559989
75593,7,-3,306,537075,7,537068
75594,12,7,517,870884,12,870872
75595,15,3,703,747191,15,747176
75596,18,-5,395,493943,18,493925
75597,5,3,106,721171,5,721166
75598,11,-13,838,247259,11,247248
75599,18,-17,563,119777,18,119759
75600,13,11,233,992455,13,992442
75601,7,13,64,1032130,7,1032123
75602,18,-10,422,338166,18,338148
75603,18,12,577,1026291,18,1026273
75604,15,-8,683,402729,15,402714
75605,18,18,459,1212380,18,1212362
75606,11,-1,91,617276,11,617265
75607,9,-2,148,565987,9,565978
75608,6,6,471,823077,6,823071
75609,14,-7,595,432767,14,432753
75610,20,19,869,1247843,20,1247823
75611,20,6,807,842273,20,842253
75612,6,13,524,1041917,6,1041911
75613,16,-4,708,527413,16,527397
75614,8,-3,565,543225,8,543217
75615,6,4,325,757565,6,757559
75616,16,18,45,1209276,16,1209260
75617,18,-12,829,278624,18,278606
75618,8,15,827,1111976,8,1111968
75619,9,7,248,850147,9,850138
75620,6,-20,332,7411,6,7405
75621,16,1,818,686208,16,686192
75622,16,-19,24,54074,16,54058
75623,6,7,894,863770,6,863764
75624,9,-4,780,516109,9,516100
75625,14,-12,690,277584,14,277570
75626,16,-19,132,55070,16,55054
75627,19,8,419,901328,19,901309
75628,17,4,828,779406,17,779389
75629,14,0,965,655671,14,655657
75630,12,-1,912,623542,12,623530
75631,14,11,5,990896,14,990882
75632,15,14,732,1091191,15,1091176
75633,14,16,818,1152981,14,1152967
75634,19,1,445,683341,19,683322
75635,13,17,389,1180857,13,1180844
75636,18,11,880,997261,18,997243
75637,15,15,641,1121475,15,1121460
75638,9,5,986,802485,9,802476
75639,18,-13,772,246788,18,246770
75640,7,0,12,625472,7,625465
75641,6,-11,469,291611,6,291605
75642,17,4,744,778745,17,778728
75643,14,-18,261,87336,14,87322
75644,5,-20,136,2997,5,2992
75645,7,9,607,919660,7,919653
75646,14,-19,97,54702,14,54688
75647,8,-5,509,479039,8,479031
75648,14,13,843,1059544,14,1059530
75649,10,-8,901,394673,10,394663
75650,19,3,1000,749572,19,749553
75651,18,19,934,1248275,18,1248257
75652,5,1,852,675522,5,675517
75653,8,4,229,755657,8,755649
75654,14,14,138,1086567,14,1086553
75655,6,15,37,1095264,6,1095258
75656,18,-3,598,558511,18,558493
75657,20,14,64,1085962,20,1085942
75658,11,-15,791,183638,11,183627
75659,13,15,438,1119875,13,1119862
75660,9,19,539,1229687,9,1229678
75661,7,7,539,856256,7,856249
75662,13,-11,348,306511,13,306498
75663,13,13,964,1060387,13,1060374
75664,12,9,399,931922,12,931910
75665,6,19,738,1233900,6,1233894
75666,9,-7,684,420308,9,420299
75667,15,-20,547,26986,15,26971
75668,11,6,136,836799,11,836788
75669,6,-18,816,80116,6,80110
75670,15,-1,184,617914,15,617899
75671,13,-7,975,435545,13,435532
75672,10,6,197,816483,10,816473
75673,18,-11,212,305383,18,305365
75674,5,3,981,740373,5,740368
75675,9,1,849,675456,9,675447
75676,13,18,750,1214418,13,1214405
75677,5,-17,139,96371,5,96366
75678,8,11,660,982558,8,982550
75679,13,12,129,1022989,13,1022976
75680,6,-14,135,189456,6,189450
75681,14,16,438,1150271,14,1150257
75682,19,2,554,714772,19,714753
75683,17,14,805,1091761,17,1091744
75684,9,-3,695,546110,9,546101
75685,19,-8,54,398345,19,398326
75686,6,-14,330,193919,6,193913
75687,13,-18,632,89828,13,89815
75688,11,5,398,806706,11,806695
75689,19,-14,151,210465,19,210446
75690,18,9,264,930855,18,930837
75691,8,-15,465,165516,8,165508
75692,9,-11,903,300581,9,300572
75693,10,-14,248,192167,10,192157
75694,5,-14,712,202331,5,202326
75695,15,3,201,743445,15,743430
75696,11,13,388,1056113,11,1056102
75697,15,14,854,1092066,15,1092051
75698,16,-13,525,244923,16,244907
75699,20,6,133,836786,20,836766
75700,14,-8,50,398295,14,398281
75701,5,4,546,762349,5,762344
75702,16,-1,582,621125,16,621109
75703,15,11,17,990992,15,990977
75704,20,6,107,836583,20,836563
75705,17,-3,750,559771,17,559754
75706,16,-16,432,150184,16,150168
75707,17,-15,440,181033,17,181016
75708,20,15,241,1118577,20,1118557
75709,14,7,912,873529,14,873515
75710,6,-20,998,22115,6,22109
75711,12,6,658,841070,12,841058
75712,12,13,692,1058420,12,1058408
75713,6,-15,849,173509,6,173503
75714,13,-1,531,620806,13,620793
75715,16,12,722,1027470,16,1027454
75716,16,-16,232,148691,16,148675
75717,18,-16,95,147605,18,147587
75718,5,-4,430,508929,5,508924
75719,5,-17,669,107910,5,107905
75720,19,-11,136,304814,19,304795
75721,13,-11,297,306066,13,306053
75722,19,11,46,991197,19,991178
75723,18,12,562,1026169,18,1026151
75724,10,-14,594,199711,10,199701
75725,10,4,681,765308,10,765298
75726,18,15,37,1117058,18,1117040
75727,15,2,115,711466,15,711451
75728,19,16,770,1152542,19,1152523
75729,11,-13,955,248273,11,248262
75730,11,-19,596,58710,11,58699
75731,18,-17,827,121695,18,121677
75732,9,13,38,1031597,9,1031588
75733,8,13,915,1050250,8,1050242
75734,16,7,900,873456,16,873440
75735,16,11,903,997433,16,997417
75736,9,4,318,757377,9,757368
75737,20,9,326,931391,20,931371
75738,14,15,850,1122977,14,1122963
75739,9,-3,15,530933,9,530924
75740,11,-4,164,523325,11,523314
75741,7,-11,920,300835,7,300828
75742,20,-20,568,27152,20,27132
75743,10,12,579,1011505,10,1011495
75744,15,6,844,842531,15,842516
75745,9,16,220,1129899,9,1129890
75746,13,-12,813,278475,13,278462
75747,6,7,669,859027,6,859021
75748,6,-8,161,378943,6,378937
75749,15,-2,78,585709,15,585694
75750,11,-18,100,85996,11,85985
75751,10,-7,443,415344,10,415334
75752,15,17,664,1182801,15,1182786
75753,6,10,284,943512,6,943506
75754,15,14,800,1091707,15,1091692
75755,20,-8,277,399842,20,399822
75756,13,17,815,1184059,13,1184046
75757,9,0,808,643050,9,643041
75758,12,-7,230,430006,12,429994
75759,10,-3,408,539448,10,539438
75760,7,2,606,701407,7,701400
75761,10,0,922,645403,10,645393
75762,7,9,540,918162,7,918155
75763,16,-2,673,590191,16,590175
75764,13,-11,751,309557,13,309544
75765,6,2,336,695872,6,695866
75766,17,-13,295,243292,17,243275
75767,19,-9,941,374022,19,374003
75768,5,-20,746,16404,5,16399
75769,19,16,761,1152485,19,1152466
75770,12,-5,126,491895,12,491883
75771,17,-9,387,369570,17,369553
75772,13,19,433,1244421,13,1244408
75773,15,-16,935,153831,15,153816
75774,19,13,722,1058601,19,1058582
75775,8,-18,891,81733,8,81725
75776,5,3,714,734369,5,734364
75777,12,-20,862,29408,12,29396
75778,17,-14,171,210607,17,210590
75779,18,18,724,1214129,18,1214111
75780,17,-6,240,461051,17,461034
75781,17,13,918,1059979,17,1059962
75782,7,-12,915,269554,7,269547
75783,19,-20,540,26931,19,26912
75784,11,-3,356,556386,11,556375
75785,20,-9,231,368248,20,368228
75786,16,-15,653,182675,16,182659
75787,7,14,192,1065992,7,1065985
75788,18,-9,469,370328,18,370310
75789,12,0,843,654668,12,654656
75790,12,-15,130,178772,12,178760
75791,9,-17,142,96394,9,96385
75792,18,18,864,1215242,18,1215224
75793,8,8,825,893143,8,893135
75794,11,7,690,872072,11,872061
75795,18,-15,204,179209,18,179191
75796,20,19,21,1240871,20,1240851
75797,13,-7,910,435028,13,435015
75798,10,-8,784,392130,10,392120
75799,7,14,413,1071039,7,1071032
75800,16,-2,588,589544,16,589528
75801,11,18,131,1209975,11,1209964
75802,16,-18,501,88972,16,88956
75803,9,-13,320,225164,9,225155
75804,5,1,3,657099,5,657094
75805,17,-19,247,55992,17,55975
75806,17,-12,965,279823,17,279806
75807,9,-11,234,286120,9,286111
75808,14,-20,289,25054,14,25040
75809,6,-12,46,250517,6,250511
75810,14,16,620,1151461,14,1151447
75811,5,2,563,700517,5,700512
75812,13,-12,953,279729,13,279716
75813,19,-15,619,182316,19,182297
75814,16,2,153,711749,16,711733
75815,18,11,378,993636,18,993618
75816,15,6,546,840172,15,840157
75817,13,-19,815,60252,13,60239
75818,9,-2,162,566213,9,566204
75819,20,11,655,995497,20,995477
75820,6,14,221,1066634,6,1066628
75821,5,0,462,635452,5,635447
75822,19,-13,83,241641,19,241622
75823,8,8,317,882201,8,882193
75824,9,-10,121,315252,9,315243
75825,14,12,866,1028590,14,1028576
75826,17,-8,631,402316,17,402299
75827,13,-6,199,460694,13,460681
75828,11,-7,453,431737,11,431726
75829,9,-1,818,611436,9,611427
75830,16,19,565,1245395,16,1245379
75831,11,-3,218,555303,11,555292
75832,8,1,833,675034,8,675026
75833,8,-18,681,76982,8,76974
75834,11,12,220,1023684,11,1023673
75835,15,-7,995,435717,15,435702
75836,17,-17,154,116629,17,116612
75837,18,2,285,712722,18,712704
75838,14,-2,413,588188,14,588174
75839,8,-10,312,319357,8,319349
75840,19,14,101,1086273,19,1086254
75841,13,-7,371,431160,13,431147
75842,15,0,670,653367,15,653352
75843,19,3,106,742652,19,742633
75844,5,6,101,814364,5,814359
75845,13,19,212,1242435,13,1242422
75846,8,-14,81,188371,8,188363
75847,15,-16,892,153520,15,153505
75848,20,-17,451,118827,20,118807
75849,16,5,983,811014,16,810998
75850,19,-9,423,369913,19,369894
75851,11,-15,45,178121,11,178110
75852,17,18,811,1214844,17,1214827
75853,5,-1,400,602742,5,602737
75854,11,6,197,837210,11,837199
75855,19,13,795,1059217,19,1059198
75856,19,0,637,653074,19,653055
75857,10,6,274,818418,10,818408
75858,9,-8,890,394381,9,394372
75859,11,0,860,654756,11,654745
75860,8,6,385,820979,8,820971
75861,15,-17,850,121833,15,121818
75862,18,-16,787,152702,18,152684
75863,19,15,205,1118350,19,1118331
75864,13,-4,204,523685,13,523672
75865,20,-5,720,496301,20,496281
75866,15,5,583,808046,15,808031
75867,10,-1,260,599516,10,599506
75868,6,-9,101,345779,6,345773
75869,18,13,949,1060274,18,1060256
75870,5,3,229,723839,5,723834
75871,14,-7,1,428264,14,428250
75872,7,0,44,626250,7,626243
75873,7,13,37,1031579,7,1031572
75874,17,17,37,1178156,17,1178139
75875,15,-11,161,305041,15,305026
75876,10,-5,487,478559,10,478549
75877,10,-10,852,330861,10,330851
75878,7,-1,297,600425,7,600418
75879,5,-15,638,169219,5,169214
75880,11,-20,649,27750,11,27739
75881,6,4,853,769504,6,769498
75882,20,-10,966,342345,20,342325
75883,15,-1,608,621295,15,621280
75884,10,-12,788,266548,10,266538
75885,16,14,398,1088545,16,1088529
75886,5,-10,848,330772,5,330767
75887,10,2,658,702564,10,702554
75888,11,-18,404,88316,11,88305
75889,7,-10,756,328850,7,328843
75890,8,-11,257,286663,8,286655
75891,7,-10,780,329254,7,329247
75892,19,15,755,1122423,19,1122404
75893,19,-14,846,216115,19,216096
75894,17,7,478,870614,17,870597
75895,20,-20,856,29398,20,29378
75896,9,-1,279,599963,9,599954
75897,20,-5,326,493574,20,493554
75898,9,10,215,942137,9,942128
75899,11,-12,270,274524,11,274513
75900,13,14,600,1090078,13,1090065
75901,13,1,556,684285,13,684272
75902,7,5,447,790947,7,790940
75903,8,-5,670,482507,8,482499
75904,19,-3,615,558668,19,558649
75905,8,4,541,762264,8,762256
75906,20,19,724,1246685,20,1246665
75907,18,-11,823,310136,18,310118
75908,11,6,416,839115,11,839104
75909,13,-2,191,586507,13,586494
75910,17,-5,287,493176,17,493159
75911,16,-20,784,28868,16,28852
75912,17,-17,253,117337,17,117320
75913,18,-7,260,430230,18,430212
75914,16,-4,481,525693,16,525677
75915,13,-17,385,118350,13,118337
75916,11,-19,293,56268,11,56257
75917,17,-7,362,431119,17,431102
75918,17,-7,996,435741,17,435724
75919,7,15,915,1113928,7,1113921
75920,8,-6,207,441418,8,441410
75921,20,13,817,1059378,20,1059358
75922,7,-7,53,407144,7,407137
75923,19,8,12,898017,19,897998
75924,11,6,560,840278,11,840267
75925,12,3,411,744953,12,744941
75926,9,13,513,1041755,9,1041746
75927,13,-1,216,618245,13,618232
75928,10,7,958,865015,10,865005
75929,14,2,962,717665,14,717651
75930,19,-18,19,85346,19,85327
75931,10,-17,337,100754,10,100744
75932,14,1,104,680644,14,680630
75933,15,-6,707,464542,15,464527
75934,11,10,177,961208,11,961197
75935,8,12,348,1006740,8,1006732
75936,16,-10,124,336023,16,336007
75937,11,4,565,777367,11,777356
75938,17,-4,1,522061,17,522044
75939,15,-5,100,491690,15,491675
75940,7,12,153,1002449,7,1002442
75941,7,-18,171,66244,7,66237
75942,15,-3,92,554427,15,554412
75943,9,19,512,1229172,9,1229163
75944,11,-3,848,560565,11,560554
75945,17,14,363,1088254,17,1088237
75946,11,0,966,655682,11,655671
75947,13,-14,788,215690,13,215677
75948,20,-13,920,247965,20,247945
75949,19,-19,944,61123,19,61104
75950,20,-1,871,623211,20,623191
75951,14,-12,985,279990,14,279976
75952,10,-7,179,409684,10,409674
75953,16,-20,990,30375,16,30359
75954,5,-4,839,517225,5,517220
75955,16,-8,974,404840,16,404824
75956,18,-14,620,214393,18,214375
75957,7,0,485,635917,7,635910
75958,17,-7,519,432276,17,432259
75959,11,-20,948,29979,11,29968
75960,12,-1,32,616803,12,616791
75961,19,-5,323,493521,19,493502
75962,16,17,124,1178781,16,1178765
75963,5,6,326,819630,5,819625
75964,16,10,461,963353,16,963337
75965,19,11,202,992265,19,992246
75966,11,-19,438,57392,11,57381
75967,9,1,488,667926,9,667917
75968,9,-16,47,124839,9,124830
75969,18,-12,237,274263,18,274245
75970,12,-2,928,592192,12,592180
75971,5,9,42,907690,5,907685
75972,17,19,879,1247889,17,1247872
75973,12,4,968,780351,12,780339
75974,15,-9,40,366909,15,366894
75975,6,-11,301,287743,6,287737
75976,18,-13,154,242143,18,242125
75977,19,-14,943,216808,19,216789
75978,13,0,980,655803,13,655790
75979,19,9,476,932478,19,932459
75980,19,12,316,1024438,19,1024419
75981,7,-13,718,233690,7,233683
75982,15,18,203,1210646,15,1210631
75983,12,8,572,902456,12,902444
75984,6,7,72,846364,6,846358
75985,13,11,630,995334,13,995321
75986,5,-14,12,186714,5,186709
75987,10,-2,152,566031,10,566021
75988,13,16,996,1154276,13,1154263
75989,18,-16,834,153023,18,153005
75990,10,-15,93,157430,10,157420
75991,11,-16,707,152094,11,152083
75992,11,2,391,713564,11,713553
75993,13,-15,151,178922,13,178909
75994,10,13,92,1032725,10,1032715
75995,5,8,967,896203,5,896198
75996,14,-10,455,338427,14,338413
75997,8,0,329,632287,8,632279
75998,5,7,727,860137,5,860132
75999,5,-6,572,449076,5,449071
76000,6,4,271,756454,6,756448
76001,10,-20,546,11940,10,11930
76002,8,-13,132,221205,8,221197
76003,19,6,147,836883,19,836864
76004,20,-7,859,434601,20,434581
76005,7,-19,503,42344,7,42337
76006,6,-10,454,322477,6,322471
76007,7,-20,941,20723,7,20716
76008,15,1,421,683142,15,683127
76009,10,0,94,627466,10,627456
76010,6,-20,802,17782,6,17776
76011,6,7,53,846025,6,846019
76012,9,-4,425,508883,9,508874
76013,17,-18,166,86539,17,86522
76014,13,17,700,1183128,13,1183115
76015,17,5,499,807433,17,807416
76016,15,4,995,780524,15,780509
76017,13,-1,575,621079,13,621066
76018,15,-11,92,304399,15,304384
76019,18,4,778,778982,18,778964
76020,10,13,945,1050940,10,1050930
76021,11,14,686,1090878,11,1090867
76022,20,-20,926,29857,20,29837
76023,6,11,530,979829,6,979823
76024,5,-18,624,75798,5,75793
76025,5,18,436,1196082,5,1196077
76026,12,5,906,810397,12,810385
76027,17,-1,269,618670,17,618653
76028,16,-13,139,242007,16,241991
76029,5,16,246,1130431,5,1130426
76030,11,-3,985,561654,11,561643
76031,5,8,359,883058,5,883053
76032,8,9,911,926101,8,926093
76033,6,14,543,1073907,6,1073901
76034,8,8,103,877276,8,877268
76035,7,-12,32,250273,7,250266
76036,15,2,954,717609,15,717594
76037,17,14,556,1089804,17,1089787
76038,13,-17,543,119565,13,119552
76039,11,-8,744,403158,11,403147
76040,6,15,500,1105009,6,1105003
76041,10,-1,983,615150,10,615140
76042,15,-3,986,561661,15,561646
76043,10,-6,380,444972,10,444962
76044,15,16,369,1149801,15,1149786
76045,10,-3,460,540779,10,540769
76046,10,-18,841,80560,10,80550
76047,5,4,414,759607,5,759602
76048,12,-8,1,397837,12,397825
76049,14,11,482,994381,14,994367
76050,7,-5,695,483045,7,483038
76051,12,-11,719,309303,12,309291
76052,18,-9,92,367327,18,367309
76053,19,7,129,867946,19,867927
76054,5,18,782,1203277,5,1203272
76055,5,5,39,782429,5,782424
76056,10,-11,871,299787,10,299777
76057,18,6,612,840687,18,840669
76058,9,10,428,946710,9,946701
76059,9,-10,786,329369,9,329360
76060,9,15,294,1100838,9,1100829
76061,9,-19,788,48737,9,48728
76062,9,-10,174,316441,9,316432
76063,9,12,983,1020760,9,1020751
76064,7,-10,540,324276,7,324269
76065,8,-7,136,408690,8,408682
76066,10,15,668,1108645,10,1108635
76067,5,10,985,958550,5,958545
76068,12,12,517,1025805,12,1025793
76069,14,17,5,1177897,14,1177883
76070,19,-3,95,554458,19,554439
76071,17,-10,43,335479,17,335462
76072,9,2,967,708898,9,708889
76073,12,-3,321,556130,12,556118
76074,14,18,755,1214435,14,1214421
76075,7,-16,965,144798,7,144791
76076,7,8,138,878086,7,878079
76077,11,-10,778,340912,11,340901
76078,9,-18,118,65064,9,65055
76079,16,3,245,743709,16,743693
76080,8,4,261,756251,8,756243
76081,11,17,983,1185325,11,1185314
76082,17,-15,514,181553,17,181536
76083,19,8,167,899275,19,899256
76084,5,-5,35,468605,5,468600
76085,6,3,267,724639,6,724633
76086,17,18,356,1211661,17,1211644
76087,17,-6,777,465095,17,465078
76088,12,7,915,873559,12,873547
76089,14,10,136,960948,14,960934
76090,8,5,620,794545,8,794537
76091,6,5,363,789053,6,789047
76092,16,-11,223,305452,16,305436
76093,20,-16,123,147857,20,147837
76094,16,17,502,1181662,16,1181646
76095,15,-20,746,28534,15,28519
76096,15,11,610,995226,15,995211
76097,14,5,29,803951,14,803937
76098,20,10,754,965637,20,965617
76099,13,16,599,1151336,13,1151323
76100,17,-12,70,273060,17,273043
76101,8,5,62,783000,8,782992
76102,7,-14,154,189853,7,189846
76103,6,-18,943,82891,6,82885
76104,19,15,295,1118969,19,1118950
76105,8,0,753,641875,8,641867
76106,9,2,355,696379,9,696370
76107,17,-16,186,148288,17,148271
76108,7,10,490,947922,7,947915
76109,12,8,191,899450,12,899438
76110,16,-5,810,496903,16,496887
76111,5,-2,494,573343,5,573338
76112,15,-20,157,23942,15,23927
76113,13,1,803,686102,13,686089
76114,8,5,95,783595,8,783587
76115,12,5,481,807339,12,807327
76116,15,16,700,1152074,15,1152059
76117,20,10,627,964762,20,964742
76118,7,-15,912,174856,7,174849
76119,13,16,550,1151005,13,1150992
76120,19,-15,328,180147,19,180128
76121,18,-17,270,117473,18,117455
76122,15,15,193,1118250,15,1118235
76123,12,7,992,874059,12,874047
76124,10,0,761,642077,10,642067
76125,5,-4,569,511723,5,511718
76126,16,0,689,653563,16,653547
76127,15,-8,565,401857,15,401842
76128,19,17,496,1181612,19,1181593
76129,18,10,442,963195,18,963177
76130,7,-16,228,129098,7,129091
76131,14,-17,373,118252,14,118238
76132,14,9,341,931508,14,931494
76133,5,14,914,1082198,5,1082193
76134,16,18,900,1215549,16,1215533
76135,19,-3,41,554094,19,554075
76136,17,-17,210,117011,17,116994
76137,6,-15,848,173504,6,173498
76138,15,0,123,649194,15,649179
76139,12,15,88,1117451,12,1117439
76140,10,-6,260,442509,10,442499
76141,18,-18,82,85848,18,85830
76142,10,-19,198,36011,10,36001
76143,5,-14,184,190411,5,190406
76144,14,10,928,966992,14,966978
76145,5,-11,497,292316,5,292311
76146,12,1,197,681439,12,681427
76147,17,-9,347,369240,17,369223
76148,12,5,343,806301,12,806289
76149,9,0,212,630084,9,630075
76150,10,-3,888,550295,10,550285
76151,9,11,323,975323,9,975314
76152,11,0,933,655329,11,655318
76153,16,-2,352,587753,16,587737
76154,17,8,627,902938,17,902921
76155,8,2,316,695383,8,695375
76156,18,2,16,710570,18,710552
76157,20,-7,145,429343,20,429323
76158,11,5,33,803987,11,803976
76159,16,5,134,804752,16,804736
76160,6,-3,963,552102,6,552096
76161,17,11,835,996872,17,996855
76162,13,-7,533,432377,13,432364
76163,15,8,712,903635,15,903620
76164,20,10,906,966761,20,966741
76165,7,1,31,657721,7,657714
76166,7,18,661,1200667,7,1200660
76167,8,19,293,1224014,8,1224006
76168,9,-1,997,615440,9,615431
76169,18,-7,446,431685,18,431667
76170,20,1,467,683537,20,683517
76171,6,-12,690,264427,6,264421
76172,6,-8,89,377313,6,377307
76173,6,10,587,950163,6,950157
76174,19,4,510,776943,19,776924
76175,9,-19,992,52677,9,52668
76176,15,-4,267,524160,15,524145
76177,19,17,902,1184738,19,1184719
76178,5,-8,211,379994,5,379989
76179,6,-9,600,357011,6,357005
76180,11,-1,803,622746,11,622735
76181,5,0,547,637193,5,637188
76182,19,-18,427,88496,19,88477
76183,14,7,239,868707,14,868693
76184,12,3,273,743946,12,743934
76185,18,-14,72,209883,18,209865
76186,7,-2,677,577195,7,577188
76187,18,-12,636,277176,18,277158
76188,12,-12,294,274689,12,274677
76189,19,-19,224,55825,19,55806
76190,12,2,208,712154,12,712142
76191,11,-20,560,27065,11,27054
76192,13,17,473,1181463,13,1181450
76193,5,-14,954,207214,5,207209
76194,16,0,149,649326,16,649310
76195,12,-15,166,178989,12,178977
76196,11,-8,320,400159,11,400148
76197,5,-12,628,263088,5,263083
76198,5,-15,742,171341,5,171336
76199,7,-13,900,237766,7,237759
76200,9,4,521,761873,9,761864
76201,7,-16,12,124126,7,124119
76202,20,17,86,1178477,20,1178457
76203,12,-19,557,58378,12,58366
76204,10,4,163,754168,10,754158
76205,8,1,182,661145,8,661137
76206,17,-7,103,429050,17,429033
76207,7,-13,268,224163,7,224156
76208,9,-15,868,173927,9,173918
76209,17,19,482,1244734,17,1244717
76210,8,15,287,1100695,8,1100687
76211,13,-14,980,217115,13,217102
76212,17,-19,538,58178,17,58161
76213,14,-9,661,371708,14,371694
76214,10,16,55,1126333,10,1126323
76215,8,8,527,886851,8,886843
76216,7,13,542,1042323,7,1042316
76217,10,12,619,1012526,10,1012516
76218,19,4,422,776301,19,776282
76219,5,1,726,672784,5,672779
76220,17,-5,186,492335,17,492318
76221,14,-7,735,433652,14,433638
76222,9,11,994,989724,9,989715
76223,10,-9,137,346489,10,346479
76224,9,-15,64,156697,9,156688
76225,15,-20,945,29970,15,29955
76226,15,-11,230,305500,15,305485
76227,11,-20,554,27045,11,27034
76228,19,-17,257,117383,19,117364
76229,11,-8,276,399827,11,399816
76230,9,-15,159,158837,9,158828
76231,9,9,200,910969,9,910960
76232,17,15,927,1123544,17,1123527
76233,17,-9,384,369539,17,369522
76234,19,2,635,715338,19,715319
76235,16,-5,532,494983,16,494967
76236,17,15,412,1119695,17,1119678
76237,6,4,650,764708,6,764702
76238,8,-14,979,207862,8,207854
76239,20,-10,2,335142,20,335122
76240,5,-19,125,34369,5,34364
76241,10,-4,412,508556,10,508546
76242,13,-2,402,588121,13,588108
76243,5,8,396,883871,5,883866
76244,12,3,410,744952,12,744940
76245,11,5,270,805828,11,805817
76246,10,8,497,886092,10,886082
76247,12,17,816,1184064,12,1184052
76248,6,-7,712,420970,6,420964
76249,14,4,860,779697,14,779683
76250,13,-19,781,60072,13,60059
76251,16,-13,318,243426,16,243410
76252,8,-5,249,473503,8,473495
76253,17,2,805,716494,17,716477
76254,13,6,193,837196,13,837183
76255,17,8,279,900178,17,900161
76256,5,17,315,1162113,5,1162108
76257,12,17,138,1178894,12,1178882
76258,19,1,791,686003,19,685984
76259,13,-6,588,463643,13,463630
76260,17,-13,357,243657,17,243640
76261,10,19,822,1235699,10,1235689
76262,17,10,248,961677,17,961660
76263,18,18,790,1214754,18,1214736
76264,16,-14,377,212469,16,212453
76265,20,-15,668,182755,20,182735
76266,8,10,882,956480,8,956472
76267,17,-9,490,370547,17,370530
76268,15,5,523,807619,15,807604
76269,19,-14,459,213055,19,213036
76270,8,-14,454,196543,8,196535
76271,6,-19,718,47308,6,47302
76272,17,4,520,777038,17,777021
76273,15,7,381,869829,15,869814
76274,8,19,411,1226905,8,1226897
76275,11,11,303,993110,11,993099
76276,14,-6,591,463653,14,463639
76277,6,5,478,791552,6,791546
76278,20,-6,371,462018,20,461998
76279,19,9,918,935906,19,935887
76280,13,-8,736,403092,13,403079
76281,19,17,493,1181593,19,1181574
76282,13,-11,680,309125,13,309112
76283,16,5,422,806837,16,806821
76284,17,-13,123,241914,17,241897
76285,11,18,633,1213525,11,1213514
76286,10,-10,116,315084,10,315074
76287,19,9,399,931931,19,931912
76288,16,3,101,742580,16,742564
76289,8,-3,132,533276,8,533268
76290,16,7,724,872274,16,872258
76291,19,-15,768,183502,19,183483
76292,19,2,96,711321,19,711302
76293,11,4,891,779851,11,779840
76294,16,-1,221,618285,16,618269
76295,16,-4,394,525194,16,525178
76296,18,-10,52,335548,18,335530
76297,13,-8,303,400006,13,399993
76298,20,18,1000,1216322,20,1216302
76299,16,13,958,1060360,16,1060344
76300,15,-1,66,617044,15,617029
76301,12,14,631,1090351,12,1090339
76302,19,-5,359,493728,19,493709
76303,17,15,186,1118219,17,1118202
76304,13,-3,230,555372,13,555359
76305,7,-16,311,130717,7,130710
76306,15,17,977,1185267,15,1185252
76307,17,16,441,1150301,17,1150284
76308,14,14,999,1093335,14,1093321
76309,12,13,790,1059184,12,1059172
76310,20,19,951,1248435,20,1248415
76311,10,-14,754,203159,10,203149
76312,18,3,958,749193,18,749175
76313,14,16,181,1148431,14,1148417
76314,5,16,960,1145175,5,1145170
76315,10,12,845,1017561,10,1017551
76316,19,-6,107,459865,19,459846
76317,11,9,56,929490,11,929479
76318,20,-19,740,59848,20,59828
76319,8,11,553,980284,8,980276
76320,12,1,167,681191,12,681179
76321,11,18,843,1215096,11,1215085
76322,11,-12,497,276220,11,276209
76323,5,14,481,1072567,5,1072562
76324,8,-2,931,582760,8,582752
76325,14,15,378,1119552,14,1119538
76326,9,-12,187,253447,9,253438
76327,7,-11,947,301467,7,301460
76328,12,-10,420,338150,12,338138
76329,6,-13,217,222963,6,222957
76330,15,-16,932,153803,15,153788
76331,18,13,698,1058489,18,1058471
76332,5,-17,235,98435,5,98430
76333,9,-16,411,132863,9,132854
76334,8,-2,675,577170,8,577162
76335,6,-13,445,227707,6,227701
76336,14,-19,74,54471,14,54457
76337,10,5,147,784618,10,784608
76338,8,18,728,1201882,8,1201874
76339,20,17,960,1185129,20,1185109
76340,17,-17,909,122242,17,122225
76341,17,-14,839,216042,17,216025
76342,12,14,907,1092533,12,1092521
76343,7,16,588,1137535,7,1137528
76344,16,19,202,1242380,16,1242364
76345,9,-3,791,548121,9,548112
76346,11,0,360,650754,11,650743
76347,6,-14,798,204063,6,204057
76348,5,-19,481,41871,5,41866
76349,6,-15,860,173779,6,173773
76350,12,-15,764,183464,12,183452
76351,15,-8,226,399516,15,399501
76352,6,-7,335,413179,6,413173
76353,14,11,478,994336,14,994322
76354,9,16,125,1127669,9,1127660
76355,8,4,25,751078,8,751070
76356,12,13,114,1054061,12,1054049
76357,16,-20,417,25936,16,25920
76358,6,-4,37,500126,6,500120
76359,9,-2,881,581762,9,581753
76360,12,-5,159,492189,12,492177
76361,18,0,89,648884,18,648866
76362,10,2,857,706454,10,706444
76363,19,8,218,899687,19,899668
76364,11,8,903,905007,11,904996
76365,17,0,331,650530,17,650513
76366,11,19,166,1242075,11,1242064
76367,8,13,688,1045530,8,1045522
76368,12,1,459,683485,12,683473
76369,19,18,866,1215265,19,1215246
76370,19,-13,13,241147,19,241128
76371,9,-20,714,15710,9,15701
76372,8,6,729,828864,8,828856
76373,8,4,141,753624,8,753616
76374,14,19,276,1242977,14,1242963
76375,8,2,949,708422,8,708414
76376,18,9,12,929126,18,929108
76377,19,-13,371,243750,19,243731
76378,14,-13,768,246746,14,246732
76379,12,6,405,839039,12,839027
76380,17,4,922,780068,17,780051
76381,12,-5,866,497337,12,497325
76382,14,-11,941,311057,14,311043
76383,7,-8,58,376682,7,376675
76384,10,11,349,975905,10,975895
76385,11,0,16,648314,11,648303
76386,19,-11,533,308027,19,308008
76387,12,11,204,992274,12,992262
76388,9,0,103,627757,9,627748
76389,11,8,86,898588,11,898577
76390,20,-5,997,498317,20,498297
76391,5,-14,44,187537,5,187532
76392,15,19,730,1246713,15,1246698
76393,18,-20,862,29416,18,29398
76394,16,9,98,929776,16,929760
76395,13,-18,715,90447,13,90434
76396,12,-20,510,26680,12,26668
76397,11,-2,166,586287,11,586276
76398,11,4,966,780342,11,780331
76399,9,-3,653,545163,9,545154
76400,19,-13,935,248110,19,248091
76401,8,-14,485,197167,8,197159
76402,5,10,835,955526,5,955521
76403,5,11,309,974987,5,974982
76404,7,5,753,797356,7,797349
76405,6,-14,548,198347,6,198341
76406,11,-8,844,403868,11,403857
76407,8,9,324,913589,8,913581
76408,15,-13,248,242880,15,242865
76409,18,14,543,1089713,18,1089695
76410,19,-15,998,185398,19,185379
76411,6,2,478,698888,6,698882
76412,10,-16,259,129674,10,129664
76413,7,1,831,674978,7,674971
76414,14,19,932,1248256,14,1248242
76415,20,2,785,716379,20,716359
76416,14,12,574,1026242,14,1026228
76417,17,-14,326,211953,17,211936
76418,12,3,796,747848,12,747836
76419,10,9,948,926891,10,926881
76420,5,-13,169,221979,5,221974
76421,12,9,226,930719,12,930707
76422,13,7,227,868614,13,868601
76423,7,-11,711,296552,7,296545
76424,10,-12,429,258884,10,258874
76425,16,2,782,716347,16,716331
76426,15,12,15,1022202,15,1022187
76427,14,8,810,904331,14,904317
76428,14,-8,123,398748,14,398734
76429,20,6,635,840906,20,840886
76430,6,-14,941,206937,6,206931
76431,16,-14,909,216612,16,216596
76432,12,-11,574,308282,12,308270
76433,5,16,887,1143534,5,1143529
76434,19,0,289,650240,19,650221
76435,14,-5,108,491762,14,491748
76436,19,6,15,835917,19,835898
76437,10,-3,532,542527,10,542517
76438,19,-9,451,370159,19,370140
76439,9,-7,346,413405,9,413396
76440,19,14,946,1092881,19,1092862
76441,19,-14,709,215061,19,215042
76442,5,7,674,859144,5,859139
76443,15,-2,735,590647,15,590632
76444,10,-2,764,579033,10,579023
76445,11,13,422,1056391,11,1056380
76446,5,-4,844,517366,5,517361
76447,7,-3,983,552439,7,552432
76448,11,5,944,810728,11,810717
76449,13,-13,481,244522,13,244509
76450,20,0,483,651805,20,651785
76451,15,-17,476,119017,15,119002
76452,15,-18,548,89282,15,89267
76453,9,-12,156,252933,9,252924
76454,9,0,243,630668,9,630659
76455,20,-15,929,184844,20,184824
76456,10,-9,902,363920,10,363910
76457,18,-12,275,274569,18,274551
76458,19,16,407,1150058,19,1150039
76459,9,-19,215,36337,9,36328
76460,11,-16,319,149329,11,149318
76461,20,3,185,743289,20,743269
76462,12,18,97,1209695,12,1209683
76463,19,7,324,869397,19,869378
76464,17,17,739,1183393,17,1183376
76465,9,12,184,1003217,9,1003208
76466,18,-11,287,305981,18,305963
76467,12,4,498,776837,12,776825
76468,10,-5,978,489330,10,489320
76469,10,-1,875,612705,10,612695
76470,9,-5,515,479193,9,479184
76471,18,17,846,1184351,18,1184333
76472,19,16,242,1148826,19,1148807
76473,15,-4,886,528724,15,528709
76474,13,5,781,809453,13,809440
76475,19,13,116,1054080,19,1054061
76476,16,-15,639,182544,16,182528
76477,18,-1,297,618921,18,618903
76478,16,-12,403,275458,16,275442
76479,7,16,801,1141883,7,1141876
76480,20,13,380,1056025,20,1056005
76481,14,1,212,681567,14,681553
76482,10,14,145,1065120,10,1065110
76483,11,-11,611,308627,11,308616
76484,18,3,520,745676,18,745658
76485,5,6,89,814109,5,814104
76486,17,6,912,843052,17,843035
76487,12,8,517,902071,12,902059
76488,14,17,356,1180629,14,1180615
76489,20,-7,919,435122,20,435102
76490,5,-7,321,412874,5,412869
76491,9,2,908,707520,9,707511
76492,10,12,655,1013378,10,1013368
76493,16,6,689,841317,16,841301
76494,14,-5,794,496782,14,496768
76495,18,9,552,933079,18,933061
76496,14,-16,870,153391,14,153377
76497,6,0,914,645188,6,645182
76498,20,-6,256,461185,20,461165
76499,13,-17,439,118731,13,118718
76500,16,-6,796,465222,16,465206
76501,7,-2,372,570580,7,570573
76502,9,3,610,731821,9,731812
76503,8,-6,528,448204,8,448196
76504,7,19,177,1221436,7,1221429
76505,20,8,546,902245,20,902225
76506,8,4,406,759423,8,759415
76507,14,-16,225,148642,14,148628
76508,15,-3,630,558840,15,558825
76509,9,-19,621,45149,9,45140
76510,16,-8,349,400359,16,400343
76511,9,-15,158,158821,9,158812
76512,16,-14,311,211796,16,211780
76513,19,-20,379,25734,19,25715
76514,18,3,353,744566,18,744548
76515,17,9,925,935986,17,935969
76516,11,-19,606,58779,11,58768
76517,19,-17,965,122570,19,122551
76518,11,-5,431,494175,11,494164
76519,8,-20,351,7729,8,7721
76520,20,-4,467,525591,20,525571
76521,13,-7,299,430565,13,430552
76522,20,-16,352,149507,20,149487
76523,14,16,930,1153767,14,1153753
76524,19,7,397,869970,19,869951
76525,13,12,1,1022117,13,1022104
76526,6,4,439,760059,6,760053
76527,9,-6,79,438401,9,438392
76528,9,2,144,691685,9,691676
76529,14,-16,26,146948,14,146934
76530,7,-9,497,354935,7,354928
76531,14,6,384,838788,14,838774
76532,6,-6,948,457006,6,457000
76533,8,0,568,637599,8,637591
76534,7,-17,200,97647,7,97640
76535,7,15,735,1110127,7,1110120
76536,6,12,338,1006591,6,1006585
76537,5,-5,969,489178,5,489173
76538,12,-11,348,306513,12,306501
76539,8,6,443,822452,8,822444
76540,10,-5,750,484209,10,484199
76541,11,-20,460,26263,11,26252
76542,13,-12,308,274820,13,274807
76543,12,-19,971,61279,12,61267
76544,6,-10,838,330594,6,330588
76545,11,-13,380,243832,11,243821
76546,8,6,386,821001,8,820993
76547,17,5,228,805547,17,805530
76548,15,1,229,681696,15,681681
76549,10,1,834,675063,10,675053
76550,8,-15,330,162570,8,162562
76551,6,4,306,757138,6,757132
76552,11,13,248,1055027,11,1055016
76553,14,-7,942,435273,14,435259
76554,13,-8,135,398841,13,398828
76555,18,-19,133,55077,18,55059
76556,6,-14,463,196699,6,196693
76557,17,-7,991,435658,17,435641
76558,11,-3,101,554499,11,554488
76559,16,-15,797,183675,16,183659
76560,7,1,263,662961,7,662954
76561,9,-16,910,143621,9,143612
76562,20,-6,819,465407,20,465387
76563,9,0,376,633458,9,633449
76564,11,-1,815,622830,11,622819
76565,6,15,480,1104647,6,1104641
76566,12,-19,867,60668,12,60656
76567,20,0,911,655213,20,655193
76568,16,-2,141,586163,16,586147
76569,13,12,675,1027146,13,1027133
76570,16,9,85,929667,16,929651
76571,20,9,973,936393,20,936373
76572,19,-19,677,59269,19,59250
76573,18,15,675,1121729,18,1121711
76574,14,-4,800,528011,14,527997
76575,9,11,183,972161,9,972152
76576,9,-7,553,417760,9,417751
76577,7,-11,223,285876,7,285869
76578,18,6,954,843344,18,843326
76579,14,-13,192,242480,14,242466
76580,15,11,262,992716,15,992701
76581,20,-10,503,338836,20,338816
76582,9,-11,451,291216,9,291207
76583,7,-13,294,224729,7,224722
76584,19,12,153,1023152,19,1023133
76585,11,13,105,1053998,11,1053987
76586,20,6,848,842563,20,842543
76587,16,-11,195,305297,16,305281
76588,7,-20,733,16110,7,16103
76589,19,-20,341,25471,19,25452
76590,6,-10,169,316356,6,316350
76591,18,-10,398,337929,18,337911
76592,10,8,631,889062,10,889052
76593,14,-6,6,459191,14,459177
76594,12,-2,13,585228,12,585216
76595,14,8,410,901266,14,901252
76596,9,0,44,626259,9,626250
76597,12,19,559,1245355,12,1245343
76598,16,14,974,1093063,16,1093047
76599,11,10,741,965578,11,965567
76600,20,-8,743,403137,20,403117
76601,6,-5,633,481721,6,481715
76602,6,4,474,760786,6,760780
76603,14,-12,710,277757,14,277743
76604,6,-16,645,138019,6,138013
76605,20,19,308,1243252,20,1243232
76606,12,12,81,1022649,12,1022637
76607,9,1,106,659391,9,659382
76608,7,8,687,890348,7,890341
76609,5,-7,15,406398,5,406393
76610,17,14,456,1089036,17,1089019
76611,12,-5,365,493780,12,493768
76612,7,-6,14,437161,7,437154
76613,17,-16,830,153003,17,152986
76614,9,-16,362,131750,9,131741
76615,15,7,185,868343,15,868328
76616,18,-13,413,244016,18,243998
76617,11,-17,261,117402,11,117391
76618,15,5,440,806956,15,806941
76619,11,7,52,867438,11,867427
76620,12,-8,695,402801,12,402789
76621,18,-17,578,119891,18,119873
76622,13,9,698,934201,13,934188
76623,14,8,58,898323,14,898309
76624,5,5,940,801462,5,801457
76625,6,13,499,1041473,6,1041467
76626,12,-1,216,618247,12,618235
76627,19,-5,264,492975,19,492956
76628,14,6,724,841660,14,841646
76629,8,-8,344,382672,8,382664
76630,13,12,617,1026618,13,1026605
76631,5,18,792,1203592,5,1203587
76632,8,-10,20,313027,8,313019
76633,10,10,107,939900,10,939890
76634,12,-6,550,463417,12,463405
76635,20,-4,732,527557,20,527537
76636,20,-3,321,556140,20,556120
76637,11,1,625,684773,11,684762
76638,6,-7,766,422119,6,422113
76639,12,-1,275,618694,12,618682
76640,14,4,243,775035,14,775021
76641,16,-3,754,559817,16,559801
76642,18,-7,920,435129,18,435111
76643,17,-1,427,619955,17,619938
76644,7,-2,955,583250,7,583243
76645,8,16,752,1140704,8,1140696
76646,14,-11,948,311104,14,311090
76647,6,-3,465,540875,6,540869
76648,7,-15,738,171314,7,171307
76649,11,18,916,1215632,11,1215621
76650,20,12,613,1026553,20,1026533
76651,13,-16,967,154059,13,154046
76652,13,-20,917,29817,13,29804
76653,18,-17,907,122224,18,122206
76654,15,-1,981,624006,15,623991
76655,20,-14,244,211323,20,211303
76656,9,-4,821,516869,9,516860
76657,7,-19,280,37673,7,37666
76658,7,-11,4,281202,7,281195
76659,13,16,511,1150733,13,1150720
76660,14,-10,904,341891,14,341877
76661,15,9,792,934930,15,934915
76662,9,-10,617,325988,9,325979
76663,18,9,290,931048,18,931030
76664,15,-8,679,402719,15,402704
76665,19,-6,600,463744,19,463725
76666,8,7,418,853829,8,853821
76667,15,4,968,780356,15,780341
76668,18,-6,382,462091,18,462073
76669,20,-13,611,245573,20,245553
76670,12,-11,3,303685,12,303673
76671,11,-12,980,279956,11,279945
76672,19,16,888,1153396,19,1153377
76673,19,-11,586,308409,19,308390
76674,5,-5,258,473729,5,473724
76675,7,11,525,979722,7,979715
76676,12,0,359,650747,12,650735
76677,20,-7,54,428686,20,428666
76678,12,15,848,1122962,12,1122950
76679,18,-7,17,428419,18,428401
76680,13,5,785,809483,13,809470
76681,12,12,51,1022436,12,1022424
76682,6,1,583,670072,6,670066
76683,7,0,7,625361,7,625354
76684,13,-13,282,243199,13,243186
76685,19,-10,507,338863,19,338844
76686,18,-2,216,586757,18,586739
76687,12,-6,252,461127,12,461115
76688,12,-9,203,367989,12,367977
76689,9,-14,902,206106,9,206097
76690,9,3,770,735466,9,735457
76691,6,11,899,987907,6,987901
76692,7,8,586,888020,7,888013
76693,13,16,952,1153883,13,1153870
76694,15,16,561,1151080,15,1151065
76695,14,-12,578,276773,14,276759
76696,11,15,969,1123932,11,1123921
76697,7,-10,478,323115,7,323108
76698,11,15,444,1119937,11,1119926
76699,18,9,657,933912,18,933894
76700,18,11,251,992650,18,992632
76701,9,-3,394,539091,9,539082
76702,16,-14,569,214001,16,213985
76703,16,-3,448,557236,16,557220
76704,7,3,421,727839,7,727832
76705,20,-10,58,335616,20,335596
76706,18,-6,501,463020,18,463002
76707,8,-1,424,603252,8,603244
76708,10,-13,243,223539,10,223529
76709,20,18,968,1216111,20,1216091
76710,18,-11,762,309676,18,309658
76711,10,-7,515,416901,10,416891
76712,17,-7,863,434633,17,434616
76713,19,-12,265,274497,19,274478
76714,7,-17,770,109978,7,109971
76715,7,-11,981,302273,7,302266
76716,17,3,692,747154,17,747137
76717,11,-3,758,559847,11,559836
76718,9,-19,883,50754,9,50745
76719,19,18,684,1213922,19,1213903
76720,5,-12,625,262983,5,262978
76721,10,5,214,786137,10,786127
76722,10,-9,631,357576,10,357566
76723,11,13,591,1057742,11,1057731
76724,9,-14,548,198356,9,198347
76725,9,-17,627,107030,9,107021
76726,16,-19,523,58056,16,58040
76727,12,-11,163,305045,12,305033
76728,18,-2,943,592337,18,592319
76729,8,15,913,1113903,8,1113895
76730,19,-5,326,493583,19,493564
76731,17,-11,356,306629,17,306612
76732,12,-20,544,26960,12,26948
76733,11,0,981,655806,11,655795
76734,20,13,584,1057716,20,1057696
76735,20,16,425,1150204,20,1150184
76736,8,18,125,1189549,8,1189541
76737,14,-3,835,560474,14,560460
76738,9,9,199,910923,9,910914
76739,6,-17,29,94142,6,94136
76740,18,14,956,1092930,18,1092912
76741,9,-17,389,101804,9,101795
76742,13,17,823,1184124,13,1184111
76743,17,18,949,1215942,17,1215925
76744,9,0,112,627893,9,627884
76745,15,14,158,1086726,15,1086711
76746,13,13,56,1053648,13,1053635
76747,8,-19,290,37845,8,37837
76748,12,10,758,965671,12,965659
76749,14,-15,350,180341,14,180327
76750,20,16,891,1153438,20,1153418
76751,16,-8,469,401093,16,401077
76752,20,7,79,867599,20,867579
76753,9,13,585,1043413,9,1043404
76754,15,8,975,905525,15,905510
76755,6,18,413,1195574,6,1195568
76756,7,13,843,1048899,7,1048892
76757,11,-2,145,586190,11,586179
76758,13,-10,590,339464,13,339451
76759,6,4,62,751944,6,751938
76760,9,-3,805,548398,9,548389
76761,8,-17,681,108075,8,108067
76762,9,7,54,846042,9,846033
76763,12,-7,302,430589,12,430577
76764,7,-16,152,127335,7,127328
76765,5,4,333,757712,5,757707
76766,7,3,409,727582,7,727575
76767,18,-2,939,592306,18,592288
76768,5,9,586,919189,5,919184
76769,8,-8,169,379122,8,379114
76770,5,-11,303,287805,5,287800
76771,16,13,356,1055867,16,1055851
76772,19,13,556,1057433,19,1057414
76773,17,2,889,717127,17,717110
76774,7,9,796,923660,7,923653
76775,5,-5,754,484265,5,484260
76776,12,9,174,930356,12,930344
76777,18,-4,343,524765,18,524747
76778,15,-16,820,152926,15,152911
76779,13,10,711,965343,13,965330
76780,9,17,184,1159205,9,1159196
76781,19,2,886,717101,19,717082
76782,16,-10,180,336416,16,336400
76783,16,17,265,1179899,16,1179883
76784,13,-2,649,590001,13,589988
76785,13,-10,635,339844,13,339831
76786,7,11,325,975382,7,975375
76787,16,-12,942,279617,16,279601
76788,12,-3,899,561009,12,560997
76789,16,-16,670,151842,16,151826
76790,20,8,280,900195,20,900175
76791,17,11,730,996085,17,996068
76792,9,-15,955,175857,9,175848
76793,11,10,706,965333,11,965322
76794,17,-1,699,621936,17,621919
76795,5,-16,135,126971,5,126966
76796,15,-14,95,210072,15,210057
76797,9,7,90,846806,9,846797
76798,15,17,423,1181056,15,1181041
76799,11,10,873,966522,11,966511
76800,6,-9,747,360153,6,360147
76801,16,-20,865,29455,16,29439
76802,7,-8,726,390972,7,390965
76803,7,-20,209,4829,7,4822
76804,5,4,510,761580,5,761575
76805,8,-4,611,512604,8,512596
76806,15,17,593,1182245,15,1182230
76807,7,-12,835,267690,7,267683
76808,13,-5,947,498000,13,497987
76809,20,12,960,1029517,20,1029497
76810,19,-3,605,558569,19,558550
76811,15,6,464,839498,15,839483
76812,17,-7,327,430834,17,430817
76813,12,12,255,1023975,12,1023963
76814,11,-9,300,368782,11,368771
76815,5,-4,980,520516,5,520511
76816,8,0,250,630831,8,630823
76817,11,-11,291,305994,11,305983
76818,9,13,198,1034981,9,1034972
76819,19,15,860,1123060,19,1123041
76820,8,4,228,755630,8,755622
76821,12,-11,693,309189,12,309177
76822,9,5,441,790710,9,790701
76823,7,13,953,1051149,7,1051142
76824,13,14,476,1089141,13,1089128
76825,10,-3,551,542879,10,542869
76826,18,-9,710,372041,18,372023
76827,16,5,176,805097,16,805081
76828,17,8,752,903881,17,903864
76829,18,6,951,843323,18,843305
76830,8,-4,492,510034,8,510026
76831,10,-3,653,545173,10,545163
76832,14,-19,264,56091,14,56077
76833,14,16,639,1151701,14,1151687
76834,10,12,169,1002874,10,1002864
76835,7,0,534,636890,7,636883
76836,6,12,254,1004729,6,1004723
76837,12,2,310,712920,12,712908
76838,11,8,311,900401,11,900390
76839,8,-19,839,49885,8,49877
76840,18,11,110,991645,18,991627
76841,11,15,204,1118333,11,1118322
76842,17,15,204,1118340,17,1118323
76843,16,7,112,867837,16,867821
76844,11,-6,98,459814,11,459803
76845,13,10,790,965956,13,965943
76846,12,-3,913,561118,12,561106
76847,7,-5,522,479379,7,479372
76848,15,-8,276,399832,15,399817
76849,16,-2,751,590734,16,590718
76850,10,-3,14,530925,10,530915
76851,19,8,72,898452,19,898433
76852,7,-15,16,155683,7,155676
76853,12,-8,856,403942,12,403930
76854,13,-14,899,216497,13,216484
76855,17,19,923,1248204,17,1248187
76856,13,-13,867,247493,13,247480
76857,7,5,891,800323,7,800316
76858,6,-7,516,416946,6,416940
76859,20,7,35,867289,20,867269
76860,16,4,32,773499,16,773483
76861,16,-14,980,217121,16,217105
76862,9,-17,591,106249,9,106240
76863,13,-3,350,556346,13,556333
76864,7,2,18,688926,7,688919
76865,12,-20,556,27048,12,27036
76866,8,19,414,1227065,8,1227057
76867,7,12,736,1015161,7,1015154
76868,11,12,904,1028969,11,1028958
76869,13,6,536,840104,13,840091
76870,18,-2,591,589572,18,589554
76871,17,1,901,686862,17,686845
76872,20,9,989,936451,20,936431
76873,12,-12,170,273760,12,273748
76874,19,14,704,1091006,19,1090987
76875,8,10,634,951227,8,951219
76876,16,-17,310,117821,16,117805
76877,8,-14,57,187810,8,187802
76878,20,-9,858,373367,20,373347
76879,6,10,269,943268,6,943262
76880,9,9,369,914523,9,914514
76881,14,4,259,775083,14,775069
76882,14,-13,998,248578,14,248564
76883,6,6,810,830611,6,830605
76884,11,8,575,902477,11,902466
76885,18,-16,823,152957,18,152939
76886,14,7,978,873971,14,873957
76887,9,-4,96,501471,9,501462
76888,16,1,371,682849,16,682833
76889,7,-20,464,9914,7,9907
76890,9,19,414,1227074,9,1227065
76891,15,12,341,1024621,15,1024606
76892,13,17,90,1178509,13,1178496
76893,16,6,506,839886,16,839870
76894,20,-16,369,149626,20,149606
76895,8,-4,921,519148,8,519140
76896,18,0,569,652538,18,652520
76897,12,16,284,1149194,12,1149182
76898,6,3,44,719766,6,719760
76899,12,4,519,777032,12,777020
76900,13,11,494,994457,13,994444
76901,20,14,208,1087033,20,1087013
76902,6,18,910,1205991,6,1205985
76903,17,0,776,654202,17,654185
76904,13,18,717,1214073,13,1214060
76905,14,-1,762,622405,14,622391
76906,6,10,416,946441,6,946435
76907,13,-14,170,210601,13,210588
76908,14,12,840,1028369,14,1028355
76909,10,3,743,734932,10,734922
76910,19,-1,638,621501,19,621482
76911,13,9,755,934546,13,934533
76912,6,-9,475,354271,6,354265
76913,5,-2,701,577825,5,577820
76914,17,-16,440,150262,17,150245
76915,16,-11,964,311284,16,311268
76916,15,9,192,930467,15,930452
76917,10,19,430,1227517,10,1227507
76918,11,19,290,1243061,11,1243050
76919,18,2,674,715697,18,715679
76920,5,-10,722,328174,5,328169
76921,19,0,167,649512,19,649493
76922,17,1,865,686558,17,686541
76923,20,1,732,685568,20,685548
76924,10,-7,274,411663,10,411653
76925,9,2,642,702159,9,702150
76926,6,-10,191,316777,6,316771
76927,17,-19,344,56703,17,56686
76928,10,-5,729,483797,10,483787
76929,19,7,48,867410,19,867391
76930,11,-13,778,246842,11,246831
76931,20,-7,521,432293,20,432273
76932,8,-5,667,482422,8,482414
76933,15,-6,998,466711,15,466696
76934,16,-5,950,498029,16,498013
76935,6,11,507,979324,6,979318
76936,13,6,1000,843738,13,843725
76937,6,10,336,944655,6,944649
76938,17,-2,553,589324,17,589307
76939,12,8,27,898080,12,898068
76940,8,-11,581,294087,8,294079
76941,13,12,355,1024685,13,1024672
76942,18,-2,793,591098,18,591080
76943,8,-18,411,71236,8,71228
76944,14,2,219,712236,14,712222
76945,12,13,455,1056639,12,1056627
76946,5,-19,166,35323,5,35318
76947,20,-19,489,57743,20,57723
76948,15,15,169,1118046,15,1118031
76949,14,14,773,1091556,14,1091542
76950,19,6,771,841952,19,841933
76951,12,6,691,841333,12,841321
76952,18,-11,6,303752,18,303734
76953,12,8,733,903794,12,903782
76954,11,1,730,685546,11,685535
76955,10,-10,289,318773,10,318763
76956,13,-4,800,528014,13,528001
76957,20,15,442,1119930,20,1119910
76958,15,9,353,931615,15,931600
76959,6,-5,101,470330,6,470324
76960,13,-6,267,461265,13,461252
76961,11,18,277,1211182,11,1211171
76962,12,14,519,1089506,12,1089494
76963,12,-12,833,278661,12,278649
76964,6,2,308,695247,6,695241
76965,16,6,34,836078,16,836062
76966,10,-5,954,488747,10,488737
76967,8,-8,478,385223,8,385215
76968,5,-2,451,572406,5,572401
76969,20,7,975,873934,20,873914
76970,20,16,160,1148194,20,1148174
76971,16,-1,970,623916,16,623900
76972,20,5,567,807905,20,807885
76973,7,-19,460,41376,7,41369
76974,11,19,166,1242076,11,1242065
76975,8,8,543,887093,8,887085
76976,12,19,991,1248725,12,1248713
76977,11,-2,520,589064,11,589053
76978,19,13,601,1057819,19,1057800
76979,11,14,764,1091459,11,1091448
76980,19,11,971,997840,19,997821
76981,12,12,304,1024373,12,1024361
76982,15,9,686,934106,15,934091
76983,14,-5,97,491677,14,491663
76984,14,1,654,685026,14,685012
76985,8,11,557,980378,8,980370
76986,15,3,465,745326,15,745311
76987,19,9,748,934523,19,934504
76988,8,-13,241,223490,8,223482
76989,15,19,240,1242617,15,1242602
76990,14,-9,29,366828,14,366814
76991,18,15,430,1119832,18,1119814
76992,11,11,643,995421,11,995410
76993,14,14,861,1092163,14,1092149
76994,10,-14,935,206811,10,206801
76995,6,-18,802,79763,6,79757
76996,7,-20,964,21202,7,21195
76997,19,-12,209,274012,19,273993
76998,11,-20,784,28869,11,28858
76999,18,18,911,1215609,18,1215591
77000,19,17,365,1180694,19,1180675
77001,8,-17,738,109332,8,109324
77002,8,-9,603,357078,8,357070
77003,18,13,399,1056204,18,1056186
77004,18,5,933,810642,18,810624
77005,6,-16,571,136409,6,136403
77006,10,-17,365,101327,10,101317
77007,18,-15,890,184521,18,184503
77008,14,-12,615,276974,14,276960
77009,5,-10,357,320315,5,320310
77010,10,-2,423,571768,10,571758
77011,9,16,895,1143705,9,1143696
77012,18,4,110,774078,18,774060
77013,10,-13,429,227374,10,227364
77014,5,-11,849,299327,5,299322
77015,11,-18,810,91161,11,91150
77016,17,12,727,1027521,17,1027504
77017,18,-7,316,430752,18,430734
77018,10,16,539,1136639,10,1136629
77019,19,19,828,1247453,19,1247434
77020,10,-18,376,70512,10,70502
77021,14,13,550,1057382,14,1057368
77022,13,-11,300,306105,13,306092
77023,7,-8,637,388999,7,388992
77024,19,-18,819,91234,19,91215
77025,18,-16,191,148339,18,148321
77026,5,-14,336,194037,5,194032
77027,19,11,361,993502,19,993483
77028,16,16,112,1147840,16,1147824
77029,13,-20,144,23861,13,23848
77030,10,-19,810,49132,10,49122
77031,14,10,297,962050,14,962036
77032,7,-4,991,520801,7,520794
77033,14,-18,85,85855,14,85841
77034,8,12,731,1015081,8,1015073
77035,8,-8,950,395684,8,395676
77036,13,-13,543,245031,13,245018
77037,7,-7,555,417809,7,417802
77038,9,11,581,980933,9,980924
77039,11,11,814,996768,11,996757
77040,5,-2,479,573004,5,572999
77041,16,-8,667,402628,16,402612
77042,8,-12,634,263187,8,263179
77043,19,-7,759,433821,19,433802
77044,14,2,470,714171,14,714157
77045,8,19,607,1231110,8,1231102
77046,8,16,193,1129292,8,1129284
77047,10,-8,540,386767,10,386757
77048,6,15,185,1098432,6,1098426
77049,10,8,111,877474,10,877464
77050,11,-5,80,491486,11,491475
77051,11,0,833,654590,11,654579
77052,11,15,652,1121591,11,1121580
77053,11,-2,905,592029,11,592018
77054,14,9,61,929510,14,929496
77055,17,-5,877,497494,17,497477
77056,9,15,640,1108031,9,1108022
77057,12,-18,45,85562,12,85550
77058,12,-1,759,622381,12,622369
77059,13,6,829,842421,13,842408
77060,14,8,482,901752,14,901738
77061,18,19,974,1248620,18,1248602
77062,20,19,440,1244489,20,1244469
77063,16,-20,679,28028,16,28012
77064,11,-2,349,587710,11,587699
77065,10,13,404,1039470,10,1039460
77066,6,7,633,858192,6,858186
77067,7,13,543,1042357,7,1042350
77068,11,-13,602,245476,11,245465
77069,18,-19,827,60343,18,60325
77070,7,6,367,820528,7,820521
77071,9,-14,348,194285,9,194276
77072,13,-16,806,152827,13,152814
77073,6,6,651,827008,6,827002
77074,15,4,781,779004,15,778989
77075,16,-2,211,586683,16,586667
77076,9,1,429,666464,9,666455
77077,9,-15,444,165020,9,165011
77078,11,-8,641,402363,11,402352
77079,6,4,85,752435,6,752429
77080,5,-2,563,574729,5,574724
77081,8,4,814,768357,8,768349
77082,6,10,594,950319,6,950313
77083,5,7,966,865151,5,865146
77084,11,-19,377,56943,11,56932
77085,9,-12,614,262729,9,262720
77086,6,-3,445,540400,6,540394
77087,20,-9,472,370378,20,370358
77088,19,3,885,748460,19,748441
77089,10,4,819,768497,10,768487
77090,5,-16,92,126015,5,126010
77091,9,2,43,689562,9,689553
77092,9,-9,660,358115,9,358106
77093,9,-6,676,451246,9,451237
77094,13,-6,702,464520,13,464507
77095,5,18,457,1196582,5,1196577
77096,11,-4,817,528081,11,528070
77097,9,-18,302,69104,9,69095
77098,7,-10,970,333316,7,333309
77099,19,1,717,685411,19,685392
77100,10,-16,240,129321,10,129311
77101,9,12,448,1008673,9,1008664
77102,17,5,832,809861,17,809844
77103,13,-9,463,370234,13,370221
77104,16,19,598,1245647,16,1245631
77105,16,-18,582,89481,16,89465
77106,13,16,75,1147617,13,1147604
77107,16,13,700,1058501,16,1058485
77108,14,2,928,717356,14,717342
77109,13,13,743,1058747,13,1058734
77110,16,3,944,749025,16,749009
77111,19,4,323,775534,19,775515
77112,9,19,211,1222175,9,1222166
77113,20,4,890,779848,20,779828
77114,5,-7,645,419538,5,419533
77115,13,15,571,1120936,13,1120923
77116,15,-6,990,466690,15,466675
77117,11,5,969,810938,11,810927
77118,5,-5,877,487168,5,487163
77119,18,12,780,1027858,18,1027840
77120,8,-4,291,505848,8,505840
77121,14,6,328,838339,14,838325
77122,10,-16,825,141763,10,141753
77123,8,-13,11,218520,8,218512
77124,12,13,229,1054900,12,1054888
77125,9,3,302,725502,9,725493
77126,11,-11,478,307550,11,307539
77127,17,-8,750,403210,17,403193
77128,11,6,404,839026,11,839015
77129,17,-1,902,623479,17,623462
77130,12,-16,831,153004,12,152992
77131,14,-4,129,523039,14,523025
77132,14,-14,750,215299,14,215285
77133,14,10,556,964127,14,964113
77134,17,15,717,1122108,17,1122091
77135,11,-18,686,90226,11,90215
77136,17,-3,717,559481,17,559464
77137,17,2,621,715196,17,715179
77138,7,1,206,661710,7,661703
77139,9,-19,386,39858,9,39849
77140,7,-17,123,96008,7,96001
77141,5,-20,371,8142,5,8137
77142,16,5,119,804665,16,804649
77143,8,2,818,705642,8,705634
77144,12,17,488,1181570,12,1181558
77145,13,-9,364,369376,13,369363
77146,10,-3,387,538941,10,538931
77147,10,7,967,865187,10,865177
77148,18,-14,770,215557,18,215539
77149,16,18,331,1211521,16,1211505
77150,9,6,295,818888,9,818879
77151,12,-5,803,496816,12,496804
77152,14,2,621,715200,14,715186
77153,18,3,988,749436,18,749418
77154,19,0,496,651963,19,651944
77155,20,9,626,933724,20,933704
77156,7,-14,591,199610,7,199603
77157,9,-7,396,414533,9,414524
77158,16,12,439,1025285,16,1025269
77159,19,1,268,682030,19,682011
77160,14,15,296,1118993,14,1118979
77161,5,-20,864,19206,5,19201
77162,9,-9,956,364990,9,364981
77163,10,-15,374,163545,10,163535
77164,8,13,222,1035495,8,1035487
77165,5,-13,33,219138,5,219133
77166,14,-10,273,337052,14,337038
77167,20,11,821,996789,20,996769
77168,16,-19,375,56926,16,56910
77169,11,10,791,965970,11,965959
77170,10,19,977,1239135,10,1239125
77171,16,8,579,902499,16,902483
77172,18,18,609,1213317,18,1213299
77173,5,12,669,1013759,5,1013754
77174,9,4,658,764813,9,764804
77175,13,-15,122,178714,13,178701
77176,10,19,2,1217439,10,1217429
77177,17,-3,549,558125,17,558108
77178,13,16,257,1148975,13,1148962
77179,19,-3,944,561357,19,561338
77180,14,16,5,1147148,14,1147134
77181,8,-13,877,237376,8,237368
77182,8,-15,284,161481,8,161473
77183,13,-5,554,495122,13,495109
77184,14,-8,507,401395,14,401381
77185,16,9,851,935380,16,935364
77186,18,-13,623,245687,18,245669
77187,14,8,997,905706,14,905692
77188,14,0,314,650389,14,650375
77189,13,-3,897,560978,13,560965
77190,5,-12,603,262550,5,262545
77191,18,5,430,806903,18,806885
77192,13,-18,20,85348,13,85335
77193,11,-2,805,591187,11,591176
77194,15,2,685,715753,15,715738
77195,15,-8,435,400897,15,400882
77196,7,-6,944,456926,7,456919
77197,11,12,811,1028079,11,1028068
77198,15,-16,13,146855,15,146840
77199,6,-9,879,363321,6,363315
77200,6,-6,429,445932,6,445926
77201,16,18,890,1215504,16,1215488
77202,15,-15,465,181222,15,181207
77203,11,19,260,1242822,11,1242811
77204,19,-4,844,528258,19,528239
77205,5,-9,428,353055,5,353050
77206,12,-5,212,492535,12,492523
77207,9,-16,536,135689,9,135680
77208,7,-17,18,93962,7,93955
77209,17,-8,261,399744,17,399727
77210,15,0,910,655189,15,655174
77211,20,18,741,1214282,20,1214262
77212,8,1,518,668644,8,668636
77213,8,-6,211,441509,8,441501
77214,16,-9,863,373406,16,373390
77215,11,13,487,1056811,11,1056800
77216,19,-19,944,61132,19,61113
77217,6,6,710,828426,6,828420
77218,13,14,581,1089925,13,1089912
77219,10,-13,276,224342,10,224332
77220,11,12,406,1025010,11,1024999
77221,16,-17,292,117657,16,117641
77222,7,-3,633,544733,7,544726
77223,13,12,435,1025257,13,1025244
77224,5,-6,245,442227,5,442222
77225,19,-4,357,524918,19,524899
77226,9,15,777,1110923,9,1110914
77227,8,-1,538,605736,8,605728
77228,12,18,18,1209032,12,1209020
77229,17,-17,2,115569,17,115552
77230,15,11,375,993600,15,993585
77231,15,-9,407,369751,15,369736
77232,12,18,221,1210751,12,1210739
77233,8,-3,482,541271,8,541263
77234,14,-12,695,277613,14,277599
77235,10,9,673,920891,10,920881
77236,14,-8,936,404506,14,404492
77237,14,-9,47,367006,14,366992
77238,10,-16,978,145023,10,145013
77239,10,6,723,828690,10,828680
77240,10,-14,766,203455,10,203445
77241,18,1,147,681016,18,680998
77242,5,-17,543,105180,5,105175
77243,18,7,642,871725,18,871707
77244,19,-16,645,151767,19,151748
77245,14,-15,610,182244,14,182230
77246,7,-6,539,448454,7,448447
77247,14,-13,58,241504,14,241490
77248,7,14,782,1079492,7,1079485
77249,5,-8,939,395402,5,395397
77250,5,-8,191,379592,5,379587
77251,20,-12,887,279160,20,279140
77252,10,-8,844,393356,10,393346
77253,15,-15,360,180402,15,180387
77254,11,6,379,838729,11,838718
77255,11,2,473,714210,11,714199
77256,5,8,464,885374,5,885369
77257,18,0,657,653287,18,653269
77258,10,8,976,896419,10,896409
77259,20,-14,326,211963,20,211943
77260,20,16,598,1151326,20,1151306
77261,19,-13,918,247953,19,247934
77262,7,11,594,981231,7,981224
77263,7,-14,199,190821,7,190814
77264,15,-8,743,403142,15,403127
77265,10,17,508,1166225,10,1166215
77266,12,-13,398,243938,12,243926
77267,6,-3,697,546141,6,546135
77268,11,-20,968,30112,11,30101
77269,14,-17,207,116990,14,116976
77270,20,12,524,1025872,20,1025852
77271,12,-4,894,528772,12,528760
77272,15,-3,963,561506,15,561491
77273,9,-18,816,80125,9,80116
77274,8,-13,500,228872,8,228864
77275,16,-11,794,309901,16,309885
77276,12,17,139,1178915,12,1178903
77277,6,6,440,822383,6,822377
77278,15,-1,419,619897,15,619882
77279,20,11,752,996276,20,996256
77280,11,-2,330,587586,11,587575
77281,14,1,615,684685,14,684671
77282,15,-2,394,588032,15,588017
77283,9,15,119,1097112,9,1097103
77284,6,-16,819,141580,6,141574
77285,10,2,676,702907,10,702897
77286,15,-10,898,341838,15,341823
77287,15,-10,464,338499,15,338484
77288,12,10,135,960938,12,960926
77289,15,2,577,714913,15,714898
77290,7,17,197,1159449,7,1159442
77291,12,-6,52,459489,12,459477
77292,15,1,763,685815,15,685800
77293,5,3,417,727756,5,727751
77294,17,-6,390,462131,17,462114
77295,18,13,497,1056916,18,1056898
77296,20,-6,405,462237,20,462217
77297,14,-1,204,618132,14,618118
77298,20,-9,53,367049,20,367029
77299,12,-4,330,524643,12,524631
77300,14,-17,412,118504,14,118490
77301,6,-17,20,93992,6,93986
77302,11,0,865,654826,11,654815
77303,11,-8,408,400790,11,400779
77304,8,18,412,1195540,8,1195532
77305,7,17,329,1162453,7,1162446
77306,12,1,596,684535,12,684523
77307,12,3,431,745091,12,745079
77308,17,-8,655,402509,17,402492
77309,9,13,166,1034189,9,1034180
77310,15,16,182,1148435,15,1148420
77311,8,-9,135,346445,8,346437
77312,18,-11,56,304118,18,304100
77313,17,1,609,684651,17,684634
77314,15,-11,268,305843,15,305828
77315,16,17,417,1181037,16,1181021
77316,16,5,629,808406,16,808390
77317,11,-17,771,121369,11,121358
77318,9,1,226,662171,9,662162
77319,17,7,148,868098,17,868081
77320,18,-10,211,336635,18,336617
77321,11,-6,245,461094,11,461083
77322,7,-1,528,605569,7,605562
77323,7,-16,508,135101,7,135094
77324,10,-18,287,68725,10,68715
77325,6,-7,873,424414,6,424408
77326,6,-19,23,31985,6,31979
77327,20,-16,89,147546,20,147526
77328,15,-19,6,53942,15,53927
77329,19,-1,148,617674,19,617655
77330,12,-1,196,618014,12,618002
77331,15,-6,881,465759,15,465744
77332,10,2,785,705017,10,705007
77333,8,13,577,1043221,8,1043213
77334,5,-13,610,231430,5,231425
77335,11,-20,928,29875,11,29864
77336,20,18,469,1212432,20,1212412
77337,6,14,195,1066062,6,1066056
77338,19,-17,635,120265,19,120246
77339,7,3,592,731411,7,731404
77340,15,-16,906,153611,15,153596
77341,8,7,736,860430,8,860422
77342,7,-10,610,325838,7,325831
77343,16,-11,555,308185,16,308169
77344,15,4,190,774617,15,774602
77345,15,18,608,1213298,15,1213283
77346,20,6,625,840801,20,840781
77347,11,-1,14,616611,11,616600
77348,12,-11,338,306439,12,306427
77349,15,1,679,685174,15,685159
77350,11,3,368,744633,11,744622
77351,5,5,29,782196,5,782191
77352,20,11,986,997957,20,997937
77353,9,-4,361,507487,9,507478
77354,5,-9,355,351444,5,351439
77355,15,-6,164,460404,15,460389
77356,8,-18,32,63102,8,63094
77357,19,15,531,1120647,19,1120628
77358,19,-11,349,306521,19,306502
77359,11,4,172,774536,11,774525
77360,11,12,674,1027136,11,1027125
77361,12,7,842,873111,12,873099
77362,15,4,155,774383,15,774368
77363,16,-6,337,461786,16,461770
77364,11,3,724,747337,11,747326
77365,16,-20,359,25592,16,25576
77366,15,-3,966,561540,15,561525
77367,17,-1,444,620083,17,620066
77368,18,15,766,1122451,18,1122433
77369,7,10,159,941007,7,941000
77370,20,18,140,1210121,20,1210101
77371,20,-15,292,179918,20,179898
77372,20,-9,353,369297,20,369277
77373,15,13,591,1057747,15,1057732
77374,10,4,856,769551,10,769541
77375,10,6,468,823018,10,823008
77376,9,-9,277,349668,9,349659
77377,10,-8,384,383398,10,383388
77378,5,7,975,865383,5,865378
77379,11,3,646,746725,11,746714
77380,15,1,786,685964,15,685949
77381,6,-13,756,234572,6,234566
77382,14,18,247,1210957,14,1210943
77383,20,-9,334,369096,20,369076
77384,17,11,123,991703,17,991686
77385,12,-9,259,368490,12,368478
77386,18,-9,534,370965,18,370947
77387,11,-1,467,620303,11,620292
77388,16,-19,949,61163,16,61147
77389,19,-1,834,622957,19,622938
77390,5,1,142,660284,5,660279
77391,18,-20,142,23851,18,23833
77392,5,-6,215,441568,5,441563
77393,15,-10,791,341026,15,341011
77394,11,15,167,1118020,11,1118009
77395,13,3,30,742008,13,741995
77396,14,8,791,904223,14,904209
77397,20,15,892,1123280,20,1123260
77398,11,-17,945,122460,11,122449
77399,10,-8,425,384130,10,384120
77400,15,0,798,654365,15,654350
77401,8,19,946,1238462,8,1238454
77402,8,7,642,858395,8,858387
77403,15,-16,89,147551,15,147536
77404,5,-2,720,578204,5,578199
77405,6,18,226,1191739,6,1191733
77406,11,6,459,839423,11,839412
77407,8,-16,273,129958,8,129950
77408,7,-11,988,302496,7,302489
77409,10,10,395,945947,10,945937
77410,6,-13,373,226186,6,226180
77411,18,-8,957,404692,18,404674
77412,19,6,275,837881,19,837862
77413,20,-9,44,366944,20,366924
77414,19,-19,983,61363,19,61344
77415,9,-4,686,514246,9,514237
77416,14,-9,590,371322,14,371308
77417,19,4,462,776579,19,776560
77418,8,13,118,1033273,8,1033265
77419,7,15,273,1100363,7,1100356
77420,17,14,429,1088838,17,1088821
77421,15,7,74,867545,15,867530
77422,13,10,950,967143,13,967130
77423,5,-13,513,229240,5,229235
77424,15,-7,693,433350,15,433335
77425,10,1,588,670133,10,670123
77426,18,19,879,1247897,18,1247879
77427,6,-5,115,470632,6,470626
77428,15,10,983,967341,15,967326
77429,16,6,306,838113,16,838097
77430,20,-20,984,30327,20,30307
77431,17,-1,161,617735,17,617718
77432,15,-9,576,371253,15,371238
77433,10,-16,462,134221,10,134211
77434,7,0,135,628394,7,628387
77435,20,-14,277,211615,20,211595
77436,5,18,559,1198669,5,1198664
77437,19,1,811,686170,19,686151
77438,7,-14,199,190828,7,190821
77439,13,-18,611,89662,13,89649
77440,6,-8,32,376048,6,376042
77441,10,19,905,1237699,10,1237689
77442,15,2,480,714262,15,714247
77443,17,-4,439,525469,17,525452
77444,8,-15,112,157935,8,157927
77445,11,-5,564,495194,11,495183
77446,19,-9,899,373722,19,373703
77447,15,19,63,1241236,15,1241221
77448,10,-10,547,324479,10,324469
77449,13,-15,207,179236,13,179223
77450,10,-3,330,537664,10,537654
77451,19,4,78,773818,19,773799
77452,16,-9,312,368889,16,368873
77453,16,17,346,1180567,16,1180551
77454,12,12,600,1026447,12,1026435
77455,5,-14,279,192892,5,192887
77456,20,2,514,714523,20,714503
77457,18,-7,142,429332,18,429314
77458,16,11,659,995524,16,995508
77459,10,-20,147,3266,10,3256
77460,9,12,884,1018509,9,1018500
77461,10,4,529,762080,10,762070
77462,9,-9,177,347332,9,347323
77463,7,-20,340,7503,7,7496
77464,7,11,800,985593,7,985586
77465,10,17,906,1174825,10,1174815
77466,20,-17,769,121360,20,121340
77467,13,-19,636,59013,13,59000
77468,9,2,153,691867,9,691858
77469,18,-13,185,242438,18,242420
77470,18,-16,691,151986,18,151968
77471,5,5,9,781823,5,781818
77472,7,-17,863,111718,7,111711
77473,11,11,496,994465,11,994454
77474,8,12,667,1013667,8,1013659
77475,9,-16,501,134976,9,134967
77476,19,13,153,1054342,19,1054323
77477,18,3,695,747170,18,747152
77478,9,15,346,1101933,9,1101924
77479,20,19,860,1247752,20,1247732
77480,13,-15,220,179323,13,179310
77481,6,-12,160,253035,6,253029
77482,7,-1,206,598217,7,598210
77483,19,-13,220,242665,19,242646
77484,14,15,213,1118415,14,1118401
77485,6,11,902,987940,6,987934
77486,20,3,743,747466,20,747446
77487,5,-5,56,469091,5,469086
77488,7,-6,391,445159,7,445152
77489,10,13,925,1050555,10,1050545
77490,12,-11,480,307559,12,307547
77491,15,18,780,1214643,15,1214628
77492,20,-6,161,460366,20,460346
77493,20,-6,224,460882,20,460862
77494,13,-17,189,116842,13,116829
77495,13,-7,747,433701,13,433688
77496,14,1,494,683783,14,683769
77497,5,-14,886,205749,5,205744
77498,13,9,758,934565,13,934552
77499,15,-10,995,342682,15,342667
77500,15,16,667,1151923,15,1151908
77501,6,18,992,1207731,6,1207725
77502,18,8,589,902586,18,902568
77503,10,-18,446,71979,10,71969
77504,7,2,248,693933,7,693926
77505,12,-7,216,429929,12,429917
77506,16,9,564,933221,16,933205
77507,7,19,790,1235017,7,1235010
77508,7,2,76,690270,7,690263
77509,13,6,207,837265,13,837252
77510,11,13,332,1055682,11,1055671
77511,17,-19,121,54975,17,54958
77512,19,5,831,809840,19,809821
77513,13,8,517,902074,13,902061
77514,6,-13,416,226999,6,226993
77515,17,-19,759,59941,17,59924
77516,9,10,46,938543,9,938534
77517,5,3,218,723522,5,723517
77518,13,-14,38,209602,13,209589
77519,12,14,372,1088334,12,1088322
77520,7,-14,622,200375,7,200368
77521,17,17,171,1179177,17,1179160
77522,7,-11,298,287620,7,287613
77523,16,13,180,1054554,16,1054538
77524,15,10,130,960902,15,960887
77525,13,6,696,841415,13,841402
77526,18,-7,1,428272,18,428254
77527,13,-8,54,398348,13,398335
77528,15,7,962,873823,15,873808
77529,5,-7,752,421777,5,421772
77530,16,-9,831,373139,16,373123
77531,20,12,809,1028066,20,1028046
77532,12,4,771,778923,12,778911
77533,14,9,310,931262,14,931248
77534,11,-4,924,528996,11,528985
77535,13,-15,846,184136,13,184123
77536,7,2,29,689213,7,689206
77537,11,11,795,996649,11,996638
77538,10,5,812,798592,10,798582
77539,9,-6,849,454928,9,454919
77540,19,2,87,711194,19,711175
77541,9,-6,992,458000,9,457991
77542,15,-4,813,528074,15,528059
77543,14,-7,334,430861,14,430847
77544,5,0,352,632845,5,632840
77545,13,-12,667,277437,13,277424
77546,17,-1,634,621455,17,621438
77547,8,-17,804,110638,8,110630
77548,18,18,38,1209181,18,1209163
77549,14,1,747,685686,14,685672
77550,7,17,12,1155481,7,1155474
77551,17,-8,309,400065,17,400048
77552,20,16,127,1147963,20,1147943
77553,19,-5,578,495309,19,495290
77554,16,-9,326,368991,16,368975
77555,5,-1,652,607981,5,607976
77556,9,-14,831,204653,9,204644
77557,14,17,987,1185382,14,1185368
77558,14,4,914,780010,14,779996
77559,6,18,424,1195792,6,1195786
77560,11,8,212,899644,11,899633
77561,13,-3,668,559108,13,559095
77562,13,-13,88,241672,13,241659
77563,17,13,2,1053265,17,1053248
77564,18,-6,469,462750,18,462732
77565,16,-14,998,217289,16,217273
77566,7,-14,32,187209,7,187202
77567,20,-17,258,117397,20,117377
77568,19,-14,243,211314,19,211295
77569,19,1,121,680783,19,680764
77570,16,15,713,1122071,16,1122055
77571,7,9,47,907795,7,907788
77572,12,19,707,1246513,12,1246501
77573,11,-13,327,243472,11,243461
77574,15,19,967,1248528,15,1248513
77575,7,-5,663,482389,7,482382
77576,16,-13,143,242046,16,242030
77577,13,4,823,779326,13,779313
77578,11,10,660,965009,11,964998
77579,10,17,748,1171225,10,1171215
77580,12,-7,321,430784,12,430772
77581,18,13,541,1057275,18,1057257
77582,18,-4,406,525278,18,525260
77583,18,-13,401,243949,18,243931
77584,19,17,1000,1185507,19,1185488
77585,16,4,806,779190,16,779174
77586,11,6,142,836830,11,836819
77587,5,-20,349,7675,5,7670
77588,20,17,747,1183460,20,1183440
77589,16,-11,921,310916,16,310900
77590,12,-7,464,431831,12,431819
77591,13,-10,410,338068,13,338055
77592,15,6,965,843445,15,843430
77593,5,-3,325,537475,5,537470
77594,20,-17,527,119429,20,119409
77595,19,-18,615,89685,19,89666
77596,6,-3,900,550601,6,550595
77597,6,7,374,852875,6,852869
77598,9,-9,205,347924,9,347915
77599,14,5,913,810444,14,810430
77600,18,-7,935,435248,18,435230
77601,14,3,591,746249,14,746235
77602,16,5,146,804866,16,804850
77603,6,5,264,787208,6,787202
77604,12,-7,94,428942,12,428930
77605,7,10,853,955849,7,955842
77606,5,8,960,896028,5,896023
77607,19,8,227,899784,19,899765
77608,14,-12,652,277312,14,277298
77609,12,-11,15,303794,12,303782
77610,19,14,323,1087986,19,1087967
77611,8,6,126,814883,8,814875
77612,20,16,228,1148738,20,1148718
77613,10,18,507,1197595,10,1197585
77614,10,-11,396,289925,10,289915
77615,13,5,548,807784,13,807771
77616,11,8,57,898317,11,898306
77617,12,-10,65,335662,12,335650
77618,15,-18,942,92064,15,92049
77619,18,4,167,774490,18,774472
77620,10,14,397,1070618,10,1070608
77621,10,-19,234,36727,10,36717
77622,19,7,312,869292,19,869273
77623,7,-2,907,582265,7,582258
77624,11,6,826,842396,11,842385
77625,10,14,494,1072832,10,1072822
77626,11,10,218,961484,11,961473
77627,10,8,516,886570,10,886560
77628,11,9,387,931840,11,931829
77629,6,-3,705,546330,6,546324
77630,15,-4,584,526491,15,526476
77631,12,-13,785,246892,12,246880
77632,16,-8,947,404601,16,404585
77633,18,-4,56,522451,18,522433
77634,6,0,650,639589,6,639583
77635,19,-5,406,493998,19,493979
77636,19,7,186,868351,19,868332
77637,10,19,874,1237021,10,1237011
77638,9,-9,574,356603,9,356594
77639,11,19,692,1246375,11,1246364
77640,8,6,291,818756,8,818748
77641,11,-7,106,429067,11,429056
77642,11,12,230,1023734,11,1023723
77643,10,16,892,1143638,10,1143628
77644,5,-13,969,239358,5,239353
77645,16,17,185,1179290,16,1179274
77646,16,5,736,809154,16,809138
77647,8,15,683,1108954,8,1108946
77648,5,-11,510,292563,5,292558
77649,15,15,97,1117512,15,1117497
77650,9,-1,321,601019,9,601010
77651,14,15,599,1121170,14,1121156
77652,12,18,622,1213398,12,1213386
77653,8,0,178,629399,8,629391
77654,10,-12,626,263052,10,263042
77655,11,19,416,1244254,11,1244243
77656,17,7,134,868017,17,868000
77657,17,4,865,779723,17,779706
77658,20,-14,311,211806,20,211786
77659,15,4,99,774020,15,774005
77660,16,4,66,773736,16,773720
77661,6,12,118,1001723,6,1001717
77662,9,0,18,625625,9,625616
77663,5,-19,73,33018,5,33013
77664,15,-8,254,399702,15,399687
77665,20,-6,290,461453,20,461433
77666,7,9,294,912827,7,912820
77667,20,9,449,932295,20,932275
77668,12,19,443,1244517,12,1244505
77669,12,8,727,903740,12,903728
77670,14,4,764,778891,14,778877
77671,17,15,968,1123924,17,1123907
77672,11,-10,981,342490,11,342479
77673,19,6,655,841036,19,841017
77674,8,-14,688,201824,8,201816
77675,16,6,775,841974,16,841958
77676,15,-9,898,373713,15,373698
77677,7,-8,836,393208,7,393201
77678,9,-9,941,364721,9,364712
77679,20,11,462,994237,20,994217
77680,10,-11,901,300524,10,300514
77681,5,12,135,1002028,5,1002023
77682,14,-14,317,211852,14,211838
77683,13,-15,367,180459,13,180446
77684,20,-2,766,590837,20,590817
77685,11,-8,862,403992,11,403981
77686,7,-19,20,31930,7,31923
77687,18,4,982,780472,18,780454
77688,20,-14,501,213368,20,213348
77689,14,-11,333,306418,14,306404
77690,12,6,632,840868,12,840856
77691,6,8,928,895305,6,895299
77692,7,-8,636,388983,7,388976
77693,6,-14,169,190169,6,190163
77694,6,-2,116,565381,6,565375
77695,10,-7,787,422458,10,422448
77696,14,8,344,900710,14,900696
77697,9,18,878,1205303,9,1205294
77698,7,-4,736,515215,7,515208
77699,18,15,76,1117346,18,1117328
77700,17,-1,222,618306,17,618289
77701,7,-15,16,155690,7,155683
77702,7,9,808,923890,7,923883
77703,11,-13,995,248550,11,248539
77704,19,-4,867,528495,19,528476
77705,5,15,286,1100669,5,1100664
77706,15,-13,253,242904,15,242889
77707,13,6,486,839669,13,839656
77708,19,-3,908,561077,19,561058
77709,12,11,801,996665,12,996653
77710,20,-15,235,179437,20,179417
77711,9,7,360,852618,9,852609
77712,20,9,571,933272,20,933252
77713,10,8,958,895995,10,895985
77714,7,10,339,944702,7,944695
77715,14,6,839,842521,14,842507
77716,16,-9,419,369852,16,369836
77717,5,-7,166,409313,5,409308
77718,16,-13,982,248447,16,248431
77719,7,5,80,783322,7,783315
77720,7,15,442,1103800,7,1103793
77721,6,12,699,1014480,6,1014474
77722,19,7,651,871784,19,871765
77723,19,-20,557,27058,19,27039
77724,11,-19,524,58060,11,58049
77725,16,16,518,1150788,16,1150772
77726,20,3,52,742225,20,742205
77727,16,-2,282,587236,16,587220
77728,12,-17,607,120062,12,120050
77729,18,-17,7,115615,18,115597
77730,8,-12,866,268461,8,268453
77731,7,-10,641,326514,7,326507
77732,7,11,242,973408,7,973401
77733,16,-14,436,212902,16,212886
77734,12,13,595,1057768,12,1057756
77735,13,-20,435,26090,13,26077
77736,10,-19,932,51519,10,51509
77737,19,11,593,995155,19,995136
77738,20,-3,78,554341,20,554321
77739,17,0,855,654732,17,654715
77740,5,-4,969,520295,5,520290
77741,13,5,524,807623,13,807610
77742,12,-5,366,493781,12,493769
77743,7,-20,577,12573,7,12566
77744,6,2,355,696385,6,696379
77745,8,3,513,729724,8,729716
77746,18,16,297,1149279,18,1149261
77747,20,13,229,1054910,20,1054890
77748,10,15,700,1109328,10,1109318
77749,18,-13,44,241383,18,241365
77750,15,6,754,841846,15,841831
77751,14,7,691,872075,14,872061
77752,11,-14,611,214339,11,214328
77753,9,-3,950,551803,9,551794
77754,19,-3,897,560987,19,560968
77755,6,-17,799,110540,6,110534
77756,11,-15,972,185158,11,185147
77757,8,-7,544,417580,8,417572
77758,15,3,303,744212,15,744197
77759,14,18,606,1213271,14,1213257
77760,12,10,260,961783,12,961771
77761,16,4,324,775550,16,775534
77762,8,2,812,705535,8,705527
77763,18,-18,748,90718,18,90700
77764,15,-18,239,87201,15,87186
77765,20,13,811,1059334,20,1059314
77766,13,18,930,1215768,13,1215755
77767,19,14,674,1090748,19,1090729
77768,7,16,730,1140269,7,1140262
77769,10,3,788,735776,10,735766
77770,12,-8,660,402563,12,402551
77771,6,-8,818,392908,6,392902
77772,15,-2,672,590167,15,590152
77773,12,0,82,648819,12,648807
77774,5,11,943,988721,5,988716
77775,16,-3,132,554725,16,554709
77776,13,10,854,966377,13,966364
77777,15,-7,706,433446,15,433431
77778,12,12,874,1028644,12,1028632
77779,12,-8,590,401972,12,401960
77780,15,18,229,1210807,15,1210792
77781,8,-5,622,481506,8,481498
77782,13,-13,797,246960,13,246947
77783,7,17,364,1163122,7,1163115
77784,10,17,676,1169783,10,1169773
77785,19,1,358,682728,19,682709
77786,13,-18,294,87527,13,87514
77787,17,-4,263,524142,17,524125
77788,19,4,562,777332,19,777313
77789,5,5,444,790835,5,790830
77790,8,19,86,1219457,8,1219449
77791,17,1,145,680990,17,680973
77792,7,5,586,793772,7,793765
77793,5,0,407,634162,5,634157
77794,18,10,353,962455,18,962437
77795,8,-18,425,71557,8,71549
77796,11,19,391,1243961,11,1243950
77797,13,11,996,998001,13,997988
77798,6,0,150,628722,6,628716
77799,17,12,106,1022828,17,1022811
77800,6,-2,623,576042,6,576036
77801,19,5,877,810167,19,810148
77802,10,1,958,677849,10,677839
77803,13,13,826,1059425,13,1059412
77804,20,-20,869,29504,20,29484
77805,10,15,185,1098442,10,1098432
77806,20,-15,538,181721,20,181701
77807,9,-17,969,113902,9,113893
77808,8,-2,344,570085,8,570077
77809,16,10,96,960642,16,960626
77810,10,-4,656,513547,10,513537
77811,16,19,149,1241972,16,1241956
77812,14,-5,686,496022,14,496008
77813,9,1,528,668897,9,668888
77814,16,-20,123,23684,16,23668
77815,12,0,348,650674,12,650662
77816,6,11,275,974142,6,974136
77817,17,-6,129,460069,17,460052
77818,12,6,503,839852,12,839840
77819,16,15,627,1121387,16,1121371
77820,5,-16,821,141665,5,141660
77821,8,-11,425,290621,8,290613
77822,16,1,948,687281,16,687265
77823,7,6,14,812512,7,812505
77824,20,0,158,649428,20,649408
77825,19,16,536,1150906,19,1150887
77826,8,18,944,1206710,8,1206702
77827,10,5,652,795041,10,795031
77828,11,0,575,652615,11,652604
77829,7,11,474,978586,7,978579
77830,6,-8,683,390022,6,390016
77831,15,-13,759,246659,15,246644
77832,9,17,208,1159681,9,1159672
77833,14,12,805,1028020,14,1028006
77834,18,-11,257,305729,18,305711
77835,9,-16,64,125204,9,125195
77836,6,2,423,697745,6,697739
77837,5,14,996,1084231,5,1084226
77838,5,-9,717,359386,5,359381
77839,14,-18,394,88251,14,88237
77840,12,-4,919,528957,12,528945
77841,6,17,987,1176582,6,1176576
77842,19,1,920,687060,19,687041
77843,13,-8,258,399719,13,399706
77844,13,-17,405,118434,13,118421
77845,19,4,693,778330,19,778311
77846,7,-14,295,193134,7,193127
77847,12,-5,276,493068,12,493056
77848,5,-18,574,74800,5,74795
77849,19,-10,216,336680,19,336661
77850,15,-2,320,587532,15,587517
77851,10,8,235,880439,10,880429
77852,15,-19,819,60281,15,60266
77853,20,5,777,809427,20,809407
77854,15,-6,296,461489,15,461474
77855,13,0,70,648762,13,648749
77856,7,11,130,971243,7,971236
77857,8,7,691,859444,8,859436
77858,12,0,458,651589,12,651577
77859,11,15,419,1119730,11,1119719
77860,17,-4,879,528664,17,528647
77861,16,-2,38,585406,16,585390
77862,19,15,54,1117208,19,1117189
77863,15,15,424,1119775,15,1119760
77864,18,18,357,1211693,18,1211675
77865,6,13,437,1040175,6,1040169
77866,13,-11,341,306465,13,306452
77867,12,-13,353,243627,12,243615
77868,19,15,512,1120497,19,1120478
77869,15,12,461,1025423,15,1025408
77870,20,16,724,1152271,20,1152251
77871,5,-7,484,416235,5,416230
77872,13,-6,180,460585,13,460572
77873,15,-7,765,433868,15,433853
77874,15,-8,964,404760,15,404745
77875,17,5,48,804160,17,804143
77876,17,0,442,651433,17,651416
77877,12,-17,886,122087,12,122075
77878,8,18,405,1195375,8,1195367
77879,6,1,895,676462,6,676456
77880,9,-5,856,486567,9,486558
77881,5,-9,301,350172,5,350167
77882,8,-20,21,546,8,538
77883,11,-1,900,623439,11,623428
77884,7,2,986,709279,7,709272
77885,13,4,346,775717,13,775704
77886,6,10,530,948842,6,948836
77887,8,-15,576,167894,8,167886
77888,20,-5,438,494245,20,494225
77889,17,2,724,716061,17,716044
77890,10,8,673,889979,10,889969
77891,16,-8,847,403873,16,403857
77892,15,-8,35,398173,15,398158
77893,6,3,267,724645,6,724639
77894,8,2,784,704978,8,704970
77895,6,4,220,755441,6,755435
77896,6,15,150,1097733,6,1097727
77897,18,5,276,805845,18,805827
77898,18,9,426,932131,18,932113
77899,11,-13,686,246004,11,245993
77900,6,4,952,771450,6,771444
77901,19,-19,376,56934,19,56915
77902,6,-12,827,267470,6,267464
77903,18,9,874,935548,18,935530
77904,13,16,639,1151704,13,1151691
77905,10,15,463,1104239,10,1104229
77906,16,-8,362,400414,16,400398
77907,14,12,222,1023693,14,1023679
77908,18,1,598,684541,18,684523
77909,18,-2,985,592636,18,592618
77910,18,-2,6,585166,18,585148
77911,8,-14,392,195397,8,195389
77912,6,9,628,920140,6,920134
77913,15,-14,319,211880,15,211865
77914,18,-7,964,435459,18,435441
77915,19,19,980,1248638,19,1248619
77916,9,-17,135,96260,9,96251
77917,13,7,18,867153,13,867140
77918,5,16,76,1126772,5,1126767
77919,9,-8,418,383980,9,383971
77920,14,-10,676,340206,14,340192
77921,16,-9,24,366781,16,366765
77922,13,15,324,1119162,13,1119149
77923,7,-10,737,328471,7,328464
77924,18,-10,316,337364,18,337346
77925,10,3,711,734329,10,734319
77926,7,2,66,690056,7,690049
77927,20,1,768,685872,20,685852
77928,13,4,420,776274,13,776261
77929,18,-20,182,24220,18,24202
77930,15,11,563,994910,15,994895
77931,9,10,648,951585,9,951576
77932,17,-8,221,399495,17,399478
77933,6,1,884,676209,6,676203
77934,19,18,534,1212906,19,1212887
77935,6,-5,337,475571,6,475565
77936,18,-13,853,247395,18,247377
77937,6,-4,496,510172,6,510166
77938,15,15,845,1122952,15,1122937
77939,10,12,736,1015171,10,1015161
77940,9,-14,911,206364,9,206355
77941,19,15,694,1121884,19,1121865
77942,5,-9,766,360644,5,360639
77943,12,18,518,1212787,12,1212775
77944,8,-16,107,126384,8,126376
77945,12,15,257,1118677,12,1118665
77946,6,10,653,951660,6,951654
77947,9,7,153,848073,9,848064
77948,6,-1,42,594749,6,594743
77949,17,-15,993,185288,17,185271
77950,18,-17,275,117525,18,117507
77951,17,14,997,1093324,17,1093307
77952,14,-1,876,623275,14,623261
77953,20,-4,47,522392,20,522372
77954,19,-5,37,491110,19,491091
77955,19,-15,918,184771,19,184752
77956,5,3,685,733697,5,733692
77957,11,-9,828,373086,11,373075
77958,17,-16,414,149978,17,149961
77959,14,-7,500,432083,14,432069
77960,8,0,880,644423,8,644415
77961,11,-2,243,586973,11,586962
77962,10,-19,877,50644,10,50634
77963,18,19,238,1242607,18,1242589
77964,20,0,391,651056,20,651036
77965,17,-18,71,85752,17,85735
77966,13,-12,524,276434,13,276421
77967,17,13,644,1058106,17,1058089
77968,11,14,664,1090639,11,1090628
77969,18,-2,105,585919,18,585901
77970,5,15,950,1114735,5,1114730
77971,19,-1,324,619127,19,619108
77972,14,5,726,809075,14,809061
77973,17,10,557,964146,17,964129
77974,13,5,931,810620,13,810607
77975,7,16,224,1130009,7,1130002
77976,10,-8,198,379723,10,379713
77977,9,19,192,1221781,9,1221772
77978,9,-20,609,13322,9,13313
77979,11,-1,479,620413,11,620402
77980,14,-19,597,58723,14,58709
77981,15,4,759,778863,15,778848
77982,7,-3,632,544720,7,544713
77983,19,-19,849,60514,19,60495
77984,5,12,415,1007954,5,1007949
77985,12,10,801,966135,12,966123
77986,16,2,639,715358,16,715342
77987,6,8,885,894356,6,894350
77988,15,8,408,901245,15,901230
77989,19,-8,397,400728,19,400709
77990,15,-20,508,26658,15,26643
77991,17,0,188,649681,17,649664
77992,10,-13,219,222991,10,222981
77993,10,18,676,1200924,10,1200914
77994,20,-12,848,278808,20,278788
77995,8,-10,813,330041,8,330033
77996,18,5,902,810368,18,810350
77997,7,7,14,845086,7,845079
77998,13,-16,883,153471,13,153458
77999,15,8,185,899388,15,899373
78000,9,8,444,884937,9,884928
78001,10,9,939,926712,10,926702
78002,6,-17,268,99196,6,99190
78003,16,-3,572,558335,16,558319
78004,13,0,364,650798,13,650785
78005,15,-17,459,118918,15,118903
78006,6,3,69,720308,6,720302
78007,17,-5,729,496394,17,496377
78008,8,-1,565,606246,8,606238
78009,14,13,967,1060411,14,1060397
78010,8,5,705,796315,8,796307
78011,11,-9,646,371636,11,371625
78012,7,-7,841,423664,7,423657
78013,18,3,937,748964,18,748946
78014,5,7,127,847537,5,847532
78015,13,-12,391,275389,13,275376
78016,7,10,938,957709,7,957702
78017,7,5,447,790954,7,790947
78018,20,-18,413,88382,20,88362
78019,17,-17,547,119615,17,119598
78020,20,-20,836,29290,20,29270
78021,8,7,316,851609,8,851601
78022,6,10,78,939186,6,939180
78023,18,12,960,1029525,18,1029507
78024,16,13,333,1055705,16,1055689
78025,12,-4,763,527749,12,527737
78026,18,-2,858,591647,18,591629
78027,19,17,665,1182820,19,1182801
78028,8,13,456,1040593,8,1040585
78029,18,-11,95,304445,18,304427
78030,20,8,630,902977,20,902957
78031,6,16,359,1132785,6,1132779
78032,7,17,518,1166435,7,1166428
78033,9,-2,273,568657,9,568648
78034,20,-18,700,90305,20,90285
78035,13,-8,342,400319,13,400306
78036,19,7,78,867581,19,867562
78037,19,-2,391,587991,19,587972
78038,16,-19,667,59185,16,59169
78039,8,14,182,1065812,8,1065804
78040,9,17,207,1159673,9,1159664
78041,17,9,793,934941,17,934924
78042,15,8,441,901506,15,901491
78043,14,-3,851,560584,14,560570
78044,18,-6,316,461629,18,461611
78045,13,-12,199,273907,13,273894
78046,5,-10,153,315998,5,315993
78047,19,-20,940,29937,19,29918
78048,12,-13,40,241349,12,241337
78049,12,-17,586,119960,12,119948
78050,16,-17,515,119379,16,119363
78051,5,7,268,850519,5,850514
78052,5,15,393,1102795,5,1102790
78053,15,16,363,1149770,15,1149755
78054,10,1,321,664264,10,664254
78055,5,-6,345,444229,5,444224
78056,8,-2,471,572842,8,572834
78057,5,-5,626,481576,5,481571
78058,17,-14,388,212607,17,212590
78059,14,-14,107,210153,14,210139
78060,13,-12,778,278218,13,278205
78061,6,10,457,947268,6,947262
78062,17,-5,169,492262,17,492245
78063,7,8,562,887513,7,887506
78064,18,3,735,747409,18,747391
78065,14,8,39,898164,14,898150
78066,10,5,874,800000,10,799990
78067,9,-11,210,285627,9,285618
78068,7,18,84,1188608,7,1188601
78069,12,3,298,744141,12,744129
78070,7,10,801,954977,7,954970
78071,13,5,589,808094,13,808081
78072,15,-7,547,432459,15,432444
78073,15,3,0,741828,15,741813
78074,17,-8,308,400046,17,400029
78075,10,16,640,1138693,10,1138683
78076,14,4,586,777496,14,777482
78077,5,-8,236,380539,5,380534
78078,11,7,171,868226,11,868215
78079,10,-19,635,45493,10,45483
78080,15,-14,529,213590,15,213575
78081,7,5,268,787296,7,787289
78082,16,-6,98,459820,16,459804
78083,8,14,631,1076012,8,1076004
78084,7,4,355,758222,7,758215
78085,16,-19,245,55973,16,55957
78086,17,6,581,840480,17,840463
78087,17,13,828,1059449,17,1059432
78088,16,18,469,1212438,16,1212422
78089,13,3,309,744278,13,744265
78090,5,16,223,1129956,5,1129951
78091,5,12,352,1006825,5,1006820
78092,14,13,148,1054297,14,1054283
78093,17,2,484,714272,17,714255
78094,8,-20,82,1823,8,1815
78095,13,17,157,1179015,13,1179002
78096,11,14,316,1087876,11,1087865
78097,17,-16,97,147654,17,147637
78098,11,-4,519,526040,11,526029
78099,11,18,586,1213158,11,1213147
78100,14,11,472,994297,14,994283
78101,6,12,349,1006755,6,1006749
78102,18,-13,948,248217,18,248199
78103,8,9,35,907549,8,907541
78104,6,-18,744,78492,6,78486
78105,17,12,208,1023559,17,1023542
78106,15,11,312,993154,15,993139
78107,7,-5,21,468274,7,468267
78108,17,14,757,1091381,17,1091364
78109,12,6,722,841620,12,841608
78110,8,-19,180,35556,8,35548
78111,8,-19,857,50274,8,50266
78112,6,7,983,865600,6,865594
78113,20,4,424,776324,20,776304
78114,16,2,476,714235,16,714219
78115,14,-19,575,58579,14,58565
78116,15,7,178,868308,15,868293
78117,6,18,512,1197795,6,1197789
78118,6,6,622,826379,6,826373
78119,9,-6,660,450948,9,450939
78120,16,-2,710,590488,16,590472
78121,14,12,398,1024991,14,1024977
78122,10,7,687,859380,10,859370
78123,19,-1,440,620045,19,620026
78124,8,5,204,785988,8,785980
78125,10,-12,272,255408,10,255398
78126,8,14,594,1075044,8,1075036
78127,12,12,511,1025779,12,1025767
78128,9,-11,411,290218,9,290209
78129,20,16,247,1148873,20,1148853
78130,9,9,969,927474,9,927465
78131,15,-16,983,154158,15,154143
78132,14,-7,482,431956,14,431942
78133,14,18,259,1211063,14,1211049
78134,10,-1,926,613963,10,613953
78135,19,16,725,1152286,19,1152267
78136,14,-10,724,340533,14,340519
78137,11,13,6,1053303,11,1053292
78138,14,18,264,1211103,14,1211089
78139,17,5,456,807109,17,807092
78140,7,-17,542,105149,7,105142
78141,11,-2,261,587099,11,587088
78142,6,6,192,816400,6,816394
78143,7,18,49,1187724,7,1187717
78144,8,16,942,1144799,8,1144791
78145,20,-3,635,558872,20,558852
78146,20,-13,392,243907,20,243887
78147,18,6,380,838742,18,838724
78148,9,-19,359,39293,9,39284
78149,18,11,959,997719,18,997701
78150,17,-16,447,150330,17,150313
78151,14,10,744,965600,14,965586
78152,6,16,174,1128855,6,1128849
78153,20,6,492,839739,20,839719
78154,17,12,728,1027527,17,1027510
78155,17,-17,333,117967,17,117950
78156,15,11,918,997576,15,997561
78157,16,11,168,992035,16,992019
78158,15,6,978,843575,15,843560
78159,6,3,377,726959,6,726953
78160,15,-20,90,23458,15,23443
78161,16,-7,256,430193,16,430177
78162,17,-5,220,492595,17,492578
78163,12,-6,195,460667,12,460655
78164,8,10,362,945212,8,945204
78165,12,17,168,1179154,12,1179142
78166,15,-17,475,119002,15,118987
78167,7,9,659,920604,7,920597
78168,15,0,102,649057,15,649042
78169,10,13,664,1045110,10,1045100
78170,6,-8,935,395336,6,395330
78171,5,5,294,787802,5,787797
78172,8,-12,249,254879,8,254871
78173,16,-3,497,557634,16,557618
78174,12,-1,748,622312,12,622300
78175,5,-3,867,549798,5,549793
78176,5,-15,113,157949,5,157944
78177,11,9,201,930536,11,930525
78178,8,-12,625,262991,8,262983
78179,10,-4,198,503743,10,503733
78180,9,-7,657,419693,9,419684
78181,5,-15,628,168951,5,168946
78182,20,-4,599,526600,20,526580
78183,18,18,384,1211900,18,1211882
78184,19,-10,446,338359,19,338340
78185,6,-15,370,163414,6,163408
78186,5,15,124,1097231,5,1097226
78187,13,19,141,1241909,13,1241896
78188,19,-4,12,522137,19,522118
78189,16,9,574,933298,16,933282
78190,13,-4,638,526885,13,526872
78191,16,16,831,1153107,16,1153091
78192,10,17,846,1173582,10,1173572
78193,17,-10,349,337604,17,337587
78194,6,5,489,791772,6,791766
78195,9,-12,357,257420,9,257411
78196,9,-17,166,96935,9,96926
78197,20,-16,991,154265,20,154245
78198,7,19,295,1224077,7,1224070
78199,18,11,483,994399,18,994381
78200,13,-5,645,495744,13,495731
78201,11,-10,131,336089,11,336078
78202,14,-12,433,275637,14,275623
78203,10,3,217,723498,10,723488
78204,10,-14,349,194324,10,194314
78205,7,7,916,864208,7,864201
78206,14,17,70,1178399,14,1178385
78207,8,2,484,698952,8,698944
78208,6,4,667,764956,6,764950
78209,10,-1,264,599608,10,599598
78210,20,-15,785,183607,20,183587
78211,9,-11,340,288617,9,288608
78212,11,-11,458,307429,11,307418
78213,13,-1,956,623831,13,623818
78214,16,-1,566,621025,16,621009
78215,19,4,125,774139,19,774120
78216,12,5,623,808360,12,808348
78217,18,-12,5,272566,18,272548
78218,9,19,886,1237271,9,1237262
78219,12,-18,603,89618,12,89606
78220,20,-17,829,121705,20,121685
78221,12,-11,391,306869,12,306857
78222,12,11,626,995319,12,995307
78223,5,-3,672,545644,5,545639
78224,6,-9,607,357187,6,357181
78225,10,11,883,987537,10,987527
78226,13,-7,668,433119,13,433106
78227,9,9,430,915662,9,915653
78228,18,10,387,962750,18,962732
78229,6,-4,960,520067,6,520061
78230,18,-6,398,462167,18,462149
78231,16,-8,644,402399,16,402383
78232,5,-8,427,384180,5,384175
78233,14,18,448,1212328,14,1212314
78234,5,-18,558,74427,5,74422
78235,7,-13,790,235518,7,235511
78236,8,-19,37,32313,8,32305
78237,8,1,830,674956,8,674948
78238,18,-12,755,278070,18,278052
78239,11,-9,384,369540,11,369529
78240,6,-8,896,394564,6,394558
78241,14,6,374,838698,14,838684
78242,14,-6,586,463623,14,463609
78243,5,-12,602,262526,5,262521
78244,5,14,386,1070315,5,1070310
78245,9,10,461,947394,9,947385
78246,11,3,176,743166,11,743155
78247,20,-11,464,307477,20,307457
78248,15,15,52,1117188,15,1117173
78249,15,15,497,1120298,15,1120283
78250,6,7,749,860565,6,860559
78251,18,-15,990,185258,18,185240
78252,18,-3,752,559796,18,559778
78253,13,-10,355,337628,13,337615
78254,6,19,776,1234695,6,1234689
78255,7,-5,313,475000,7,474993
78256,20,-19,64,54353,20,54333
78257,9,5,956,801892,9,801883
78258,16,5,504,807481,16,807465
78259,8,-14,186,190467,8,190459
78260,17,-14,827,215951,17,215934
78261,11,-20,624,27516,11,27505
78262,16,-12,469,275959,16,275943
78263,13,11,660,995552,13,995539
78264,5,18,481,1197043,5,1197038
78265,7,15,970,1115180,7,1115173
78266,19,-8,484,401205,19,401186
78267,16,-14,1000,217311,16,217295
78268,7,12,542,1010788,7,1010781
78269,14,10,29,960072,14,960058
78270,8,-6,131,439468,8,439460
78271,9,17,809,1172724,9,1172715
78272,15,10,41,960162,15,960147
78273,6,7,347,852310,6,852304
78274,18,19,120,1241768,18,1241750
78275,5,11,132,971264,5,971259
78276,20,-15,801,183729,20,183709
78277,17,17,770,1183567,17,1183550
78278,12,14,644,1090466,12,1090454
78279,18,0,455,651574,18,651556
78280,6,-17,342,100840,6,100834
78281,19,-4,290,524333,19,524314
78282,19,13,347,1055782,19,1055763
78283,15,14,256,1087421,15,1087406
78284,15,-17,16,115696,15,115681
78285,13,2,216,712214,13,712201
78286,11,5,670,808658,11,808647
78287,16,-13,767,246731,16,246715
78288,18,11,108,991637,18,991619
78289,17,1,447,683364,17,683347
78290,8,12,600,1012023,8,1012015
78291,9,-3,393,539083,9,539074
78292,17,-3,61,554194,17,554177
78293,16,15,941,1123676,16,1123660
78294,7,14,358,1069730,7,1069723
78295,6,19,179,1221485,6,1221479
78296,9,-14,216,191366,9,191357
78297,20,-11,632,308742,20,308722
78298,7,-16,51,124916,7,124909
78299,10,11,678,982920,10,982910
78300,20,-3,957,561463,20,561443
78301,10,5,885,800264,10,800254
78302,8,3,657,732980,8,732972
78303,6,0,155,628824,6,628818
78304,13,18,112,1209876,13,1209863
78305,8,-14,27,187103,8,187095
78306,12,10,366,962606,12,962594
78307,11,-7,669,433125,11,433114
78308,14,-13,756,246616,14,246602
78309,7,-13,506,229062,7,229055
78310,11,13,333,1055706,11,1055695
78311,13,-14,412,212792,13,212779
78312,16,1,512,683908,16,683892
78313,19,-17,83,116188,19,116169
78314,13,-10,470,338607,13,338594
78315,6,6,421,821880,6,821874
78316,20,0,133,649242,20,649222
78317,6,-2,882,581807,6,581801
78318,6,10,556,949372,6,949366
78319,10,-14,855,205128,10,205118
78320,12,12,307,1024386,12,1024374
78321,9,13,22,1031275,9,1031266
78322,13,5,591,808110,13,808097
78323,9,-14,588,199533,9,199524
78324,19,18,906,1215575,19,1215556
78325,16,-15,48,178151,16,178135
78326,7,-1,27,594299,7,594292
78327,16,-1,799,622711,16,622695
78328,17,10,726,965456,17,965439
78329,11,14,329,1088041,11,1088030
78330,19,5,697,808876,19,808857
78331,19,16,468,1150477,19,1150458
78332,5,-4,108,501707,5,501702
78333,8,3,421,727847,8,727839
78334,8,-9,376,351868,8,351860
78335,10,9,928,926481,10,926471
78336,7,-5,316,475094,7,475087
78337,5,-4,354,507327,5,507322
78338,14,-5,392,493903,14,493889
78339,9,19,662,1232182,9,1232173
78340,9,-5,491,478652,9,478643
78341,8,11,451,978061,8,978053
78342,20,-20,757,28649,20,28629
78343,20,-16,503,150725,20,150705
78344,10,4,987,772024,10,772014
78345,19,-11,851,310374,19,310355
78346,14,6,185,837149,14,837135
78347,10,4,700,765631,10,765621
78348,16,4,941,780179,16,780163
78349,14,2,422,713824,14,713810
78350,6,14,302,1068493,6,1068487
78351,8,11,194,972437,8,972429
78352,8,-17,988,114292,8,114284
78353,16,-9,676,371772,16,371756
78354,5,8,988,896679,5,896674
78355,20,-4,204,523695,20,523675
78356,8,-18,616,75631,8,75623
78357,6,0,402,634070,6,634064
78358,10,-18,440,71824,10,71814
78359,13,4,727,778626,13,778613
78360,5,7,890,863639,5,863634
78361,10,-6,639,450580,10,450570
78362,20,5,541,807741,20,807721
78363,15,6,957,843361,15,843346
78364,18,12,504,1025757,18,1025739
78365,12,-17,42,115866,12,115854
78366,13,6,803,842194,13,842181
78367,14,-20,810,29137,14,29123
78368,8,-13,710,233494,8,233486
78369,19,-16,341,149404,19,149385
78370,18,-17,620,120151,18,120133
78371,18,2,123,711531,18,711513
78372,16,16,114,1147881,16,1147865
78373,18,-6,216,460826,18,460808
78374,20,0,874,654871,20,654851
78375,11,16,577,1151165,11,1151154
78376,10,-18,257,68054,10,68044
78377,6,6,988,834502,6,834496
78378,15,3,676,746996,15,746981
78379,17,-11,597,308491,17,308474
78380,10,-4,737,515240,10,515230
78381,13,11,158,991967,13,991954
78382,20,1,84,680438,20,680418
78383,13,-16,291,149089,13,149076
78384,9,3,636,732467,9,732458
78385,12,5,702,808916,12,808904
78386,11,0,989,655831,11,655820
78387,5,-10,182,316595,5,316590
78388,10,6,94,814254,10,814244
78389,11,0,35,648533,11,648522
78390,10,17,242,1160451,10,1160441
78391,19,7,477,870608,19,870589
78392,9,-15,215,159879,9,159870
78393,12,14,26,1085574,12,1085562
78394,13,9,59,929490,13,929477
78395,7,11,651,982344,7,982337
78396,17,11,256,992680,17,992663
78397,5,10,666,951949,5,951944
78398,12,-16,698,152040,12,152028
78399,15,-10,283,337099,15,337084
78400,16,10,108,960706,16,960690
78401,13,10,485,963533,13,963520
78402,20,-3,893,560943,20,560923
78403,11,2,129,711587,11,711576
78404,16,11,711,995905,16,995889
78405,11,7,778,872627,11,872616
78406,14,5,639,808464,14,808450
78407,20,-12,262,274437,20,274417
78408,17,-1,344,619367,17,619350
78409,15,-19,515,57959,15,57944
78410,8,-12,845,267932,8,267924
78411,17,-1,46,616927,17,616910
78412,15,-17,363,118171,15,118156
78413,19,9,92,929720,19,929701
78414,17,19,993,1248736,17,1248719
78415,5,3,400,727409,5,727404
78416,17,7,966,873841,17,873824
78417,10,-17,856,111562,10,111552
78418,11,2,275,712608,11,712597
78419,6,12,985,1020839,6,1020833
78420,7,-11,953,301693,7,301686
78421,14,10,663,965029,14,965015
78422,14,-20,501,26579,14,26565
78423,10,6,138,815193,10,815183
78424,5,13,493,1041313,5,1041308
78425,19,8,363,900817,19,900798
78426,17,-10,995,342689,17,342672
78427,16,-18,394,88257,16,88241
78428,10,-1,767,610280,10,610270
78429,16,11,214,992309,16,992293
78430,12,13,360,1055887,12,1055875
78431,20,9,25,929231,20,929211
78432,8,-7,478,416079,8,416071
78433,7,4,987,772031,7,772024
78434,10,-12,992,271265,10,271255
78435,11,16,225,1148719,11,1148708
78436,6,0,162,628936,6,628930
78437,6,1,812,674684,6,674678
78438,12,-11,478,307552,12,307540
78439,13,5,192,805270,13,805257
78440,12,13,240,1054983,12,1054971
78441,11,-16,55,147195,11,147184
78442,15,4,445,776435,15,776420
78443,18,8,886,904816,18,904798
78444,10,2,624,701830,10,701820
78445,10,-7,174,409541,10,409531
78446,7,10,914,957194,7,957187
78447,10,-1,308,600754,10,600744
78448,20,-15,578,182054,20,182034
78449,13,-2,973,592566,13,592553
78450,16,-4,154,523245,16,523229
78451,5,6,589,825594,5,825589
78452,18,15,827,1122842,18,1122824
78453,8,-11,414,290340,8,290332
78454,19,-10,835,341377,19,341358
78455,12,5,386,806642,12,806630
78456,11,14,701,1090965,11,1090954
78457,7,-8,58,376689,7,376682
78458,6,-2,60,564153,6,564147
78459,11,-16,228,148672,11,148661
78460,11,-12,848,278809,11,278798
78461,5,-6,899,456023,5,456018
78462,13,-17,220,117090,13,117077
78463,12,-11,684,309156,12,309144
78464,11,4,869,779739,11,779728
78465,13,-5,301,493320,13,493307
78466,9,0,936,645705,9,645696
78467,6,14,12,1061999,6,1061993
78468,9,-4,480,509771,9,509762
78469,8,-5,761,484428,8,484420
78470,7,15,666,1108580,7,1108573
78471,12,19,23,1240892,12,1240880
78472,15,11,711,995910,15,995895
78473,17,-20,676,28003,17,27986
78474,16,-1,774,622517,16,622501
78475,18,-12,827,278601,18,278583
78476,14,0,462,651630,14,651616
78477,17,-7,302,430596,17,430579
78478,8,0,950,645991,8,645983
78479,19,0,715,653797,19,653778
78480,9,6,153,815473,9,815464
78481,7,-6,545,448647,7,448640
78482,20,-6,481,462865,20,462845
78483,11,10,373,962627,11,962616
78484,17,6,387,838826,17,838809
78485,20,7,60,867467,20,867447
78486,20,13,29,1053424,20,1053404
78487,11,7,181,868324,11,868313
78488,20,-1,262,618587,20,618567
78489,15,18,521,1212807,15,1212792
78490,14,-16,192,148355,14,148341
78491,16,5,516,807565,16,807549
78492,14,-3,160,554913,14,554899
78493,9,-18,926,82596,9,82587
78494,20,-16,385,149727,20,149707
78495,5,-5,85,469904,5,469899
78496,8,19,427,1227446,8,1227438
78497,8,14,951,1083131,8,1083123
78498,14,19,342,1243518,14,1243504
78499,8,12,228,1004098,8,1004090
78500,14,2,882,717066,14,717052
78501,19,7,493,870687,19,870668
78502,7,-16,52,124955,7,124948
78503,15,-14,102,210118,15,210103
78504,11,11,530,994691,11,994680
78505,11,6,520,840023,11,840012
78506,20,12,582,1026342,20,1026322
78507,9,16,228,1130094,9,1130085
78508,17,19,125,1241803,17,1241786
78509,9,14,3,1061757,9,1061748
78510,10,-1,898,613291,10,613281
78511,16,3,193,743356,16,743340
78512,19,-19,431,57312,19,57293
78513,7,0,30,625946,7,625939
78514,16,17,857,1184434,16,1184418
78515,11,1,528,684034,11,684023
78516,20,3,490,745491,20,745471
78517,16,-6,734,464774,16,464758
78518,12,17,923,1184837,12,1184825
78519,13,6,428,839189,13,839176
78520,7,-8,5,375409,7,375402
78521,10,-4,958,520020,10,520010
78522,14,5,255,805707,14,805693
78523,5,6,528,824331,5,824326
78524,16,-9,734,372193,16,372177
78525,11,2,508,714456,11,714445
78526,11,6,896,842895,11,842884
78527,15,2,56,710952,15,710937
78528,16,18,701,1214020,16,1214004
78529,10,-18,88,64439,10,64429
78530,10,16,735,1140351,10,1140341
78531,6,-9,423,352949,6,352943
78532,13,-3,875,560785,13,560772
78533,15,9,199,930525,15,930510
78534,20,-9,138,367591,20,367571
78535,16,14,543,1089719,16,1089703
78536,19,19,161,1242059,19,1242040
78537,9,-16,234,129222,9,129213
78538,5,-9,900,363868,5,363863
78539,8,-2,774,579248,8,579240
78540,20,13,607,1057884,20,1057864
78541,14,13,223,1054882,14,1054868
78542,14,-2,454,588578,14,588564
78543,10,1,853,675561,10,675551
78544,8,7,361,852625,8,852617
78545,14,-8,939,404520,14,404506
78546,20,-15,953,185068,20,185048
78547,18,-13,719,246321,18,246303
78548,6,-15,276,161314,6,161308
78549,14,-14,33,209582,14,209568
78550,6,1,485,667849,6,667843
78551,11,11,668,995584,11,995573
78552,14,8,267,900060,14,900046
78553,15,-5,13,490839,15,490824
78554,20,6,63,836236,20,836216
78555,18,16,41,1147357,18,1147339
78556,17,-20,974,30215,17,30198
78557,8,1,332,664507,8,664499
78558,14,7,309,869265,14,869251
78559,15,6,923,843113,15,843098
78560,17,-20,709,28247,17,28230
78561,8,13,433,1040087,8,1040079
78562,8,-18,105,64845,8,64837
78563,13,3,257,743799,13,743786
78564,18,-1,163,617761,18,617743
78565,16,16,38,1147342,16,1147326
78566,16,10,931,967028,16,967012
78567,12,-20,776,28796,12,28784
78568,17,0,297,650317,17,650300
78569,10,-11,696,296341,10,296331
78570,7,-20,169,3794,7,3787
78571,17,-7,162,429522,17,429505
78572,17,-6,429,462442,17,462425
78573,10,-15,350,163025,10,163015
78574,5,1,557,669529,5,669524
78575,12,-16,657,151788,12,151776
78576,15,-10,110,335917,15,335902
78577,14,-14,742,215263,14,215249
78578,18,-19,865,60661,18,60643
78579,18,-1,20,616672,18,616654
78580,9,-1,69,595264,9,595255
78581,10,-20,463,9880,10,9870
78582,9,9,889,925517,9,925508
78583,8,-4,439,509094,8,509086
78584,16,3,517,745653,16,745637
78585,15,-14,753,215366,15,215351
78586,7,-1,948,614451,7,614444
78587,16,14,625,1090279,16,1090263
78588,15,-18,187,86741,15,86726
78589,13,6,548,840188,13,840175
78590,7,5,721,796659,7,796652
78591,14,-11,46,303967,14,303953
78592,8,-16,991,145474,8,145466
78593,20,-11,995,311488,20,311468
78594,13,-20,264,24793,13,24780
78595,13,15,249,1118649,13,1118636
78596,17,5,998,811127,17,811110
78597,12,17,428,1181111,12,1181099
78598,7,-2,673,577107,7,577100
78599,5,-12,889,268926,5,268921
78600,20,-5,37,491120,20,491100
78601,5,1,611,670570,5,670565
78602,18,14,235,1087256,18,1087238
78603,18,2,758,716265,18,716247
78604,15,-10,987,342557,15,342542
78605,8,-2,599,575494,8,575486
78606,19,18,810,1214838,19,1214819
78607,5,12,883,1018485,5,1018480
78608,18,-1,688,621854,18,621836
78609,9,4,43,751489,9,751480
78610,11,15,415,1119714,11,1119703
78611,13,16,409,1150072,13,1150059
78612,9,14,477,1072441,9,1072432
78613,15,-18,463,88786,15,88771
78614,8,-16,386,132277,8,132269
78615,17,-3,950,561419,17,561402
78616,7,14,271,1067849,7,1067842
78617,19,6,231,837512,19,837493
78618,15,4,774,778961,15,778946
78619,10,2,174,692420,10,692410
78620,11,-9,269,368549,11,368538
78621,12,15,859,1123042,12,1123030
78622,5,-3,754,547352,5,547347
78623,13,-5,997,498320,13,498307
78624,13,-20,532,26814,13,26801
78625,15,13,467,1056677,15,1056662
78626,19,10,596,964509,19,964490
78627,14,16,263,1149013,14,1148999
78628,14,-5,650,495762,14,495748
78629,13,-14,278,211623,13,211610
78630,10,-8,468,384979,10,384969
78631,19,-12,819,278528,19,278509
78632,5,-14,642,200880,5,200875
78633,19,-13,954,248264,19,248245
78634,20,-20,790,28932,20,28912
78635,17,-12,866,279000,17,278983
78636,19,-10,368,337713,19,337694
78637,9,-18,18,62803,9,62794
78638,11,11,179,992080,11,992069
78639,9,7,295,851139,9,851130
78640,10,-10,810,330016,10,330006
78641,17,-13,230,242743,17,242726
78642,18,19,617,1245816,18,1245798
78643,19,10,793,966034,19,966015
78644,7,6,647,826862,7,826855
78645,5,-13,89,220287,5,220282
78646,14,-15,835,184057,14,184043
78647,12,-9,733,372164,12,372152
78648,13,19,66,1241281,13,1241268
78649,18,-12,147,273642,18,273624
78650,5,-12,210,254003,5,253998
78651,8,-18,21,62885,8,62877
78652,14,13,699,1058496,14,1058482
78653,17,1,229,681703,17,681686
78654,20,-7,189,429711,20,429691
78655,19,-16,225,148651,19,148632
78656,7,11,227,973010,7,973003
78657,13,15,635,1121443,13,1121430
78658,15,1,367,682800,15,682785
78659,14,-8,995,405002,14,404988
78660,6,-7,611,418868,6,418862
78661,10,10,512,948430,10,948420
78662,20,12,575,1026257,20,1026237
78663,8,13,882,1049677,8,1049669
78664,15,-8,52,398320,15,398305
78665,13,-18,545,89268,13,89255
78666,20,19,266,1242898,20,1242878
78667,14,-9,634,371554,14,371540
78668,15,-3,187,555094,15,555079
78669,5,-20,49,1069,5,1064
78670,9,18,798,1203670,9,1203661
78671,14,-15,249,179587,14,179573
78672,20,-1,827,622897,20,622877
78673,10,7,882,863533,10,863523
78674,20,14,739,1091243,20,1091223
78675,6,13,798,1047913,6,1047907
78676,10,-11,538,293183,10,293173
78677,15,-9,228,368221,15,368206
78678,12,-1,897,623418,12,623406
78679,11,8,522,902133,11,902122
78680,5,-14,651,200968,5,200963
78681,18,-10,534,339038,18,339020
78682,6,1,527,668859,6,668853
78683,13,-14,638,214539,13,214526
78684,8,-15,270,161146,8,161138
78685,11,-8,689,402780,11,402769
78686,18,0,979,655799,18,655781
78687,15,-15,806,183787,15,183772
78688,14,10,845,966299,14,966285
78689,17,9,893,935671,17,935654
78690,12,11,242,992577,12,992565
78691,19,-10,821,341277,19,341258
78692,14,-13,40,241353,14,241339
78693,20,7,156,868178,20,868158
78694,10,-8,556,387092,10,387082
78695,20,10,973,967272,20,967252
78696,13,2,157,711784,13,711771
78697,9,-18,227,67427,9,67418
78698,11,-17,489,119123,11,119112
78699,17,-5,933,497913,17,497896
78700,10,9,752,922496,10,922486
78701,9,-8,639,389065,9,389056
78702,6,-13,339,225518,6,225512
78703,18,-16,320,149345,18,149327
78704,20,15,78,1117372,20,1117352
78705,9,11,194,972446,9,972437
78706,17,-6,770,465020,17,465003
78707,17,-17,453,118855,17,118838
78708,16,-9,923,373886,16,373870
78709,16,17,508,1181734,16,1181718
78710,16,-17,150,116598,16,116582
78711,17,3,3,741848,17,741831
78712,16,15,157,1117939,16,1117923
78713,5,-6,875,455476,5,455471
78714,9,10,11,937719,9,937710
78715,14,11,409,993869,14,993855
78716,18,-16,966,154053,18,154035
78717,8,17,365,1163151,8,1163143
78718,10,-15,147,158610,10,158600
78719,10,-16,772,140650,10,140640
78720,18,6,416,839123,18,839105
78721,8,-18,932,82728,8,82720
78722,20,2,19,710599,20,710579
78723,13,-1,794,622677,13,622664
78724,10,-19,468,41625,10,41615
78725,18,-2,483,588809,18,588791
78726,11,7,600,871453,11,871442
78727,6,17,236,1160276,6,1160270
78728,9,-4,403,508426,9,508417
78729,20,-5,173,492282,20,492262
78730,15,4,401,776103,15,776088
78731,18,-2,879,591867,18,591849
78732,5,17,205,1159620,5,1159615
78733,5,-3,279,536402,5,536397
78734,10,-11,604,294545,10,294535
78735,9,-17,940,113270,9,113261
78736,12,-1,415,619858,12,619846
78737,6,-6,542,448538,6,448532
78738,12,-7,678,433218,12,433206
78739,19,0,824,654506,19,654487
78740,19,-10,788,340998,19,340979
78741,14,-16,976,154103,14,154089
78742,6,1,431,666537,6,666531
78743,18,3,516,745646,18,745628
78744,16,19,900,1248083,16,1248067
78745,9,0,476,635714,9,635705
78746,15,10,411,962985,15,962970
78747,7,12,938,1019742,7,1019735
78748,7,0,733,641502,7,641495
78749,19,7,198,868404,19,868385
78750,20,-18,391,88238,20,88218
78751,19,-13,905,247793,19,247774
78752,17,-19,61,54315,17,54298
78753,6,16,302,1131565,6,1131559
78754,5,4,354,758208,5,758203
78755,18,-18,408,88350,18,88332
78756,14,-5,808,496875,14,496861
78757,7,15,194,1098649,7,1098642
78758,20,-8,337,400295,20,400275
78759,17,-2,734,590637,17,590620
78760,10,-5,149,471333,10,471323
78761,17,-17,672,120578,17,120561
78762,6,-12,25,250139,6,250133
78763,11,6,330,838341,11,838330
78764,13,-2,463,588619,13,588606
78765,16,-9,756,372481,16,372465
78766,18,2,699,715901,18,715883
78767,11,9,813,935066,11,935055
78768,11,-17,831,121719,11,121708
78769,15,-16,509,150755,15,150740
78770,16,13,229,1054916,16,1054900
78771,8,-14,710,202289,8,202281
78772,20,-2,600,589632,20,589612
78773,12,12,800,1027994,12,1027982
78774,8,-5,170,471816,8,471808
78775,7,-6,345,444236,7,444229
78776,11,-1,65,617033,11,617022
78777,13,18,145,1210162,13,1210149
78778,11,11,602,995187,11,995176
78779,18,-18,754,90772,18,90754
78780,14,12,152,1023122,14,1023108
78781,13,6,17,835944,13,835931
78782,7,-2,297,569200,7,569193
78783,7,-7,840,423633,7,423626
78784,19,-11,211,305374,19,305355
78785,20,-15,287,179866,20,179846
78786,5,-15,874,174059,5,174054
78787,9,8,415,884339,9,884330
78788,13,-17,142,116520,13,116507
78789,9,-8,591,387829,9,387820
78790,18,9,93,929759,18,929741
78791,13,0,531,652242,13,652229
78792,5,5,982,802423,5,802418
78793,18,5,139,804820,18,804802
78794,20,-15,824,183962,20,183942
78795,18,10,549,964061,18,964043
78796,17,0,863,654782,17,654765
78797,11,-11,833,310211,11,310200
78798,20,17,607,1182379,20,1182359
78799,19,-6,943,466296,19,466277
78800,16,-11,575,308304,16,308288
78801,9,13,518,1041839,9,1041830
78802,11,-12,300,274757,11,274746
78803,15,12,117,1022913,15,1022898
78804,11,0,706,653654,11,653643
78805,14,-17,210,117015,14,117001
78806,10,-11,33,281752,10,281742
78807,11,15,836,1122908,11,1122897
78808,5,16,397,1133682,5,1133677
78809,5,18,565,1198793,5,1198788
78810,6,9,27,907379,6,907373
78811,14,-3,813,560321,14,560307
78812,12,1,659,685069,12,685057
78813,19,19,100,1241578,19,1241559
78814,6,-5,394,476641,6,476635
78815,19,-8,368,400463,19,400444
78816,12,-19,794,60153,12,60141
78817,5,-9,822,361912,5,361907
78818,15,7,287,869078,15,869063
78819,9,-1,722,609460,9,609451
78820,17,18,132,1209991,17,1209974
78821,16,11,759,996325,16,996309
78822,5,-10,113,314996,5,314991
78823,17,10,736,965551,17,965534
78824,9,-20,0,25,9,16
78825,15,12,643,1026876,15,1026861
78826,10,1,199,661538,10,661528
78827,12,-20,604,27394,12,27382
78828,12,-20,75,23351,12,23339
78829,16,-20,235,24561,16,24545
78830,16,-20,56,23199,16,23183
78831,9,-6,432,446019,9,446010
78832,9,-18,40,63231,9,63222
78833,19,-3,822,560387,19,560368
78834,12,-5,458,494423,12,494411
78835,20,-14,971,217069,20,217049
78836,17,13,198,1054692,17,1054675
78837,18,-8,726,403045,18,403027
78838,8,-7,805,422843,8,422835
78839,12,2,80,711151,12,711139
78840,5,6,152,815456,5,815451
78841,18,16,409,1150080,18,1150062
78842,13,-17,263,117419,13,117406
78843,17,-5,793,496776,17,496759
78844,8,6,922,832950,8,832942
78845,15,1,797,686088,15,686073
78846,10,-10,618,326017,10,326007
78847,16,-6,878,465733,16,465717
78848,17,-13,573,245281,17,245264
78849,14,-5,73,491420,14,491406
78850,8,-1,685,608637,8,608629
78851,19,-3,856,560621,19,560602
78852,8,-16,550,136006,8,135998
78853,11,2,317,712948,11,712937
78854,19,2,948,717550,19,717531
78855,18,-17,935,122403,18,122385
78856,8,-13,18,218696,8,218688
78857,13,-13,687,246014,13,246001
78858,17,1,160,681141,17,681124
78859,15,-19,879,60757,15,60742
78860,13,-2,644,589959,13,589946
78861,16,-18,631,89822,16,89806
78862,12,-13,529,244943,12,244931
78863,17,-14,761,215428,17,215411
78864,11,-17,33,115797,11,115786
78865,11,4,660,778061,11,778050
78866,8,13,998,1052164,8,1052156
78867,12,-10,507,338865,12,338853
78868,20,3,842,748162,20,748142
78869,7,-1,255,599408,7,599401
78870,12,-2,256,587051,12,587039
78871,17,-2,955,592407,17,592390
78872,12,13,311,1055480,12,1055468
78873,17,-20,156,23938,17,23921
78874,20,15,220,1118480,20,1118460
78875,12,19,250,1242721,12,1242709
78876,20,8,415,901303,20,901283
78877,17,13,531,1057147,17,1057130
78878,13,4,680,778246,13,778233
78879,12,4,727,778628,12,778616
78880,16,-10,225,336732,16,336716
78881,14,7,597,871432,14,871418
78882,20,-15,43,178112,20,178092
78883,10,-20,0,35,10,25
78884,14,-17,204,116947,14,116933
78885,10,7,814,862073,10,862063
78886,18,19,583,1245548,18,1245530
78887,20,-3,310,556049,20,556029
78888,14,-20,343,25513,14,25499
78889,17,19,488,1244785,17,1244768
78890,19,-1,676,621758,19,621739
78891,11,17,639,1182603,11,1182592
78892,16,19,43,1241059,16,1241043
78893,18,16,519,1150815,18,1150797
78894,8,15,453,1104056,8,1104048
78895,7,-20,619,13546,7,13539
78896,16,5,190,805246,16,805230
78897,10,12,252,1004652,10,1004642
78898,9,14,123,1064592,9,1064583
78899,16,-20,32,18511,16,18495
78900,18,-20,140,23821,18,23803
78901,9,11,327,975417,9,975408
78902,14,-15,816,183909,14,183895
78903,8,-20,989,21881,8,21873
78904,12,-15,392,180631,12,180619
78905,17,8,54,898291,17,898274
78906,8,-10,164,316223,8,316215
78907,9,0,672,640056,9,640047
78908,10,-1,939,614252,10,614242
78909,12,-9,501,370637,12,370625
78910,9,4,890,770204,9,770195
78911,14,18,616,1213366,14,1213352
78912,18,-17,484,119089,18,119071
78913,12,10,399,962836,12,962824
78914,8,-18,81,64248,8,64240
78915,12,-17,725,121020,12,121008
78916,15,1,577,684467,15,684452
78917,9,-13,140,221375,9,221366
78918,15,3,47,742171,15,742156
78919,10,13,969,1051469,10,1051459
78920,17,-8,940,404532,17,404515
78921,6,14,47,1062866,6,1062860
78922,16,-1,4,616537,16,616521
78923,8,-14,859,205226,8,205218
78924,16,18,875,1215331,16,1215315
78925,11,-3,580,558382,11,558371
78926,5,11,881,987509,5,987504
78927,20,18,463,1212401,20,1212381
78928,15,16,364,1149774,15,1149759
78929,12,15,777,1122507,12,1122495
78930,7,10,601,950509,7,950502
78931,18,19,60,1241211,18,1241193
78932,16,9,893,935677,16,935661
78933,15,-12,565,276696,15,276681
78934,7,16,42,1126072,7,1126065
78935,17,18,887,1215475,17,1215458
78936,14,0,414,651254,14,651240
78937,10,-13,473,228299,10,228289
78938,11,-10,537,339068,11,339057
78939,18,9,83,929663,18,929645
78940,5,18,456,1196535,5,1196530
78941,12,7,226,868595,12,868583
78942,14,-6,285,461413,14,461399
78943,11,-13,530,244950,11,244939
78944,12,-2,397,588065,12,588053
78945,17,5,595,808124,17,808107
78946,9,-5,497,478769,9,478760
78947,18,11,409,993877,18,993859
78948,15,14,955,1092911,15,1092896
78949,8,-9,40,344473,8,344465
78950,8,-16,434,133497,8,133489
78951,15,18,472,1212454,15,1212439
78952,6,-3,791,548127,6,548121
78953,10,4,184,754548,10,754538
78954,12,1,937,687176,12,687164
78955,15,10,556,964132,15,964117
78956,16,4,948,780251,16,780235
78957,18,9,121,929952,18,929934
78958,10,-11,339,288562,10,288552
78959,19,15,114,1117638,19,1117619
78960,8,7,727,860145,8,860137
78961,8,-12,539,261324,8,261316
78962,12,-2,40,585428,12,585416
78963,5,-6,679,451305,5,451300
78964,8,12,727,1015027,8,1015019
78965,18,9,98,929784,18,929766
78966,9,4,139,753598,9,753589
78967,9,4,95,752717,9,752708
78968,16,13,464,1056671,16,1056655
78969,19,7,6,867066,19,867047
78970,10,4,884,770078,10,770068
78971,14,1,337,682606,14,682592
78972,15,8,265,900042,15,900027
78973,13,10,363,962568,13,962555
78974,20,-1,404,619792,20,619772
78975,18,-8,984,404903,18,404885
78976,19,-14,231,211243,19,211224
78977,17,-12,212,274053,17,274036
78978,7,-2,697,577753,7,577746
78979,14,15,162,1117966,14,1117952
78980,15,-1,712,622098,15,622083
78981,17,10,716,965393,17,965376
78982,8,-10,456,322541,8,322533
78983,7,-15,764,171743,7,171736
78984,16,3,249,743758,16,743742
78985,10,-16,627,137656,10,137646
78986,16,-9,406,369744,16,369728
78987,12,-4,539,526193,12,526181
78988,9,-9,49,344701,9,344692
78989,12,1,28,679998,12,679986
78990,17,-9,935,373992,17,373975
78991,20,9,122,929972,20,929952
78992,12,-2,867,591742,12,591730
78993,12,-15,53,178173,12,178161
78994,6,11,503,979191,6,979185
78995,13,-3,194,555126,13,555113
78996,18,13,648,1058137,18,1058119
78997,17,-1,658,621659,17,621642
78998,7,10,104,939873,7,939866
78999,6,19,954,1238672,6,1238666
79000,15,-10,654,339985,15,339970
79001,19,3,387,744819,19,744800
79002,17,-10,752,340761,17,340744
79003,18,-13,49,241411,18,241393
79004,10,2,42,689530,10,689520
79005,5,14,565,1074391,5,1074386
79006,5,-19,144,34810,5,34805
79007,7,19,303,1224293,7,1224286
79008,13,-4,163,523319,13,523306
79009,15,-8,747,403176,15,403161
79010,5,-13,564,230364,5,230359
79011,9,18,532,1198231,9,1198222
79012,11,7,861,873230,11,873219
79013,20,-19,878,60742,20,60722
79014,15,-12,252,274362,15,274347
79015,11,-14,633,214495,11,214484
79016,16,19,269,1242918,16,1242902
79017,17,-8,801,403610,17,403593
79018,8,-7,937,425876,8,425868
79019,12,-3,419,556915,12,556903
79020,12,-17,415,118504,12,118492
79021,9,9,82,908458,9,908449
79022,10,1,956,677797,10,677787
79023,17,-2,968,592505,17,592488
79024,14,5,61,804278,14,804264
79025,15,-18,608,89637,15,89622
79026,6,14,899,1081977,6,1081971
79027,15,0,484,651818,15,651803
79028,17,-3,281,555764,17,555747
79029,14,19,696,1246445,14,1246431
79030,15,-18,815,91184,15,91169
79031,15,-7,28,428549,15,428534
79032,19,6,10,835834,19,835815
79033,7,12,43,1000081,7,1000074
79034,6,7,654,858647,6,858641
79035,9,-17,217,98085,9,98076
79036,12,-19,792,60128,12,60116
79037,10,-14,8,186612,10,186602
79038,11,-9,121,367493,11,367482
79039,16,-16,261,148878,16,148862
79040,9,-1,920,613830,9,613821
79041,6,17,940,1175442,6,1175436
79042,18,-8,697,402835,18,402817
79043,18,3,792,747832,18,747814
79044,11,-9,867,373451,11,373440
79045,9,-4,241,504932,9,504923
79046,15,-7,849,434520,15,434505
79047,7,16,144,1128143,7,1128136
79048,14,17,612,1182426,14,1182412
79049,11,0,271,650165,11,650154
79050,5,7,48,845926,5,845921
79051,9,-17,649,107485,9,107476
79052,15,14,269,1087510,15,1087495
79053,13,8,128,898940,13,898927
79054,8,-19,744,47967,8,47959
79055,10,-10,292,318853,10,318843
79056,14,-5,232,492678,14,492664
79057,5,-10,434,322043,5,322038
79058,12,8,559,902331,12,902319
79059,5,4,672,765076,5,765071
79060,12,13,267,1055153,12,1055141
79061,6,-6,437,446095,6,446089
79062,20,7,733,872378,20,872358
79063,15,9,70,929584,15,929569
79064,8,-5,70,469412,8,469404
79065,18,-8,145,398953,18,398935
79066,9,-6,301,443393,9,443384
79067,5,-7,750,421704,5,421699
79068,12,3,788,747776,12,747764
79069,11,1,601,684569,11,684558
79070,18,19,986,1248694,18,1248676
79071,18,-18,454,88682,18,88664
79072,7,2,265,694331,7,694324
79073,10,1,966,678009,10,677999
79074,12,-8,149,398977,12,398965
79075,6,5,804,798449,6,798443
79076,19,-17,599,120036,19,120017
79077,20,-5,89,491613,20,491593
79078,5,-5,103,470359,5,470354
79079,18,-1,916,623575,18,623557
79080,7,8,692,890390,7,890383
79081,16,18,970,1216122,16,1216106
79082,11,6,908,843002,11,842991
79083,15,-20,526,26783,15,26768
79084,19,9,364,931717,19,931698
79085,9,8,882,894299,9,894290
79086,17,-13,785,246899,17,246882
79087,10,18,627,1200017,10,1200007
79088,8,7,871,863355,8,863347
79089,13,11,979,997894,13,997881
79090,12,-8,923,404402,12,404390
79091,19,17,718,1183271,19,1183252
79092,20,0,579,652660,20,652640
79093,19,19,177,1242159,19,1242140
79094,11,6,393,838884,11,838873
79095,18,-17,974,122620,18,122602
79096,10,18,113,1189288,10,1189278
79097,8,18,848,1204722,8,1204714
79098,14,-16,407,149907,14,149893
79099,13,-14,220,211073,13,211060
79100,14,-1,839,622998,14,622984
79101,20,8,312,900413,20,900393
79102,14,-14,178,210663,14,210649
79103,16,-2,944,592353,16,592337
79104,5,-14,66,187947,5,187942
79105,20,9,693,934172,20,934152
79106,6,11,903,987972,6,987966
79107,9,-3,978,552382,9,552373
79108,20,-20,491,26484,20,26464
79109,5,12,549,1010913,5,1010908
79110,12,-19,429,57285,12,57273
79111,18,-8,170,399129,18,399111
79112,8,3,992,740583,8,740575
79113,19,-11,99,304483,19,304464
79114,16,19,605,1245682,16,1245666
79115,5,7,11,845008,5,845003
79116,12,19,707,1246515,12,1246503
79117,11,19,267,1242898,11,1242887
79118,16,-15,53,178179,16,178163
79119,12,4,484,776729,12,776717
79120,18,12,98,1022755,18,1022737
79121,7,6,230,817411,7,817404
79122,10,15,245,1099790,10,1099780
79123,15,-1,49,616940,15,616925
79124,18,0,472,651714,18,651696
79125,10,-19,321,38504,10,38494
79126,7,-19,936,51621,7,51614
79127,8,19,479,1228449,8,1228441
79128,16,-3,326,556159,16,556143
79129,7,13,388,1039079,7,1039072
79130,15,-4,52,522416,15,522401
79131,7,3,933,739115,7,739108
79132,20,-12,273,274547,20,274527
79133,13,-1,769,622470,13,622457
79134,20,-16,313,149258,20,149238
79135,8,-18,949,83076,8,83068
79136,13,-13,579,245324,13,245311
79137,15,-1,170,617827,15,617812
79138,5,6,260,818101,5,818096
79139,14,-9,581,371271,14,371257
79140,19,-6,111,459914,19,459895
79141,6,-19,292,37876,6,37870
79142,10,16,76,1126782,10,1126772
79143,5,9,269,912297,5,912292
79144,9,-12,503,260549,9,260540
79145,5,4,907,770528,5,770523
79146,8,-14,942,206961,8,206953
79147,13,-3,297,555942,13,555929
79148,15,19,364,1243736,15,1243721
79149,6,-15,967,176062,6,176056
79150,7,-14,71,188113,7,188106
79151,10,-13,508,229115,10,229105
79152,8,10,211,942006,8,941998
79153,6,-18,508,73389,6,73383
79154,8,-10,796,329624,8,329616
79155,10,4,160,754026,10,754016
79156,16,4,497,776815,16,776799
79157,12,-16,823,152959,12,152947
79158,12,-17,794,121493,12,121481
79159,11,-10,794,341049,11,341038
79160,5,14,986,1083919,5,1083914
79161,11,19,788,1247184,11,1247173
79162,18,5,627,808398,18,808380
79163,7,-3,88,532297,7,532290
79164,14,16,991,1154206,14,1154192
79165,14,-1,824,622877,14,622863
79166,15,0,393,651062,15,651047
79167,13,3,816,747983,13,747970
79168,12,17,989,1185412,12,1185400
79169,16,-18,7,85280,16,85264
79170,18,-12,436,275662,18,275644
79171,12,-12,751,278021,12,278009
79172,19,-18,217,86974,19,86955
79173,15,-11,349,306526,15,306511
79174,8,13,308,1037317,8,1037309
79175,6,7,212,849252,6,849246
79176,19,-14,871,216288,19,216269
79177,13,-16,431,150164,13,150151
79178,5,-19,378,39681,5,39676
79179,6,-17,21,94017,6,94011
79180,12,15,532,1120664,12,1120652
79181,13,-16,677,151887,13,151874
79182,11,-20,880,29587,11,29576
79183,18,3,562,745977,18,745959
79184,7,3,374,726901,7,726894
79185,10,-14,739,202777,10,202767
79186,13,-19,177,55442,13,55429
79187,14,-16,559,151121,14,151107
79188,18,19,825,1247444,18,1247426
79189,5,-13,887,237558,5,237553
79190,13,-4,191,523534,13,523521
79191,19,1,463,683507,19,683488
79192,8,-4,469,509593,8,509585
79193,10,-12,404,258406,10,258396
79194,6,16,975,1145618,6,1145612
79195,14,-12,678,277493,14,277479
79196,14,13,192,1054622,14,1054608
79197,19,-20,618,27497,19,27478
79198,12,1,233,681743,12,681731
79199,13,-12,27,272704,13,272691
79200,19,-12,439,275692,19,275673
79201,6,-18,778,79325,6,79319
79202,13,15,259,1118687,13,1118674
79203,5,-3,152,533682,5,533677
79204,11,-14,567,213993,11,213982
79205,13,-17,482,119076,13,119063
79206,17,11,223,992411,17,992394
79207,11,15,282,1118873,11,1118862
79208,5,-18,541,74035,5,74030
79209,14,-20,286,25027,14,25013
79210,9,-20,845,18801,9,18792
79211,13,2,778,716333,13,716320
79212,5,-8,832,393145,5,393140
79213,14,6,845,842545,14,842531
79214,9,6,609,826086,9,826077
79215,11,-15,568,181956,11,181945
79216,19,-6,668,464250,19,464231
79217,7,-1,435,603487,7,603480
79218,14,6,619,840747,14,840733
79219,17,-10,354,337626,17,337609
79220,9,-12,371,257662,9,257653
79221,17,-12,826,278583,17,278566
79222,20,17,582,1182149,20,1182129
79223,18,-4,880,528681,18,528663
79224,15,9,916,935889,15,935874
79225,9,13,136,1033608,9,1033599
79226,7,-3,995,552712,7,552705
79227,20,-11,832,310200,20,310180
79228,10,10,276,943406,10,943396
79229,17,-1,821,622865,17,622848
79230,7,3,982,740379,7,740372
79231,20,-11,280,305922,20,305902
79232,15,16,571,1151145,15,1151130
79233,20,-18,800,91075,20,91055
79234,16,4,134,774237,16,774221
79235,8,9,210,911239,8,911231
79236,13,-20,357,25582,13,25569
79237,11,-12,788,278281,11,278270
79238,11,7,576,871275,11,871264
79239,10,-4,461,509461,10,509451
79240,18,13,210,1054795,18,1054777
79241,14,4,31,773474,14,773460
79242,18,-13,254,242911,18,242893
79243,18,17,525,1181799,18,1181781
79244,15,-12,498,276224,15,276209
79245,18,-3,373,556572,18,556554
79246,16,-17,850,121839,16,121823
79247,14,-14,775,215606,14,215592
79248,5,-11,185,285136,5,285131
79249,7,-14,592,199663,7,199656
79250,6,10,225,942308,6,942302
79251,15,19,887,1247973,15,1247958
79252,8,-4,902,518817,8,518809
79253,19,-18,154,86444,19,86425
79254,13,-8,707,402890,13,402877
79255,5,9,202,911031,5,911026
79256,20,-12,598,276882,20,276862
79257,14,13,293,1055389,14,1055375
79258,9,16,955,1145053,9,1145044
79259,19,16,896,1153464,19,1153445
79260,6,0,931,645587,6,645581
79261,11,3,827,748035,11,748024
79262,6,8,53,876209,6,876203
79263,12,19,966,1248516,12,1248504
79264,14,16,91,1147720,14,1147706
79265,17,-1,614,621339,17,621322
79266,15,14,451,1088983,15,1088968
79267,14,-10,822,341288,14,341274
79268,5,5,853,799403,5,799398
79269,6,16,778,1141246,6,1141240
79270,11,-20,978,30246,11,30235
79271,16,-11,506,307802,16,307786
79272,11,-5,91,491633,11,491622
79273,5,1,892,676413,5,676408
79274,16,-7,557,432515,16,432499
79275,7,-8,447,384553,7,384546
79276,10,-16,405,132770,10,132760
79277,16,0,436,651389,16,651373
79278,20,0,833,654600,20,654580
79279,12,10,919,966928,12,966916
79280,7,-7,942,425956,7,425949
79281,17,-3,943,561346,17,561329
79282,17,-20,355,25568,17,25551
79283,17,-19,265,56097,17,56080
79284,11,14,329,1088042,11,1088031
79285,16,11,83,991483,16,991467
79286,7,-17,168,96980,7,96973
79287,9,-6,317,443664,9,443655
79288,12,14,279,1087598,12,1087586
79289,7,16,358,1132780,7,1132773
79290,10,6,367,820538,10,820528
79291,7,16,391,1133527,7,1133520
79292,10,-10,883,331554,10,331544
79293,8,9,199,910941,8,910933
79294,11,-15,46,178125,11,178114
79295,17,-7,816,434235,17,434218
79296,19,-14,915,216662,19,216643
79297,18,19,933,1248264,18,1248246
79298,19,9,363,931707,19,931688
79299,9,9,75,908311,9,908302
79300,6,11,533,979886,6,979880
79301,6,-20,719,15808,6,15802
79302,18,1,335,682561,18,682543
79303,15,9,5,929075,15,929060
79304,12,-11,394,306887,12,306875
79305,19,5,630,808420,19,808401
79306,5,5,311,788017,5,788012
79307,8,-13,183,222290,8,222282
79308,10,2,170,692319,10,692309
79309,9,1,412,666201,9,666192
79310,14,-18,49,85567,14,85553
79311,10,-12,0,249625,10,249615
79312,12,-16,26,146950,12,146938
79313,5,-8,980,396399,5,396394
79314,16,-10,875,341674,16,341658
79315,14,6,556,840233,14,840219
79316,8,9,197,910901,8,910893
79317,14,-16,709,152096,14,152082
79318,14,8,372,900867,14,900853
79319,11,-18,832,91265,11,91254
79320,18,18,266,1211124,18,1211106
79321,15,3,765,747637,15,747622
79322,6,0,885,644588,6,644582
79323,10,10,322,944370,10,944360
79324,5,6,760,829383,5,829378
79325,20,-20,566,27121,20,27101
79326,6,7,517,855920,6,855914
79327,20,12,246,1023869,20,1023849
79328,17,-11,299,306087,17,306070
79329,8,-10,41,313519,8,313511
79330,10,0,442,634909,10,634899
79331,6,-16,799,141169,6,141163
79332,17,-4,906,528887,17,528870
79333,12,-4,764,527756,12,527744
79334,14,17,945,1184973,14,1184959
79335,8,-5,970,489205,8,489197
79336,19,-16,106,147719,19,147700
79337,5,-3,305,537059,5,537054
79338,9,-8,142,378482,9,378473
79339,18,-11,158,304994,18,304976
79340,12,-17,665,120524,12,120512
79341,18,15,273,1118807,18,1118789
79342,17,1,125,680817,17,680800
79343,17,-13,57,241501,17,241484
79344,20,12,602,1026473,20,1026453
79345,7,7,767,861011,7,861004
79346,5,15,258,1100074,5,1100069
79347,5,2,811,705499,5,705494
79348,16,-6,141,460188,16,460172
79349,8,-11,987,302472,8,302464
79350,16,-17,383,118317,16,118301
79351,5,-13,752,234501,5,234496
79352,10,-20,241,5432,10,5422
79353,17,-19,604,58764,17,58747
79354,11,4,433,776381,11,776370
79355,8,18,403,1195329,8,1195321
79356,15,-13,409,243980,15,243965
79357,20,-13,190,242465,20,242445
79358,13,0,779,654216,13,654203
79359,15,-12,274,274562,15,274547
79360,19,-9,556,371125,19,371106
79361,17,5,52,804211,17,804194
79362,18,7,955,873772,18,873754
79363,6,-17,590,106231,6,106225
79364,20,4,563,777343,20,777323
79365,15,-13,271,243089,15,243074
79366,19,-19,922,60978,19,60959
79367,14,2,675,715707,14,715693
79368,10,-6,36,437644,10,437634
79369,17,-12,503,276295,17,276278
79370,6,13,740,1046613,6,1046607
79371,20,-13,381,243841,20,243821
79372,16,1,682,685177,16,685161
79373,11,19,205,1242392,11,1242381
79374,6,12,793,1016295,6,1016289
79375,17,-19,449,57445,17,57428
79376,19,12,565,1026194,19,1026175
79377,18,2,590,715020,18,715002
79378,20,11,678,995681,20,995661
79379,10,10,589,950181,10,950171
79380,10,-15,103,157675,10,157665
79381,9,2,300,695067,9,695058
79382,11,2,509,714464,11,714453
79383,8,-1,879,612843,8,612835
79384,15,4,282,775217,15,775202
79385,6,-5,923,488111,6,488105
79386,5,5,529,792609,5,792604
79387,10,-12,719,265066,10,265056
79388,10,-14,261,192513,10,192503
79389,19,-1,491,620506,19,620487
79390,11,-3,941,561340,11,561329
79391,10,-5,574,480420,10,480410
79392,11,-20,741,28477,11,28466
79393,5,-18,759,78922,5,78917
79394,5,-5,700,483171,5,483166
79395,13,12,856,1028499,13,1028486
79396,9,5,121,784090,9,784081
79397,11,7,799,872794,11,872783
79398,10,9,276,912456,10,912446
79399,20,-14,151,210475,20,210455
79400,20,-6,963,466425,20,466405
79401,20,-5,435,494233,20,494213
79402,11,8,552,902299,11,902288
79403,12,-18,527,89141,12,89129
79404,7,17,776,1171804,7,1171797
79405,6,17,256,1160723,6,1160717
79406,18,-4,725,527510,18,527492
79407,14,14,475,1089120,14,1089106
79408,12,-15,482,181339,12,181327
79409,16,-10,584,339412,16,339396
79410,15,1,738,685605,15,685590
79411,6,14,790,1079654,6,1079648
79412,10,-15,807,172691,10,172681
79413,7,9,106,909011,7,909004
79414,5,3,569,730920,5,730915
79415,7,-9,815,361775,7,361768
79416,5,-8,996,396739,5,396734
79417,8,-2,829,580582,8,580574
79418,20,-20,727,28391,20,28371
79419,16,0,798,654371,16,654355
79420,5,2,995,709402,5,709397
79421,13,18,234,1210845,13,1210832
79422,7,10,415,946410,7,946403
79423,16,18,572,1213095,16,1213079
79424,14,9,815,935105,14,935091
79425,11,-1,982,624034,11,624023
79426,5,3,363,726745,5,726740
79427,10,-4,930,519344,10,519334
79428,20,6,506,839896,20,839876
79429,11,3,539,745772,11,745761
79430,8,-17,178,97168,8,97160
79431,11,13,218,1054850,11,1054839
79432,7,13,427,1039954,7,1039947
79433,9,10,552,949259,9,949250
79434,17,-18,200,86844,17,86827
79435,11,8,366,900822,11,900811
79436,20,-5,39,491137,20,491117
79437,19,4,588,777529,19,777510
79438,16,-10,580,339385,16,339369
79439,20,-11,836,310238,20,310218
79440,5,8,159,878555,5,878550
79441,13,-17,714,120848,13,120835
79442,16,-14,975,217106,16,217090
79443,5,19,542,1229772,5,1229767
79444,19,15,242,1118585,19,1118566
79445,11,-1,69,617082,11,617071
79446,14,2,983,717768,14,717754
79447,17,4,377,775959,17,775942
79448,19,1,343,682638,19,682619
79449,14,-14,178,210667,14,210653
79450,19,6,277,837914,19,837895
79451,6,-16,819,141586,6,141580
79452,7,10,739,953406,7,953399
79453,5,2,956,708660,5,708655
79454,7,10,377,945532,7,945525
79455,15,-5,499,494717,15,494702
79456,12,-5,985,498251,12,498239
79457,9,9,70,908239,9,908230
79458,7,16,142,1128118,7,1128111
79459,20,-10,878,341713,20,341693
79460,7,15,821,1111833,7,1111826
79461,5,16,464,1135181,5,1135176
79462,12,-7,417,431472,12,431460
79463,7,6,994,834636,7,834629
79464,9,9,545,918284,9,918275
79465,15,15,96,1117497,15,1117482
79466,12,-13,796,246948,12,246936
79467,19,-14,63,209802,19,209783
79468,18,0,189,649688,18,649670
79469,16,10,742,965583,16,965567
79470,11,-18,418,88414,11,88403
79471,17,18,250,1210997,17,1210980
79472,10,15,82,1096216,10,1096206
79473,14,9,330,931423,14,931409
79474,5,11,213,972713,5,972708
79475,14,19,419,1244307,14,1244293
79476,20,2,289,712787,20,712767
79477,15,8,809,904318,15,904303
79478,13,11,101,991593,13,991580
79479,6,3,220,723590,6,723584
79480,6,-12,677,264174,6,264168
79481,5,-17,729,109131,5,109126
79482,5,0,162,628941,5,628936
79483,8,16,515,1136165,8,1136157
79484,13,-6,910,466046,13,466033
79485,18,17,578,1182108,18,1182090
79486,18,7,516,870862,18,870844
79487,20,-13,722,246356,20,246336
79488,14,16,697,1152062,14,1152048
79489,15,-8,643,402375,15,402360
79490,8,-12,137,252539,8,252531
79491,5,-4,782,516157,5,516152
79492,19,0,152,649346,19,649327
79493,7,-6,151,440019,7,440012
79494,10,-2,257,568283,10,568273
79495,13,-10,273,337055,13,337042
79496,15,17,283,1180048,15,1180033
79497,13,-11,802,309948,13,309935
79498,12,10,849,966339,12,966327
79499,10,3,814,736360,10,736350
79500,16,13,219,1054864,16,1054848
79501,14,-4,369,524989,14,524975
79502,16,-10,472,338621,16,338605
79503,16,-12,760,278118,16,278102
79504,6,-3,453,540599,6,540593
79505,7,12,196,1003400,7,1003393
79506,10,14,260,1067637,10,1067627
79507,14,-18,737,90650,14,90636
79508,14,-11,351,306555,14,306541
79509,18,11,631,995341,18,995323
79510,9,-4,752,515466,9,515457
79511,7,-20,497,10674,7,10667
79512,15,-3,856,560626,15,560611
79513,13,-6,151,460294,13,460281
79514,15,-13,360,243672,15,243657
79515,13,13,613,1057919,13,1057906
79516,14,8,989,905639,14,905625
79517,14,-20,136,23792,14,23778
79518,11,1,210,681558,11,681547
79519,5,-17,295,99855,5,99850
79520,16,0,885,655007,16,654991
79521,19,3,414,744981,19,744962
79522,12,-12,360,275226,12,275214
79523,16,5,202,805364,16,805348
79524,11,7,561,871149,11,871138
79525,10,9,368,914505,10,914495
79526,12,8,150,899126,12,899114
79527,6,-1,628,607463,6,607457
79528,10,11,941,988708,10,988698
79529,6,11,779,985131,6,985125
79530,14,4,318,775464,14,775450
79531,11,15,650,1121565,11,1121554
79532,7,5,756,797390,7,797383
79533,5,-8,983,396450,5,396445
79534,17,-6,478,462828,17,462811
79535,6,-13,960,239206,6,239200
79536,18,2,384,713512,18,713494
79537,9,11,78,970148,9,970139
79538,18,-1,557,620963,18,620945
79539,6,-5,940,488501,6,488495
79540,14,-11,648,308896,14,308882
79541,6,5,702,796249,6,796243
79542,20,9,701,934239,20,934219
79543,17,13,292,1055382,17,1055365
79544,20,-1,439,620030,20,620010
79545,11,12,441,1025285,11,1025274
79546,17,-19,521,58032,17,58015
79547,11,-9,820,373045,11,373034
79548,10,4,6,750686,10,750676
79549,5,-2,622,575999,5,575994
79550,9,9,627,920115,9,920106
79551,11,5,730,809086,11,809075
79552,14,-5,660,495813,14,495799
79553,8,2,709,703601,8,703593
79554,12,19,817,1247375,12,1247363
79555,17,-4,648,526958,17,526941
79556,9,12,39,999955,9,999946
79557,6,16,753,1140739,6,1140733
79558,9,11,354,976004,9,975995
79559,11,-1,575,621080,11,621069
79560,14,-11,366,306699,14,306685
79561,10,11,751,984503,10,984493
79562,15,-15,790,183634,15,183619
79563,5,-11,741,297154,5,297149
79564,10,-6,448,446313,10,446303
79565,18,-18,809,91157,18,91139
79566,12,4,502,776865,12,776853
79567,5,-6,494,447470,5,447465
79568,13,-18,44,85515,13,85502
79569,14,-15,982,185239,14,185225
79570,9,15,960,1114947,9,1114938
79571,20,18,294,1211251,20,1211231
79572,19,-12,390,275365,19,275346
79573,17,17,539,1181883,17,1181866
79574,12,-15,56,178190,12,178178
79575,18,-17,57,115951,18,115933
79576,5,-10,185,316648,5,316643
79577,16,6,188,837173,16,837157
79578,10,7,880,863525,10,863515
79579,5,-6,581,449287,5,449282
79580,6,15,366,1102217,6,1102211
79581,9,9,150,909896,9,909887
79582,20,6,82,836346,20,836326
79583,9,10,647,951567,9,951558
79584,19,-18,952,92140,19,92121
79585,19,5,759,809306,19,809287
79586,9,3,566,730809,9,730800
79587,8,5,519,792417,8,792409
79588,13,-16,291,149092,13,149079
79589,15,-19,23,54059,15,54044
79590,20,7,594,871399,20,871379
79591,19,-15,765,183479,19,183460
79592,5,6,456,822705,5,822700
79593,12,19,855,1247707,12,1247695
79594,10,-7,807,422887,10,422877
79595,10,-5,860,486656,10,486646
79596,18,5,733,809132,18,809114
79597,9,13,197,1034948,9,1034939
79598,5,13,197,1034953,5,1034948
79599,20,-4,74,522622,20,522602
79600,8,17,429,1164451,8,1164443
79601,15,-17,718,120927,15,120912
79602,6,0,994,647033,6,647027
79603,17,-17,280,117575,17,117558
79604,18,-14,541,213657,18,213639
79605,11,15,466,1120081,11,1120070
79606,8,12,9,999210,8,999202
79607,16,-4,526,526110,16,526094
79608,13,-7,945,435320,13,435307
79609,5,15,246,1099804,5,1099799
79610,10,2,707,703561,10,703551
79611,9,16,476,1135431,9,1135422
79612,7,10,717,952983,7,952976
79613,16,-7,154,429432,16,429416
79614,14,-13,201,242542,14,242528
79615,13,-13,681,245978,13,245965
79616,14,-8,670,402647,14,402633
79617,18,19,422,1244341,18,1244323
79618,5,16,361,1132835,5,1132830
79619,15,-19,314,56414,15,56399
79620,20,10,664,965044,20,965024
79621,7,16,511,1136090,7,1136083
79622,11,-15,384,180580,11,180569
79623,10,19,661,1232164,10,1232154
79624,20,18,206,1210682,20,1210662
79625,10,-9,34,344361,10,344351
79626,8,-15,116,158038,8,158030
79627,16,10,238,961617,16,961601
79628,16,-16,275,149012,16,148996
79629,20,10,211,961428,20,961408
79630,6,16,577,1137308,6,1137302
79631,19,9,482,932592,19,932573
79632,5,13,475,1040914,5,1040909
79633,15,7,286,869065,15,869050
79634,19,-16,859,153238,19,153219
79635,12,-18,887,91663,12,91651
79636,20,-11,722,309360,20,309340
79637,6,-14,622,200381,6,200375
79638,13,-13,605,245519,13,245506
79639,10,0,859,643975,10,643965
79640,18,15,563,1120865,18,1120847
79641,17,9,81,929641,17,929624
79642,11,-1,815,622831,11,622820
79643,13,-16,746,152341,13,152328
79644,6,17,643,1169080,6,1169074
79645,14,-8,502,401339,14,401325
79646,5,2,510,699523,5,699518
79647,17,-18,542,89235,17,89218
79648,9,-10,559,324781,9,324772
79649,5,-10,68,314102,5,314097
79650,18,-14,469,213142,18,213124
79651,9,8,977,896457,9,896448
79652,7,0,248,630780,7,630773
79653,5,11,545,980153,5,980148
79654,15,-20,159,23952,15,23937
79655,11,5,102,804540,11,804529
79656,10,-8,103,377526,10,377516
79657,19,6,487,839693,19,839674
79658,14,-16,694,152009,14,151995
79659,19,-18,540,89196,19,89177
79660,10,0,686,640393,10,640383
79661,17,2,864,716944,17,716927
79662,5,7,649,858496,5,858491
79663,10,10,426,946653,10,946643
79664,14,14,809,1091818,14,1091804
79665,14,-16,74,147389,14,147375
79666,20,16,824,1153024,20,1153004
79667,15,3,223,743542,15,743527
79668,13,-6,116,459956,13,459943
79669,6,-4,642,513265,6,513259
79670,10,-8,291,381573,10,381563
79671,20,-3,159,554901,20,554881
79672,7,-7,817,423083,7,423076
79673,13,-7,197,429757,13,429744
79674,14,12,67,1022554,14,1022540
79675,13,-11,794,309904,13,309891
79676,19,-11,158,305003,19,304984
79677,12,-20,300,25150,12,25138
79678,6,3,955,739591,6,739585
79679,15,-12,622,277049,15,277034
79680,20,-18,610,89660,20,89640
79681,20,16,6,1147158,20,1147138
79682,13,-13,105,241837,13,241824
79683,5,4,93,752660,5,752655
79684,12,7,274,868976,12,868964
79685,13,-17,335,117976,13,117963
79686,7,12,452,1008743,7,1008736
79687,6,2,615,701610,6,701604
79688,6,-5,759,484363,6,484357
79689,5,19,636,1231683,5,1231678
79690,14,14,132,1086504,14,1086490
79691,17,6,863,842666,17,842649
79692,7,-11,837,299067,7,299060
79693,13,-12,102,273270,13,273257
79694,12,16,733,1152331,12,1152319
79695,9,-20,719,15817,9,15808
79696,16,17,323,1180404,16,1180388
79697,12,13,657,1058206,12,1058194
79698,17,-15,76,178310,17,178293
79699,16,4,463,776584,16,776568
79700,18,-3,434,557068,18,557050
79701,18,-6,488,462911,18,462893
79702,7,-6,139,439696,7,439689
79703,16,-17,546,119607,16,119591
79704,19,-20,176,24146,19,24127
79705,20,13,469,1056716,20,1056696
79706,7,-18,585,75020,7,75013
79707,10,-5,936,488439,10,488429
79708,11,1,604,684605,11,684594
79709,7,-8,279,381371,7,381364
79710,16,4,239,775021,16,775005
79711,19,3,996,749517,19,749498
79712,16,-19,918,60919,16,60903
79713,15,7,81,867631,15,867616
79714,18,14,581,1089933,18,1089915
79715,14,8,197,899496,14,899482
79716,18,11,297,993083,18,993065
79717,7,-2,30,563434,7,563427
79718,7,10,185,941536,7,941529
79719,20,11,534,994716,20,994696
79720,17,-19,258,56029,17,56012
79721,18,4,671,778146,18,778128
79722,9,-13,530,229588,9,229579
79723,18,12,642,1026867,18,1026849
79724,7,16,677,1139398,7,1139391
79725,8,-9,265,349387,8,349379
79726,20,-14,751,215333,20,215313
79727,17,5,71,804329,17,804312
79728,20,-12,339,275042,20,275022
79729,10,12,314,1006087,10,1006077
79730,5,7,191,848826,5,848821
79731,5,-9,512,355222,5,355217
79732,9,-20,494,10602,9,10593
79733,17,-6,818,465398,17,465381
79734,5,16,215,1129794,5,1129789
79735,14,-19,430,57288,14,57274
79736,20,10,805,966144,20,966124
79737,5,-2,731,578307,5,578302
79738,16,-8,720,402986,16,402970
79739,13,16,898,1153482,13,1153469
79740,11,10,848,966317,11,966306
79741,19,7,977,873953,19,873934
79742,20,2,808,716513,20,716493
79743,16,-5,751,496528,16,496512
79744,6,19,870,1236934,6,1236928
79745,16,-18,512,89027,16,89011
79746,10,7,361,852635,10,852625
79747,14,-19,495,57787,14,57773
79748,11,-9,600,371350,11,371339
79749,15,7,384,869845,15,869830
79750,12,-18,691,90238,12,90226
79751,20,-3,626,558780,20,558760
79752,7,2,268,694418,7,694411
79753,20,-6,643,464093,20,464073
79754,18,2,543,714702,18,714684
79755,15,16,520,1150819,15,1150804
79756,8,-7,496,416440,8,416432
79757,17,-5,298,493291,17,493274
79758,8,13,494,1041357,8,1041349
79759,14,-12,48,272833,14,272819
79760,12,7,33,867257,12,867245
79761,20,16,712,1152192,20,1152172
79762,14,-15,611,182256,14,182242
79763,17,-1,26,616742,17,616725
79764,17,19,981,1248651,17,1248634
79765,16,11,128,991766,16,991750
79766,11,1,269,682060,11,682049
79767,12,-16,415,149979,12,149967
79768,11,18,467,1212419,11,1212408
79769,19,2,435,713891,19,713872
79770,7,7,674,859151,7,859144
79771,11,-14,582,214107,11,214096
79772,20,1,235,681751,20,681731
79773,12,15,803,1122649,12,1122637
79774,8,-18,25,62995,8,62987
79775,9,-15,837,173222,9,173213
79776,9,-7,550,417714,9,417705
79777,6,9,78,908371,6,908365
79778,15,5,645,808497,15,808482
79779,8,-3,762,547533,8,547525
79780,18,-2,98,585861,18,585843
79781,9,-12,406,258477,9,258468
79782,17,17,948,1185003,17,1184986
79783,11,-7,605,432782,11,432771
79784,19,-11,271,305870,19,305851
79785,15,12,326,1024504,15,1024489
79786,5,-14,295,193139,5,193134
79787,8,10,509,948383,8,948375
79788,5,-19,250,37071,5,37066
79789,19,14,290,1087678,19,1087659
79790,7,11,46,969451,7,969444
79791,8,-4,347,507161,8,507153
79792,16,3,992,749474,16,749458
79793,11,10,399,962837,11,962826
79794,16,8,330,900586,16,900570
79795,13,17,272,1179966,13,1179953
79796,15,12,467,1025466,15,1025451
79797,8,-11,392,289824,8,289816
79798,15,10,729,965502,15,965487
79799,15,-16,269,148964,15,148949
79800,17,-5,417,494098,17,494081
79801,9,-8,494,385626,9,385617
79802,14,-5,893,497584,14,497570
79803,14,-14,613,214341,14,214327
79804,9,-15,343,162888,9,162879
79805,20,15,319,1119124,20,1119104
79806,12,-18,691,90240,12,90228
79807,10,-12,944,270131,10,270121
79808,18,-19,104,54756,18,54738
79809,7,11,163,971858,7,971851
79810,15,-6,130,460082,15,460067
79811,16,7,702,872152,16,872136
79812,6,19,352,1225411,6,1225405
79813,5,-6,429,445947,5,445942
79814,20,-7,735,433662,20,433642
79815,12,-4,412,525311,12,525299
79816,12,7,411,870078,12,870066
79817,10,5,681,795773,10,795763
79818,6,9,359,914332,6,914326
79819,12,-13,1,241052,12,241040
79820,19,-8,382,400581,19,400562
79821,18,-12,310,274830,18,274812
79822,18,-11,434,307263,18,307245
79823,18,-7,277,430380,18,430362
79824,18,3,44,742151,18,742133
79825,8,5,522,792487,8,792479
79826,7,-8,130,378152,7,378145
79827,14,7,764,872541,14,872527
79828,20,5,180,805148,20,805128
79829,6,9,85,908521,6,908515
79830,5,-1,626,607422,5,607417
79831,6,-7,691,420469,6,420463
79832,5,-16,922,143781,5,143776
79833,9,6,842,831275,9,831266
79834,17,-9,784,372756,17,372739
79835,9,4,627,764200,9,764191
79836,18,-5,252,492886,18,492868
79837,15,-19,446,57407,15,57392
79838,13,4,755,778822,13,778809
79839,15,15,385,1119592,15,1119577
79840,5,5,50,782698,5,782693
79841,5,-15,370,163419,5,163414
79842,6,-11,790,298094,6,298088
79843,14,14,555,1089783,14,1089769
79844,11,-2,401,588087,11,588076
79845,20,-16,771,152574,20,152554
79846,15,-9,279,368619,15,368604
79847,19,12,661,1026978,19,1026959
79848,17,10,447,963229,17,963212
79849,20,5,433,806920,20,806900
79850,16,18,533,1212898,16,1212882
79851,15,8,630,902982,15,902967
79852,17,4,210,774758,17,774741
79853,7,1,979,678274,7,678267
79854,11,2,472,714188,11,714177
79855,18,3,454,745227,18,745209
79856,5,13,536,1042199,5,1042194
79857,7,-12,708,264849,7,264842
79858,9,14,297,1068393,9,1068384
79859,15,12,866,1028595,15,1028580
79860,7,-10,118,315153,7,315146
79861,7,4,576,763011,7,763004
79862,18,7,896,873441,18,873423
79863,20,-3,833,560449,20,560429
79864,8,17,554,1167127,8,1167119
79865,7,11,634,981983,7,981976
79866,17,4,596,777609,17,777592
79867,15,7,93,867683,15,867668
79868,19,10,469,963433,19,963414
79869,10,-9,106,345830,10,345820
79870,18,-19,840,60487,18,60469
79871,11,-15,198,179179,11,179168
79872,18,14,669,1090680,18,1090662
79873,16,-14,561,213876,16,213860
79874,10,-9,412,352601,10,352591
79875,8,13,950,1051079,8,1051071
79876,7,-9,491,354773,7,354766
79877,6,11,692,983164,6,983158
79878,6,14,454,1071944,6,1071938
79879,8,3,298,725382,8,725374
79880,17,-17,128,116451,17,116434
79881,17,-14,585,214118,17,214101
79882,8,17,939,1175414,8,1175406
79883,11,7,370,869679,11,869668
79884,20,-2,881,591899,20,591879
79885,14,-12,216,274082,14,274068
79886,11,13,30,1053431,11,1053420
79887,16,7,507,870772,16,870756
79888,15,-6,673,464257,15,464242
79889,7,7,610,857721,7,857714
79890,12,0,274,650182,12,650170
79891,18,0,345,650659,18,650641
79892,9,4,630,764271,9,764262
79893,16,-2,551,589289,16,589273
79894,9,-15,51,156440,9,156431
79895,8,-9,91,345559,8,345551
79896,12,-14,954,216888,12,216876
79897,15,14,453,1089005,15,1088990
79898,7,9,821,924174,7,924167
79899,13,-13,423,244083,13,244070
79900,12,2,92,711254,12,711242
79901,20,12,659,1026950,20,1026930
79902,20,14,376,1088382,20,1088362
79903,9,-13,62,219720,9,219711
79904,7,2,177,692516,7,692509
79905,14,6,175,837052,14,837038
79906,19,-2,591,589581,19,589562
79907,20,15,705,1121970,20,1121950
79908,16,15,479,1120179,16,1120163
79909,10,18,67,1188254,10,1188244
79910,11,8,2,897933,11,897922
79911,13,8,19,898055,13,898042
79912,12,15,702,1121942,12,1121930
79913,9,2,961,708778,9,708769
79914,9,-18,755,78795,9,78786
79915,14,-5,716,496272,14,496258
79916,20,6,521,840051,20,840031
79917,19,-17,967,122587,19,122568
79918,18,-8,182,399208,18,399190
79919,19,-6,727,464725,19,464706
79920,17,-16,670,151849,17,151832
79921,13,2,91,711253,13,711240
79922,10,17,856,1173785,10,1173775
79923,17,-17,556,119672,17,119655
79924,16,13,64,1053696,16,1053680
79925,20,-13,255,242926,20,242906
79926,13,-7,780,433975,13,433962
79927,13,-8,947,404604,13,404591
79928,8,-15,76,156927,8,156919
79929,13,0,97,649003,13,648990
79930,17,-12,106,273306,17,273289
79931,13,-8,811,403687,13,403674
79932,15,-11,897,310729,15,310714
79933,9,-17,327,100512,9,100503
79934,18,17,519,1181789,18,1181771
79935,8,-5,503,478905,8,478897
79936,11,9,473,932447,11,932436
79937,19,19,1000,1248804,19,1248785
79938,8,13,691,1045589,8,1045581
79939,16,-16,314,149263,16,149247
79940,20,-17,561,119735,20,119715
79941,7,-16,838,141956,7,141949
79942,8,-7,982,426853,8,426845
79943,15,-13,414,244020,15,244005
79944,8,3,334,726195,8,726187
79945,8,13,218,1035398,8,1035390
79946,9,-10,852,330870,9,330861
79947,16,5,244,805639,16,805623
79948,10,-18,644,76196,10,76186
79949,10,7,196,848937,10,848927
79950,10,-15,153,158723,10,158713
79951,16,-2,19,585277,16,585261
79952,18,15,956,1123820,18,1123802
79953,13,1,403,683062,13,683049
79954,13,-6,434,462472,13,462459
79955,17,-3,200,555189,17,555172
79956,12,16,249,1148888,12,1148876
79957,11,-5,178,492311,11,492300
79958,11,1,735,685577,11,685566
79959,8,-20,700,15454,8,15446
79960,17,15,470,1120111,17,1120094
79961,13,-14,707,215037,13,215024
79962,18,-17,536,119511,18,119493
79963,17,19,238,1242614,17,1242597
79964,5,-2,960,583413,5,583408
79965,7,-4,761,515616,7,515609
79966,13,13,919,1060004,13,1059991
79967,18,-6,823,465433,18,465415
79968,11,-1,619,621375,11,621364
79969,14,7,752,872448,14,872434
79970,20,-10,633,339791,20,339771
79971,12,-4,668,527143,12,527131
79972,12,8,684,903415,12,903403
79973,8,-8,63,376805,8,376797
79974,8,-17,63,94717,8,94709
79975,20,10,740,965573,20,965553
79976,8,7,795,861617,8,861609
79977,6,-12,208,253939,6,253933
79978,5,-19,855,50245,5,50240
79979,9,0,313,631921,9,631912
79980,15,4,12,773362,15,773347
79981,10,6,185,816227,10,816217
79982,12,13,302,1055422,12,1055410
79983,17,7,823,872975,17,872958
79984,10,13,207,1035148,10,1035138
79985,14,-14,536,213628,14,213614
79986,18,-8,998,405020,18,405002
79987,9,-16,476,134476,9,134467
79988,12,-20,444,26176,12,26164
79989,13,10,330,962343,13,962330
79990,7,-3,699,546181,7,546174
79991,8,7,934,864567,8,864559
79992,8,2,13,688806,8,688798
79993,19,12,253,1023933,19,1023914
79994,14,3,295,744125,14,744111
79995,6,1,725,672771,6,672765
79996,17,-15,626,182402,17,182385
79997,19,-10,278,337088,19,337069
79998,10,-18,359,70198,10,70188
79999,13,-19,229,55852,13,55839
80000,17,-3,530,558021,17,558004
80001,17,-13,936,248127,17,248110
80002,17,-13,771,246777,17,246760
80003,17,18,708,1214054,17,1214037
80004,15,-10,10,335192,15,335177
80005,9,-19,376,39620,9,39611
80006,13,6,583,840492,13,840479
80007,6,11,630,981908,6,981902
80008,16,-9,85,367282,16,367266
80009,19,-5,100,491699,19,491680
80010,7,0,715,641089,7,641082
80011,15,11,472,994302,15,994287
80012,18,-19,779,60065,18,60047
80013,19,19,450,1244543,19,1244524
80014,14,-16,687,151959,14,151945
80015,5,-11,9,281346,5,281341
80016,15,17,515,1181773,15,1181758
80017,14,13,515,1057075,14,1057061
80018,9,-4,540,511185,9,511176
80019,16,3,32,742053,16,742037
80020,6,-5,475,478288,6,478282
80021,7,-6,9,437073,7,437066
80022,7,15,238,1099567,7,1099560
80023,13,-18,784,90954,13,90941
80024,6,-10,776,329163,6,329157
80025,7,-18,742,78436,7,78429
80026,20,15,133,1117800,20,1117780
80027,6,15,152,1097763,6,1097757
80028,20,6,823,842387,20,842367
80029,8,13,347,1038270,8,1038262
80030,5,6,671,827457,5,827452
80031,18,-6,60,459542,18,459524
80032,17,-19,712,59545,17,59528
80033,9,-14,873,205454,9,205445
80034,7,-13,473,228306,7,228299
80035,6,4,226,755595,6,755589
80036,8,2,242,693811,8,693803
80037,12,-10,214,336651,12,336639
80038,7,-19,35,32254,7,32247
80039,16,8,76,898497,16,898481
80040,18,1,369,682831,18,682813
80041,7,0,370,633301,7,633294
80042,10,7,732,860284,10,860274
80043,9,7,631,858158,9,858149
80044,5,-9,358,351494,5,351489
80045,20,5,143,804833,20,804813
80046,5,13,140,1033658,5,1033653
80047,14,-18,765,90826,14,90812
80048,17,15,927,1123551,17,1123534
80049,18,-11,645,308875,18,308857
80050,17,1,531,684087,17,684070
80051,5,-15,303,161923,5,161918
80052,15,10,102,960684,15,960669
80053,5,15,598,1107139,5,1107134
80054,5,14,518,1073392,5,1073387
80055,5,-15,1,155350,5,155345
80056,12,-5,920,497788,12,497776
80057,12,-19,170,55375,12,55363
80058,6,-3,430,539986,6,539980
80059,14,-7,755,433763,14,433749
80060,16,11,741,996165,16,996149
80061,18,-14,8,209412,18,209394
80062,15,-8,950,404634,15,404619
80063,20,-19,734,59797,20,59777
80064,20,-4,851,528332,20,528312
80065,11,-9,223,368165,11,368154
80066,5,-4,697,514439,5,514434
80067,13,7,956,873781,13,873768
80068,14,-18,148,86379,14,86365
80069,12,17,561,1182018,12,1182006
80070,14,2,787,716381,14,716367
80071,12,-16,196,148383,12,148371
80072,10,-8,870,393917,10,393907
80073,6,4,601,763677,6,763671
80074,13,0,415,651280,13,651267
80075,6,-11,920,300841,6,300835
80076,17,-20,648,27735,17,27718
80077,6,18,50,1187778,6,1187772
80078,20,8,912,905089,20,905069
80079,18,-2,682,590277,18,590259
80080,8,-11,232,286064,8,286056
80081,18,-18,28,85410,18,85392
80082,6,-15,557,167420,6,167414
80083,8,6,862,831696,8,831688
80084,10,-2,902,582130,10,582120
80085,10,-13,361,225930,10,225920
80086,10,17,738,1171040,10,1171030
80087,16,15,689,1121818,16,1121802
80088,9,17,651,1169253,9,1169244
80089,9,-5,358,475958,9,475949
80090,19,13,504,1056982,19,1056963
80091,7,3,279,724921,7,724914
80092,7,-16,439,133681,7,133674
80093,18,-20,862,29424,18,29406
80094,16,3,450,745223,16,745207
80095,14,12,990,1029731,14,1029717
80096,15,3,924,748841,15,748826
80097,14,1,6,679794,14,679780
80098,18,19,1,1240633,18,1240615
80099,20,16,339,1149579,20,1149559
80100,13,18,501,1212619,13,1212606
80101,5,-11,946,301461,5,301456
80102,20,-19,148,55215,20,55195
80103,9,-12,532,261159,9,261150
80104,19,-13,704,246183,19,246164
80105,18,-16,347,149458,18,149440
80106,13,2,380,713469,13,713456
80107,5,18,329,1193859,5,1193854
80108,19,-18,20,85357,19,85338
80109,11,-17,764,121298,11,121287
80110,5,10,477,947643,5,947638
80111,18,5,366,806494,18,806476
80112,16,10,728,965491,16,965475
80113,7,17,143,1158293,7,1158286
80114,10,7,587,857301,10,857291
80115,11,-9,729,372134,11,372123
80116,10,-17,402,102006,10,101996
80117,11,-3,422,556956,11,556945
80118,5,-5,52,469001,5,468996
80119,12,-2,153,586220,12,586208
80120,10,-15,310,162129,10,162119
80121,10,-11,761,297501,10,297491
80122,6,-10,403,321359,6,321353
80123,10,10,472,947599,10,947589
80124,10,-14,7,186562,10,186552
80125,16,-18,14,85318,16,85302
80126,13,-7,493,432028,13,432015
80127,8,14,848,1080845,8,1080837
80128,8,-13,590,230993,8,230985
80129,16,4,733,778672,16,778656
80130,19,4,707,778448,19,778429
80131,20,-1,270,618679,20,618659
80132,12,-18,175,86672,12,86660
80133,13,-14,663,214699,13,214686
80134,8,2,954,708605,8,708597
80135,10,-3,833,548997,10,548987
80136,18,-13,148,242098,18,242080
80137,16,12,512,1025784,16,1025768
80138,6,19,870,1236940,6,1236934
80139,16,-12,487,276087,16,276071
80140,16,-19,233,55866,16,55850
80141,5,-9,881,363344,5,363339
80142,10,-9,153,346902,10,346892
80143,20,-3,524,557957,20,557937
80144,12,3,667,746875,12,746863
80145,17,14,749,1091328,17,1091311
80146,12,-3,922,561186,12,561174
80147,20,-13,144,242070,20,242050
80148,11,8,726,903737,11,903726
80149,5,-14,815,204381,5,204376
80150,11,6,362,838556,11,838545
80151,15,-14,475,213179,15,213164
80152,20,10,307,962120,20,962100
80153,15,-11,957,311214,15,311199
80154,19,3,920,748800,19,748781
80155,15,18,181,1210431,15,1210416
80156,20,-2,957,592450,20,592430
80157,14,-12,980,279960,14,279946
80158,10,-9,908,364053,10,364043
80159,20,-15,84,178440,20,178420
80160,6,16,662,1139113,6,1139107
80161,17,8,442,901521,17,901504
80162,7,-18,548,74251,7,74244
80163,14,9,325,931382,14,931368
80164,12,10,58,960280,12,960268
80165,17,-14,130,210309,17,210292
80166,17,-11,194,305272,17,305255
80167,10,1,898,676541,10,676531
80168,8,-12,204,253852,8,253844
80169,15,-3,505,557681,15,557666
80170,7,13,175,1034402,7,1034395
80171,12,7,270,868957,12,868945
80172,12,-14,366,212299,12,212287
80173,6,5,491,791836,6,791830
80174,16,-20,490,26475,16,26459
80175,8,5,511,792176,8,792168
80176,9,7,944,864707,9,864698
80177,16,-10,781,340943,16,340927
80178,9,-18,386,70710,9,70701
80179,6,1,645,671278,6,671272
80180,7,13,211,1035237,7,1035230
80181,9,-16,256,129606,9,129597
80182,8,-8,152,378725,8,378717
80183,7,4,906,770509,7,770502
80184,19,-2,195,586552,19,586533
80185,9,-19,344,38992,9,38983
80186,15,-17,606,120061,15,120046
80187,8,-19,608,44857,8,44849
80188,17,6,256,837713,17,837696
80189,11,-10,504,338846,11,338835
80190,18,-5,174,492305,18,492287
80191,12,-20,661,27886,12,27874
80192,7,2,788,705058,7,705051
80193,19,17,90,1178518,19,1178499
80194,20,6,8,835791,20,835771
80195,16,7,311,869274,16,869258
80196,16,12,164,1023249,16,1023233
80197,15,-2,720,590577,15,590562
80198,13,-13,847,247343,13,247330
80199,11,1,335,682562,11,682551
80200,14,-3,372,556539,14,556525
80201,16,11,284,992933,16,992917
80202,5,13,438,1040229,5,1040224
80203,11,-11,187,305225,11,305214
80204,10,8,163,878662,10,878652
80205,11,13,287,1055330,11,1055319
80206,10,-2,624,576057,10,576047
80207,11,12,319,1024449,11,1024438
80208,15,-15,368,180488,15,180473
80209,17,10,391,962766,17,962749
80210,9,-12,358,257436,9,257427
80211,15,-4,94,522766,15,522751
80212,14,-20,770,28744,14,28730
80213,6,18,292,1193140,6,1193134
80214,13,-19,175,55437,13,55424
80215,12,-3,834,560461,12,560449
80216,13,1,482,683668,13,683655
80217,18,-16,224,148633,18,148615
80218,8,9,161,910197,8,910189
80219,13,6,702,841481,13,841468
80220,9,12,552,1010949,9,1010940
80221,11,-13,964,248330,11,248319
80222,5,6,687,827802,5,827797
80223,14,2,218,712231,14,712217
80224,17,11,264,992738,17,992721
80225,5,-13,511,229211,5,229206
80226,14,-15,371,180510,14,180496
80227,10,-12,372,257711,10,257701
80228,6,0,520,636566,6,636560
80229,10,-3,234,535488,10,535478
80230,20,10,720,965400,20,965380
80231,18,1,741,685646,18,685628
80232,17,-11,177,305183,17,305166
80233,7,18,942,1206620,7,1206613
80234,12,-2,417,588248,12,588236
80235,12,17,325,1180414,12,1180402
80236,18,8,624,902896,18,902878
80237,5,14,954,1083180,5,1083175
80238,16,-4,441,525483,16,525467
80239,6,-2,556,574602,6,574596
80240,10,5,182,785445,10,785435
80241,19,11,672,995614,19,995595
80242,20,-14,464,213107,20,213087
80243,8,-8,76,377168,8,377160
80244,20,12,741,1027580,20,1027560
80245,16,-18,973,92296,16,92280
80246,16,-14,215,211018,16,211002
80247,8,18,712,1201563,8,1201555
80248,10,17,772,1171693,10,1171683
80249,12,-2,92,585820,12,585808
80250,7,-8,843,393327,7,393320
80251,9,12,891,1018660,9,1018651
80252,5,6,345,820136,5,820131
80253,5,-12,61,250904,5,250899
80254,10,-12,424,258771,10,258761
80255,8,-12,285,255726,8,255718
80256,12,-4,328,524643,12,524631
80257,9,13,526,1041954,9,1041945
80258,18,-13,22,241231,18,241213
80259,8,15,470,1104419,8,1104411
80260,12,12,219,1023681,12,1023669
80261,13,-11,532,308001,13,307988
80262,9,17,429,1164460,9,1164451
80263,19,16,870,1153292,19,1153273
80264,9,-9,499,354997,9,354988
80265,17,-19,207,55736,17,55719
80266,17,16,66,1147561,17,1147544
80267,19,-19,241,55936,19,55917
80268,7,11,299,974778,7,974771
80269,9,-4,202,503905,9,503896
80270,15,13,198,1054697,15,1054682
80271,11,-5,44,491169,11,491158
80272,10,-20,349,7685,10,7675
80273,11,-14,751,215334,11,215323
80274,11,-11,481,307568,11,307557
80275,20,19,807,1247321,20,1247301
80276,5,4,290,756848,5,756843
80277,13,7,935,873675,13,873662
80278,8,15,675,1108778,8,1108770
80279,6,8,623,888807,6,888801
80280,5,16,379,1133235,5,1133230
80281,16,-11,249,305668,16,305652
80282,12,2,199,712108,12,712096
80283,12,5,931,810622,12,810610
80284,6,-13,693,232942,6,232936
80285,18,-4,660,527088,18,527070
80286,17,-12,683,277536,17,277519
80287,17,13,640,1058079,17,1058062
80288,11,6,48,836155,11,836144
80289,9,-17,122,96002,9,95993
80290,13,-3,281,555767,13,555754
80291,13,1,411,683098,13,683085
80292,11,-10,934,342091,11,342080
80293,19,7,575,871271,19,871252
80294,7,-8,653,389375,7,389368
80295,8,9,144,909825,8,909817
80296,9,16,330,1132169,9,1132160
80297,17,-11,294,306033,17,306016
80298,18,16,962,1153994,18,1153976
80299,11,-20,320,25333,11,25322
80300,10,-11,742,297173,10,297163
80301,7,-6,933,456688,7,456681
80302,11,-6,757,464932,11,464921
80303,8,-2,52,564044,8,564036
80304,5,17,298,1161756,5,1161751
80305,13,13,949,1060277,13,1060264
80306,15,-3,86,554372,15,554357
80307,11,-18,962,92219,11,92208
80308,5,-11,837,299072,5,299067
80309,5,17,27,1155857,5,1155852
80310,20,19,597,1245642,20,1245622
80311,5,-7,88,407727,5,407722
80312,16,-13,870,247530,16,247514
80313,5,-5,177,471976,5,471971
80314,12,9,565,933222,12,933210
80315,10,-19,911,51117,10,51107
80316,20,6,119,836694,20,836674
80317,18,3,563,746003,18,745985
80318,17,9,995,936505,17,936488
80319,16,2,350,713243,16,713227
80320,9,4,985,771982,9,771973
80321,17,9,571,933279,17,933262
80322,13,12,501,1025745,13,1025732
80323,19,-6,487,462904,19,462885
80324,7,-11,435,290865,7,290858
80325,18,10,38,960141,18,960123
80326,20,-8,891,404223,20,404203
80327,6,6,697,828092,6,828086
80328,18,-3,873,560774,18,560756
80329,9,6,641,826790,9,826781
80330,13,12,31,1022323,13,1022310
80331,12,1,109,680682,12,680670
80332,19,-19,336,56639,19,56620
80333,7,-15,459,165326,7,165319
80334,19,-19,524,58069,19,58050
80335,5,16,707,1139848,5,1139843
80336,5,-20,527,11369,5,11364
80337,20,-9,279,368629,20,368609
80338,19,16,623,1151516,19,1151497
80339,5,-17,252,98823,5,98818
80340,18,-9,522,370829,18,370811
80341,16,19,295,1243121,16,1243105
80342,12,-14,663,214701,12,214689
80343,19,-5,79,491485,19,491466
80344,14,16,865,1153254,14,1153240
80345,16,11,470,994286,16,994270
80346,20,13,84,1053866,20,1053846
80347,7,7,432,854094,7,854087
80348,5,16,682,1139467,5,1139462
80349,15,9,97,929771,15,929756
80350,13,-3,743,559680,13,559667
80351,11,-6,957,466378,11,466367
80352,16,10,124,960865,16,960849
80353,19,8,323,900519,19,900500
80354,9,19,9,1217653,9,1217644
80355,14,3,721,747327,14,747313
80356,12,13,483,1056803,12,1056791
80357,18,8,108,898789,18,898771
80358,13,-7,341,430941,13,430928
80359,14,-10,372,337751,14,337737
80360,14,-5,995,498305,14,498291
80361,18,-14,998,217297,18,217279
80362,11,-1,389,619675,11,619664
80363,8,5,404,789866,8,789858
80364,7,11,578,980855,7,980848
80365,12,-18,193,86790,12,86778
80366,12,-12,168,273742,12,273730
80367,8,19,877,1237055,8,1237047
80368,9,-8,688,390217,9,390208
80369,20,-7,892,434923,20,434903
80370,10,15,804,1111455,10,1111445
80371,9,-8,544,386819,9,386810
80372,8,-17,256,98924,8,98916
80373,5,10,869,956213,5,956208
80374,5,-17,454,103136,5,103131
80375,7,1,785,674063,7,674056
80376,6,14,115,1064434,6,1064428
80377,12,-18,438,88537,12,88525
80378,20,15,544,1120731,20,1120711
80379,5,-6,182,440889,5,440884
80380,20,-3,864,560700,20,560680
80381,8,6,25,812826,8,812818
80382,9,4,30,751198,9,751189
80383,14,8,805,904312,14,904298
80384,15,19,970,1248566,15,1248551
80385,13,0,161,649440,13,649427
80386,5,4,527,762015,5,762010
80387,11,0,997,655922,11,655911
80388,8,17,838,1173363,8,1173355
80389,17,-10,409,338053,17,338036
80390,17,-15,604,182209,17,182192
80391,9,12,40,999963,9,999954
80392,10,8,933,895463,10,895453
80393,20,0,798,654381,20,654361
80394,16,3,592,746259,16,746243
80395,15,0,327,650503,15,650488
80396,14,-2,352,587757,14,587743
80397,19,-1,330,619195,19,619176
80398,15,18,248,1210971,15,1210956
80399,5,-5,480,478373,5,478368
80400,14,18,681,1213866,14,1213852
80401,12,-2,757,590780,12,590768
80402,19,14,604,1090121,19,1090102
80403,14,4,970,780364,14,780350
80404,9,8,589,888088,9,888079
80405,6,11,543,980095,6,980089
80406,13,-6,853,465584,13,465571
80407,17,4,823,779333,17,779316
80408,13,-8,961,404707,13,404694
80409,12,11,710,995891,12,995879
80410,18,3,120,742734,18,742716
80411,16,-14,479,213203,16,213187
80412,12,19,211,1242426,12,1242414
80413,20,-14,897,216494,20,216474
80414,19,-7,1000,435783,19,435764
80415,18,14,876,1092283,18,1092265
80416,13,13,190,1054614,13,1054601
80417,8,-10,198,316942,8,316934
80418,6,-10,16,312943,6,312937
80419,12,7,347,869549,12,869537
80420,20,5,719,809049,20,809029
80421,5,-17,626,106987,5,106982
80422,8,-7,816,423077,8,423069
80423,11,1,11,679814,11,679803
80424,13,-2,541,589192,13,589179
80425,11,16,151,1148151,11,1148140
80426,13,-7,698,433385,13,433372
80427,19,-20,517,26719,19,26700
80428,15,18,842,1215096,15,1215081
80429,5,17,336,1162634,5,1162629
80430,9,-4,989,520762,9,520753
80431,6,13,951,1051104,6,1051098
80432,13,-3,353,556365,13,556352
80433,7,-1,56,594983,7,594976
80434,9,18,660,1200641,9,1200632
80435,14,-2,70,585660,14,585646
80436,5,2,713,703704,5,703699
80437,13,-18,908,91820,13,91807
80438,10,-19,644,45717,10,45707
80439,9,-18,757,78882,9,78873
80440,6,-15,947,175682,6,175676
80441,7,-19,843,50026,7,50019
80442,18,-4,590,526544,18,526526
80443,20,-6,154,460315,20,460295
80444,19,-19,526,58094,19,58075
80445,12,-15,517,181575,12,181563
80446,10,-2,435,572075,10,572065
80447,15,11,42,991170,15,991155
80448,11,18,560,1213037,11,1213026
80449,20,-4,880,528691,20,528671
80450,15,-7,690,433300,15,433285
80451,20,-3,668,559118,20,559098
80452,20,17,999,1185491,20,1185471
80453,5,8,467,885415,5,885410
80454,14,-12,91,273213,14,273199
80455,9,-4,632,513064,9,513055
80456,19,2,272,712600,19,712581
80457,13,-8,271,399775,13,399762
80458,13,-18,947,92091,13,92078
80459,12,12,153,1023154,12,1023142
80460,12,13,91,1053893,12,1053881
80461,14,-11,142,304851,14,304837
80462,20,-16,872,153399,20,153379
80463,9,-3,429,539971,9,539962
80464,8,14,911,1082133,8,1082125
80465,10,-4,791,516317,10,516307
80466,10,12,42,1000068,10,1000058
80467,19,-8,233,399562,19,399543
80468,6,-3,169,534009,6,534003
80469,13,-13,910,247867,13,247854
80470,9,-12,249,254888,9,254879
80471,6,17,520,1166502,6,1166496
80472,16,10,88,960527,16,960511
80473,19,-4,43,522373,19,522354
80474,7,17,624,1168630,7,1168623
80475,13,-5,385,493859,13,493846
80476,6,7,435,854177,6,854171
80477,20,2,392,713573,20,713553
80478,7,3,280,724954,7,724947
80479,13,-12,67,273034,13,273021
80480,6,-14,64,187934,6,187928
80481,5,14,85,1063695,5,1063690
80482,17,-20,477,26353,17,26336
80483,8,-15,114,157992,8,157984
80484,19,-12,907,279391,19,279372
80485,15,17,278,1180014,15,1179999
80486,5,18,481,1197048,5,1197043
80487,19,-4,535,526158,19,526139
80488,10,-15,128,158275,10,158265
80489,12,-3,2,553857,12,553845
80490,17,-18,353,87998,17,87981
80491,18,17,599,1182334,18,1182316
80492,20,-14,764,215471,20,215451
80493,18,11,428,993987,18,993969
80494,11,9,817,935123,11,935112
80495,16,15,190,1118234,16,1118218
80496,15,16,989,1154181,15,1154166
80497,15,9,191,930456,15,930441
80498,13,4,858,779688,13,779675
80499,20,-17,571,119826,20,119806
80500,10,-13,644,232071,10,232061
80501,6,-16,135,126977,6,126971
80502,10,-7,22,406574,10,406564
80503,10,-7,738,421472,10,421462
80504,10,-18,166,66123,10,66113
80505,9,-10,18,312987,9,312978
80506,14,12,382,1024853,14,1024839
80507,13,3,926,748846,13,748833
80508,17,-19,393,57067,17,57050
80509,10,-14,962,207457,10,207447
80510,6,-2,273,568663,6,568657
80511,15,-20,476,26340,15,26325
80512,9,-5,991,489557,9,489548
80513,19,-16,351,149496,19,149477
80514,16,7,636,871671,16,871655
80515,11,19,396,1244033,11,1244022
80516,6,-8,567,387394,6,387388
80517,17,2,37,710805,17,710788
80518,10,3,820,736502,10,736492
80519,7,-5,145,471267,7,471260
80520,14,-17,490,119140,14,119126
80521,6,13,151,1033883,6,1033877
80522,13,13,692,1058423,13,1058410
80523,6,13,612,1043969,6,1043963
80524,6,16,879,1143382,6,1143376
80525,5,8,310,882034,5,882029
80526,20,-4,858,528418,20,528398
80527,12,-19,630,58978,12,58966
80528,7,11,36,969255,7,969248
80529,15,-18,710,90407,15,90392
80530,19,13,243,1055005,19,1054986
80531,11,-3,34,554069,11,554058
80532,18,2,64,711013,18,710995
80533,11,-19,947,61143,11,61132
80534,12,-7,871,434675,12,434663
80535,8,11,55,969674,8,969666
80536,8,2,780,704912,8,704904
80537,19,12,253,1023942,19,1023923
80538,19,18,507,1212687,19,1212668
80539,13,3,913,748726,13,748713
80540,20,-13,619,245666,20,245646
80541,20,-1,17,616657,20,616637
80542,7,19,878,1237071,7,1237064
80543,16,-20,403,25883,16,25867
80544,8,-11,365,289228,8,289220
80545,14,16,909,1153598,14,1153584
80546,20,14,167,1086751,20,1086731
80547,18,-18,276,87398,18,87380
80548,7,-4,898,518723,7,518716
80549,8,8,648,889394,8,889386
80550,12,-2,703,590436,12,590424
80551,7,0,127,628285,7,628278
80552,12,-1,568,621028,12,621016
80553,19,-11,785,309864,19,309845
80554,9,-6,216,441596,9,441587
80555,17,-8,721,402992,17,402975
80556,10,-15,80,157024,10,157014
80557,19,18,98,1209714,19,1209695
80558,20,-10,204,336557,20,336537
80559,10,10,503,948234,10,948224
80560,16,-14,348,212118,16,212102
80561,12,14,751,1091343,12,1091331
80562,10,-12,991,271223,10,271213
80563,12,-7,614,432834,12,432822
80564,11,14,463,1089071,11,1089060
80565,9,9,220,911493,9,911484
80566,8,-18,992,84051,8,84043
80567,8,9,660,920631,8,920623
80568,18,9,827,935179,18,935161
80569,6,2,418,697666,6,697660
80570,20,13,743,1058757,20,1058737
80571,16,-3,290,555862,16,555846
80572,14,-5,37,491124,14,491110
80573,7,-15,651,169537,7,169530
80574,9,1,364,665238,9,665229
80575,15,6,201,837229,15,837214
80576,19,-1,779,622595,19,622576
80577,14,1,783,685957,14,685943
80578,12,9,446,932286,12,932274
80579,15,-19,795,60157,15,60142
80580,10,5,627,794662,10,794652
80581,6,8,911,894992,6,894986
80582,15,13,279,1055252,15,1055237
80583,15,-10,246,336859,15,336844
80584,5,11,338,975684,5,975679
80585,10,14,712,1078016,10,1078006
80586,20,-14,809,215882,20,215862
80587,5,-8,936,395370,5,395365
80588,13,-20,425,25970,13,25957
80589,19,-10,465,338514,19,338495
80590,9,-14,885,205725,9,205716
80591,20,-15,80,178359,20,178339
80592,6,-6,849,454934,6,454928
80593,10,-1,590,606793,10,606783
80594,19,14,103,1086291,19,1086272
80595,7,-7,473,415962,7,415955
80596,16,-18,874,91571,16,91555
80597,18,16,780,1152658,18,1152640
80598,18,18,53,1209325,18,1209307
80599,8,-9,483,354536,8,354528
80600,12,-5,698,496132,12,496120
80601,18,16,984,1154152,18,1154134
80602,10,18,540,1198366,10,1198356
80603,9,-9,183,347498,9,347489
80604,13,6,607,840663,13,840650
80605,7,-3,905,550691,7,550684
80606,15,10,619,964701,15,964686
80607,13,9,354,931634,13,931621
80608,14,-6,814,465373,14,465359
80609,6,-18,3,62506,6,62500
80610,8,9,193,910808,8,910800
80611,9,7,979,865519,9,865510
80612,7,-8,14,375657,7,375650
80613,15,14,539,1089659,15,1089644
80614,13,-14,925,216706,13,216693
80615,15,-17,257,117388,15,117373
80616,15,4,464,776588,15,776573
80617,8,7,21,845208,8,845200
80618,15,-10,659,340041,15,340026
80619,6,-3,595,543831,6,543825
80620,8,17,396,1163782,8,1163774
80621,18,-10,74,335775,18,335757
80622,10,2,177,692526,10,692516
80623,7,-15,542,167132,7,167125
80624,5,-14,217,191408,5,191403
80625,8,11,870,987192,8,987184
80626,16,0,173,649535,16,649519
80627,6,-2,464,572659,6,572653
80628,19,-3,482,557475,19,557456
80629,20,-6,618,463892,20,463872
80630,20,9,835,935260,20,935240
80631,19,12,381,1024850,19,1024831
80632,10,-1,815,611373,10,611363
80633,13,-10,956,342249,13,342236
80634,5,15,634,1107916,5,1107911
80635,17,-8,750,403217,17,403200
80636,11,10,88,960528,11,960517
80637,12,-2,290,587326,12,587314
80638,9,7,983,865609,9,865600
80639,18,14,365,1088296,18,1088278
80640,20,-7,262,430253,20,430233
80641,9,11,605,981444,9,981435
80642,10,4,196,754873,10,754863
80643,12,7,35,867291,12,867279
80644,15,18,629,1213454,15,1213439
80645,18,-4,291,524340,18,524322
80646,16,-20,161,23983,16,23967
80647,8,-15,409,164317,8,164309
80648,14,-9,38,366899,14,366885
80649,11,-5,311,493371,11,493360
80650,8,-2,3,562838,8,562830
80651,6,11,905,988006,6,988000
80652,9,-4,563,511527,9,511518
80653,10,9,446,916071,10,916061
80654,12,19,414,1244250,12,1244238
80655,16,-11,364,306665,16,306649
80656,6,11,583,981003,6,980997
80657,15,17,877,1184548,15,1184533
80658,7,-15,291,161679,7,161672
80659,14,-19,396,57110,14,57096
80660,8,-12,472,259816,8,259808
80661,17,11,789,996567,17,996550
80662,16,-16,788,152716,16,152700
80663,11,-14,1000,217312,11,217301
80664,15,10,844,966296,15,966281
80665,19,-10,271,337048,19,337029
80666,8,-13,92,220395,8,220387
80667,18,14,824,1091913,18,1091895
80668,8,11,619,981720,8,981712
80669,5,-15,251,160822,5,160817
80670,9,2,450,698228,9,698219
80671,14,-12,167,273741,14,273727
80672,11,-8,786,403484,11,403473
80673,17,-4,878,528658,17,528641
80674,9,7,457,854622,9,854613
80675,19,9,826,935169,19,935150
80676,14,-13,119,241896,14,241882
80677,5,-16,442,133760,5,133755
80678,16,8,581,902512,16,902496
80679,5,7,600,857578,5,857573
80680,16,-1,805,622754,16,622738
80681,16,4,908,779961,16,779945
80682,12,13,286,1055297,12,1055285
80683,7,-12,95,251594,7,251587
80684,9,-3,501,541704,9,541695
80685,19,-3,284,555790,19,555771
80686,7,-16,173,127672,7,127665
80687,7,-18,472,72555,7,72548
80688,17,10,599,964551,17,964534
80689,16,14,252,1087406,16,1087390
80690,13,13,143,1054252,13,1054239
80691,6,3,746,734994,6,734988
80692,10,-15,995,176656,10,176646
80693,16,-17,749,121199,16,121183
80694,20,-12,905,279347,20,279327
80695,18,-6,84,459682,18,459664
80696,15,-14,727,215169,15,215154
80697,10,12,730,1015059,10,1015049
80698,13,14,387,1088423,13,1088410
80699,5,-6,5,436969,5,436964
80700,19,11,991,997988,19,997969
80701,12,-13,713,246271,12,246259
80702,14,-17,398,118404,14,118390
80703,20,-14,180,210696,20,210676
80704,16,-15,922,184789,16,184773
80705,15,-7,616,432848,15,432833
80706,19,-4,12,522146,19,522127
80707,9,-1,922,613854,9,613845
80708,12,-1,575,621082,12,621070
80709,19,-7,746,433696,19,433677
80710,5,15,550,1106106,5,1106101
80711,10,-20,237,5341,10,5331
80712,8,-17,255,98898,8,98890
80713,6,2,180,692598,6,692592
80714,8,-4,713,514735,8,514727
80715,18,-13,926,247989,18,247971
80716,11,14,917,1092580,11,1092569
80717,12,2,762,716272,12,716260
80718,14,17,268,1179928,14,1179914
80719,10,-9,407,352517,10,352507
80720,12,-3,989,561688,12,561676
80721,12,5,377,806570,12,806558
80722,10,18,584,1199105,10,1199095
80723,10,5,467,791320,10,791310
80724,11,-17,907,122225,11,122214
80725,19,-12,495,276198,19,276179
80726,16,-9,283,368661,16,368645
80727,14,14,134,1086537,14,1086523
80728,11,2,447,713995,11,713984
80729,10,-19,700,46891,10,46881
80730,7,-15,179,159251,7,159244
80731,9,-4,853,517584,9,517575
80732,11,-20,794,28968,11,28957
80733,5,19,103,1219788,5,1219783
80734,6,-4,861,517827,6,517821
80735,15,-9,46,366976,15,366961
80736,10,2,55,689799,10,689789
80737,15,-12,619,277034,15,277019
80738,16,-14,397,212664,16,212648
80739,6,0,210,630038,6,630032
80740,20,12,288,1024260,20,1024240
80741,7,-2,873,581492,7,581485
80742,8,19,137,1220452,8,1220444
80743,9,14,641,1076266,9,1076257
80744,13,-7,908,435014,13,435001
80745,14,-18,342,87897,14,87883
80746,5,-10,565,324939,5,324934
80747,5,12,816,1016826,5,1016821
80748,12,13,728,1058666,12,1058654
80749,8,6,528,824339,8,824331
80750,5,-16,264,129774,5,129769
80751,18,0,216,649870,18,649852
80752,18,17,319,1180365,18,1180347
80753,6,-12,668,264043,6,264037
80754,6,3,617,731978,6,731972
80755,12,-20,74,23350,12,23338
80756,5,-16,239,129281,5,129276
80757,19,-13,734,246447,19,246428
80758,14,16,248,1148887,14,1148873
80759,14,7,806,872848,14,872834
80760,11,17,602,1182337,11,1182326
80761,17,7,41,867341,17,867324
80762,19,0,952,655526,19,655507
80763,5,19,454,1227953,5,1227948
80764,13,-18,450,88644,13,88631
80765,8,12,733,1015097,8,1015089
80766,16,15,984,1124019,16,1124003
80767,11,-7,282,430450,11,430439
80768,19,3,682,747042,19,747023
80769,9,3,117,721381,9,721372
80770,16,15,893,1123295,16,1123279
80771,15,14,218,1087112,15,1087097
80772,19,0,921,655274,19,655255
80773,11,12,864,1028571,11,1028560
80774,11,-6,92,459767,11,459756
80775,14,-2,65,585651,14,585637
80776,15,-6,240,461056,15,461041
80777,18,13,752,1058833,18,1058815
80778,12,-10,921,342008,12,341996
80779,17,12,296,1024332,17,1024315
80780,13,-4,98,522784,13,522771
80781,15,0,836,654625,15,654610
80782,11,-2,999,592695,11,592684
80783,19,-5,230,492666,19,492647
80784,16,12,940,1029334,16,1029318
80785,8,-3,829,548883,8,548875
80786,18,15,663,1121672,18,1121654
80787,12,19,754,1246887,12,1246875
80788,19,18,184,1210480,19,1210461
80789,8,-20,317,7091,8,7083
80790,9,-5,426,477210,9,477201
80791,15,5,865,810070,15,810055
80792,10,2,260,694239,10,694229
80793,16,-20,809,29118,16,29102
80794,8,-10,378,320749,8,320741
80795,20,17,603,1182346,20,1182326
80796,7,-9,40,344480,7,344473
80797,14,14,433,1088868,14,1088854
80798,11,17,112,1178658,11,1178647
80799,13,9,300,931152,13,931139
80800,19,2,320,713007,19,712988
80801,13,11,899,997416,13,997403
80802,6,-12,202,253807,6,253801
80803,20,-9,899,373732,20,373712
80804,12,-3,519,557817,12,557805
80805,10,-5,346,475760,10,475750
80806,11,15,30,1117007,11,1116996
80807,15,-2,408,588172,15,588157
80808,19,-3,95,554467,19,554448
80809,5,17,68,1156781,5,1156776
80810,8,12,936,1019704,8,1019696
80811,15,-8,148,398974,15,398959
80812,8,-17,243,98631,8,98623
80813,7,-18,894,81788,7,81781
80814,13,-14,904,216546,13,216533
80815,6,4,11,750758,6,750752
80816,14,-18,396,88283,14,88269
80817,17,5,123,804681,17,804664
80818,9,-20,858,19011,9,19002
80819,19,11,597,995178,19,995159
80820,5,-6,145,439846,5,439841
80821,14,-5,728,496372,14,496358
80822,10,7,223,849519,10,849509
80823,15,-8,628,402256,15,402241
80824,14,-11,497,307742,14,307728
80825,14,-15,952,185052,14,185038
80826,6,-1,457,603995,6,603989
80827,5,-4,250,505142,5,505137
80828,18,13,823,1059408,18,1059390
80829,11,11,482,994382,11,994371
80830,6,2,505,699347,6,699341
80831,11,17,579,1182119,11,1182108
80832,7,13,228,1035572,7,1035565
80833,5,-20,897,19896,5,19891
80834,13,-15,28,178024,13,178011
80835,6,-15,954,175827,6,175821
80836,16,6,867,842687,16,842671
80837,18,-5,26,491011,18,490993
80838,18,-15,312,180023,18,180005
80839,10,-8,797,392394,10,392384
80840,20,-13,696,246084,20,246064
80841,9,-13,611,231463,9,231454
80842,17,-9,469,370335,17,370318
80843,5,1,286,663411,5,663406
80844,14,19,977,1248631,14,1248617
80845,19,16,638,1151678,19,1151659
80846,7,-18,780,79398,7,79391
80847,15,-8,563,401821,15,401806
80848,14,0,797,654361,14,654347
80849,17,3,454,745234,17,745217
80850,18,-9,257,368475,18,368457
80851,12,-5,927,497830,12,497818
80852,5,-7,123,408423,5,408418
80853,16,-17,400,118424,16,118408
80854,17,-10,657,340024,17,340007
80855,5,-14,846,204916,5,204911
80856,16,-5,279,493095,16,493079
80857,20,-5,13,490849,20,490829
80858,17,-15,746,183336,17,183319
80859,9,-19,226,36538,9,36529
80860,20,2,626,715250,20,715230
80861,10,-8,41,376269,10,376259
80862,18,8,710,903615,18,903597
80863,13,-17,367,118204,13,118191
80864,17,-1,509,620597,17,620580
80865,7,14,988,1083991,7,1083984
80866,15,-7,674,433168,15,433153
80867,18,-5,817,496918,18,496900
80868,10,7,159,848239,10,848229
80869,14,-4,596,526571,14,526557
80870,20,-19,719,59606,20,59586
80871,15,4,394,776049,15,776034
80872,20,3,360,744601,20,744581
80873,9,14,143,1065076,9,1065067
80874,15,-20,36,20864,15,20849
80875,14,-13,340,243561,14,243547
80876,18,1,94,680534,18,680516
80877,12,14,987,1093197,12,1093185
80878,10,-9,181,347422,10,347412
80879,20,-16,555,151083,20,151063
80880,19,4,490,776771,19,776752
80881,9,-11,571,293785,9,293776
80882,18,-12,138,273574,18,273556
80883,8,19,112,1219968,8,1219960
80884,5,15,371,1102334,5,1102329
80885,9,-9,211,348074,9,348065
80886,20,12,701,1027344,20,1027324
80887,15,-8,874,404086,15,404071
80888,13,11,869,997186,13,997173
80889,16,0,192,649730,16,649714
80890,15,-1,407,619804,15,619789
80891,15,-11,878,310621,15,310606
80892,17,-10,508,338871,17,338854
80893,5,-7,279,411813,5,411808
80894,19,-18,956,92200,19,92181
80895,14,-14,196,210818,14,210804
80896,18,-11,109,304558,18,304540
80897,6,2,891,707196,6,707190
80898,10,-1,831,611738,10,611728
80899,17,11,853,997045,17,997028
80900,9,10,109,939972,9,939963
80901,20,-19,583,58650,20,58630
80902,19,-19,715,59577,19,59558
80903,9,-1,754,610002,9,609993
80904,14,-18,505,88978,14,88964
80905,12,19,523,1245139,12,1245127
80906,9,7,935,864595,9,864586
80907,20,-8,776,403405,20,403385
80908,5,16,551,1136845,5,1136840
80909,18,-13,787,246905,18,246887
80910,10,-8,683,390032,10,390022
80911,19,18,313,1211362,19,1211343
80912,13,18,297,1211274,13,1211261
80913,9,-20,799,17718,9,17709
80914,5,2,180,692603,5,692598
80915,7,6,915,832869,7,832862
80916,8,-12,180,253319,8,253311
80917,17,15,337,1119251,17,1119234
80918,10,-19,5,31565,10,31555
80919,7,-13,569,230499,7,230492
80920,18,-1,794,622685,18,622667
80921,8,9,729,922067,8,922059
80922,13,-6,857,465633,13,465620
80923,18,17,4,1177888,18,1177870
80924,8,-9,493,354861,8,354853
80925,14,-18,354,88003,14,87989
80926,20,16,638,1151688,20,1151668
80927,17,-9,383,369515,17,369498
80928,5,10,868,956189,5,956184
80929,6,-6,177,440723,6,440717
80930,6,5,60,782947,6,782941
80931,17,7,890,873399,17,873382
80932,14,-20,389,25773,14,25759
80933,16,7,570,871235,16,871219
80934,7,14,718,1078198,7,1078191
80935,17,15,714,1122088,17,1122071
80936,18,16,254,1148945,18,1148927
80937,19,-12,284,274626,19,274607
80938,11,-13,142,242039,11,242028
80939,9,-8,39,376207,9,376198
80940,12,8,934,905220,12,905208
80941,13,6,821,842372,13,842359
80942,6,-11,998,302635,6,302629
80943,16,-5,864,497325,16,497309
80944,12,7,967,873850,12,873838
80945,6,-8,253,380871,6,380865
80946,12,18,800,1214784,12,1214772
80947,19,19,234,1242573,19,1242554
80948,14,-8,519,401466,14,401452
80949,17,8,515,902067,17,902050
80950,7,0,761,642084,7,642077
80951,12,14,971,1093036,12,1093024
80952,14,5,242,805627,14,805613
80953,6,-16,4,123877,6,123871
80954,18,-6,722,464670,18,464652
80955,18,16,607,1151389,18,1151371
80956,16,11,646,995426,16,995410
80957,13,4,59,773668,13,773655
80958,16,-11,600,308519,16,308503
80959,18,7,912,873537,18,873519
80960,18,-7,717,433546,18,433528
80961,7,-13,510,229197,7,229190
80962,15,14,967,1092992,15,1092977
80963,13,4,251,775056,13,775043
80964,13,-19,930,61009,13,60996
80965,9,12,788,1016173,9,1016164
80966,5,5,677,795612,5,795607
80967,20,9,879,935612,20,935592
80968,11,-13,297,243316,11,243305
80969,16,10,149,961015,16,960999
80970,8,9,571,918819,8,918811
80971,19,4,902,779937,19,779918
80972,7,-7,695,420621,7,420614
80973,12,-16,295,149138,12,149126
80974,6,17,824,1173029,6,1173023
80975,11,-14,683,214878,11,214867
80976,8,14,104,1064182,8,1064174
80977,6,5,345,788752,6,788746
80978,8,-3,23,531061,8,531053
80979,9,-11,67,282591,9,282582
80980,17,2,74,711135,17,711118
80981,13,19,37,1240991,13,1240978
80982,14,-4,199,523617,14,523603
80983,18,7,287,869086,18,869068
80984,17,-16,342,149410,17,149393
80985,10,19,522,1229418,10,1229408
80986,16,-8,162,399058,16,399042
80987,8,-16,131,126917,8,126909
80988,12,19,129,1241812,12,1241800
80989,7,0,264,631115,7,631108
80990,19,-3,446,557205,19,557186
80991,14,8,514,902051,14,902037
80992,19,-6,129,460078,19,460059
80993,14,-17,321,117873,14,117859
80994,17,11,830,996836,17,996819
80995,16,-20,677,28017,16,28001
80996,13,-8,207,399351,13,399338
80997,20,-8,287,399902,20,399882
80998,18,-6,619,463902,18,463884
80999,13,2,246,712420,13,712407
81000,8,-20,243,5478,8,5470
81001,8,-12,992,271273,8,271265
81002,17,17,650,1182707,17,1182690
81003,9,-8,425,384139,9,384130
81004,11,-20,653,27783,11,27772
81005,13,17,492,1181582,13,1181569
81006,11,-9,688,371869,11,371858
81007,11,10,289,961992,11,961981
81008,6,4,280,756601,6,756595
81009,10,-7,708,420863,10,420853
81010,8,-3,105,532685,8,532677
81011,7,-12,705,264763,7,264756
81012,5,-12,518,260871,5,260866
81013,15,8,47,898241,15,898226
81014,10,7,183,848686,10,848676
81015,17,-20,517,26726,17,26709
81016,19,-7,518,432257,19,432238
81017,7,11,635,982006,7,981999
81018,18,12,412,1025052,18,1025034
81019,8,0,482,635821,8,635813
81020,16,-8,57,398371,16,398355
81021,14,-6,891,465856,14,465842
81022,17,-10,433,338232,17,338215
81023,20,-15,218,179305,20,179285
81024,11,9,1000,936519,11,936508
81025,5,-18,674,76844,5,76839
81026,18,-14,290,211677,18,211659
81027,6,1,311,663936,6,663930
81028,6,-13,94,220437,6,220431
81029,15,15,324,1119167,15,1119152
81030,19,7,238,868694,19,868675
81031,20,5,39,804063,20,804043
81032,19,7,239,868716,19,868697
81033,11,0,940,655377,11,655366
81034,13,-8,684,402765,13,402752
81035,11,-8,238,399591,11,399580
81036,20,-8,144,398930,20,398910
81037,20,5,71,804339,20,804319
81038,7,-8,288,381493,7,381486
81039,12,16,847,1153166,12,1153154
81040,14,15,251,1118656,14,1118642
81041,5,-13,399,226697,5,226692
81042,5,12,937,1019726,5,1019721
81043,14,-4,784,527906,14,527892
81044,12,-17,103,116355,12,116343
81045,8,17,164,1158700,8,1158692
81046,16,0,773,654179,16,654163
81047,13,19,153,1241992,13,1241979
81048,7,15,960,1114954,7,1114947
81049,19,9,442,932250,19,932231
81050,16,-12,491,276131,16,276115
81051,11,17,928,1184860,11,1184849
81052,5,-7,370,413911,5,413906
81053,19,12,659,1026959,19,1026940
81054,19,-1,360,619507,19,619488
81055,18,6,987,843645,18,843627
81056,20,11,542,994764,20,994744
81057,11,-12,126,273492,11,273481
81058,16,-11,770,309754,16,309738
81059,15,3,659,746832,15,746817
81060,15,-5,90,491617,15,491602
81061,10,2,389,697035,10,697025
81062,10,7,215,849345,10,849335
81063,11,-13,542,245013,11,245002
81064,7,10,422,946552,7,946545
81065,8,19,884,1237228,8,1237220
81066,14,19,394,1243989,14,1243975
81067,19,18,190,1210573,19,1210554
81068,9,3,913,738595,9,738586
81069,9,1,695,672174,9,672165
81070,5,5,366,789179,5,789174
81071,12,-6,454,462611,12,462599
81072,20,-18,588,89511,20,89491
81073,9,-13,942,238759,9,238750
81074,19,-7,269,430316,19,430297
81075,15,2,240,712373,15,712358
81076,13,-6,279,461371,13,461358
81077,14,3,865,748367,14,748353
81078,15,14,1,1085366,15,1085351
81079,9,-15,735,171233,9,171224
81080,11,-1,992,624116,11,624105
81081,17,-3,400,556741,17,556724
81082,10,-11,491,292179,10,292169
81083,8,-13,270,224205,8,224197
81084,20,13,294,1055398,20,1055378
81085,12,3,448,745209,12,745197
81086,14,-14,555,213781,14,213767
81087,12,-11,796,309912,12,309900
81088,15,-3,378,556597,15,556582
81089,8,5,861,799652,8,799644
81090,5,-11,881,300078,5,300073
81091,14,16,928,1153764,14,1153750
81092,6,-10,693,327636,6,327630
81093,10,12,789,1016208,10,1016198
81094,16,3,726,747350,16,747334
81095,5,14,118,1064494,5,1064489
81096,11,10,211,961429,11,961418
81097,18,-2,101,585892,18,585874
81098,13,-2,921,592134,13,592121
81099,16,-7,894,434932,16,434916
81100,20,-9,81,367273,20,367253
81101,12,-12,999,280104,12,280092
81102,12,-11,843,310286,12,310274
81103,19,9,970,936356,19,936337
81104,7,-10,657,326860,7,326853
81105,15,-5,313,493394,15,493379
81106,8,-13,71,219897,8,219889
81107,17,11,806,996709,17,996692
81108,14,-15,492,181408,14,181394
81109,15,-2,146,586194,15,586179
81110,10,-4,692,514356,10,514346
81111,10,-17,784,110236,10,110226
81112,5,13,449,1040415,5,1040410
81113,5,6,280,818599,5,818594
81114,8,9,806,923868,8,923860
81115,7,-11,204,285554,7,285547
81116,6,-6,327,443869,6,443863
81117,13,-14,110,210173,13,210160
81118,14,18,491,1212569,14,1212555
81119,19,-15,563,181929,19,181910
81120,13,5,188,805223,13,805210
81121,18,15,457,1120017,18,1119999
81122,13,-19,746,59883,13,59870
81123,20,-14,226,211148,20,211128
81124,18,4,599,777642,18,777624
81125,10,-14,286,192965,10,192955
81126,7,-13,118,220935,7,220928
81127,8,-8,5,375417,8,375409
81128,7,-7,182,409736,7,409729
81129,5,11,74,970075,5,970070
81130,20,-2,64,585644,20,585624
81131,15,13,992,1060562,15,1060547
81132,10,-10,486,323230,10,323220
81133,11,0,105,649074,11,649063
81134,8,3,459,728656,8,728648
81135,20,12,931,1029227,20,1029207
81136,16,-18,86,85869,16,85853
81137,7,-15,113,157956,7,157949
81138,9,-14,266,192606,9,192597
81139,6,10,147,940774,6,940768
81140,10,-14,208,191124,10,191114
81141,5,-2,419,571645,5,571640
81142,15,-9,278,368615,15,368600
81143,8,14,311,1068674,8,1068666
81144,6,13,438,1040235,6,1040229
81145,11,-12,668,277447,11,277436
81146,15,4,25,773438,15,773423
81147,5,-13,260,223933,5,223928
81148,7,-19,731,47628,7,47621
81149,10,0,972,646496,10,646486
81150,8,18,263,1192606,8,1192598
81151,10,1,517,668630,10,668620
81152,17,13,917,1059973,17,1059956
81153,5,-15,264,161034,5,161029
81154,16,12,80,1022634,16,1022618
81155,20,16,704,1152127,20,1152107
81156,11,18,248,1210972,11,1210961
81157,15,12,910,1029029,15,1029014
81158,19,3,946,749062,19,749043
81159,17,8,848,904586,17,904569
81160,12,-2,259,587076,12,587064
81161,13,-2,556,589335,13,589322
81162,15,13,71,1053758,15,1053743
81163,7,7,875,863408,7,863401
81164,16,-17,41,115865,16,115849
81165,9,-15,192,159412,9,159403
81166,16,9,941,936111,16,936095
81167,11,-14,198,210838,11,210827
81168,7,4,333,757719,7,757712
81169,20,-10,158,336261,20,336241
81170,15,-4,940,529118,15,529103
81171,11,19,741,1246808,11,1246797
81172,10,-8,857,393644,10,393634
81173,15,10,989,967378,15,967363
81174,5,6,386,821006,5,821001
81175,5,17,958,1175885,5,1175880
81176,17,-11,445,307334,17,307317
81177,15,12,110,1022864,15,1022849
81178,17,19,24,1240908,17,1240891
81179,11,-6,99,459833,11,459822
81180,11,3,592,746260,11,746249
81181,12,-5,282,493119,12,493107
81182,6,-18,475,72653,6,72647
81183,9,2,444,698127,9,698118
81184,13,13,834,1059478,13,1059465
81185,7,11,472,978541,7,978534
81186,11,5,278,805875,11,805864
81187,18,16,899,1153489,18,1153471
81188,18,19,670,1246210,18,1246192
81189,10,-20,219,4989,10,4979
81190,20,-10,235,336795,20,336775
81191,19,0,993,655893,19,655874
81192,12,-3,405,556793,12,556781
81193,7,-5,477,478348,7,478341
81194,17,17,266,1179919,17,1179902
81195,9,7,949,864836,9,864827
81196,17,15,662,1121662,17,1121645
81197,17,19,863,1247785,17,1247768
81198,16,-1,114,617427,16,617411
81199,15,12,585,1026368,15,1026353
81200,11,19,176,1242145,11,1242134
81201,14,0,8,648241,14,648227
81202,15,-3,808,560285,15,560270
81203,7,-20,606,13282,7,13275
81204,10,16,235,1130268,10,1130258
81205,19,9,650,933857,19,933838
81206,9,19,94,1219582,9,1219573
81207,14,-2,663,590138,14,590124
81208,18,17,123,1178773,18,1178755
81209,9,8,683,890269,9,890260
81210,14,8,608,902747,14,902733
81211,6,-17,547,105306,6,105300
81212,19,-5,203,492441,19,492422
81213,7,4,281,756607,7,756600
81214,12,-20,369,25642,12,25630
81215,19,-8,392,400683,19,400664
81216,12,3,186,743290,12,743278
81217,13,9,678,934050,13,934037
81218,8,2,727,703986,8,703978
81219,20,-14,936,216771,20,216751
81220,9,8,852,893661,9,893652
81221,17,2,531,714618,17,714601
81222,6,5,703,796269,6,796263
81223,11,-9,518,370765,11,370754
81224,7,-18,655,76478,7,76471
81225,9,-4,679,514149,9,514140
81226,16,6,325,838318,16,838302
81227,18,18,343,1211604,18,1211586
81228,7,-18,903,82052,7,82045
81229,11,4,47,773586,11,773575
81230,15,19,5,1240684,15,1240669
81231,8,4,817,768451,8,768443
81232,10,-5,465,478070,10,478060
81233,20,17,324,1180413,20,1180393
81234,16,-20,960,30053,16,30037
81235,10,15,711,1109605,10,1109595
81236,9,6,93,814235,9,814226
81237,6,16,655,1138928,6,1138922
81238,20,18,92,1209669,20,1209649
81239,15,-12,452,275774,15,275759
81240,8,-18,461,72365,8,72357
81241,19,-5,483,494647,19,494628
81242,8,-18,133,65383,8,65375
81243,8,-10,168,316331,8,316323
81244,11,-2,636,589893,11,589882
81245,17,-14,859,216228,17,216211
81246,10,11,28,969074,10,969064
81247,20,10,12,959926,20,959906
81248,19,8,324,900535,19,900516
81249,19,-15,421,180901,19,180882
81250,14,17,69,1178387,14,1178373
81251,16,-6,761,464956,16,464940
81252,12,6,779,842000,12,841988
81253,13,3,285,744068,13,744055
81254,19,-13,448,244294,19,244275
81255,16,17,26,1178060,16,1178044
81256,12,-1,32,616805,12,616793
81257,16,-19,25,54084,16,54068
81258,17,1,773,685899,17,685882
81259,8,9,233,911650,8,911642
81260,11,-17,25,115747,11,115736
81261,17,14,645,1090482,17,1090465
81262,7,-16,8,123965,7,123958
81263,13,8,15,898034,13,898021
81264,17,16,446,1150354,17,1150337
81265,11,0,544,652343,11,652332
81266,20,4,386,776016,20,775996
81267,20,-4,211,523746,20,523726
81268,9,-4,168,503073,9,503064
81269,14,-11,589,308431,14,308417
81270,20,19,713,1246555,20,1246535
81271,13,-6,772,465053,13,465040
81272,18,-3,247,555529,18,555511
81273,9,-19,973,52361,9,52352
81274,15,-6,215,460819,15,460804
81275,15,12,461,1025428,15,1025413
81276,14,-1,150,617684,14,617670
81277,8,17,776,1171812,8,1171804
81278,16,-13,824,247133,16,247117
81279,19,-2,336,587623,19,587604
81280,10,-7,90,407755,10,407745
81281,12,-14,494,213329,12,213317
81282,13,-4,621,526762,13,526749
81283,19,5,38,804052,19,804033
81284,17,-13,288,243237,17,243220
81285,15,2,899,717184,15,717169
81286,8,-9,584,356787,8,356779
81287,7,-9,449,353562,7,353555
81288,8,-10,623,326084,8,326076
81289,18,16,991,1154214,18,1154196
81290,11,17,906,1184752,11,1184741
81291,20,-1,862,623169,20,623149
81292,6,-4,153,502702,6,502696
81293,11,-19,963,61231,11,61220
81294,20,6,771,841962,20,841942
81295,9,11,512,979400,9,979391
81296,12,16,413,1150149,12,1150137
81297,5,12,387,1007439,5,1007434
81298,16,10,856,966396,16,966380
81299,6,-20,804,17867,6,17861
81300,20,11,291,992993,20,992973
81301,11,15,782,1122523,11,1122512
81302,8,10,830,955426,8,955418
81303,7,7,682,859279,7,859272
81304,7,15,125,1097252,7,1097245
81305,6,-12,65,251009,6,251003
81306,13,-12,415,275564,13,275551
81307,12,-17,699,120738,12,120726
81308,5,13,22,1031280,5,1031275
81309,10,-4,342,506992,10,506982
81310,19,-8,783,403462,19,403443
81311,17,14,936,1092787,17,1092770
81312,6,16,409,1133970,6,1133964
81313,15,-13,756,246621,15,246606
81314,20,-12,931,279526,20,279506
81315,7,-13,138,221318,7,221311
81316,15,16,661,1151864,15,1151849
81317,18,16,278,1149154,18,1149136
81318,16,-1,533,620810,16,620794
81319,7,-12,477,259906,7,259899
81320,11,-15,548,181839,11,181828
81321,13,1,138,680959,13,680946
81322,10,0,311,631898,10,631888
81323,14,-10,606,339606,14,339592
81324,8,-18,3,62514,8,62506
81325,7,-4,70,500884,7,500877
81326,9,14,545,1074005,9,1073996
81327,16,3,689,747082,16,747066
81328,11,0,412,651226,11,651215
81329,11,14,773,1091557,11,1091546
81330,11,-14,933,216742,11,216731
81331,19,-6,420,462373,19,462354
81332,13,18,3,1208925,13,1208912
81333,20,11,860,997100,20,997080
81334,15,-6,683,464346,15,464331
81335,5,2,772,704816,5,704811
81336,9,3,33,719571,9,719562
81337,14,-5,19,490929,14,490915
81338,8,19,92,1219555,8,1219547
81339,17,9,98,929791,17,929774
81340,16,-13,996,248576,16,248560
81341,6,5,865,799797,6,799791
81342,15,14,907,1092538,15,1092523
81343,5,14,276,1068002,5,1067997
81344,9,15,982,1115384,9,1115375
81345,14,1,344,682641,14,682627
81346,9,-18,489,72965,9,72956
81347,18,14,153,1086666,18,1086648
81348,10,4,149,753836,10,753826
81349,13,-3,762,559902,13,559889
81350,10,-11,155,284563,10,284553
81351,11,-3,539,558092,11,558081
81352,10,-16,733,139752,10,139742
81353,9,1,801,674436,9,674427
81354,9,15,169,1098055,9,1098046
81355,14,6,131,836752,14,836738
81356,12,8,399,901136,12,901124
81357,9,-3,359,538302,9,538293
81358,5,-16,55,125023,5,125018
81359,14,17,954,1185036,14,1185022
81360,15,-10,505,338850,15,338835
81361,5,-1,217,598493,5,598488
81362,12,-9,910,373808,12,373796
81363,17,-10,708,340420,17,340403
81364,7,-3,458,540704,7,540697
81365,8,18,866,1205026,8,1205018
81366,11,12,326,1024505,11,1024494
81367,18,-4,433,525423,18,525405
81368,9,-20,747,16442,9,16433
81369,11,-12,790,278295,11,278284
81370,20,-9,370,369417,20,369397
81371,9,15,333,1101614,9,1101605
81372,8,6,235,817504,8,817496
81373,19,-15,945,184996,19,184977
81374,5,15,280,1100506,5,1100501
81375,6,13,653,1044843,6,1044837
81376,12,-1,451,620135,12,620123
81377,5,-7,631,419216,5,419211
81378,17,17,576,1182095,17,1182078
81379,9,10,788,954502,9,954493
81380,18,13,194,1054653,18,1054635
81381,12,-10,63,335662,12,335650
81382,19,17,463,1181398,19,1181379
81383,11,-6,306,461545,11,461534
81384,8,-18,29,63039,8,63031
81385,13,-9,870,373486,13,373473
81386,9,-15,571,167739,9,167730
81387,11,19,890,1247997,11,1247986
81388,15,-12,218,274108,15,274093
81389,5,-1,463,604185,5,604180
81390,20,6,323,838292,20,838272
81391,15,3,915,748747,15,748732
81392,20,-8,988,404930,20,404910
81393,13,-8,497,401298,13,401285
81394,6,13,587,1043432,6,1043426
81395,10,10,615,950759,10,950749
81396,14,-2,14,585232,14,585218
81397,6,16,592,1137650,6,1137644
81398,5,17,450,1164972,5,1164967
81399,17,17,970,1185225,17,1185208
81400,16,-19,85,54594,16,54578
81401,20,-15,622,182339,20,182319
81402,10,15,767,1110751,10,1110741
81403,13,-19,914,60901,13,60888
81404,16,-7,635,432965,16,432949
81405,5,-12,155,252882,5,252877
81406,7,-7,839,423617,7,423610
81407,11,-10,540,339087,11,339076
81408,10,-7,535,417358,10,417348
81409,10,-5,421,477101,10,477091
81410,13,-3,90,554416,13,554403
81411,18,-9,267,368537,18,368519
81412,16,18,639,1213596,16,1213580
81413,14,5,385,806630,14,806616
81414,19,-3,978,561629,19,561610
81415,17,18,575,1213130,17,1213113
81416,7,-18,224,67326,7,67319
81417,14,12,248,1023891,14,1023877
81418,10,16,5,1125307,10,1125297
81419,15,11,67,991382,15,991367
81420,7,-20,598,13096,7,13089
81421,10,1,268,663046,10,663036
81422,14,14,382,1088403,14,1088389
81423,10,-6,665,451053,10,451043
81424,9,-16,339,131205,9,131196
81425,12,-7,616,432850,12,432838
81426,19,5,857,809993,19,809974
81427,5,-2,986,583914,5,583909
81428,20,6,818,842352,20,842332
81429,5,6,67,813656,5,813651
81430,16,16,756,1152456,16,1152440
81431,10,16,734,1140323,10,1140313
81432,17,-18,815,91191,17,91174
81433,6,-19,589,44446,6,44440
81434,18,-6,981,466595,18,466577
81435,13,15,550,1120731,13,1120718
81436,18,9,745,934505,18,934487
81437,16,-8,815,403737,16,403721
81438,14,15,651,1121585,14,1121571
81439,18,-8,289,399919,18,399901
81440,12,19,404,1244099,12,1244087
81441,13,-11,782,309853,13,309840
81442,19,5,578,808003,19,807984
81443,10,-7,882,424707,10,424697
81444,7,18,739,1202216,7,1202209
81445,12,-5,460,494442,12,494430
81446,6,2,518,699673,6,699667
81447,18,8,592,902618,18,902600
81448,8,15,31,1095151,8,1095143
81449,10,-2,150,566013,10,566003
81450,11,19,141,1241910,11,1241899
81451,9,-13,320,225173,9,225164
81452,18,4,28,773465,18,773447
81453,18,1,859,686502,18,686484
81454,5,-15,294,161730,5,161725
81455,12,1,748,685698,12,685686
81456,5,6,632,826571,5,826566
81457,10,1,2,657070,10,657060
81458,7,-13,616,231582,7,231575
81459,5,-3,658,545311,5,545306
81460,15,4,155,774388,15,774373
81461,18,10,418,963037,18,963019
81462,6,1,675,671870,6,671864
81463,8,-8,763,391733,8,391725
81464,12,-16,225,148653,12,148641
81465,9,17,805,1172610,9,1172601
81466,15,-4,581,526477,15,526462
81467,14,1,239,681790,14,681776
81468,18,-18,952,92148,18,92130
81469,10,-12,310,256384,10,256374
81470,6,2,500,699282,6,699276
81471,15,-2,697,590414,15,590399
81472,6,10,344,944818,6,944812
81473,16,-6,965,466442,16,466426
81474,20,0,639,653095,20,653075
81475,9,-14,470,196883,9,196874
81476,17,12,931,1029234,17,1029217
81477,17,-11,111,304582,17,304565
81478,11,-11,486,307608,11,307597
81479,18,18,531,1212874,18,1212856
81480,11,-14,131,210322,11,210311
81481,13,-11,869,310519,13,310506
81482,5,14,149,1065196,5,1065191
81483,18,-15,488,181373,18,181355
81484,12,-11,246,305617,12,305605
81485,15,4,569,777385,15,777370
81486,10,-10,6,312639,10,312629
81487,20,9,480,932551,20,932531
81488,16,-6,552,463464,16,463448
81489,6,-16,639,137884,6,137878
81490,14,5,116,804640,14,804626
81491,16,-13,999,248604,16,248588
81492,18,0,367,650824,18,650806
81493,9,-12,514,260796,9,260787
81494,6,-17,472,103535,6,103529
81495,11,-13,107,241838,11,241827
81496,16,19,391,1243967,16,1243951
81497,15,-2,612,589744,15,589729
81498,6,-20,700,15460,6,15454
81499,12,14,522,1089528,12,1089516
81500,6,1,307,663856,6,663850
81501,18,7,474,870565,18,870547
81502,12,-4,836,528186,12,528174
81503,9,-1,877,612767,9,612758
81504,16,-1,470,620332,16,620316
81505,12,-13,119,241898,12,241886
81506,5,-6,144,439832,5,439827
81507,11,-16,943,153859,11,153848
81508,9,9,704,921595,9,921586
81509,16,-4,500,525865,16,525849
81510,10,9,352,914170,10,914160
81511,18,1,623,684764,18,684746
81512,15,8,75,898484,15,898469
81513,17,15,231,1118542,17,1118525
81514,6,2,284,694762,6,694756
81515,16,-2,288,587308,16,587292
81516,13,-18,277,87404,13,87391
81517,7,8,167,878752,7,878745
81518,20,17,957,1185070,20,1185050
81519,6,-9,101,345785,6,345779
81520,10,14,534,1073770,10,1073760
81521,14,-20,69,23310,14,23296
81522,17,6,804,842217,17,842200
81523,14,-18,536,89162,14,89148
81524,11,15,635,1121444,11,1121433
81525,12,-13,831,247197,12,247185
81526,13,17,825,1184141,13,1184128
81527,16,16,743,1152388,16,1152372
81528,5,3,328,726052,5,726047
81529,12,3,240,743692,12,743680
81530,11,-17,539,119518,11,119507
81531,16,-12,250,274342,16,274326
81532,17,-3,9,553929,17,553912
81533,7,-13,134,221228,7,221221
81534,9,14,141,1065020,9,1065011
81535,14,4,183,774567,14,774553
81536,13,3,226,743588,13,743575
81537,9,9,566,918693,9,918684
81538,7,6,833,831116,7,831109
81539,7,13,674,1045270,7,1045263
81540,13,-11,300,306108,13,306095
81541,19,-9,996,374231,19,374212
81542,16,-18,740,90665,16,90649
81543,17,14,449,1088970,17,1088953
81544,5,-8,803,392515,5,392510
81545,19,-1,844,623042,19,623023
81546,14,16,369,1149805,14,1149791
81547,8,15,421,1103259,8,1103251
81548,11,-18,472,88810,11,88799
81549,12,-10,868,341605,12,341593
81550,19,-2,650,590035,19,590016
81551,7,-14,33,187234,7,187227
81552,20,-12,438,275684,20,275664
81553,8,17,653,1169291,8,1169283
81554,15,12,43,1022420,15,1022405
81555,16,5,531,807660,16,807644
81556,12,18,510,1212703,12,1212691
81557,5,14,33,1062569,5,1062564
81558,19,-1,21,616687,19,616668
81559,19,10,213,961449,19,961430
81560,10,4,404,759372,10,759362
81561,10,16,799,1141771,10,1141761
81562,11,7,9,867088,11,867077
81563,19,12,543,1026072,19,1026053
81564,5,12,751,1015446,5,1015441
81565,11,2,376,713456,11,713445
81566,18,3,859,748326,18,748308
81567,17,-10,881,341744,17,341727
81568,16,2,808,716519,16,716503
81569,18,13,432,1056459,18,1056441
81570,11,-19,394,57078,11,57067
81571,7,16,563,1137090,7,1137083
81572,18,1,183,681334,18,681316
81573,7,-7,779,422369,7,422362
81574,12,-12,430,275624,12,275612
81575,11,-13,495,244655,11,244644
81576,7,-17,568,105754,7,105747
81577,11,16,552,1151021,11,1151010
81578,10,-15,204,159641,10,159631
81579,9,13,558,1042763,9,1042754
81580,5,-16,851,142286,5,142281
81581,19,-4,42,522361,19,522342
81582,14,3,417,745007,14,744993
81583,15,-17,484,119094,15,119079
81584,12,4,793,779089,12,779077
81585,16,-4,53,522435,16,522419
81586,5,-18,269,68375,5,68370
81587,9,-9,577,356674,9,356665
81588,15,-19,549,58282,15,58267
81589,9,4,17,750854,9,750845
81590,11,15,585,1121042,11,1121031
81591,19,-13,99,241789,19,241770
81592,17,-9,410,369755,17,369738
81593,8,-17,785,110273,8,110265
81594,13,-5,769,496622,13,496609
81595,12,-20,417,25938,12,25926
81596,6,-12,786,266492,6,266486
81597,18,4,127,774157,18,774139
81598,18,-1,510,620604,18,620586
81599,14,-2,938,592295,14,592281
81600,18,12,233,1023766,18,1023748
81601,15,8,275,900123,15,900108
81602,6,-16,197,128364,6,128358
81603,17,-14,796,215765,17,215748
81604,6,17,371,1163282,6,1163276
81605,10,8,689,890366,10,890356
81606,10,-6,653,450810,10,450800
81607,14,6,494,839761,14,839747
81608,11,-11,673,309073,11,309062
81609,12,-6,805,465306,12,465294
81610,13,-7,227,430001,13,429988
81611,9,-18,630,75900,9,75891
81612,16,6,146,836873,16,836857
81613,12,-8,368,400465,12,400453
81614,17,19,878,1247873,17,1247856
81615,14,3,982,749395,14,749381
81616,16,-2,369,587823,16,587807
81617,14,-20,919,29826,14,29812
81618,14,-10,972,342423,14,342409
81619,19,-20,349,25545,19,25526
81620,6,-1,31,594381,6,594375
81621,11,-10,998,342719,11,342708
81622,10,3,251,724314,10,724304
81623,5,-19,258,37207,5,37202
81624,12,15,984,1124021,12,1124009
81625,8,0,836,643523,8,643515
81626,5,10,130,940504,5,940499
81627,19,-5,192,492393,19,492374
81628,12,1,508,683852,12,683840
81629,6,-13,774,235222,6,235216
81630,18,-6,630,463978,18,463960
81631,12,5,245,805648,12,805636
81632,16,9,696,934181,16,934165
81633,8,-5,76,469590,8,469582
81634,19,14,388,1088435,19,1088416
81635,7,-1,772,610422,7,610415
81636,9,8,903,894796,9,894787
81637,7,15,925,1114150,7,1114143
81638,12,2,203,712137,12,712125
81639,11,5,598,808161,11,808150
81640,10,1,403,665997,10,665987
81641,8,-10,543,324388,8,324380
81642,13,-8,977,404864,13,404851
81643,19,4,85,773875,19,773856
81644,17,-20,115,23645,17,23628
81645,9,6,55,813410,9,813401
81646,19,16,68,1147579,19,1147560
81647,20,1,736,685597,20,685577
81648,5,-17,742,109430,5,109425
81649,7,-10,825,330305,7,330298
81650,16,-13,477,244503,16,244487
81651,12,-13,550,245088,12,245076
81652,18,-3,806,560255,18,560237
81653,11,8,329,900581,11,900570
81654,10,-19,420,40537,10,40527
81655,19,18,105,1209819,19,1209800
81656,11,-16,740,152309,11,152298
81657,15,0,921,655279,15,655264
81658,16,-20,843,29349,16,29333
81659,7,3,855,737285,7,737278
81660,16,3,109,742685,16,742669
81661,15,0,803,654427,15,654412
81662,11,10,18,959955,11,959944
81663,18,-1,77,617171,18,617153
81664,16,0,467,651663,16,651647
81665,15,11,92,991535,15,991520
81666,8,15,142,1097590,8,1097582
81667,18,-8,251,399693,18,399675
81668,5,-3,367,538449,5,538444
81669,20,0,485,651837,20,651817
81670,9,19,365,1225769,9,1225760
81671,11,-17,725,121021,11,121010
81672,17,-4,971,529424,17,529407
81673,11,3,278,744000,11,743989
81674,14,-1,594,621204,14,621190
81675,5,4,423,759796,5,759791
81676,5,14,887,1081753,5,1081748
81677,5,-13,640,231978,5,231973
81678,13,-12,299,274751,13,274738
81679,11,-14,592,214209,11,214198
81680,18,-15,33,178037,18,178019
81681,18,-11,275,305876,18,305858
81682,18,2,54,710924,18,710906
81683,11,-8,174,399156,11,399145
81684,15,-1,578,621109,15,621094
81685,11,-4,175,523392,11,523381
81686,19,-15,414,180834,19,180815
81687,13,-4,711,527435,13,527422
81688,6,-1,538,605742,6,605736
81689,18,-9,647,371644,18,371626
81690,9,-3,833,549006,9,548997
81691,9,-2,689,577529,9,577520
81692,7,-14,628,200551,7,200544
81693,13,-15,330,180156,13,180143
81694,15,-9,55,367073,15,367058
81695,8,14,605,1075320,8,1075312
81696,19,-20,657,27831,19,27812
81697,20,-10,706,340405,20,340385
81698,17,-19,903,60843,17,60826
81699,19,4,979,780432,19,780413
81700,19,12,925,1029174,19,1029155
81701,6,-1,916,613731,6,613725
81702,14,9,623,933716,14,933702
81703,16,0,720,653824,16,653808
81704,6,-5,580,480614,6,480608
81705,12,12,41,1022406,12,1022394
81706,12,6,561,840286,12,840274
81707,8,19,400,1226602,8,1226594
81708,6,-16,50,124895,6,124889
81709,7,17,810,1172730,7,1172723
81710,7,-13,798,235711,7,235704
81711,19,-16,379,149677,19,149658
81712,20,-16,88,147534,20,147514
81713,20,-16,1000,154326,20,154306
81714,5,-14,103,188783,5,188778
81715,6,-15,338,162769,6,162763
81716,18,-12,320,274906,18,274888
81717,17,-11,795,309910,17,309893
81718,20,4,715,778519,20,778499
81719,17,-16,955,153933,17,153916
81720,9,-5,344,475697,9,475688
81721,6,15,487,1104783,6,1104777
81722,9,-9,265,349396,9,349387
81723,9,3,5,718968,9,718959
81724,19,-13,810,247071,19,247052
81725,10,-20,589,12881,10,12871
81726,5,8,944,895753,5,895748
81727,18,-6,119,459975,18,459957
81728,11,-5,642,495713,11,495702
81729,16,15,519,1120543,16,1120527
81730,5,-20,358,7882,5,7877
81731,15,7,356,869609,15,869594
81732,16,-4,206,523724,16,523708
81733,10,14,99,1064040,10,1064030
81734,6,-3,564,543191,6,543185
81735,5,17,1000,1176853,5,1176848
81736,10,14,336,1069259,10,1069249
81737,9,15,114,1096965,9,1096956
81738,10,-13,698,233129,10,233119
81739,9,-20,375,8235,9,8226
81740,9,-20,908,20129,9,20120
81741,8,2,231,693549,8,693541
81742,14,-4,307,524479,14,524465
81743,20,1,559,684319,20,684299
81744,12,16,75,1147619,12,1147607
81745,8,13,862,1049312,8,1049304
81746,17,-20,854,29390,17,29373
81747,5,5,850,799362,5,799357
81748,20,12,461,1025438,20,1025418
81749,5,5,755,797369,5,797364
81750,16,5,224,805524,16,805508
81751,15,10,727,965480,15,965465
81752,16,12,807,1028024,16,1028008
81753,16,16,905,1153564,16,1153548
81754,12,-15,943,184974,12,184962
81755,20,-6,221,460857,20,460837
81756,12,-8,556,401766,12,401754
81757,13,-2,425,588321,13,588308
81758,8,19,148,1220752,8,1220744
81759,19,10,577,964336,19,964317
81760,5,-10,467,322850,5,322845
81761,17,-14,450,213007,17,212990
81762,5,19,676,1232470,5,1232465
81763,9,14,57,1063052,9,1063043
81764,16,3,563,746009,16,745993
81765,16,-12,629,277087,16,277071
81766,19,-16,228,148681,19,148662
81767,10,2,69,690118,10,690108
81768,7,-9,217,348187,7,348180
81769,15,9,762,934590,15,934575
81770,14,-8,704,402876,14,402862
81771,15,2,746,716191,15,716176
81772,6,19,994,1239442,6,1239436
81773,5,-6,485,447217,5,447212
81774,17,3,610,746395,17,746378
81775,12,-16,950,153889,12,153877
81776,6,8,506,886354,6,886348
81777,19,17,410,1180981,19,1180962
81778,20,-1,364,619523,20,619503
81779,16,10,43,960178,16,960162
81780,14,10,82,960472,14,960458
81781,9,3,708,734227,9,734218
81782,14,18,602,1213230,14,1213216
81783,17,18,461,1212389,17,1212372
81784,12,-18,966,92232,12,92220
81785,6,-6,813,454319,6,454313
81786,16,-19,318,56438,16,56422
81787,19,-3,371,556536,19,556517
81788,6,3,425,727951,6,727945
81789,16,1,781,685941,16,685925
81790,16,-19,624,58937,16,58921
81791,6,-10,351,320232,6,320226
81792,18,-11,698,309212,18,309194
81793,13,13,913,1059965,13,1059952
81794,20,-7,68,428803,20,428783
81795,7,-16,161,127524,7,127517
81796,5,-6,363,444551,5,444546
81797,19,-19,967,61265,19,61246
81798,15,-2,955,592412,15,592397
81799,5,10,195,941721,5,941716
81800,12,-6,124,460011,12,459999
81801,5,-20,860,19053,5,19048
81802,13,-5,954,498047,13,498034
81803,15,19,171,1242127,15,1242112
81804,13,-4,650,526993,13,526980
81805,19,-20,890,29658,19,29639
81806,9,-18,488,72937,9,72928
81807,6,12,800,1016430,6,1016424
81808,14,-18,73,85770,14,85756
81809,7,-6,613,449991,7,449984
81810,11,-3,296,555935,11,555924
81811,18,-17,441,118743,18,118725
81812,11,-18,643,89915,11,89904
81813,18,-15,411,180809,18,180791
81814,13,-6,753,464915,13,464902
81815,7,-9,909,364085,7,364078
81816,16,-6,940,466283,16,466267
81817,19,-5,35,491091,19,491072
81818,5,3,499,729524,5,729519
81819,19,-15,754,183400,19,183381
81820,19,-17,779,121426,19,121407
81821,7,6,861,831663,7,831656
81822,12,-4,847,528296,12,528284
81823,6,-11,243,286338,6,286332
81824,15,-20,754,28621,15,28606
81825,8,-19,374,39561,8,39553
81826,18,-7,54,428694,18,428676
81827,9,11,135,971299,9,971290
81828,11,-15,907,184642,11,184631
81829,20,-6,166,460426,20,460406
81830,7,0,337,632509,7,632502
81831,13,19,673,1246233,13,1246220
81832,6,-7,387,414264,6,414258
81833,10,-8,230,380423,10,380413
81834,7,-2,683,577364,7,577357
81835,11,-13,720,246332,11,246321
81836,19,-13,129,241952,19,241933
81837,18,19,723,1246657,18,1246639
81838,12,2,386,713515,12,713503
81839,6,-2,735,578433,6,578427
81840,10,-14,892,205893,10,205883
81841,7,18,797,1203640,7,1203633
81842,12,-4,523,526082,12,526070
81843,20,-15,829,184023,20,184003
81844,15,8,228,899814,15,899799
81845,7,-1,343,601657,7,601650
81846,17,4,966,780349,17,780332
81847,9,2,347,696082,9,696073
81848,17,-12,394,275397,17,275380
81849,17,14,929,1092692,17,1092675
81850,8,-2,233,567725,8,567717
81851,20,-16,55,147205,20,147185
81852,8,5,47,782631,8,782623
81853,13,3,37,742099,13,742086
81854,10,15,603,1107289,10,1107279
81855,16,11,332,993312,16,993296
81856,7,-4,417,508713,7,508706
81857,6,-9,593,356938,6,356932
81858,6,15,828,1112021,6,1112015
81859,6,-8,870,393923,6,393917
81860,18,10,648,964948,18,964930
81861,20,14,711,1091047,20,1091027
81862,11,4,913,780004,11,779993
81863,11,-20,971,30143,11,30132
81864,16,-5,836,497095,16,497079
81865,8,19,4,1217520,8,1217512
81866,8,7,962,865100,8,865092
81867,17,4,25,773445,17,773428
81868,6,15,454,1104076,6,1104070
81869,5,14,180,1065753,5,1065748
81870,7,17,499,1165978,7,1165971
81871,11,8,536,902191,11,902180
81872,8,18,437,1196089,8,1196081
81873,6,13,218,1035404,6,1035398
81874,10,6,601,825887,10,825877
81875,19,18,605,1213262,19,1213243
81876,17,-11,503,307776,17,307759
81877,14,-15,703,183000,14,182986
81878,6,-15,802,172544,6,172538
81879,17,-8,48,398262,17,398245
81880,12,-18,197,86828,12,86816
81881,7,-1,520,605373,7,605366
81882,6,-18,576,74845,6,74839
81883,11,-11,36,303922,11,303911
81884,17,-15,244,179526,17,179509
81885,5,9,380,914724,5,914719
81886,17,-6,255,461172,17,461155
81887,14,-14,879,216378,14,216364
81888,18,17,248,1179740,18,1179722
81889,10,4,328,757621,10,757611
81890,20,17,232,1179589,20,1179569
81891,5,2,823,705758,5,705753
81892,12,11,881,997274,12,997262
81893,12,13,463,1056666,12,1056654
81894,8,3,89,720735,8,720727
81895,14,12,141,1023053,14,1023039
81896,17,14,394,1088481,17,1088464
81897,18,7,643,871732,18,871714
81898,16,-1,437,620017,16,620001
81899,9,-15,218,159947,9,159938
81900,10,4,342,757914,10,757904
81901,20,-14,424,212865,20,212845
81902,12,-2,836,591495,12,591483
81903,13,1,252,681902,13,681889
81904,6,0,913,645138,6,645132
81905,9,-15,442,164993,9,164984
81906,18,15,750,1122383,18,1122365
81907,14,16,751,1152408,14,1152394
81908,16,-14,574,214040,16,214024
81909,19,-11,861,310484,19,310465
81910,20,0,204,649798,20,649778
81911,14,-4,157,523257,14,523243
81912,7,3,476,729043,7,729036
81913,8,10,116,940197,8,940189
81914,10,17,909,1174883,10,1174873
81915,20,15,78,1117382,20,1117362
81916,6,10,524,948735,6,948729
81917,6,-12,296,256025,6,256019
81918,12,17,962,1185139,12,1185127
81919,7,12,231,1004173,7,1004166
81920,12,3,74,742372,12,742360
81921,7,15,364,1102163,7,1102156
81922,20,2,113,711448,20,711428
81923,7,-16,445,133832,7,133825
81924,15,0,757,654082,15,654067
81925,11,16,915,1153670,11,1153659
81926,17,13,556,1057440,17,1057423
81927,15,8,885,904809,15,904794
81928,11,-6,997,466707,11,466696
81929,15,9,988,936435,15,936420
81930,15,-1,123,617492,15,617477
81931,6,3,308,725656,6,725650
81932,11,-3,101,554500,11,554489
81933,16,0,89,648890,16,648874
81934,19,-19,390,57047,19,57028
81935,11,8,863,904674,11,904663
81936,16,10,603,964595,16,964579
81937,5,2,647,702279,5,702274
81938,8,7,724,860075,8,860067
81939,14,16,334,1149533,14,1149519
81940,18,8,382,900971,18,900953
81941,10,-6,24,437390,10,437380
81942,9,-19,267,37437,9,37428
81943,7,-18,81,64255,7,64248
81944,14,-17,955,122512,14,122498
81945,5,8,263,880915,5,880910
81946,18,-9,823,373065,18,373047
81947,8,-1,332,601303,8,601295
81948,17,-2,416,588238,17,588221
81949,19,11,970,997821,19,997802
81950,7,1,38,657890,7,657883
81951,17,13,48,1053593,17,1053576
81952,16,16,948,1153836,16,1153820
81953,6,16,269,1130925,6,1130919
81954,10,-9,336,350980,10,350970
81955,15,-7,134,429263,15,429248
81956,6,13,227,1035566,6,1035560
81957,16,-14,577,214078,16,214062
81958,5,-9,264,349380,5,349375
81959,18,-10,660,340057,18,340039
81960,12,10,632,964792,12,964780
81961,18,15,866,1123119,18,1123101
81962,16,-6,550,463423,16,463407
81963,17,5,876,810159,17,810142
81964,7,-10,218,317412,7,317405
81965,10,9,794,923618,10,923608
81966,13,-20,80,23387,13,23374
81967,13,16,427,1150216,13,1150203
81968,10,19,886,1237281,10,1237271
81969,17,-5,4,490803,17,490786
81970,18,-4,866,528486,18,528468
81971,7,-8,402,383817,7,383810
81972,5,-1,218,598507,5,598502
81973,18,-5,870,497386,18,497368
81974,20,-14,199,210847,20,210827
81975,20,10,953,967162,20,967142
81976,5,11,372,976427,5,976422
81977,6,-6,491,447401,6,447395
81978,17,10,145,961005,17,960988
81979,20,-15,528,181662,20,181642
81980,19,4,177,774567,19,774548
81981,19,0,450,651516,19,651497
81982,9,18,681,1201024,9,1201015
81983,12,-18,462,88766,12,88754
81984,9,0,666,639934,9,639925
81985,10,-12,751,265789,10,265779
81986,12,-1,427,619957,12,619945
81987,8,5,809,798525,8,798517
81988,18,-18,419,88431,18,88413
81989,20,5,134,804762,20,804742
81990,8,4,343,757921,8,757913
81991,16,-8,980,404877,16,404861
81992,19,0,532,652252,19,652233
81993,8,-17,488,103920,8,103912
81994,16,-5,88,491590,16,491574
81995,10,7,913,864165,10,864155
81996,11,-13,618,245657,11,245646
81997,20,0,570,652566,20,652546
81998,16,-20,13,7377,16,7361
81999,5,17,610,1168315,5,1168310
82000,7,7,757,860781,7,860774
82001,13,16,911,1153629,13,1153616
82002,8,10,477,947651,8,947643
82003,8,3,639,732541,8,732533
82004,11,17,132,1178831,11,1178820
82005,19,6,13,835888,19,835869
82006,15,14,251,1087398,15,1087383
82007,20,17,225,1179535,20,1179515
82008,19,17,644,1182645,19,1182626
82009,15,2,979,717742,15,717727
82010,16,-17,571,119832,16,119816
82011,11,1,860,686511,11,686500
82012,11,3,351,744547,11,744536
82013,6,14,49,1062918,6,1062912
82014,17,6,929,843159,17,843142
82015,19,0,387,651020,19,651001
82016,9,6,600,825868,9,825859
82017,6,14,840,1080682,6,1080676
82018,18,-1,346,619373,18,619355
82019,14,-14,23,209502,14,209488
82020,5,0,934,645632,5,645627
82021,10,12,837,1017304,10,1017294
82022,9,3,845,737071,9,737062
82023,20,7,400,870016,20,869996
82024,17,1,213,681586,17,681569
82025,7,-13,405,226763,7,226756
82026,19,17,848,1184365,19,1184346
82027,8,8,195,879392,8,879384
82028,12,-12,931,279528,12,279516
82029,9,16,914,1144216,9,1144207
82030,20,-9,749,372375,20,372355
82031,10,4,85,752455,10,752445
82032,20,15,47,1117155,20,1117135
82033,20,12,0,1022115,20,1022095
82034,5,-19,875,50592,5,50587
82035,17,-20,660,27875,17,27858
82036,12,7,150,868123,12,868111
82037,5,-20,795,17565,5,17560
82038,8,-11,867,299694,8,299686
82039,7,-4,950,519780,7,519773
82040,15,18,146,1210166,15,1210151
82041,18,-7,562,432539,18,432521
82042,20,-13,741,246507,20,246487
82043,10,18,460,1196627,10,1196617
82044,13,-12,594,276842,13,276829
82045,16,17,728,1183341,16,1183325
82046,6,-12,938,269988,6,269982
82047,15,-10,542,339123,15,339108
82048,6,-15,137,158430,6,158424
82049,19,-13,872,247563,19,247544
82050,7,11,252,973669,7,973662
82051,6,-14,569,199004,6,198998
82052,9,-2,924,582618,9,582609
82053,20,16,561,1151090,20,1151070
82054,20,-19,785,60086,20,60066
82055,16,-4,238,523991,16,523975
82056,16,17,229,1179561,16,1179545
82057,20,14,834,1091977,20,1091957
82058,19,-7,312,430677,19,430658
82059,16,-12,817,278509,16,278493
82060,13,-14,749,215288,13,215275
82061,6,13,328,1037800,6,1037794
82062,14,-1,200,618065,14,618051
82063,7,-15,252,160838,7,160831
82064,11,-5,282,493120,11,493109
82065,10,-20,983,21715,10,21705
82066,9,-12,923,269664,9,269655
82067,8,18,371,1194729,8,1194721
82068,9,1,671,671791,9,671782
82069,6,-12,607,262600,6,262594
82070,10,-1,677,608474,10,608464
82071,16,-3,852,560602,16,560586
82072,7,14,669,1076977,7,1076970
82073,16,11,766,996390,16,996374
82074,14,-14,801,215831,14,215817
82075,8,-16,622,137577,8,137569
82076,11,-16,156,148086,11,148075
82077,10,4,203,755027,10,755017
82078,10,17,331,1162505,10,1162495
82079,5,7,770,861059,5,861054
82080,6,-19,283,37768,6,37762
82081,13,-4,193,523559,13,523546
82082,18,11,584,995074,18,995056
82083,8,9,571,918827,8,918819
82084,18,-3,554,558172,18,558154
82085,10,-8,878,394127,10,394117
82086,20,13,65,1053724,20,1053704
82087,7,1,188,661294,7,661287
82088,13,0,632,653030,13,653017
82089,17,-15,750,183364,17,183347
82090,10,19,355,1225455,10,1225445
82091,6,18,591,1199185,6,1199179
82092,6,-18,692,77217,6,77211
82093,18,1,698,685285,18,685267
82094,15,7,476,870600,15,870585
82095,17,-3,422,556963,17,556946
82096,16,1,779,685928,16,685912
82097,18,-9,87,367296,18,367278
82098,16,-16,420,150031,16,150015
82099,15,4,898,779886,15,779871
82100,6,-15,792,172276,6,172270
82101,8,-9,971,365188,8,365180
82102,11,-16,378,149668,11,149657
82103,6,2,110,690975,6,690969
82104,6,-20,624,13625,6,13619
82105,5,-9,700,359025,5,359020
82106,19,-7,118,429154,19,429135
82107,16,-4,10,522130,16,522114
82108,13,2,23,710642,13,710629
82109,20,-3,882,560837,20,560817
82110,15,16,825,1153028,15,1153013
82111,5,-15,18,155746,5,155741
82112,9,-14,752,203083,9,203074
82113,8,-11,897,300377,8,300369
82114,11,-19,514,57955,11,57944
82115,9,10,47,938561,9,938552
82116,20,1,172,681236,20,681216
82117,16,17,337,1180504,16,1180488
82118,13,-12,968,279856,13,279843
82119,14,-12,849,278823,14,278809
82120,19,12,661,1026987,19,1026968
82121,17,8,973,905510,17,905493
82122,20,3,777,747697,20,747677
82123,20,-3,766,559931,20,559911
82124,16,17,274,1179978,16,1179962
82125,7,-1,527,605543,7,605536
82126,9,-7,966,426476,9,426467
82127,15,10,385,962717,15,962702
82128,19,-19,287,56244,19,56225
82129,6,-8,325,382333,6,382327
82130,16,9,563,933216,16,933200
82131,14,-10,513,338895,14,338881
82132,12,3,788,747778,12,747766
82133,5,-4,866,517909,5,517904
82134,15,15,512,1120502,15,1120487
82135,8,19,372,1225921,8,1225913
82136,6,4,710,765955,6,765949
82137,15,-8,393,400706,15,400691
82138,5,16,374,1133119,5,1133114
82139,11,-6,63,459563,11,459552
82140,18,-3,766,559939,18,559921
82141,6,-15,100,157621,6,157615
82142,18,-8,982,404891,18,404873
82143,20,-8,496,401296,20,401276
82144,8,-14,864,205299,8,205291
82145,15,19,752,1246868,15,1246853
82146,19,14,282,1087612,19,1087593
82147,14,-19,625,58946,14,58932
82148,19,0,881,654955,19,654936
82149,6,8,52,876159,6,876153
82150,13,-7,801,434103,13,434090
82151,5,-15,516,166577,5,166572
82152,18,-3,402,556749,18,556731
82153,7,-18,896,81840,7,81833
82154,9,2,296,695017,9,695008
82155,12,-6,678,464280,12,464268
82156,14,12,926,1029177,14,1029163
82157,6,-3,774,547835,6,547829
82158,8,4,537,762180,8,762172
82159,11,-16,55,147206,11,147195
82160,7,9,355,914262,7,914255
82161,9,8,638,889230,9,889221
82162,15,-10,916,341955,15,341940
82163,12,4,619,777771,12,777759
82164,19,9,17,929176,19,929157
82165,19,11,704,995836,19,995817
82166,13,19,798,1247228,13,1247215
82167,19,-6,232,460986,19,460967
82168,12,6,221,837386,12,837374
82169,13,-10,292,337145,13,337132
82170,11,11,748,996218,11,996207
82171,19,-3,505,557690,19,557671
82172,10,-12,448,259262,10,259252
82173,14,-6,143,460226,14,460212
82174,13,-5,522,494923,13,494910
82175,20,3,100,742569,20,742549
82176,5,-16,336,131161,5,131156
82177,14,17,88,1178490,14,1178476
82178,15,-11,269,305858,15,305843
82179,16,-15,146,178898,16,178882
82180,15,-1,197,618033,15,618018
82181,17,-4,199,523624,17,523607
82182,6,5,433,790541,6,790535
82183,10,-15,39,156154,10,156144
82184,18,-11,554,308180,18,308162
82185,18,15,739,1122281,18,1122263
82186,20,-3,912,561117,20,561097
82187,9,-17,802,110606,9,110597
82188,16,12,731,1027540,16,1027524
82189,20,13,223,1054892,20,1054872
82190,16,19,625,1245884,16,1245868
82191,15,-18,192,86768,15,86753
82192,11,-8,686,402767,11,402756
82193,12,-3,73,554304,12,554292
82194,11,9,311,931278,11,931267
82195,5,17,315,1162118,5,1162113
82196,6,-1,385,602429,6,602423
82197,8,17,206,1159647,8,1159639
82198,5,-2,879,581688,5,581683
82199,14,-10,56,335590,14,335576
82200,18,10,425,963098,18,963080
82201,17,-13,100,241815,17,241798
82202,11,-9,297,368738,11,368727
82203,14,1,414,683114,14,683100
82204,5,18,547,1198504,5,1198499
82205,17,13,516,1057085,17,1057068
82206,6,-1,909,613570,6,613564
82207,5,-10,88,314561,5,314556
82208,16,16,801,1152891,16,1152875
82209,18,-9,984,374172,18,374154
82210,10,-12,843,267870,10,267860
82211,12,-20,114,23631,12,23619
82212,7,16,669,1139252,7,1139245
82213,10,17,40,1156216,10,1156206
82214,12,-6,17,459260,12,459248
82215,17,-18,986,92374,17,92357
82216,5,3,684,733655,5,733650
82217,7,8,169,878808,7,878801
82218,5,17,588,1167809,5,1167804
82219,11,2,234,712329,11,712318
82220,18,-1,445,620100,18,620082
82221,16,-16,51,147169,16,147153
82222,6,10,759,953805,6,953799
82223,12,1,516,683934,12,683922
82224,13,0,656,653276,13,653263
82225,17,-17,279,117551,17,117534
82226,12,-19,118,54949,12,54937
82227,18,8,75,898492,18,898474
82228,11,-7,870,434674,11,434663
82229,5,9,405,915221,5,915216
82230,19,-10,168,336371,19,336352
82231,9,-15,113,157965,9,157956
82232,13,-16,898,153537,13,153524
82233,19,19,63,1241245,19,1241226
82234,9,-5,837,486120,9,486111
82235,12,-4,105,522843,12,522831
82236,15,16,67,1147565,15,1147550
82237,17,-8,43,398244,17,398227
82238,19,3,120,742743,19,742724
82239,19,-4,983,529508,19,529489
82240,8,-15,272,161229,8,161221
82241,15,5,363,806440,15,806425
82242,9,-13,454,227836,9,227827
82243,12,-14,116,210209,12,210197
82244,17,-12,57,272936,17,272919
82245,15,12,172,1023305,15,1023290
82246,11,-4,35,522295,11,522284
82247,8,-14,553,198482,8,198474
82248,18,-2,106,585933,18,585915
82249,11,2,137,711639,11,711628
82250,11,7,799,872795,11,872784
82251,7,-3,593,543797,7,543790
82252,12,11,73,991422,12,991410
82253,5,-10,361,320391,5,320386
82254,11,-16,775,152601,11,152590
82255,6,-13,441,227610,6,227604
82256,12,-4,62,522522,12,522510
82257,14,-18,218,86978,14,86964
82258,8,-3,2,530675,8,530667
82259,7,-14,406,195690,7,195683
82260,9,2,905,707420,9,707411
82261,7,8,176,878925,7,878918
82262,5,13,279,1036697,5,1036692
82263,14,6,714,841576,14,841562
82264,7,5,923,801062,7,801055
82265,8,-18,632,75961,8,75953
82266,6,2,973,708997,6,708991
82267,20,-2,185,586448,20,586428
82268,8,-17,73,94983,8,94975
82269,20,-2,823,591385,20,591365
82270,7,-14,206,191056,7,191049
82271,16,-3,703,559398,16,559382
82272,6,14,567,1074427,6,1074421
82273,18,-6,881,465767,18,465749
82274,12,9,239,930763,12,930751
82275,7,18,90,1188712,7,1188705
82276,18,-12,53,272910,18,272892
82277,20,18,991,1216246,20,1216226
82278,8,2,153,691875,8,691867
82279,18,17,248,1179748,18,1179730
82280,6,4,947,771314,6,771308
82281,11,-4,506,525932,11,525921
82282,19,4,318,775473,19,775454
82283,8,12,627,1012721,8,1012713
82284,9,-7,329,413033,9,413024
82285,8,17,648,1169166,8,1169158
82286,8,-1,92,595852,8,595844
82287,7,-15,59,156623,7,156616
82288,9,-16,668,138409,9,138400
82289,17,-2,403,588139,17,588122
82290,18,-18,34,85467,18,85449
82291,17,-3,47,554162,17,554145
82292,12,-18,670,90162,12,90150
82293,10,-12,366,257597,10,257587
82294,8,6,638,826744,8,826736
82295,19,-7,713,433511,19,433492
82296,15,13,759,1058893,15,1058878
82297,7,0,673,640062,7,640055
82298,18,1,429,683200,18,683182
82299,5,13,883,1049731,5,1049726
82300,10,-9,490,354740,10,354730
82301,10,1,297,663642,10,663632
82302,19,2,353,713273,19,713254
82303,17,0,16,648321,17,648304
82304,13,-7,315,430735,13,430722
82305,6,14,400,1070661,6,1070655
82306,15,2,308,712904,15,712889
82307,10,16,1,1125187,10,1125177
82308,12,-2,797,591124,12,591112
82309,19,-8,520,401481,19,401462
82310,11,3,785,747748,11,747737
82311,16,1,193,681400,16,681384
82312,14,-12,110,273331,14,273317
82313,18,-11,135,304801,18,304783
82314,20,4,805,779165,20,779145
82315,12,-8,433,400885,12,400873
82316,7,-10,544,324414,7,324407
82317,19,-8,438,400927,19,400908
82318,9,-3,372,538553,9,538544
82319,11,16,982,1154145,11,1154134
82320,8,-17,598,106442,8,106434
82321,13,-9,932,373961,13,373948
82322,13,-13,420,244054,13,244041
82323,7,-5,896,487576,7,487569
82324,8,-3,169,534017,8,534009
82325,14,-17,568,119789,14,119775
82326,17,-6,816,465382,17,465365
82327,15,-3,67,554244,15,554229
82328,10,15,848,1112507,10,1112497
82329,9,12,518,1010145,9,1010136
82330,10,-17,362,101233,10,101223
82331,20,11,357,993456,20,993436
82332,15,-20,176,24151,15,24136
82333,14,-4,292,524351,14,524337
82334,13,-3,347,556337,13,556324
82335,19,-13,360,243681,19,243662
82336,12,-7,634,432954,12,432942
82337,8,-1,21,594138,8,594130
82338,5,-9,54,344805,5,344800
82339,10,14,636,1076167,10,1076157
82340,13,-5,550,495087,13,495074
82341,7,10,745,953549,7,953542
82342,15,1,604,684610,15,684595
82343,20,11,330,993263,20,993243
82344,11,-14,905,216546,11,216535
82345,9,5,769,797714,9,797705
82346,7,7,478,855147,7,855140
82347,17,5,615,808351,17,808334
82348,19,18,99,1209731,19,1209712
82349,16,13,785,1059105,16,1059089
82350,16,-10,45,335503,16,335487
82351,5,3,912,738542,5,738537
82352,7,10,939,957734,7,957727
82353,20,-2,519,589061,20,589041
82354,18,-3,982,561641,18,561623
82355,18,1,467,683545,18,683527
82356,6,15,254,1100002,6,1099996
82357,12,18,974,1216153,12,1216141
82358,8,-7,420,414933,8,414925
82359,5,3,362,726721,5,726716
82360,19,-16,670,151858,19,151839
82361,15,5,811,809706,15,809691
82362,18,-15,421,180909,18,180891
82363,9,-9,232,348600,9,348591
82364,12,-20,11,7004,12,6992
82365,5,14,842,1080704,5,1080699
82366,10,-2,438,572119,10,572109
82367,6,-17,569,105779,6,105773
82368,16,14,842,1092017,16,1092001
82369,12,-12,447,275750,12,275738
82370,16,-8,103,398637,16,398621
82371,14,13,898,1059923,14,1059909
82372,13,17,166,1179135,13,1179122
82373,9,-11,617,294818,9,294809
82374,13,-6,145,460237,13,460224
82375,15,15,637,1121453,15,1121438
82376,17,11,28,991092,17,991075
82377,15,10,632,964797,15,964782
82378,7,11,498,979096,7,979089
82379,6,-6,300,443345,6,443339
82380,11,13,670,1058294,11,1058283
82381,5,-2,346,570107,5,570102
82382,13,-13,275,243130,13,243117
82383,7,-10,830,330381,7,330374
82384,5,-5,857,486581,5,486576
82385,12,-13,584,245349,12,245337
82386,12,1,122,680784,12,680772
82387,6,-17,853,111516,6,111510
82388,13,-17,842,121792,13,121779
82389,18,9,431,932158,18,932140
82390,12,-6,420,462375,12,462363
82391,7,-10,729,328319,7,328312
82392,6,-1,1000,615501,6,615495
82393,20,18,621,1213397,20,1213377
82394,16,7,66,867504,16,867488
82395,7,14,787,1079619,7,1079612
82396,6,-14,15,186812,6,186806
82397,14,19,217,1242479,14,1242465
82398,16,-6,886,465832,16,465816
82399,18,-7,800,434101,18,434083
82400,8,-9,71,345104,8,345096
82401,8,15,658,1108405,8,1108397
82402,12,16,910,1153611,12,1153599
82403,12,6,589,840530,12,840518
82404,5,18,352,1194284,5,1194279
82405,5,7,529,856071,5,856066
82406,16,-6,395,462144,16,462128
82407,5,-16,316,130813,5,130808
82408,12,15,174,1118116,12,1118104
82409,12,-1,686,621848,12,621836
82410,17,15,313,1119092,17,1119075
82411,19,-20,659,27847,19,27828
82412,20,-11,130,304731,20,304711
82413,11,2,210,712186,11,712175
82414,17,-1,154,617719,17,617702
82415,19,12,777,1027816,19,1027797
82416,19,-1,519,620722,19,620703
82417,13,-20,149,23917,13,23904
82418,7,11,604,981429,7,981422
82419,13,6,165,836988,13,836975
82420,7,-6,902,456075,7,456068
82421,14,6,604,840630,14,840616
82422,8,4,182,754487,8,754479
82423,20,7,26,867187,20,867167
82424,19,16,474,1150513,19,1150494
82425,17,-19,170,55382,17,55365
82426,13,7,866,873274,13,873261
82427,16,13,796,1059222,16,1059206
82428,11,-9,596,371332,11,371321
82429,12,-6,771,465033,12,465021
82430,10,3,564,730757,10,730747
82431,6,4,717,766116,6,766110
82432,10,12,11,999250,10,999240
82433,16,-4,771,527814,16,527798
82434,16,-20,396,25827,16,25811
82435,18,-16,281,149048,18,149030
82436,12,-6,777,465097,12,465085
82437,17,7,343,869522,17,869505
82438,14,-14,798,215793,14,215779
82439,7,-1,462,604151,7,604144
82440,16,-11,19,303823,16,303807
82441,19,-7,961,435441,19,435422
82442,19,9,467,932416,19,932397
82443,9,18,285,1193045,9,1193036
82444,13,9,873,935534,13,935521
82445,18,-1,705,622003,18,621985
82446,19,-6,510,463120,19,463101
82447,12,2,670,715634,12,715622
82448,15,17,905,1184752,15,1184737
82449,9,11,356,976017,9,976008
82450,10,9,954,926995,10,926985
82451,10,-6,667,451110,10,451100
82452,15,10,740,965578,15,965563
82453,12,-7,528,432332,12,432320
82454,14,-12,709,277750,14,277736
82455,9,-11,821,298677,9,298668
82456,13,16,209,1148628,13,1148615
82457,11,1,21,679948,11,679937
82458,10,-5,715,483472,10,483462
82459,5,18,618,1199784,5,1199779
82460,13,19,927,1248240,13,1248227
82461,6,-20,150,3347,6,3341
82462,6,4,929,770989,6,770983
82463,6,-10,719,328084,6,328078
82464,5,17,330,1162496,5,1162491
82465,11,1,305,682263,11,682252
82466,11,-3,389,556671,11,556660
82467,16,14,955,1092917,16,1092901
82468,10,7,981,865567,10,865557
82469,11,-2,419,588256,11,588245
82470,15,-7,832,434341,15,434326
82471,10,3,161,722255,10,722245
82472,16,6,683,841259,16,841243
82473,17,-6,478,462835,17,462818
82474,9,-5,730,483815,9,483806
82475,9,-20,937,20644,9,20635
82476,18,-8,808,403671,18,403653
82477,14,-18,870,91540,14,91526
82478,6,-12,440,259117,6,259111
82479,8,17,107,1157545,8,1157537
82480,12,-5,488,494656,12,494644
82481,15,-6,484,462892,15,462877
82482,13,11,149,991904,13,991891
82483,5,13,585,1043418,5,1043413
82484,15,10,789,965946,15,965931
82485,12,-19,680,59301,12,59289
82486,12,-7,409,431432,12,431420
82487,20,16,606,1151369,20,1151349
82488,14,-1,547,620904,14,620890
82489,17,12,437,1025275,17,1025258
82490,6,-20,737,16208,6,16202
82491,20,-15,630,182430,20,182410
82492,10,5,275,787406,10,787396
82493,17,18,466,1212410,17,1212393
82494,7,-16,315,130809,7,130802
82495,9,-3,944,551657,9,551648
82496,17,6,465,839504,17,839487
82497,13,-12,899,279273,13,279260
82498,17,3,65,742312,17,742295
82499,12,12,128,1022984,12,1022972
82500,8,9,178,910561,8,910553
82501,10,8,30,875755,10,875745
82502,17,9,708,934302,17,934285
82503,6,-15,458,165320,6,165314
82504,8,2,988,709337,8,709329
82505,5,-9,250,349087,5,349082
82506,9,-16,468,134335,9,134326
82507,7,-18,610,75494,7,75487
82508,12,-19,447,57410,12,57398
82509,7,-11,768,297613,7,297606
82510,6,9,538,918157,6,918151
82511,5,-20,119,2675,5,2670
82512,8,11,556,980346,8,980338
82513,7,-11,239,286227,7,286220
82514,5,1,977,678240,5,678235
82515,5,-2,476,572952,5,572947
82516,18,-16,490,150624,18,150606
82517,19,-7,254,430176,19,430157
82518,16,-14,71,209873,16,209857
82519,17,-8,543,401694,17,401677
82520,12,8,234,899894,12,899882
82521,15,-3,453,557276,15,557261
82522,7,16,186,1129124,7,1129117
82523,5,9,257,912069,5,912064
82524,11,3,614,746416,11,746405
82525,19,7,931,873641,19,873622
82526,10,5,896,800477,10,800467
82527,16,-20,358,25587,16,25571
82528,11,0,913,655221,11,655210
82529,7,-9,794,361361,7,361354
82530,7,0,2,625205,7,625198
82531,12,15,915,1123480,12,1123468
82532,17,-6,892,465884,17,465867
82533,15,-1,462,620256,15,620241
82534,13,-7,45,428651,13,428638
82535,13,-13,580,245330,13,245317
82536,17,-5,785,496707,17,496690
82537,5,19,615,1231272,5,1231267
82538,15,19,60,1241216,15,1241201
82539,17,-19,805,60212,17,60195
82540,15,-9,785,372773,15,372758
82541,12,17,236,1179640,12,1179628
82542,15,11,191,992186,15,992171
82543,16,-20,993,30401,16,30385
82544,6,11,985,989561,6,989555
82545,13,-16,957,153965,13,153952
82546,18,-20,213,24457,18,24439
82547,19,4,136,774244,19,774225
82548,17,2,168,711882,17,711865
82549,8,13,597,1043640,8,1043632
82550,9,9,10,906947,9,906938
82551,16,0,173,649541,16,649525
82552,11,-16,996,154285,11,154274
82553,5,-16,164,127564,5,127559
82554,6,-10,952,332921,6,332915
82555,9,8,633,889084,9,889075
82556,19,-8,398,400751,19,400732
82557,19,11,53,991268,19,991249
82558,11,-7,599,432782,11,432771
82559,8,1,397,665874,8,665866
82560,17,11,179,992087,17,992070
82561,16,-18,328,87758,16,87742
82562,12,-19,736,59810,12,59798
82563,10,-13,919,238263,10,238253
82564,17,-15,33,178044,17,178027
82565,13,1,432,683238,13,683225
82566,20,1,520,683971,20,683951
82567,20,14,234,1087246,20,1087226
82568,10,-20,887,19678,10,19668
82569,14,9,444,932270,14,932256
82570,8,18,434,1196028,8,1196020
82571,17,1,535,684142,17,684125
82572,16,2,118,711489,16,711473
82573,15,-4,277,524249,15,524234
82574,15,16,957,1153910,15,1153895
82575,8,2,185,692691,8,692683
82576,6,7,992,865817,6,865811
82577,12,18,136,1210066,12,1210054
82578,7,-9,870,363115,7,363108
82579,19,4,84,773864,19,773845
82580,20,-12,149,273653,20,273633
82581,17,15,725,1122176,17,1122159
82582,13,-20,767,28708,13,28695
82583,5,-14,488,197213,5,197208
82584,16,9,815,935111,16,935095
82585,20,3,548,745859,20,745839
82586,5,13,229,1035633,5,1035628
82587,20,11,294,993057,20,993037
82588,13,-13,646,245749,13,245736
82589,8,8,225,880079,8,880071
82590,10,8,743,891592,10,891582
82591,19,13,989,1060524,19,1060505
82592,13,-1,525,620756,13,620743
82593,16,-19,996,61427,16,61411
82594,15,-19,228,55850,15,55835
82595,15,7,414,870091,15,870076
82596,6,-11,750,297321,6,297315
82597,15,-6,197,460675,15,460660
82598,5,19,825,1235780,5,1235775
82599,12,-6,290,461455,12,461443
82600,9,-3,445,540409,9,540400
82601,19,-12,404,275475,19,275456
82602,20,-16,303,149175,20,149155
82603,11,7,582,871310,11,871299
82604,7,-13,240,223473,7,223466
82605,13,4,857,779685,13,779672
82606,11,5,951,810793,11,810782
82607,13,14,170,1086784,13,1086771
82608,15,-17,137,116496,15,116481
82609,14,-3,567,558283,14,558269
82610,15,15,383,1119589,15,1119574
82611,9,8,285,881483,9,881474
82612,11,7,753,872461,11,872450
82613,14,14,652,1090563,14,1090549
82614,18,3,101,742588,18,742570
82615,10,-18,234,67660,10,67650
82616,16,-20,627,27547,16,27531
82617,9,-17,993,114351,9,114342
82618,6,-9,167,347133,6,347127
82619,11,2,259,712518,11,712507
82620,10,17,40,1156226,10,1156216
82621,18,3,245,743717,18,743699
82622,6,3,438,728255,6,728249
82623,9,-13,269,224181,9,224172
82624,5,-20,57,1185,5,1180
82625,15,8,145,899082,15,899067
82626,14,13,683,1058373,14,1058359
82627,15,-17,286,117611,15,117596
82628,5,-4,512,510589,5,510584
82629,10,2,885,707061,10,707051
82630,12,-14,54,209733,12,209721
82631,7,16,979,1145706,7,1145699
82632,9,4,913,770688,9,770679
82633,6,-16,718,139458,6,139452
82634,16,-11,503,307782,16,307766
82635,18,11,90,991507,18,991489
82636,19,10,83,960487,19,960468
82637,18,6,369,838640,18,838622
82638,12,19,846,1247603,12,1247591
82639,11,-2,303,587412,11,587401
82640,11,13,90,1053892,11,1053881
82641,20,-19,168,55371,20,55351
82642,17,-19,22,54047,17,54030
82643,7,-20,741,16289,7,16282
82644,16,0,626,652964,16,652948
82645,14,-18,571,89384,14,89370
82646,12,-14,14,209448,12,209436
82647,20,-12,630,277096,20,277076
82648,18,-16,437,150222,18,150204
82649,10,17,834,1173261,10,1173251
82650,14,1,672,685133,14,685119
82651,13,14,846,1092030,13,1092017
82652,20,0,39,648553,20,648533
82653,13,14,923,1092648,13,1092635
82654,8,14,517,1073361,8,1073353
82655,7,-1,959,614583,7,614576
82656,15,14,907,1092543,15,1092528
82657,18,18,572,1213103,18,1213085
82658,5,-1,134,596750,5,596745
82659,11,12,599,1026446,11,1026435
82660,9,18,296,1193257,9,1193248
82661,13,-14,952,216878,13,216865
82662,5,-6,707,452020,5,452015
82663,15,-3,179,555052,15,555037
82664,13,-17,256,117359,13,117346
82665,14,11,985,997941,14,997927
82666,15,-8,584,401930,15,401915
82667,9,-20,172,3876,9,3867
82668,9,-15,247,160745,9,160736
82669,20,-14,26,209541,20,209521
82670,13,-1,910,623524,13,623511
82671,8,-9,153,346910,8,346902
82672,18,8,470,901654,18,901636
82673,8,-14,828,204569,8,204561
82674,12,-16,16,146901,12,146889
82675,16,4,678,778229,16,778213
82676,19,2,627,715277,19,715258
82677,18,6,392,838876,18,838858
82678,11,14,249,1087393,11,1087382
82679,19,0,585,652714,19,652695
82680,18,-18,291,87500,18,87482
82681,15,15,952,1123776,15,1123761
82682,11,4,606,777707,11,777696
82683,14,7,12,867116,14,867102
82684,5,0,590,638171,5,638166
82685,13,-17,72,116048,13,116035
82686,16,8,161,899221,16,899205
82687,7,-17,202,97658,7,97651
82688,6,-7,808,422902,6,422896
82689,5,-16,530,135575,5,135570
82690,16,15,707,1122002,16,1121986
82691,16,5,163,804991,16,804975
82692,17,13,71,1053765,17,1053748
82693,17,7,658,871837,17,871820
82694,16,3,733,747381,16,747365
82695,5,17,398,1163795,5,1163790
82696,12,7,283,869048,12,869036
82697,19,-19,275,56149,19,56130
82698,18,10,252,961722,18,961704
82699,17,4,846,779601,17,779584
82700,16,3,803,747910,16,747894
82701,20,-4,302,524434,20,524414
82702,15,-3,676,559194,15,559179
82703,13,9,85,929670,13,929657
82704,12,13,619,1057956,12,1057944
82705,19,7,429,870233,19,870214
82706,17,14,462,1089061,17,1089044
82707,18,7,43,867368,18,867350
82708,5,-8,492,385599,5,385594
82709,5,-7,653,419631,5,419626
82710,13,14,557,1089809,13,1089796
82711,9,-9,391,352234,9,352225
82712,14,-12,308,274824,14,274810
82713,8,-12,274,255472,8,255464
82714,14,7,860,873225,14,873211
82715,8,-11,920,300849,8,300841
82716,14,-1,529,620801,14,620787
82717,10,-4,297,505965,10,505955
82718,20,2,146,711712,20,711692
82719,9,11,443,977897,9,977888
82720,8,-3,505,541800,8,541792
82721,9,13,600,1043708,9,1043699
82722,15,11,880,997266,15,997251
82723,19,18,420,1212162,19,1212143
82724,5,-12,584,262174,5,262169
82725,5,17,180,1159046,5,1159041
82726,5,-10,122,315266,5,315261
82727,14,8,696,903496,14,903482
82728,12,-15,730,183231,12,183219
82729,13,0,767,654158,13,654145
82730,13,-4,762,527730,13,527717
82731,15,19,99,1241556,15,1241541
82732,20,6,117,836670,20,836650
82733,5,4,909,770600,5,770595
82734,11,-15,804,183772,11,183761
82735,13,9,711,934317,13,934304
82736,16,-11,606,308582,16,308566
82737,9,6,727,828831,9,828822
82738,9,13,811,1048259,9,1048250
82739,10,-8,205,379845,10,379835
82740,6,-7,968,426500,6,426494
82741,12,-13,179,242370,12,242358
82742,11,17,267,1179919,11,1179908
82743,18,13,996,1060602,18,1060584
82744,12,-11,460,307435,12,307423
82745,17,11,557,994857,17,994840
82746,14,6,867,842691,14,842677
82747,19,8,992,905671,19,905652
82748,6,-13,940,238742,6,238736
82749,17,-17,213,117044,17,117027
82750,19,-1,211,618189,19,618170
82751,11,-9,672,371742,11,371731
82752,18,-8,981,404884,18,404866
82753,17,-16,210,148498,17,148481
82754,13,-7,595,432770,13,432757
82755,16,15,812,1122744,16,1122728
82756,5,-2,643,576445,5,576440
82757,11,16,45,1147396,11,1147385
82758,10,-10,747,328687,10,328677
82759,8,11,273,974078,8,974070
82760,18,-11,577,308343,18,308325
82761,11,7,177,868302,11,868291
82762,11,14,666,1090655,11,1090644
82763,14,4,314,775441,14,775427
82764,14,-5,668,495852,14,495838
82765,6,-10,817,330108,6,330102
82766,17,-10,756,340791,17,340774
82767,5,-16,848,142195,5,142190
82768,19,11,674,995627,19,995608
82769,12,-15,626,182404,12,182392
82770,7,-2,225,567585,7,567578
82771,15,6,786,842065,15,842050
82772,6,-3,410,539482,6,539476
82773,7,8,660,889569,7,889562
82774,16,-15,261,179647,16,179631
82775,14,3,617,746456,14,746442
82776,20,7,387,869884,20,869864
82777,20,-18,142,86284,20,86264
82778,10,17,304,1161905,10,1161895
82779,16,9,619,933664,16,933648
82780,20,-19,178,55461,20,55441
82781,14,1,186,681363,14,681349
82782,14,7,568,871202,14,871188
82783,14,-15,763,183444,14,183430
82784,11,13,78,1053802,11,1053791
82785,11,-16,394,149777,11,149766
82786,20,-16,125,147890,20,147870
82787,5,13,319,1037579,5,1037574
82788,15,-18,971,92282,15,92267
82789,10,6,245,817688,10,817678
82790,11,15,160,1117953,11,1117942
82791,8,18,22,1187048,8,1187040
82792,5,13,592,1043530,5,1043525
82793,15,-3,422,556968,15,556953
82794,12,-17,197,116917,12,116905
82795,10,-2,732,578342,10,578332
82796,9,-8,476,385147,9,385138
82797,18,-16,735,152292,18,152274
82798,9,-1,300,600538,9,600529
82799,8,-16,905,143457,8,143449
82800,20,2,623,715225,20,715205
82801,20,-7,307,430647,20,430627
82802,10,9,749,922460,10,922450
82803,8,-10,12,312814,8,312806
82804,10,-15,304,161991,10,161981
82805,13,-11,310,306259,13,306246
82806,9,-17,920,112972,9,112963
82807,8,-13,264,224038,8,224030
82808,16,-9,192,367902,16,367886
82809,10,17,885,1174325,10,1174315
82810,9,10,824,955363,9,955354
82811,16,10,354,962490,16,962474
82812,20,-1,464,620296,20,620276
82813,5,19,957,1238719,5,1238714
82814,12,-2,833,591476,12,591464
82815,12,-19,824,60321,12,60309
82816,16,-9,364,369382,16,369366
82817,18,-15,323,180119,18,180101
82818,6,9,391,914936,6,914930
82819,9,15,298,1100949,9,1100940
82820,15,2,37,710810,15,710795
82821,13,-12,264,274473,13,274460
82822,17,13,627,1058016,17,1057999
82823,15,-2,637,589899,15,589884
82824,13,9,250,930831,13,930818
82825,11,-3,782,560084,11,560073
82826,12,-13,164,242221,12,242209
82827,8,-9,476,354316,8,354308
82828,7,15,520,1105570,7,1105563
82829,20,-8,143,398904,20,398884
82830,14,-18,192,86772,14,86758
82831,5,-4,218,504297,5,504292
82832,11,4,844,779559,11,779548
82833,20,17,203,1179404,20,1179384
82834,9,-5,173,471879,9,471870
82835,19,12,222,1023702,19,1023683
82836,16,-5,768,496606,16,496590
82837,12,12,283,1024212,12,1024200
82838,13,14,516,1089488,13,1089475
82839,16,-8,524,401529,16,401513
82840,15,-9,44,366949,15,366934
82841,11,7,44,867377,11,867366
82842,13,-4,581,526480,13,526467
82843,8,16,263,1130809,8,1130801
82844,17,0,464,651635,17,651618
82845,9,8,546,887166,9,887157
82846,14,-18,562,89334,14,89320
82847,12,5,758,809298,12,809286
82848,19,19,981,1248660,19,1248641
82849,8,-7,900,425191,8,425183
82850,18,-20,342,25488,18,25470
82851,20,-3,706,559416,20,559396
82852,10,4,62,751954,10,751944
82853,11,19,517,1245050,11,1245039
82854,15,-19,464,57528,15,57513
82855,15,11,704,995841,15,995826
82856,19,-8,963,404738,19,404719
82857,14,14,625,1090283,14,1090269
82858,6,-2,621,575995,6,575989
82859,19,8,189,899426,19,899407
82860,18,-3,73,554312,18,554294
82861,15,2,720,716035,15,716020
82862,9,-11,658,295625,9,295616
82863,19,-10,510,338885,19,338866
82864,16,6,625,840807,16,840791
82865,10,8,460,885295,10,885285
82866,13,-15,223,179348,13,179335
82867,9,0,896,644853,9,644844
82868,9,-18,233,67621,9,67612
82869,17,3,420,745032,17,745015
82870,17,-12,738,277893,17,277876
82871,19,-3,931,561236,19,561217
82872,18,-3,416,556890,18,556872
82873,6,-9,340,351137,6,351131
82874,18,5,172,805035,18,805017
82875,17,4,204,774699,17,774682
82876,14,-16,363,149565,14,149551
82877,9,9,160,910151,9,910142
82878,15,13,675,1058314,15,1058299
82879,12,4,987,780483,12,780471
82880,6,-5,57,469096,6,469090
82881,9,-5,813,485533,9,485524
82882,7,-13,527,229504,7,229497
82883,9,4,288,756786,9,756777
82884,19,5,447,807077,19,807058
82885,6,-10,515,323840,6,323834
82886,14,5,190,805250,14,805236
82887,16,18,346,1211616,16,1211600
82888,12,19,506,1244951,12,1244939
82889,19,-4,127,523024,19,523005
82890,20,12,519,1025838,20,1025818
82891,18,-15,601,182192,18,182174
82892,18,14,712,1091070,18,1091052
82893,10,16,518,1136239,10,1136229
82894,8,-17,613,106705,8,106697
82895,6,-1,793,610912,6,610906
82896,8,-2,551,574477,8,574469
82897,10,17,613,1168352,10,1168342
82898,12,-20,840,29332,12,29320
82899,16,-10,983,342498,16,342482
82900,5,-2,455,572513,5,572508
82901,20,4,368,775901,20,775881
82902,8,5,359,788959,8,788951
82903,16,14,671,1090714,16,1090698
82904,20,-17,765,121333,20,121313
82905,6,18,696,1201326,6,1201320
82906,20,-5,790,496735,20,496715
82907,19,6,393,838893,19,838874
82908,14,4,139,774278,14,774264
82909,20,-18,695,90269,20,90249
82910,14,8,17,898045,14,898031
82911,10,-12,107,251877,10,251867
82912,9,4,400,759263,9,759254
82913,5,-9,296,350026,5,350021
82914,15,-19,572,58538,15,58523
82915,10,11,834,986256,10,986246
82916,17,-18,721,90525,17,90508
82917,5,0,971,646457,5,646452
82918,7,-1,321,601026,7,601019
82919,15,8,67,898397,15,898382
82920,5,-18,582,74969,5,74964
82921,20,14,528,1089579,20,1089559
82922,18,5,262,805765,18,805747
82923,14,16,312,1149395,14,1149381
82924,15,18,358,1211699,15,1211684
82925,16,13,139,1054219,16,1054203
82926,16,-13,605,245525,16,245509
82927,16,-10,918,341989,16,341973
82928,15,-12,215,274075,15,274060
82929,16,6,313,838153,16,838137
82930,20,-6,312,461595,20,461575
82931,19,13,41,1053535,19,1053516
82932,20,-8,218,399462,20,399442
82933,9,2,610,701525,9,701516
82934,16,3,582,746198,16,746182
82935,13,-8,4,397859,13,397846
82936,15,13,479,1056785,15,1056770
82937,7,17,370,1163277,7,1163270
82938,9,5,741,797134,9,797125
82939,20,-11,174,305136,20,305116
82940,8,14,226,1066800,8,1066792
82941,11,-15,474,181280,11,181269
82942,12,-2,717,590547,12,590535
82943,10,-3,661,545365,10,545355
82944,14,3,91,742488,14,742474
82945,13,-19,614,58816,13,58803
82946,20,-16,626,151644,20,151624
82947,14,-16,909,153637,14,153623
82948,11,8,693,903441,11,903430
82949,6,4,373,758660,6,758654
82950,9,13,849,1049008,9,1048999
82951,20,8,342,900694,20,900674
82952,7,6,592,825673,7,825666
82953,16,-11,336,306439,16,306423
82954,19,7,529,870953,19,870934
82955,11,-7,182,429666,11,429655
82956,8,11,823,986022,8,986014
82957,19,-5,73,491429,19,491410
82958,19,5,206,805392,19,805373
82959,6,15,406,1102974,6,1102968
82960,16,-12,956,279748,16,279732
82961,6,7,500,855495,6,855489
82962,13,3,614,746419,13,746406
82963,10,8,391,883754,10,883744
82964,11,13,998,1060633,11,1060622
82965,11,-15,226,179371,11,179360
82966,11,-11,558,308196,11,308185
82967,8,-14,10,186693,8,186685
82968,10,-10,493,323354,10,323344
82969,19,5,803,809630,19,809611
82970,18,14,51,1085822,18,1085804
82971,5,-5,520,479278,5,479273
82972,5,-4,702,514526,5,514521
82973,13,2,875,717022,13,717009
82974,20,13,624,1057990,20,1057970
82975,18,-14,792,215712,18,215694
82976,18,-1,161,617743,18,617725
82977,19,3,578,746180,19,746161
82978,19,4,915,780018,19,779999
82979,11,-14,230,211224,11,211213
82980,16,16,303,1149326,16,1149310
82981,17,7,539,871007,17,870990
82982,18,14,812,1091846,18,1091828
82983,16,1,170,681213,16,681197
82984,17,-8,964,404767,17,404750
82985,12,2,283,712681,12,712669
82986,18,-15,917,184746,18,184728
82987,14,16,736,1152342,14,1152328
82988,12,-14,197,210819,12,210807
82989,11,17,378,1180764,11,1180753
82990,13,-4,96,522783,13,522770
82991,7,16,889,1143575,7,1143568
82992,16,-12,294,274695,16,274679
82993,15,-9,123,367501,15,367486
82994,18,-10,662,340102,18,340084
82995,19,-19,205,55710,19,55691
82996,8,-16,51,124934,8,124926
82997,20,-9,518,370775,20,370755
82998,18,2,877,717046,18,717028
82999,9,13,594,1043557,9,1043548
83000,9,-1,821,611519,9,611510
83001,18,-6,123,459997,18,459979
83002,19,-20,75,23360,19,23341
83003,14,4,940,780170,14,780156
83004,18,17,411,1180988,18,1180970
83005,12,16,438,1150273,12,1150261
83006,13,18,85,1209602,13,1209589
83007,17,17,808,1184011,17,1183994
83008,12,-1,33,616821,12,616809
83009,15,-4,366,524973,15,524958
83010,11,8,403,901189,11,901178
83011,9,13,863,1049346,9,1049337
83012,10,3,785,735662,10,735652
83013,12,13,663,1058255,12,1058243
83014,6,11,971,989288,6,989282
83015,12,1,338,682607,12,682595
83016,16,-8,913,404389,16,404373
83017,16,8,855,904636,16,904620
83018,14,-5,735,496423,14,496409
83019,19,18,630,1213480,19,1213461
83020,17,-3,501,557656,17,557639
83021,5,-5,604,481182,5,481177
83022,6,-1,702,609010,6,609004
83023,17,-8,601,402064,17,402047
83024,8,-9,683,358561,8,358553
83025,18,10,805,966152,18,966134
83026,19,12,564,1026186,19,1026167
83027,7,13,862,1049319,7,1049312
83028,5,3,75,720431,5,720426
83029,11,-14,204,210908,11,210897
83030,8,-7,860,424125,8,424117
83031,20,-19,596,58720,20,58700
83032,17,-9,415,369811,17,369794
83033,18,3,956,749159,18,749141
83034,8,10,78,939194,8,939186
83035,7,18,494,1197299,7,1197292
83036,9,7,925,864374,9,864365
83037,9,-6,278,442892,9,442883
83038,6,-16,164,127570,6,127564
83039,6,13,918,1050289,6,1050283
83040,12,-11,159,305011,12,304999
83041,19,-13,856,247428,19,247409
83042,20,-9,53,367059,20,367039
83043,16,13,837,1059506,16,1059490
83044,8,-13,490,228717,8,228709
83045,6,-9,213,348088,6,348082
83046,19,-10,990,342598,19,342579
83047,15,-3,432,557044,15,557029
83048,9,-15,494,166192,9,166183
83049,17,-16,864,153322,17,153305
83050,10,-15,573,167841,10,167831
83051,10,-15,759,171615,10,171605
83052,11,9,125,929994,11,929983
83053,15,-1,449,620119,15,620104
83054,19,-7,636,432983,19,432964
83055,12,19,649,1246059,12,1246047
83056,15,-6,370,461990,15,461975
83057,14,5,918,810466,14,810452
83058,7,19,153,1220880,7,1220873
83059,17,5,12,803861,17,803844
83060,17,-17,417,118515,17,118498
83061,18,-6,936,466241,18,466223
83062,19,-20,146,23900,19,23881
83063,15,0,29,648452,15,648437
83064,16,2,7,710525,16,710509
83065,7,-18,234,67667,7,67660
83066,8,-13,700,233161,8,233153
83067,6,-11,395,289908,6,289902
83068,14,17,890,1184635,14,1184621
83069,6,9,590,919290,6,919284
83070,16,-6,489,462934,16,462918
83071,15,18,884,1215412,15,1215397
83072,12,-13,557,245145,12,245133
83073,16,19,855,1247713,16,1247697
83074,18,15,171,1118074,18,1118056
83075,8,1,596,670231,8,670223
83076,15,11,950,997702,15,997687
83077,13,-13,743,246524,13,246511
83078,8,2,928,707896,8,707888
83079,14,19,325,1243395,14,1243381
83080,11,7,582,871311,11,871300
83081,9,-2,122,565484,9,565475
83082,13,0,753,654057,13,654044
83083,10,-15,121,158133,10,158123
83084,7,-4,267,505435,7,505428
83085,7,-7,382,414173,7,414166
83086,10,13,257,1036088,10,1036078
83087,5,5,789,798089,5,798084
83088,14,-14,275,211582,14,211568
83089,12,5,861,810040,12,810028
83090,6,15,157,1097807,6,1097801
83091,19,-6,596,463683,19,463664
83092,10,2,83,690362,10,690352
83093,13,-3,629,558817,13,558804
83094,14,-10,547,339148,14,339134
83095,13,-4,798,527987,13,527974
83096,16,13,716,1058575,16,1058559
83097,12,-15,828,183988,12,183976
83098,15,10,797,966082,15,966067
83099,11,15,797,1122616,11,1122605
83100,18,-17,296,117725,18,117707
83101,17,10,902,966702,17,966685
83102,12,1,286,682131,12,682119
83103,17,-18,517,89062,17,89045
83104,20,13,593,1057768,20,1057748
83105,10,11,392,976912,10,976902
83106,14,0,421,651321,14,651307
83107,17,-15,421,180916,17,180899
83108,7,9,548,918303,7,918296
83109,6,-8,637,389005,6,388999
83110,18,-3,593,558485,18,558467
83111,5,-9,247,349005,5,349000
83112,8,10,5,937621,8,937613
83113,20,-19,854,60565,20,60545
83114,5,-9,714,359332,5,359327
83115,6,-17,638,107261,6,107255
83116,12,-1,484,620450,12,620438
83117,18,-3,8,553923,18,553905
83118,15,14,576,1089910,15,1089895
83119,7,18,98,1188904,7,1188897
83120,15,15,934,1123627,15,1123612
83121,5,-10,124,315325,5,315320
83122,12,-10,95,335842,12,335830
83123,18,1,456,683451,18,683433
83124,18,6,370,838670,18,838652
83125,19,10,849,966348,19,966329
83126,5,-10,963,333128,5,333123
83127,14,-9,95,367330,14,367316
83128,20,-13,911,247895,20,247875
83129,18,4,821,779303,18,779285
83130,6,-12,626,263058,6,263052
83131,12,-20,509,26666,12,26654
83132,7,5,783,798015,7,798008
83133,9,17,645,1169117,9,1169108
83134,13,15,68,1117276,13,1117263
83135,7,4,270,756399,7,756392
83136,16,-19,677,59275,16,59259
83137,15,3,882,748454,15,748439
83138,10,2,308,695267,10,695257
83139,20,-4,833,528154,20,528134
83140,15,1,310,682288,15,682273
83141,17,17,550,1181982,17,1181965
83142,12,-8,31,398149,12,398137
83143,9,-1,523,605445,9,605436
83144,13,0,583,652676,13,652663
83145,8,-1,490,604767,8,604759
83146,17,-7,287,430488,17,430471
83147,6,-4,559,511474,6,511468
83148,19,-1,799,622720,19,622701
83149,18,-4,83,522672,18,522654
83150,17,-17,640,120287,17,120270
83151,11,0,248,650063,11,650052
83152,15,-3,187,555099,15,555084
83153,8,-7,689,420395,8,420387
83154,20,18,88,1209626,20,1209606
83155,13,-11,503,307785,13,307772
83156,16,-20,684,28069,16,28053
83157,7,7,864,863190,7,863183
83158,14,4,982,780476,14,780462
83159,12,-17,707,120809,12,120797
83160,16,1,926,687124,16,687108
83161,13,16,379,1149872,13,1149859
83162,16,12,531,1025931,16,1025915
83163,15,11,954,997707,15,997692
83164,16,4,332,775609,16,775593
83165,18,-8,144,398938,18,398920
83166,14,15,596,1121110,14,1121096
83167,11,-19,664,59163,11,59152
83168,16,-13,570,245262,16,245246
83169,10,2,451,698237,10,698227
83170,7,-18,575,74820,7,74813
83171,14,13,106,1054013,14,1053999
83172,13,4,298,775346,13,775333
83173,9,8,279,881293,9,881284
83174,18,-7,732,433627,18,433609
83175,14,-9,882,373590,14,373576
83176,6,6,793,830176,6,830170
83177,17,17,158,1179042,17,1179025
83178,5,2,250,693999,5,693994
83179,14,0,803,654431,14,654417
83180,20,5,364,806462,20,806442
83181,5,3,351,726513,5,726508
83182,13,19,389,1243957,13,1243944
83183,11,19,479,1244718,11,1244707
83184,10,-13,214,222887,10,222877
83185,7,-1,584,606657,7,606650
83186,5,-9,538,355839,5,355834
83187,12,-16,152,148063,12,148051
83188,9,-7,453,415552,9,415543
83189,18,-1,171,617843,18,617825
83190,10,-19,841,49943,10,49933
83191,7,2,87,690451,7,690444
83192,9,-10,276,318525,9,318516
83193,11,12,676,1027152,11,1027141
83194,17,8,914,905109,17,905092
83195,7,-15,390,163828,7,163821
83196,16,9,612,933605,16,933589
83197,7,-4,431,508947,7,508940
83198,13,11,779,996484,13,996471
83199,12,9,838,935287,12,935275
83200,9,-19,626,45310,9,45301
83201,6,14,652,1076580,6,1076574
83202,7,-10,143,315814,7,315807
83203,10,16,8,1125386,10,1125376
83204,16,18,179,1210413,16,1210397
83205,9,10,925,957444,9,957435
83206,6,5,257,786998,6,786992
83207,15,-17,631,120230,15,120215
83208,8,13,874,1049573,8,1049565
83209,10,5,577,793578,10,793568
83210,17,13,447,1056593,17,1056576
83211,5,-3,986,552521,5,552516
83212,20,14,63,1085950,20,1085930
83213,11,11,246,992611,11,992600
83214,15,-1,666,621690,15,621675
83215,13,-13,22,241234,13,241221
83216,6,14,68,1063379,6,1063373
83217,5,-5,890,487410,5,487405
83218,8,17,770,1171616,8,1171608
83219,15,15,833,1122891,15,1122876
83220,9,11,151,971598,9,971589
83221,19,-10,769,340860,19,340841
83222,10,-1,232,598991,10,598981
83223,7,-5,570,480381,7,480374
83224,6,-17,243,98637,6,98631
83225,13,-6,616,463851,13,463838
83226,6,-10,355,320292,6,320286
83227,5,-11,864,299629,5,299624
83228,18,5,49,804172,18,804154
83229,10,-17,444,102894,10,102884
83230,15,-2,434,588413,15,588398
83231,12,-10,612,339651,12,339639
83232,20,19,572,1245465,20,1245445
83233,12,-2,941,592311,12,592299
83234,12,-13,155,242153,12,242141
83235,20,16,910,1153621,20,1153601
83236,16,14,725,1091147,16,1091131
83237,18,17,273,1179973,18,1179955
83238,7,-6,419,445749,7,445742
83239,12,-3,882,560839,12,560827
83240,9,19,511,1229154,9,1229145
83241,10,-12,133,252470,10,252460
83242,16,-14,680,214854,16,214838
83243,19,17,639,1182612,19,1182593
83244,8,-14,856,205145,8,205137
83245,6,14,747,1078760,6,1078754
83246,11,4,822,779313,11,779302
83247,9,-13,587,230925,9,230916
83248,14,-11,408,306981,14,306967
83249,7,-8,743,391296,7,391289
83250,15,-12,505,276312,15,276297
83251,20,-15,852,184222,20,184202
83252,7,2,642,702166,7,702159
83253,6,-10,273,318462,6,318456
83254,7,14,6,1061828,7,1061821
83255,5,-15,342,162864,5,162859
83256,11,18,340,1211577,11,1211566
83257,18,2,68,711064,18,711046
83258,10,-12,769,266168,10,266158
83259,5,-6,513,447927,5,447922
83260,15,-15,824,183967,15,183952
83261,17,2,455,714070,17,714053
83262,10,7,269,850548,10,850538
83263,9,14,535,1073785,9,1073776
83264,16,6,356,838539,16,838523
83265,19,6,1000,843747,19,843728
83266,18,-8,713,402927,18,402909
83267,11,4,870,779750,11,779739
83268,16,14,847,1092035,16,1092019
83269,16,11,981,997918,16,997902
83270,7,-19,932,51526,7,51519
83271,14,-14,978,217114,14,217100
83272,15,-4,481,525698,15,525683
83273,16,-8,308,400052,16,400036
83274,15,10,781,965904,15,965889
83275,15,0,955,655546,15,655531
83276,15,6,84,836360,15,836345
83277,17,-4,853,528337,17,528320
83278,11,0,196,649749,11,649738
83279,15,16,720,1152234,15,1152219
83280,6,-3,562,543137,6,543131
83281,11,15,934,1123628,11,1123617
83282,14,16,646,1151759,14,1151745
83283,17,-12,343,275093,17,275076
83284,7,15,576,1106701,7,1106694
83285,12,-8,497,401300,12,401288
83286,10,5,291,787785,10,787775
83287,5,13,825,1048494,5,1048489
83288,9,-3,17,530950,9,530941
83289,10,-20,513,11061,10,11051
83290,7,8,983,896567,7,896560
83291,20,2,28,710682,20,710662
83292,10,16,178,1128931,10,1128921
83293,14,13,451,1056594,14,1056580
83294,14,-13,256,242946,14,242932
83295,11,5,191,805261,11,805250
83296,17,18,775,1214603,17,1214586
83297,17,3,855,748277,17,748260
83298,7,10,655,951713,7,951706
83299,8,11,92,970444,8,970436
83300,12,9,609,933575,12,933563
83301,8,13,946,1050997,8,1050989
83302,14,-9,37,366886,14,366872
83303,13,8,954,905361,13,905348
83304,6,-7,212,410392,6,410386
83305,12,-16,253,148823,12,148811
83306,15,10,497,963630,15,963615
83307,17,-8,255,399712,17,399695
83308,20,9,548,933053,20,933033
83309,7,-19,131,34487,7,34480
83310,11,16,554,1151038,11,1151027
83311,13,0,919,655253,13,655240
83312,12,-9,122,367494,12,367482
83313,7,6,66,813632,7,813625
83314,15,1,531,684092,15,684077
83315,20,-20,168,24042,20,24022
83316,10,-11,668,295902,10,295892
83317,8,-13,370,226125,8,226117
83318,9,-4,468,509560,9,509551
83319,13,18,886,1215456,13,1215443
83320,5,19,617,1231320,5,1231315
83321,14,-17,335,117980,14,117966
83322,19,-15,362,180416,19,180397
83323,5,8,772,892190,5,892185
83324,20,7,888,873385,20,873365
83325,18,-16,181,148235,18,148217
83326,20,-6,372,462030,20,462010
83327,9,13,336,1038059,9,1038050
83328,7,18,724,1201788,7,1201781
83329,11,-4,305,524452,11,524441
83330,7,9,534,918069,7,918062
83331,13,-2,931,592207,13,592194
83332,9,-17,616,106781,9,106772
83333,20,-8,4,397869,20,397849
83334,9,-2,293,569150,9,569141
83335,7,-9,422,352886,7,352879
83336,10,-1,117,596329,10,596319
83337,8,9,430,915670,8,915662
83338,10,-10,310,319294,10,319284
83339,19,0,488,651887,19,651868
83340,15,-1,480,620431,15,620416
83341,7,15,792,1111222,7,1111215
83342,20,-19,46,54233,20,54213
83343,18,-19,452,57459,18,57441
83344,11,-13,660,245827,11,245816
83345,17,6,965,843452,17,843435
83346,17,-10,172,336381,17,336364
83347,15,15,439,1119898,15,1119883
83348,20,16,829,1153103,20,1153083
83349,18,13,691,1058419,18,1058401
83350,8,-16,733,139760,8,139752
83351,19,8,895,904931,19,904912
83352,5,7,999,865977,5,865972
83353,8,9,667,920765,8,920757
83354,14,4,448,776466,14,776452
83355,18,-18,996,92466,18,92448
83356,17,18,34,1209149,17,1209132
83357,12,17,245,1179718,12,1179706
83358,14,15,346,1119345,14,1119331
83359,11,-3,680,559229,11,559218
83360,8,15,137,1097497,8,1097489
83361,6,-14,104,188838,6,188832
83362,5,-15,484,165952,5,165947
83363,7,-19,86,33307,7,33300
83364,16,-13,617,245641,16,245625
83365,19,-14,647,214587,19,214568
83366,8,16,855,1142869,8,1142861
83367,20,11,974,997876,20,997856
83368,8,5,483,791654,8,791646
83369,5,-3,675,545722,5,545717
83370,7,2,605,701382,7,701375
83371,10,-19,616,45017,10,45007
83372,7,5,250,786865,7,786858
83373,8,-18,896,81848,8,81840
83374,19,-9,878,373544,19,373525
83375,7,13,549,1042542,7,1042535
83376,17,-14,766,215520,17,215503
83377,12,18,729,1214183,12,1214171
83378,11,-20,306,25221,11,25210
83379,13,5,488,807381,13,807368
83380,16,-7,214,429924,16,429908
83381,18,-8,561,401790,18,401772
83382,16,19,382,1243864,16,1243848
83383,7,-18,441,71867,7,71860
83384,9,-6,195,441164,9,441155
83385,7,-18,780,79405,7,79398
83386,15,16,530,1150869,15,1150854
83387,13,-7,635,432968,13,432955
83388,20,0,513,652055,20,652035
83389,8,19,791,1235044,8,1235036
83390,15,-1,770,622482,15,622467
83391,13,11,589,995122,13,995109
83392,14,3,970,749292,14,749278
83393,5,18,874,1205199,5,1205194
83394,8,3,621,732101,8,732093
83395,15,2,700,715905,15,715890
83396,7,0,48,626334,7,626327
83397,16,19,998,1248780,16,1248764
83398,11,-10,808,341185,11,341174
83399,11,11,618,995280,11,995269
83400,12,12,425,1025149,12,1025137
83401,19,15,972,1123951,19,1123932
83402,10,-1,141,596826,10,596816
83403,7,12,265,1005089,7,1005082
83404,10,-14,315,193529,10,193519
83405,18,3,102,742603,18,742585
83406,16,-16,146,148005,16,147989
83407,5,-6,950,457061,5,457056
83408,7,-3,643,544954,7,544947
83409,8,-19,13,31729,8,31721
83410,16,-20,960,30059,16,30043
83411,12,16,172,1148313,12,1148301
83412,19,19,879,1247906,19,1247887
83413,12,14,953,1092905,12,1092893
83414,14,-3,171,554979,14,554965
83415,17,-7,993,435684,17,435667
83416,17,16,916,1153697,17,1153680
83417,7,-11,102,283345,7,283338
83418,13,-15,430,180987,13,180974
83419,8,-7,280,411830,8,411822
83420,18,-13,464,244369,18,244351
83421,20,-5,964,498147,20,498127
83422,6,-6,369,444658,6,444652
83423,15,-12,780,278233,15,278218
83424,8,-7,483,416204,8,416196
83425,19,-7,58,428731,19,428712
83426,13,-20,22,13423,13,13410
83427,17,-18,150,86404,17,86387
83428,13,-14,798,215796,13,215783
83429,17,-20,840,29339,17,29322
83430,8,-1,239,599166,8,599158
83431,13,15,142,1117875,13,1117862
83432,10,-10,979,333583,10,333573
83433,20,-20,113,23609,20,23589
83434,7,-16,591,136867,7,136860
83435,17,4,211,774777,17,774760
83436,20,-20,639,27648,20,27628
83437,7,8,887,894381,7,894374
83438,12,8,778,904145,12,904133
83439,14,10,797,966086,14,966072
83440,13,-3,553,558164,13,558151
83441,11,12,308,1024391,11,1024380
83442,14,-5,64,491322,14,491308
83443,8,-3,779,547963,8,547955
83444,18,-12,237,274271,18,274253
83445,15,1,238,681787,15,681772
83446,14,2,962,717669,14,717655
83447,11,7,38,867311,11,867300
83448,7,-10,708,327902,7,327895
83449,13,18,144,1210139,13,1210126
83450,11,-15,677,182804,11,182793
83451,17,0,367,650831,17,650814
83452,12,-13,142,242041,12,242029
83453,6,-11,883,300118,6,300112
83454,8,-16,918,143717,8,143709
83455,15,-6,18,459275,15,459260
83456,14,-18,567,89355,14,89341
83457,7,3,686,733721,7,733714
83458,5,-10,105,314824,5,314819
83459,13,-1,448,620115,13,620102
83460,6,16,162,1128481,6,1128475
83461,18,-6,957,466386,18,466368
83462,7,0,715,641096,7,641089
83463,17,3,782,747707,17,747690
83464,13,13,773,1059031,13,1059018
83465,16,16,714,1152212,16,1152196
83466,5,-15,452,165188,5,165183
83467,11,6,694,841390,11,841379
83468,5,-11,295,287518,5,287513
83469,10,15,816,1111725,10,1111715
83470,9,6,936,833295,9,833286
83471,6,0,927,645532,6,645526
83472,18,15,924,1123522,18,1123504
83473,6,-2,446,572273,6,572267
83474,8,-20,766,16830,8,16822
83475,7,-20,667,14706,7,14699
83476,12,1,768,685874,12,685862
83477,18,7,641,871717,18,871699
83478,14,5,82,804405,14,804391
83479,11,4,971,780374,11,780363
83480,6,10,600,950485,6,950479
83481,14,-12,751,278025,14,278011
83482,17,-8,604,402086,17,402069
83483,8,5,257,787006,8,786998
83484,19,4,567,777382,19,777363
83485,18,-3,474,557425,18,557407
83486,17,14,494,1089311,17,1089294
83487,5,-17,518,104680,5,104675
83488,19,-1,660,621679,19,621660
83489,16,18,626,1213445,16,1213429
83490,7,9,555,918487,7,918480
83491,8,8,498,886127,8,886119
83492,8,11,217,972831,8,972823
83493,9,-5,880,487184,9,487175
83494,13,7,667,871940,13,871927
83495,13,-16,337,149392,13,149379
83496,12,-14,103,210124,12,210112
83497,13,15,102,1117569,13,1117556
83498,5,-6,723,452367,5,452362
83499,14,-10,907,341904,14,341890
83500,20,-13,695,246073,20,246053
83501,19,18,821,1214892,19,1214873
83502,7,-8,679,389967,7,389960
83503,17,2,680,715734,17,715717
83504,19,14,229,1087207,19,1087188
83505,13,-3,151,554839,13,554826
83506,15,2,779,716337,15,716322
83507,19,-19,82,54534,19,54515
83508,8,19,267,1223412,8,1223404
83509,7,-17,289,99710,7,99703
83510,10,-9,832,362141,10,362131
83511,8,16,806,1141968,8,1141960
83512,9,-17,687,108206,9,108197
83513,18,15,879,1123183,18,1123165
83514,13,-5,710,496215,13,496202
83515,13,11,669,995592,13,995579
83516,20,-12,570,276724,20,276704
83517,20,12,961,1029534,20,1029514
83518,6,18,933,1206496,6,1206490
83519,11,-7,384,431256,11,431245
83520,5,9,513,917620,5,917615
83521,20,-13,929,248049,20,248029
83522,18,8,184,899371,18,899353
83523,14,-16,184,148260,14,148246
83524,14,8,663,903203,14,903189
83525,19,16,836,1153148,19,1153129
83526,6,5,717,796532,6,796526
83527,6,-17,525,104749,6,104743
83528,8,19,304,1224330,8,1224322
83529,14,-2,1000,592707,14,592693
83530,20,-5,282,493130,20,493110
83531,15,8,178,899342,15,899327
83532,6,6,213,816867,6,816861
83533,5,-17,776,110085,5,110080
83534,12,-19,16,54006,12,53994
83535,8,-16,988,145323,8,145315
83536,12,-3,439,557115,12,557103
83537,17,-6,262,461214,17,461197
83538,15,10,612,964637,15,964622
83539,9,-1,99,595975,9,595966
83540,6,-7,558,417892,6,417886
83541,17,-1,967,623896,17,623879
83542,15,18,718,1214077,15,1214062
83543,7,-19,838,49829,7,49822
83544,6,-5,954,488763,6,488757
83545,13,14,618,1090221,13,1090208
83546,7,-13,731,233980,7,233973
83547,5,-15,258,160914,5,160909
83548,11,1,789,685979,11,685968
83549,11,-8,773,403375,11,403364
83550,7,-11,51,282163,7,282156
83551,8,13,21,1031260,8,1031252
83552,19,-1,517,620682,19,620663
83553,18,10,986,967352,18,967334
83554,18,-12,944,279631,18,279613
83555,20,19,570,1245440,20,1245420
83556,13,2,688,715791,13,715778
83557,11,1,969,687411,11,687400
83558,6,-9,288,349897,6,349891
83559,10,-2,589,575279,10,575269
83560,17,15,565,1120876,17,1120859
83561,16,-3,168,554955,16,554939
83562,7,-1,896,613192,7,613185
83563,9,11,710,983599,9,983590
83564,10,5,626,794643,10,794633
83565,17,8,811,904339,17,904322
83566,8,11,922,988434,8,988426
83567,16,-4,960,529311,16,529295
83568,17,16,546,1150953,17,1150936
83569,10,-2,405,571336,10,571326
83570,14,6,370,838674,14,838660
83571,16,-8,798,403588,16,403572
83572,18,-16,837,153036,18,153018
83573,19,10,242,961625,19,961606
83574,7,-13,763,234846,7,234839
83575,12,-2,28,585351,12,585339
83576,15,-8,847,403878,15,403863
83577,5,10,709,952843,5,952838
83578,8,10,99,939792,8,939784
83579,5,-14,601,199844,5,199839
83580,12,16,560,1151076,12,1151064
83581,10,18,357,1194409,10,1194399
83582,11,12,68,1022554,11,1022543
83583,20,3,936,748946,20,748926
83584,18,-5,118,491850,18,491832
83585,9,2,787,705052,9,705043
83586,13,1,997,687541,13,687528
83587,10,-3,508,541891,10,541881
83588,11,7,168,868212,11,868201
83589,9,-6,821,454462,9,454453
83590,5,11,39,969287,5,969282
83591,14,-20,241,24624,14,24610
83592,9,-17,844,111359,9,111350
83593,10,-18,327,69602,10,69592
83594,6,14,108,1064291,6,1064285
83595,15,-11,4,303697,15,303682
83596,17,-14,575,214057,17,214040
83597,15,-17,394,118393,15,118378
83598,6,3,84,720616,6,720610
83599,16,14,703,1090977,16,1090961
83600,17,4,754,778811,17,778794
83601,20,15,787,1122556,20,1122536
83602,7,-17,881,112120,7,112113
83603,14,7,295,869144,14,869130
83604,6,-13,637,231950,6,231944
83605,19,5,697,808885,19,808866
83606,19,13,70,1053754,19,1053735
83607,7,-6,851,454959,7,454952
83608,10,-14,585,199419,10,199409
83609,19,-15,863,184321,19,184302
83610,17,-3,844,560523,17,560506
83611,10,-7,969,426559,10,426549
83612,11,1,839,686334,11,686323
83613,9,-17,207,97816,9,97807
83614,19,-19,760,59952,19,59933
83615,17,0,710,653704,17,653687
83616,19,2,66,711044,19,711025
83617,9,4,20,750943,9,750934
83618,5,15,291,1100809,5,1100804
83619,7,15,218,1099189,7,1099182
83620,9,3,593,731456,9,731447
83621,10,11,247,973547,10,973537
83622,14,9,799,934973,14,934959
83623,12,-18,588,89513,12,89501
83624,18,-10,864,341579,18,341561
83625,11,15,413,1119704,11,1119693
83626,13,9,450,932300,13,932287
83627,9,-5,602,481143,9,481134
83628,9,-5,257,473725,9,473716
83629,12,-7,426,431512,12,431500
83630,10,-1,89,595761,10,595751
83631,14,-6,798,465266,14,465252
83632,17,3,637,746643,17,746626
83633,6,8,132,877920,6,877914
83634,16,-9,209,368027,16,368011
83635,11,7,218,868531,11,868520
83636,16,13,410,1056290,16,1056274
83637,9,8,462,885336,9,885327
83638,9,8,569,887711,9,887702
83639,6,-13,916,238189,6,238183
83640,7,17,526,1166598,7,1166591
83641,13,-10,233,336777,13,336764
83642,9,-5,676,482645,9,482636
83643,19,14,176,1086833,19,1086814
83644,5,13,317,1037521,5,1037516
83645,18,12,217,1023679,18,1023661
83646,11,-16,900,153547,11,153536
83647,9,8,590,888115,9,888106
83648,7,-12,195,253677,7,253670
83649,11,-18,558,89327,11,89316
83650,12,-9,20,366749,12,366737
83651,14,4,349,775739,14,775725
83652,10,9,103,908941,10,908931
83653,14,-10,993,342659,14,342645
83654,14,-10,916,341959,14,341945
83655,11,-12,706,277723,11,277712
83656,7,2,165,692169,7,692162
83657,13,5,459,807151,13,807138
83658,13,19,855,1247716,13,1247703
83659,12,17,572,1182081,12,1182069
83660,16,-9,465,370278,16,370262
83661,8,-17,977,114086,8,114078
83662,18,-6,93,459774,18,459756
83663,13,3,485,745447,13,745434
83664,8,-15,392,163864,8,163856
83665,11,10,12,959927,11,959916
83666,15,5,97,804508,15,804493
83667,10,1,23,657554,10,657544
83668,16,7,786,872686,16,872670
83669,11,2,695,715854,11,715843
83670,13,-13,133,241969,13,241956
83671,12,-16,807,152837,12,152825
83672,9,-15,973,176196,9,176187
83673,5,7,378,852970,5,852965
83674,19,-10,561,339274,19,339255
83675,12,-16,696,152018,12,152006
83676,8,14,188,1065905,8,1065897
83677,10,-5,528,479527,10,479517
83678,7,13,749,1046804,7,1046797
83679,14,0,922,655289,14,655275
83680,13,8,164,899256,13,899243
83681,16,-13,239,242812,16,242796
83682,15,-9,740,372287,15,372272
83683,12,-13,999,248606,12,248594
83684,17,14,737,1091211,17,1091194
83685,13,8,965,905463,13,905450
83686,14,8,986,905611,14,905597
83687,10,2,904,707392,10,707382
83688,7,16,966,1145386,7,1145379
83689,18,7,505,870758,18,870740
83690,11,-12,28,272709,11,272698
83691,10,-6,371,444777,10,444767
83692,16,-3,293,555909,16,555893
83693,14,8,218,899691,14,899677
83694,11,12,183,1023381,11,1023370
83695,19,2,143,711701,19,711682
83696,12,-1,942,623754,12,623742
83697,8,-4,639,513222,8,513214
83698,12,19,322,1243348,12,1243336
83699,9,-19,748,48038,9,48029
83700,6,-1,964,614644,6,614638
83701,18,-11,114,304621,18,304603
83702,11,7,280,868999,11,868988
83703,20,12,21,1022254,20,1022234
83704,16,-1,146,617653,16,617637
83705,17,-18,375,88109,17,88092
83706,12,-6,308,461553,12,461541
83707,15,-15,866,184356,15,184341
83708,8,-18,114,64967,8,64959
83709,20,11,251,992660,20,992640
83710,16,9,771,934698,16,934682
83711,20,-10,771,340878,20,340858
83712,11,-14,412,212793,11,212782
83713,10,-1,983,615160,10,615150
83714,13,-16,668,151819,13,151806
83715,16,-5,900,497619,16,497603
83716,17,-9,419,369859,17,369842
83717,12,-9,313,368908,12,368896
83718,6,-4,937,519500,6,519494
83719,19,14,328,1088027,19,1088008
83720,7,14,606,1075375,7,1075368
83721,16,17,941,1184952,16,1184936
83722,7,-2,876,581580,7,581573
83723,15,-5,554,495127,15,495112
83724,18,17,980,1185316,18,1185298
83725,20,4,296,775326,20,775306
83726,7,-11,239,286234,7,286227
83727,14,5,714,809013,14,808999
83728,12,9,904,935788,12,935776
83729,16,-6,660,464176,16,464160
83730,12,15,493,1120272,12,1120260
83731,7,18,500,1197384,7,1197377
83732,16,-3,961,561487,16,561471
83733,9,-8,415,383948,9,383939
83734,7,0,924,645461,7,645454
83735,20,4,977,780408,20,780388
83736,16,-14,351,212140,16,212124
83737,6,-6,847,454888,6,454882
83738,10,-1,381,602330,10,602320
83739,20,-18,277,87414,20,87394
83740,14,10,234,961585,14,961571
83741,17,3,649,746754,17,746737
83742,9,10,824,955372,9,955363
83743,11,-10,29,335384,11,335373
83744,12,14,485,1089218,12,1089206
83745,7,17,960,1175954,7,1175947
83746,19,-15,649,182642,19,182623
83747,12,-20,312,25290,12,25278
83748,14,18,248,1210976,14,1210962
83749,19,0,824,654515,19,654496
83750,17,4,798,779103,17,779086
83751,15,17,150,1178965,15,1178950
83752,7,12,366,1007136,7,1007129
83753,15,5,258,805735,15,805720
83754,9,14,830,1080526,9,1080517
83755,8,-15,292,161707,8,161699
83756,17,-5,864,497332,17,497315
83757,10,9,370,914542,10,914532
83758,11,1,805,686118,11,686107
83759,5,-5,236,473222,5,473217
83760,17,13,949,1060284,17,1060267
83761,9,6,739,829012,9,829003
83762,18,-3,624,558764,18,558746
83763,16,0,815,654483,16,654467
83764,17,3,617,746463,17,746446
83765,5,14,997,1084264,5,1084259
83766,14,16,910,1153625,14,1153611
83767,11,-1,150,617685,11,617674
83768,17,3,419,745022,17,745005
83769,20,-15,625,182380,20,182360
83770,9,0,704,640773,9,640764
83771,13,-19,801,60197,13,60184
83772,15,1,758,685764,15,685749
83773,18,-5,140,492006,18,491988
83774,18,6,430,839210,18,839192
83775,17,0,222,649915,17,649898
83776,9,-4,316,506433,9,506424
83777,17,-2,678,590232,17,590215
83778,13,-6,255,461175,13,461162
83779,18,8,649,903117,18,903099
83780,15,-17,531,119443,15,119428
83781,6,-8,152,378731,6,378725
83782,15,-3,573,558339,15,558324
83783,5,-16,477,134493,5,134488
83784,17,13,141,1054229,17,1054212
83785,9,8,561,887507,9,887498
83786,8,19,321,1224717,8,1224709
83787,11,0,89,648891,11,648880
83788,18,-13,274,243125,18,243107
83789,17,-7,883,434792,17,434775
83790,18,0,383,651001,18,650983
83791,6,10,249,942706,6,942700
83792,5,-7,327,413004,5,412999
83793,6,3,880,737818,6,737812
83794,14,13,15,1053340,14,1053326
83795,19,-20,307,25247,19,25228
83796,15,4,979,780437,15,780422
83797,11,4,829,779415,11,779404
83798,19,-10,773,340897,19,340878
83799,12,11,501,994493,12,994481
83800,9,-2,752,578728,9,578719
83801,14,-3,529,558001,14,557987
83802,12,10,922,966947,12,966935
83803,9,18,161,1190342,9,1190333
83804,12,-7,704,433433,12,433421
83805,20,10,695,965264,20,965244
83806,6,7,963,865123,6,865117
83807,8,1,295,663614,8,663606
83808,6,-3,483,541312,6,541306
83809,7,16,386,1133362,7,1133355
83810,13,-7,491,432004,13,431991
83811,9,11,332,975607,9,975598
83812,19,4,992,780519,19,780500
83813,19,17,440,1181211,19,1181192
83814,18,-17,560,119704,18,119686
83815,12,-13,282,243201,12,243189
83816,17,9,991,936465,17,936448
83817,8,7,192,848843,8,848835
83818,20,-8,498,401309,20,401289
83819,5,7,408,853618,5,853613
83820,15,13,774,1059035,15,1059020
83821,17,-8,439,400942,17,400925
83822,9,-15,294,161739,9,161730
83823,19,19,328,1243426,19,1243407
83824,6,0,934,645638,6,645632
83825,16,-12,696,277632,16,277616
83826,9,-19,274,37496,9,37487
83827,20,15,656,1121614,20,1121594
83828,16,-15,389,180619,16,180603
83829,19,-16,782,152663,19,152644
83830,17,-3,286,555824,17,555807
83831,13,-20,745,28525,13,28512
83832,15,6,291,837977,15,837962
83833,12,15,162,1117968,12,1117956
83834,17,-12,661,277404,17,277387
83835,5,16,892,1143643,5,1143638
83836,8,15,753,1110574,8,1110566
83837,9,-18,431,71691,9,71682
83838,13,-9,95,367333,13,367320
83839,20,-16,794,152730,20,152710
83840,12,-8,345,400324,12,400312
83841,6,-10,376,320723,6,320717
83842,14,-11,760,309652,14,309638
83843,5,-17,414,102229,5,102224
83844,18,9,849,935373,18,935355
83845,12,-3,319,556111,12,556099
83846,7,-3,277,536381,7,536374
83847,19,12,316,1024447,19,1024428
83848,11,-3,585,558403,11,558392
83849,14,14,814,1091866,14,1091852
83850,15,12,911,1029033,15,1029018
83851,18,14,989,1093219,18,1093201
83852,12,-17,118,116422,12,116410
83853,8,16,952,1144977,8,1144969
83854,15,-18,65,85699,15,85684
83855,15,9,770,934693,15,934678
83856,13,16,475,1150524,13,1150511
83857,11,19,791,1247194,11,1247183
83858,11,-3,61,554195,11,554184
83859,18,-16,952,153905,18,153887
83860,15,-14,794,215727,15,215712
83861,17,4,985,780480,17,780463
83862,16,0,177,649578,16,649562
83863,19,-16,73,147378,19,147359
83864,18,12,841,1028407,18,1028389
83865,19,-18,650,89998,19,89979
83866,13,17,625,1182500,13,1182487
83867,5,-14,151,189767,5,189762
83868,10,-6,585,449391,10,449381
83869,17,-11,118,304655,17,304638
83870,18,-14,865,216279,18,216261
83871,16,-13,195,242491,16,242475
83872,14,-10,433,338236,14,338222
83873,15,12,865,1028575,15,1028560
83874,18,1,668,685123,18,685105
83875,15,-3,370,556528,15,556513
83876,20,13,168,1054446,20,1054426
83877,5,-10,189,316726,5,316721
83878,17,-9,302,368793,17,368776
83879,8,15,665,1108556,8,1108548
83880,14,-15,22,177969,14,177955
83881,19,-18,299,87562,19,87543
83882,13,-1,654,621645,13,621632
83883,10,5,189,785601,10,785591
83884,20,-17,978,122668,20,122648
83885,10,17,747,1171209,10,1171199
83886,16,18,258,1211060,16,1211044
83887,11,9,780,934821,11,934810
83888,5,2,28,689180,5,689175
83889,19,-11,725,309402,19,309383
83890,8,2,823,705766,8,705758
83891,12,-11,57,304126,12,304114
83892,13,1,672,685136,13,685123
83893,15,-7,642,433008,15,432993
83894,16,15,752,1122409,16,1122393
83895,19,-19,851,60534,19,60515
83896,5,-4,997,520939,5,520934
83897,7,-4,880,518332,7,518325
83898,15,-14,460,213059,15,213044
83899,5,-1,895,613166,5,613161
83900,5,19,580,1230629,5,1230624
83901,8,-2,469,572776,8,572768
83902,10,8,273,881130,10,881120
83903,10,18,741,1202261,10,1202251
83904,16,8,915,905114,16,905098
83905,5,-1,758,610096,5,610091
83906,12,10,460,963348,12,963336
83907,8,17,958,1175893,8,1175885
83908,7,11,677,982854,7,982847
83909,15,-19,732,59758,15,59743
83910,9,-7,955,426276,9,426267
83911,11,-18,618,89693,11,89682
83912,6,-17,538,105036,6,105030
83913,9,-16,715,139371,9,139362
83914,8,0,390,633841,8,633833
83915,5,-13,295,224770,5,224765
83916,14,-4,992,529565,14,529551
83917,8,-9,533,355731,8,355723
83918,5,2,576,700748,5,700743
83919,7,-9,114,346001,7,345994
83920,18,6,688,841302,18,841284
83921,18,8,93,898654,18,898636
83922,9,-2,496,573376,9,573367
83923,12,1,582,684495,12,684483
83924,18,-5,527,494954,18,494936
83925,18,17,95,1178532,18,1178514
83926,16,-16,747,152362,16,152346
83927,11,-1,279,618730,11,618719
83928,6,-3,311,537195,6,537189
83929,14,-13,706,246208,14,246194
83930,6,-4,588,512128,6,512122
83931,18,7,168,868220,18,868202
83932,20,-1,189,617958,20,617938
83933,13,12,984,1029716,13,1029703
83934,5,4,402,759358,5,759353
83935,17,-10,500,338798,17,338781
83936,8,-3,285,536556,8,536548
83937,18,0,904,655154,18,655136
83938,20,9,962,936272,20,936252
83939,20,7,455,870431,20,870411
83940,19,0,850,654690,19,654671
83941,8,-20,182,4224,8,4216
83942,17,16,671,1151930,17,1151913
83943,13,15,14,1116869,13,1116856
83944,18,12,972,1029588,18,1029570
83945,20,-18,252,87284,20,87264
83946,15,-11,367,306711,15,306696
83947,20,-16,30,146970,20,146950
83948,15,-12,573,276758,15,276743
83949,17,-17,74,116060,17,116043
83950,18,-17,985,122715,18,122697
83951,6,15,493,1104874,6,1104868
83952,10,10,543,949091,10,949081
83953,11,-11,899,310755,11,310744
83954,17,2,518,714557,17,714540
83955,17,-9,868,373460,17,373443
83956,18,-14,304,211778,18,211760
83957,5,9,966,927360,5,927355
83958,17,-10,424,338179,17,338162
83959,8,5,576,793554,8,793546
83960,15,15,822,1122804,15,1122789
83961,17,-1,741,622289,17,622272
83962,5,6,364,820424,5,820419
83963,20,2,404,713720,20,713700
83964,8,7,859,863047,8,863039
83965,5,-13,248,223659,5,223654
83966,16,0,896,655096,16,655080
83967,13,3,6,741852,13,741839
83968,8,-6,109,439067,8,439059
83969,11,-15,58,178215,11,178204
83970,11,-9,144,367620,11,367609
83971,9,16,580,1137344,9,1137335
83972,8,-8,893,394436,8,394428
83973,6,11,301,974818,6,974812
83974,5,-1,204,598182,5,598177
83975,9,3,874,737718,9,737709
83976,18,-8,489,401223,18,401205
83977,20,10,870,966514,20,966494
83978,13,13,562,1057473,13,1057460
83979,5,14,225,1066755,5,1066750
83980,16,-19,734,59803,16,59787
83981,9,13,42,1031680,9,1031671
83982,13,15,300,1119031,13,1119018
83983,19,-9,146,367635,19,367616
83984,13,3,239,743691,13,743678
83985,16,15,390,1119622,16,1119606
83986,5,-18,338,69773,5,69768
83987,6,-4,327,506659,6,506653
83988,7,10,697,952536,7,952529
83989,14,3,133,742844,14,742830
83990,6,-18,887,81646,6,81640
83991,17,11,696,995762,17,995745
83992,17,-5,315,493420,17,493403
83993,8,15,188,1098502,8,1098494
83994,20,-9,430,369970,20,369950
83995,9,-3,426,539870,9,539861
83996,14,5,458,807149,14,807135
83997,5,-7,726,421228,5,421223
83998,6,17,114,1157689,6,1157683
83999,6,14,612,1075492,6,1075486
84000,5,-7,817,423088,5,423083
84001,5,-5,313,475015,5,475010
84002,20,6,131,836762,20,836742
84003,19,-20,731,28425,19,28406
84004,20,-13,524,244918,20,244898
84005,11,-6,875,465726,11,465715
84006,19,-1,842,623029,19,623010
84007,6,-3,378,538734,6,538728
84008,19,-20,935,29921,19,29902
84009,8,1,722,672680,8,672672
84010,18,-3,585,558411,18,558393
84011,5,-12,15,249899,5,249894
84012,6,-7,996,427150,6,427144
84013,17,-16,952,153912,17,153895
84014,8,-19,119,34201,8,34193
84015,16,-15,426,180953,16,180937
84016,9,19,408,1226796,9,1226787
84017,6,-14,261,192519,6,192513
84018,7,-15,81,157092,7,157085
84019,5,-12,406,258482,5,258477
84020,8,12,101,1001304,8,1001296
84021,17,3,841,748152,17,748135
84022,8,-15,455,165246,8,165238
84023,19,-18,901,91759,19,91740
84024,13,3,290,744096,13,744083
84025,11,-4,87,522693,11,522682
84026,6,-19,152,35069,6,35063
84027,5,18,882,1205345,5,1205340
84028,14,12,725,1027505,14,1027491
84029,16,-3,646,558926,16,558910
84030,9,-9,485,354608,9,354599
84031,19,-8,470,401101,19,401082
84032,11,-20,456,26247,11,26236
84033,14,-10,394,337909,14,337895
84034,5,-1,629,607491,5,607486
84035,20,9,970,936366,20,936346
84036,9,-12,586,262211,9,262202
84037,8,-19,828,49554,8,49546
84038,5,17,300,1161772,5,1161767
84039,13,-9,504,370637,13,370624
84040,16,11,715,995960,16,995944
84041,17,-20,768,28730,17,28713
84042,10,5,551,793066,10,793056
84043,12,8,715,903672,12,903660
84044,6,-9,865,362946,6,362940
84045,16,3,477,745402,16,745386
84046,18,5,647,808524,18,808506
84047,16,1,631,684831,16,684815
84048,11,13,168,1054447,11,1054436
84049,19,12,631,1026729,19,1026710
84050,17,-15,237,179460,17,179443
84051,15,7,809,872862,15,872847
84052,9,-19,424,40634,9,40625
84053,5,-15,20,155788,5,155783
84054,12,9,316,931332,12,931320
84055,5,-10,622,326067,5,326062
84056,7,5,79,783286,7,783279
84057,5,-16,391,132385,5,132380
84058,8,-11,86,282940,8,282932
84059,13,1,915,686996,13,686983
84060,10,-12,529,261100,10,261090
84061,5,0,717,641127,5,641122
84062,20,15,331,1119228,20,1119208
84063,13,4,232,774961,13,774948
84064,14,14,80,1086056,14,1086042
84065,5,-16,480,134545,5,134540
84066,15,-5,437,494236,15,494221
84067,16,17,707,1183158,16,1183142
84068,18,-10,311,337332,18,337314
84069,18,0,940,655385,18,655367
84070,13,12,825,1028182,13,1028169
84071,14,-11,718,309294,14,309280
84072,15,-18,259,87319,15,87304
84073,6,18,868,1205070,6,1205064
84074,9,-14,286,192974,9,192965
84075,15,-15,638,182524,15,182509
84076,14,-12,709,277754,14,277740
84077,17,12,542,1026051,17,1026034
84078,8,-20,611,13346,8,13338
84079,19,-15,718,183147,19,183128
84080,15,-16,484,150586,15,150571
84081,13,-10,299,337217,13,337204
84082,16,18,260,1211073,16,1211057
84083,11,-5,72,491393,11,491382
84084,11,12,890,1028778,11,1028767
84085,19,-6,378,462063,19,462044
84086,14,15,929,1123569,14,1123555
84087,7,3,112,721266,7,721259
84088,15,16,913,1153659,15,1153644
84089,11,-3,191,555121,11,555110
84090,14,-1,542,620867,14,620853
84091,5,8,393,883794,5,883789
84092,15,-9,491,370562,15,370547
84093,11,12,73,1022574,11,1022563
84094,10,-14,999,208321,10,208311
84095,17,-9,719,372074,17,372057
84096,20,12,145,1023084,20,1023064
84097,9,0,42,626205,9,626196
84098,5,8,1,875184,5,875179
84099,10,-2,572,574924,10,574914
84100,16,16,994,1154247,16,1154231
84101,9,-15,95,157477,9,157468
84102,10,-2,880,581717,10,581707
84103,6,-3,776,547873,6,547867
84104,6,9,154,910008,6,910002
84105,5,-2,2,562811,5,562806
84106,15,-16,860,153250,15,153235
84107,16,17,170,1179171,16,1179155
84108,19,2,49,710894,19,710875
84109,11,18,678,1213851,11,1213840
84110,11,11,217,992362,11,992351
84111,14,8,250,899964,14,899950
84112,19,10,363,962577,19,962558
84113,20,-10,332,337469,20,337449
84114,5,15,939,1114423,5,1114418
84115,10,19,412,1226959,10,1226949
84116,9,-17,221,98172,9,98163
84117,18,17,935,1184903,18,1184885
84118,8,8,114,877514,8,877506
84119,10,12,775,1015896,10,1015886
84120,20,-10,955,342247,20,342227
84121,9,-20,37,883,9,874
84122,12,12,688,1027256,12,1027244
84123,16,-1,132,617577,16,617561
84124,16,-1,60,617003,16,616987
84125,16,9,333,931445,16,931429
84126,14,19,782,1247117,14,1247103
84127,20,8,634,903013,20,902993
84128,17,10,633,964803,17,964786
84129,15,3,897,748571,15,748556
84130,17,-19,814,60250,17,60233
84131,8,-1,882,612906,8,612898
84132,6,-1,754,610008,6,610002
84133,19,17,393,1180876,19,1180857
84134,11,10,30,960096,11,960085
84135,13,-10,384,337819,13,337806
84136,7,7,118,847348,7,847341
84137,8,5,456,791067,8,791059
84138,6,2,288,694861,6,694855
84139,6,-8,465,384933,6,384927
84140,6,6,259,818087,6,818081
84141,6,4,119,753122,6,753116
84142,16,-15,962,185110,16,185094
84143,6,1,302,663752,6,663746
84144,14,4,236,775000,14,774986
84145,17,11,840,996950,17,996933
84146,17,-14,984,217159,17,217142
84147,9,-17,244,98654,9,98645
84148,13,11,868,997173,13,997160
84149,14,3,678,747002,14,746988
84150,12,-19,750,59893,12,59881
84151,6,-3,947,551738,6,551732
84152,6,17,483,1165705,6,1165699
84153,15,14,246,1087359,15,1087344
84154,10,-13,24,218861,10,218851
84155,13,2,93,711262,13,711249
84156,19,-12,9,272587,19,272568
84157,16,-3,31,554028,16,554012
84158,18,-16,344,149421,18,149403
84159,14,-15,455,181128,14,181114
84160,11,19,241,1242626,11,1242615
84161,17,-8,776,403412,17,403395
84162,8,14,159,1065478,8,1065470
84163,17,2,316,712948,17,712931
84164,13,-9,254,368441,13,368428
84165,15,-3,746,559720,15,559705
84166,5,-18,809,79925,5,79920
84167,20,14,752,1091356,20,1091336
84168,13,-1,518,620713,13,620700
84169,9,-6,456,446523,9,446514
84170,17,-10,783,340955,17,340938
84171,5,-3,356,538177,5,538172
84172,6,13,668,1045158,6,1045152
84173,13,8,877,904753,13,904740
84174,15,-3,481,557466,15,557451
84175,19,16,502,1150666,19,1150647
84176,13,-18,7,85283,13,85270
84177,17,-16,922,153710,17,153693
84178,17,17,847,1184357,17,1184340
84179,14,9,816,935114,14,935100
84180,6,3,969,740052,6,740046
84181,5,12,87,1001081,5,1001076
84182,20,-11,432,307233,20,307213
84183,18,-12,765,278154,18,278136
84184,20,13,383,1056060,20,1056040
84185,6,-1,787,610770,6,610764
84186,20,7,669,871970,20,871950
84187,8,10,950,957945,8,957937
84188,11,12,155,1023174,11,1023163
84189,20,-19,622,58908,20,58888
84190,20,-16,754,152475,20,152455
84191,20,5,161,804974,20,804954
84192,15,-16,565,151162,15,151147
84193,10,-20,90,2008,10,1998
84194,9,-20,779,17171,9,17162
84195,13,-18,492,88916,13,88903
84196,8,-11,851,299375,8,299367
84197,6,1,45,658058,6,658052
84198,20,14,485,1089228,20,1089208
84199,18,-14,692,214962,18,214944
84200,7,12,486,1009592,7,1009585
84201,6,10,520,948642,6,948636
84202,13,3,359,744588,13,744575
84203,11,-4,379,525052,11,525041
84204,9,-20,165,3694,9,3685
84205,17,-14,860,216234,17,216217
84206,12,14,976,1093108,12,1093096
84207,11,18,669,1213820,11,1213809
84208,10,0,291,631556,10,631546
84209,19,-12,992,280047,19,280028
84210,13,5,277,805862,13,805849
84211,5,11,698,983268,5,983263
84212,7,1,793,674249,7,674242
84213,8,-14,821,204479,8,204471
84214,17,17,710,1183182,17,1183165
84215,9,-17,364,101308,9,101299
84216,13,-16,614,151560,13,151547
84217,7,2,456,698376,7,698369
84218,12,-15,604,182211,12,182199
84219,7,10,259,942949,7,942942
84220,20,18,89,1209635,20,1209615
84221,5,19,298,1224190,5,1224185
84222,8,-6,271,442750,8,442742
84223,8,-8,872,393956,8,393948
84224,11,15,984,1124022,11,1124011
84225,15,-9,351,369255,15,369240
84226,9,-7,905,425252,9,425243
84227,6,6,56,813415,6,813409
84228,12,-6,713,464572,12,464560
84229,18,-9,387,369578,18,369560
84230,20,-5,876,497474,20,497454
84231,5,-9,257,349241,5,349236
84232,9,-3,742,547022,9,547013
84233,10,-2,403,571290,10,571280
84234,9,4,701,765659,9,765650
84235,14,15,68,1117280,14,1117266
84236,15,17,669,1182868,15,1182853
84237,16,2,9,710533,16,710517
84238,8,-8,102,377501,8,377493
84239,17,17,300,1180208,17,1180191
84240,8,12,572,1011319,8,1011311
84241,16,-2,863,591700,16,591684
84242,14,-15,531,181689,14,181675
84243,9,-10,299,319014,9,319005
84244,12,-17,481,119060,12,119048
84245,19,6,592,840565,19,840546
84246,9,-15,939,175451,9,175442
84247,7,-18,849,80691,7,80684
84248,20,10,644,964905,20,964885
84249,18,18,657,1213725,18,1213707
84250,16,-16,219,148599,16,148583
84251,18,-17,666,120531,18,120513
84252,16,7,805,872837,16,872821
84253,20,-12,256,274398,20,274378
84254,6,6,886,832270,6,832264
84255,15,-2,377,587898,15,587883
84256,9,-1,535,605711,9,605702
84257,14,-2,154,586230,14,586216
84258,17,4,602,777674,17,777657
84259,9,-13,363,225960,9,225951
84260,16,-9,139,367596,16,367580
84261,14,-14,606,214295,14,214281
84262,18,-4,210,523737,18,523719
84263,16,8,230,899857,16,899841
84264,11,7,722,872249,11,872238
84265,17,8,297,900301,17,900284
84266,20,4,147,774350,20,774330
84267,11,6,149,836902,11,836891
84268,9,-10,526,323966,9,323957
84269,8,-11,608,294679,8,294671
84270,12,-18,728,90564,12,90552
84271,19,-12,68,273052,19,273033
84272,6,4,259,756208,6,756202
84273,9,-14,33,187243,9,187234
84274,7,-17,889,112354,7,112347
84275,16,-4,763,527755,16,527739
84276,13,-10,881,341747,13,341734
84277,5,-11,301,287748,5,287743
84278,14,0,330,650524,14,650510
84279,20,-3,139,554774,20,554754
84280,13,12,83,1022683,13,1022670
84281,12,-13,79,241615,12,241603
84282,6,6,296,818923,6,818917
84283,20,-8,541,401680,20,401660
84284,16,13,508,1057045,16,1057029
84285,10,7,520,855987,10,855977
84286,6,1,987,678447,6,678441
84287,8,7,98,846939,8,846931
84288,17,-5,188,492356,17,492339
84289,5,10,320,944333,5,944328
84290,18,5,608,808244,18,808226
84291,14,-15,819,183919,14,183905
84292,7,11,750,984474,7,984467
84293,19,-15,235,179446,19,179427
84294,19,-3,613,558643,19,558624
84295,5,9,100,908894,5,908889
84296,9,-16,632,137737,9,137728
84297,5,10,717,952988,5,952983
84298,10,5,845,799283,10,799273
84299,15,-12,660,277397,15,277382
84300,18,13,503,1056958,18,1056940
84301,13,9,764,934609,13,934596
84302,7,8,450,885033,7,885026
84303,14,-16,255,148832,14,148818
84304,15,15,795,1122612,15,1122597
84305,10,16,432,1134555,10,1134545
84306,5,-7,342,413326,5,413321
84307,15,2,687,715782,15,715767
84308,12,-15,565,181957,12,181945
84309,10,12,386,1007430,10,1007420
84310,19,-3,235,555431,19,555412
84311,9,11,571,980742,9,980733
84312,12,-2,844,591553,12,591541
84313,12,0,700,653651,12,653639
84314,17,-3,42,554100,17,554083
84315,13,4,369,775905,13,775892
84316,14,-4,892,528754,14,528740
84317,7,-20,351,7736,7,7729
84318,15,-6,423,462398,15,462383
84319,19,11,679,995689,19,995670
84320,11,4,521,777043,11,777032
84321,10,-6,903,456094,10,456084
84322,6,4,842,769146,6,769140
84323,15,-2,502,588927,15,588912
84324,17,12,842,1028413,17,1028396
84325,11,-15,289,179893,11,179882
84326,17,-4,372,525017,17,525000
84327,7,-14,318,193618,7,193611
84328,6,0,152,628741,6,628735
84329,8,-5,342,475670,8,475662
84330,11,1,935,687176,11,687165
84331,18,13,116,1054088,18,1054070
84332,10,3,495,729463,10,729453
84333,8,3,120,721459,8,721451
84334,17,0,613,652892,17,652875
84335,6,-11,925,300914,6,300908
84336,9,17,245,1160512,9,1160503
84337,14,5,543,807753,14,807739
84338,17,-19,577,58590,17,58573
84339,17,-16,316,149276,17,149259
84340,13,13,376,1055991,13,1055978
84341,11,-13,0,241051,11,241040
84342,15,-13,136,241973,15,241958
84343,5,6,373,820723,5,820718
84344,13,-1,700,621942,13,621929
84345,14,7,549,871069,14,871055
84346,5,-10,713,327972,5,327967
84347,12,-3,12,553937,12,553925
84348,7,18,277,1192925,7,1192918
84349,10,-2,280,568792,10,568782
84350,13,-11,715,309289,13,309276
84351,11,-14,187,210736,11,210725
84352,14,12,466,1025456,14,1025442
84353,14,11,658,995510,14,995496
84354,20,-19,162,55335,20,55315
84355,19,16,388,1149916,19,1149897
84356,5,0,171,629205,5,629200
84357,6,17,468,1165352,6,1165346
84358,9,11,501,979167,9,979158
84359,17,-12,731,277845,17,277828
84360,7,11,804,985666,7,985659
84361,19,-1,100,617338,19,617319
84362,8,-1,923,613891,8,613883
84363,10,-12,880,268749,10,268739
84364,9,11,13,968747,9,968738
84365,13,-18,4,85232,13,85219
84366,13,-13,85,241654,13,241641
84367,12,14,483,1089213,12,1089201
84368,6,-6,479,447067,6,447061
84369,13,-6,683,464349,13,464336
84370,15,-12,14,272615,15,272600
84371,13,-17,328,117920,13,117907
84372,15,4,753,778805,15,778790
84373,9,-9,998,365571,9,365562
84374,10,-9,453,353647,10,353637
84375,9,1,574,669906,9,669897
84376,18,-2,193,586545,18,586527
84377,7,-16,437,133594,7,133587
84378,17,6,939,843241,17,843224
84379,13,14,311,1087856,13,1087843
84380,20,-14,900,216511,20,216491
84381,12,-4,364,524949,12,524937
84382,8,4,314,757315,8,757307
84383,12,-17,869,121938,12,121926
84384,18,-19,606,58787,18,58769
84385,5,4,733,766578,5,766573
84386,14,5,203,805373,14,805359
84387,15,12,551,1026097,15,1026082
84388,17,-14,254,211444,17,211427
84389,18,-12,804,278383,18,278365
84390,13,0,700,653654,13,653641
84391,15,-13,686,246009,15,245994
84392,15,18,713,1214061,15,1214046
84393,11,-18,734,90605,11,90594
84394,12,-2,551,589291,12,589279
84395,18,-7,156,429460,18,429442
84396,18,-15,403,180726,18,180708
84397,6,-4,88,501290,6,501284
84398,18,16,626,1151530,18,1151512
84399,18,-14,68,209824,18,209806
84400,9,-3,630,544646,9,544637
84401,18,-19,197,55635,18,55617
84402,20,17,1000,1185517,20,1185497
84403,18,14,353,1088180,18,1088162
84404,7,3,445,728401,7,728394
84405,14,-9,534,370969,14,370955
84406,18,-10,633,339799,18,339781
84407,10,-17,497,104205,10,104195
84408,11,19,442,1244497,11,1244486
84409,16,2,847,716822,16,716806
84410,11,-19,227,55827,11,55816
84411,16,-10,7,335176,16,335160
84412,7,7,144,847881,7,847874
84413,7,12,537,1010645,7,1010638
84414,17,-13,768,246753,17,246736
84415,10,8,621,888766,10,888756
84416,19,15,107,1117591,19,1117572
84417,9,-20,902,20035,9,20026
84418,12,-19,418,57214,12,57202
84419,16,-19,67,54388,16,54372
84420,6,-3,426,539876,6,539870
84421,6,13,403,1039445,6,1039439
84422,8,-16,418,133009,8,133001
84423,15,17,881,1184572,15,1184557
84424,9,-16,851,142295,9,142286
84425,17,-3,550,558137,17,558120
84426,8,12,660,1013479,8,1013471
84427,6,18,581,1199083,6,1199077
84428,19,17,341,1180546,19,1180527
84429,10,6,12,812441,10,812431
84430,18,3,695,747178,18,747160
84431,11,18,378,1211843,11,1211832
84432,11,11,357,993457,11,993446
84433,9,-10,633,326283,9,326274
84434,9,-10,850,330843,9,330834
84435,12,-2,138,586139,12,586127
84436,13,-1,790,622647,13,622634
84437,13,-11,190,305254,13,305241
84438,18,14,524,1089542,18,1089524
84439,9,-15,460,165381,9,165372
84440,17,-2,182,586388,17,586371
84441,20,18,566,1213060,20,1213040
84442,8,8,383,883527,8,883519
84443,10,-1,573,606391,10,606381
84444,11,-18,253,87301,11,87290
84445,5,-10,711,327943,5,327938
84446,9,-10,139,315744,9,315735
84447,19,-7,211,429901,19,429882
84448,15,1,841,686359,15,686344
84449,14,-14,469,213146,14,213132
84450,14,19,634,1245923,14,1245909
84451,14,0,158,649432,14,649418
84452,18,-13,846,247336,18,247318
84453,11,10,961,967220,11,967209
84454,20,-10,797,341101,20,341081
84455,12,14,433,1088870,12,1088858
84456,16,-3,604,558544,16,558528
84457,19,0,759,654113,19,654094
84458,20,8,756,903921,20,903901
84459,19,-9,651,371666,19,371647
84460,17,-20,271,24855,17,24838
84461,16,-7,886,434847,16,434831
84462,10,-6,270,442733,10,442723
84463,8,15,496,1104922,8,1104914
84464,12,-8,845,403869,12,403857
84465,8,5,478,791560,8,791552
84466,17,4,759,778870,17,778853
84467,7,-7,797,422667,7,422660
84468,5,-15,639,169287,5,169282
84469,11,-13,631,245709,11,245698
84470,19,-18,597,89569,19,89550
84471,12,18,620,1213382,12,1213370
84472,16,9,704,934273,16,934257
84473,12,17,816,1184066,12,1184054
84474,6,-5,765,484495,6,484489
84475,20,19,25,1240924,20,1240904
84476,8,10,295,943762,8,943754
84477,15,-4,308,524483,15,524468
84478,17,-12,66,273026,17,273009
84479,20,-3,631,558856,20,558836
84480,17,-15,226,179378,17,179361
84481,17,1,954,687311,17,687294
84482,17,13,609,1057897,17,1057880
84483,6,4,685,765390,6,765384
84484,11,-16,764,152527,11,152516
84485,16,5,384,806614,16,806598
84486,13,9,131,930043,13,930030
84487,9,5,663,795335,9,795326
84488,6,-2,667,577016,6,577010
84489,16,-16,567,151187,16,151171
84490,5,-16,89,125906,5,125901
84491,7,-19,633,45428,7,45421
84492,14,11,248,992623,14,992609
84493,7,-7,459,415668,7,415661
84494,11,-2,813,591268,11,591257
84495,17,-5,600,495474,17,495457
84496,12,-1,368,619561,12,619549
84497,19,7,447,870391,19,870372
84498,8,-1,620,607332,8,607324
84499,15,4,363,775845,15,775830
84500,9,-3,666,545462,9,545453
84501,9,14,196,1066080,9,1066071
84502,14,-14,658,214657,14,214643
84503,9,-5,127,470862,9,470853
84504,9,-6,178,440786,9,440777
84505,9,-4,761,515625,9,515616
84506,17,-3,410,556828,17,556811
84507,17,16,883,1153359,17,1153342
84508,15,10,635,964830,15,964815
84509,11,-5,800,496803,11,496792
84510,16,-3,612,558627,16,558611
84511,18,4,822,779321,18,779303
84512,10,14,495,1072890,10,1072880
84513,19,-8,593,402007,19,401988
84514,18,5,323,806145,18,806127
84515,5,-6,817,454394,5,454389
84516,11,8,724,903728,11,903717
84517,10,-20,177,4074,10,4064
84518,9,-17,243,98646,9,98637
84519,15,7,786,872691,15,872676
84520,12,4,260,775084,12,775072
84521,18,0,699,653650,18,653632
84522,11,16,956,1153900,11,1153889
84523,8,12,916,1019277,8,1019269
84524,20,1,21,679958,20,679938
84525,7,-16,295,130447,7,130440
84526,10,12,887,1018595,10,1018585
84527,13,-7,203,429831,13,429818
84528,10,0,683,640300,10,640290
84529,12,5,717,809014,12,809002
84530,18,6,719,841607,18,841589
84531,17,-9,770,372649,17,372632
84532,17,-5,679,495962,17,495945
84533,12,-18,528,89145,12,89133
84534,18,5,852,809961,18,809943
84535,19,-13,751,246590,19,246571
84536,11,13,52,1053621,11,1053610
84537,14,-8,968,404785,14,404771
84538,15,-7,906,435008,15,434993
84539,13,-9,571,371246,13,371233
84540,20,14,496,1089343,20,1089323
84541,7,10,205,941879,7,941872
84542,20,-1,145,617633,20,617613
84543,5,-12,248,254862,5,254857
84544,17,-5,714,496247,17,496230
84545,9,-8,481,385326,9,385317
84546,9,-17,821,110903,9,110894
84547,9,-12,246,254799,9,254790
84548,10,-4,178,503305,10,503295
84549,17,9,509,932800,17,932783
84550,6,15,673,1108692,6,1108686
84551,6,-20,720,15848,6,15842
84552,16,-12,211,274040,16,274024
84553,19,-1,875,623272,19,623253
84554,10,-17,904,112618,10,112608
84555,5,-13,318,225107,5,225102
84556,13,-8,764,403292,13,403279
84557,6,2,258,694184,6,694178
84558,19,-16,454,150403,19,150384
84559,17,-10,57,335600,17,335583
84560,15,19,322,1243353,15,1243338
84561,20,0,414,651264,20,651244
84562,14,-12,886,279138,14,279124
84563,11,-5,466,494494,11,494483
84564,8,-9,785,361152,8,361144
84565,16,13,308,1055471,16,1055455
84566,18,-10,848,341458,18,341440
84567,14,17,61,1178347,14,1178333
84568,11,-13,125,241914,11,241903
84569,7,-9,144,346681,7,346674
84570,20,-8,211,399393,20,399373
84571,13,19,856,1247733,13,1247720
84572,19,6,316,838200,19,838181
84573,18,-2,440,588438,18,588420
84574,6,1,551,669413,6,669407
84575,17,-6,174,460479,17,460462
84576,5,13,515,1041798,5,1041793
84577,15,-9,679,371799,15,371784
84578,16,-6,611,463816,16,463800
84579,18,18,780,1214651,18,1214633
84580,10,4,247,756052,10,756042
84581,17,13,279,1055259,17,1055242
84582,9,6,159,815610,9,815601
84583,6,1,600,670296,6,670290
84584,11,-2,661,590099,11,590088
84585,17,0,571,652575,17,652558
84586,20,9,334,931461,20,931441
84587,6,-5,952,488719,6,488713
84588,12,13,986,1060506,12,1060494
84589,7,-12,727,265154,7,265147
84590,15,-3,585,558416,15,558401
84591,9,-20,378,8319,9,8310
84592,10,6,452,822668,10,822658
84593,6,4,524,761937,6,761931
84594,15,19,461,1244611,15,1244596
84595,12,-8,705,402887,12,402875
84596,14,-14,321,211896,14,211882
84597,8,-17,126,96067,8,96059
84598,20,16,403,1150033,20,1150013
84599,8,7,443,854343,8,854335
84600,5,7,985,865663,5,865658
84601,10,-8,344,382682,10,382672
84602,7,2,174,692427,7,692420
84603,11,-20,538,26915,11,26904
84604,7,8,535,886956,7,886949
84605,14,0,97,649007,14,648993
84606,10,-17,135,96270,10,96260
84607,6,19,374,1225985,6,1225979
84608,20,7,12,867126,20,867106
84609,13,-10,326,337383,13,337370
84610,7,-3,720,546620,7,546613
84611,19,-11,653,308958,19,308939
84612,13,15,889,1123252,13,1123239
84613,19,-3,628,558810,19,558791
84614,14,-1,217,618258,14,618244
84615,14,-3,760,559883,14,559869
84616,20,-14,417,212825,20,212805
84617,6,-8,556,387108,6,387102
84618,5,-18,859,80950,5,80945
84619,10,-16,230,129160,10,129150
84620,5,15,745,1110362,5,1110357
84621,18,19,566,1245414,18,1245396
84622,17,12,886,1028739,17,1028722
84623,12,7,772,872594,12,872582
84624,16,19,378,1243828,16,1243812
84625,19,3,51,742216,19,742197
84626,14,-3,155,554852,14,554838
84627,18,4,31,773482,18,773464
84628,11,-10,463,338489,11,338478
84629,17,-1,76,617164,17,617147
84630,14,4,7,773356,14,773342
84631,13,4,518,777018,13,777005
84632,9,14,235,1067042,9,1067033
84633,13,9,263,930847,13,930834
84634,7,-8,799,392449,7,392442
84635,12,4,901,779925,12,779913
84636,9,-2,801,579853,9,579844
84637,5,-13,12,218539,5,218534
84638,11,-13,319,243426,11,243415
84639,11,19,515,1245032,11,1245021
84640,6,5,239,786664,6,786658
84641,19,3,35,742093,19,742074
84642,6,-1,838,611873,6,611867
84643,12,-19,2,53899,12,53887
84644,10,-6,441,446155,10,446145
84645,8,-19,828,49562,8,49554
84646,14,18,767,1214505,14,1214491
84647,14,17,60,1178334,14,1178320
84648,16,-13,765,246707,16,246691
84649,7,6,316,819348,7,819341
84650,9,-2,107,565153,9,565144
84651,14,0,759,654117,14,654103
84652,8,15,323,1101375,8,1101367
84653,5,7,730,860243,5,860238
84654,5,-8,188,379549,5,379544
84655,10,-11,472,291691,10,291681
84656,20,3,462,745297,20,745277
84657,16,4,207,774731,16,774715
84658,18,5,548,807792,18,807774
84659,14,17,567,1182058,14,1182044
84660,6,-5,731,483840,6,483834
84661,15,-7,393,431337,15,431322
84662,8,17,627,1168715,8,1168707
84663,16,5,896,810292,16,810276
84664,10,7,672,859080,10,859070
84665,15,-13,116,241891,15,241876
84666,14,-14,679,214839,14,214825
84667,11,5,173,805049,11,805038
84668,6,12,672,1013837,6,1013831
84669,6,-18,299,69026,6,69020
84670,8,19,310,1224526,8,1224518
84671,18,0,961,655618,18,655600
84672,19,12,16,1022210,19,1022191
84673,20,19,309,1243276,20,1243256
84674,8,6,884,832201,8,832193
84675,18,-13,221,242679,18,242661
84676,20,-4,58,522492,20,522472
84677,20,-13,428,244164,20,244144
84678,12,-7,572,432603,12,432591
84679,17,-19,499,57826,17,57809
84680,14,19,97,1241543,14,1241529
84681,7,-12,620,262930,7,262923
84682,5,2,281,694671,5,694666
84683,19,-5,928,497849,19,497830
84684,20,17,583,1182161,20,1182141
84685,18,-17,95,116292,18,116274
84686,11,18,494,1212576,11,1212565
84687,20,-7,252,430150,20,430130
84688,18,5,461,807172,18,807154
84689,5,-19,597,44632,5,44627
84690,10,-16,238,129259,10,129249
84691,5,-16,848,142200,5,142195
84692,5,3,637,732488,5,732483
84693,10,-13,715,233648,10,233638
84694,14,-13,349,243623,14,243609
84695,17,-20,116,23651,17,23634
84696,13,-19,993,61386,13,61373
84697,6,-7,480,416131,6,416125
84698,10,-5,783,484800,10,484790
84699,20,-18,639,89895,20,89875
84700,17,5,432,806911,17,806894
84701,13,1,10,679809,13,679796
84702,20,12,120,1022927,20,1022907
84703,15,-12,676,277491,15,277476
84704,17,-10,486,338688,17,338671
84705,14,-1,228,618382,14,618368
84706,5,14,630,1075985,5,1075980
84707,10,-7,683,420280,10,420270
84708,12,-5,274,493052,12,493040
84709,5,-14,283,192933,5,192928
84710,13,6,316,838203,13,838190
84711,6,-7,19,406498,6,406492
84712,14,-17,351,118097,14,118083
84713,5,-13,35,219156,5,219151
84714,15,-5,383,493851,15,493836
84715,16,12,961,1029540,16,1029524
84716,12,17,181,1179236,12,1179224
84717,16,-15,880,184428,16,184412
84718,9,-1,945,614337,9,614328
84719,14,-18,292,87518,14,87504
84720,17,12,237,1023789,17,1023772
84721,9,-3,57,531728,9,531719
84722,12,11,847,997000,12,996988
84723,5,7,490,855383,5,855378
84724,10,9,982,927710,10,927700
84725,9,-12,189,253513,9,253504
84726,16,-16,460,150460,16,150444
84727,7,5,587,793788,7,793781
84728,20,-17,32,115797,20,115777
84729,17,-1,331,619212,17,619195
84730,7,-11,925,300921,7,300914
84731,19,-6,781,465119,19,465100
84732,7,-15,214,159851,7,159844
84733,19,-12,2,272516,19,272497
84734,7,-10,59,313959,7,313952
84735,19,-13,678,245936,19,245917
84736,6,19,206,1222096,6,1222090
84737,18,-2,103,585905,18,585887
84738,11,1,627,684775,11,684764
84739,11,-1,258,618554,11,618543
84740,6,-4,844,517382,6,517376
84741,16,9,205,930576,16,930560
84742,8,15,819,1111783,8,1111775
84743,17,6,856,842575,17,842558
84744,5,9,358,914302,5,914297
84745,10,-13,611,231473,10,231463
84746,16,-16,699,152045,16,152029
84747,7,1,413,666217,7,666210
84748,7,-9,777,360962,7,360955
84749,12,-15,797,183677,12,183665
84750,8,-1,528,605577,8,605569
84751,11,6,571,840404,11,840393
84752,17,14,9,1085448,17,1085431
84753,18,-6,532,463242,18,463224
84754,16,3,998,749532,16,749516
84755,12,7,242,868750,12,868738
84756,16,-9,934,373983,16,373967
84757,17,8,462,901631,17,901614
84758,8,2,140,691608,8,691600
84759,8,13,953,1051157,8,1051149
84760,11,-8,747,403177,11,403166
84761,10,2,176,692465,10,692455
84762,10,15,889,1113340,10,1113330
84763,6,-3,304,537028,6,537022
84764,19,-4,701,527369,19,527350
84765,16,-15,491,181405,16,181389
84766,20,10,459,963331,20,963311
84767,20,-20,430,26022,20,26002
84768,10,-10,515,323850,10,323840
84769,11,-5,491,494661,11,494650
84770,5,10,601,950514,5,950509
84771,10,0,301,631744,10,631734
84772,18,3,454,745242,18,745224
84773,15,-9,613,371449,15,371434
84774,5,-14,869,205373,5,205368
84775,10,2,948,708401,10,708391
84776,15,-4,467,525596,15,525581
84777,12,-16,701,152074,12,152062
84778,7,-12,458,259479,7,259472
84779,5,-3,285,536561,5,536556
84780,6,-13,347,225698,6,225692
84781,10,-1,271,599814,10,599804
84782,19,-13,510,244816,19,244797
84783,16,17,647,1182668,16,1182652
84784,19,-18,479,88855,19,88836
84785,11,2,887,717101,11,717090
84786,17,-19,377,56950,17,56933
84787,9,19,833,1235980,9,1235971
84788,5,19,956,1238685,5,1238680
84789,13,12,385,1024868,13,1024855
84790,10,-2,898,582011,10,582001
84791,11,0,970,655720,11,655709
84792,7,2,695,703315,7,703308
84793,17,0,377,650937,17,650920
84794,15,1,555,684282,15,684267
84795,8,1,893,676438,8,676430
84796,15,-8,427,400860,15,400845
84797,13,6,976,843556,13,843543
84798,15,7,466,870481,15,870466
84799,18,-18,884,91606,18,91588
84800,16,-14,532,213608,16,213592
84801,8,11,969,989216,8,989208
84802,6,-1,613,607187,6,607181
84803,10,12,873,1018273,10,1018263
84804,10,-14,409,195766,10,195756
84805,8,-20,27,662,8,654
84806,9,-17,776,110094,9,110085
84807,13,5,513,807516,13,807503
84808,6,2,686,703062,6,703056
84809,12,10,44,960192,12,960180
84810,17,-13,818,247119,17,247102
84811,11,19,166,1242077,11,1242066
84812,13,19,386,1243921,13,1243908
84813,14,8,279,900182,14,900168
84814,6,-2,721,578229,6,578223
84815,17,4,792,779080,17,779063
84816,9,-16,699,139021,9,139012
84817,18,9,326,931399,18,931381
84818,19,5,333,806233,19,806214
84819,20,6,462,839472,20,839452
84820,19,2,356,713303,19,713284
84821,15,11,832,996854,15,996839
84822,7,2,743,704287,7,704280
84823,16,-7,944,435300,16,435284
84824,13,-2,757,590783,13,590770
84825,10,14,789,1079632,10,1079622
84826,10,-19,617,45046,10,45036
84827,11,-16,17,146901,11,146890
84828,20,-19,105,54772,20,54752
84829,9,-1,176,597532,9,597523
84830,19,-11,874,310575,19,310556
84831,18,5,262,805773,18,805755
84832,12,12,44,1022424,12,1022412
84833,20,-4,120,522940,20,522920
84834,18,-8,533,401608,18,401590
84835,14,-8,111,398670,14,398656
84836,18,12,80,1022642,18,1022624
84837,20,17,128,1178811,20,1178791
84838,19,19,521,1245120,19,1245101
84839,13,19,104,1241612,13,1241599
84840,10,-6,602,449802,10,449792
84841,17,-9,579,371269,17,371252
84842,8,-7,140,408802,8,408794
84843,5,15,838,1112271,5,1112266
84844,17,15,738,1122266,17,1122249
84845,15,2,18,710583,15,710568
84846,9,-7,207,410253,9,410244
84847,5,-12,293,255856,5,255851
84848,18,12,600,1026455,18,1026437
84849,10,-9,192,347643,10,347633
84850,5,-2,928,582706,5,582701
84851,13,-5,177,492311,13,492298
84852,10,-17,349,101007,10,100997
84853,20,8,88,898604,20,898584
84854,15,-20,251,24690,15,24675
84855,15,-16,681,151899,15,151884
84856,14,3,112,742691,14,742677
84857,5,-17,696,108409,5,108404
84858,11,14,460,1089049,11,1089038
84859,11,-7,617,432851,11,432840
84860,13,-17,302,117773,13,117760
84861,10,0,595,638265,10,638255
84862,14,16,992,1154227,14,1154213
84863,13,15,694,1121887,13,1121874
84864,14,-5,521,494904,14,494890
84865,12,-16,997,154286,12,154274
84866,9,16,156,1128398,9,1128389
84867,5,13,446,1040374,5,1040369
84868,17,-17,504,119263,17,119246
84869,6,-8,494,385632,6,385626
84870,16,-6,869,465668,16,465652
84871,9,16,203,1129453,9,1129444
84872,12,12,997,1029806,12,1029794
84873,7,10,972,958306,7,958299
84874,6,6,408,821638,6,821632
84875,5,10,982,958478,5,958473
84876,16,13,306,1055451,16,1055435
84877,7,-2,843,580845,7,580838
84878,19,3,907,748662,19,748643
84879,5,-1,246,599273,5,599268
84880,19,-3,486,557543,19,557524
84881,19,17,49,1178267,19,1178248
84882,11,18,409,1212072,11,1212061
84883,17,5,599,808185,17,808168
84884,10,12,255,1004804,10,1004794
84885,9,8,136,878015,9,878006
84886,10,-5,985,489455,10,489445
84887,13,6,82,836349,13,836336
84888,18,9,194,930487,18,930469
84889,20,18,883,1215388,20,1215368
84890,18,-17,330,117933,18,117915
84891,8,1,878,676057,8,676049
84892,7,8,432,884630,7,884623
84893,14,9,756,934549,14,934535
84894,19,10,590,964439,19,964420
84895,12,-4,369,524991,12,524979
84896,5,-4,795,516386,5,516381
84897,12,15,44,1117120,12,1117108
84898,15,-17,244,117281,15,117266
84899,13,-13,207,242557,13,242544
84900,13,5,791,809540,13,809527
84901,19,19,833,1247524,19,1247505
84902,6,9,943,926783,6,926777
84903,5,-20,335,7433,5,7428
84904,10,-4,235,504776,10,504766
84905,15,3,116,742701,15,742686
84906,5,-14,416,195955,5,195950
84907,20,-3,937,561314,20,561294
84908,9,-12,52,250720,9,250711
84909,19,14,637,1090408,19,1090389
84910,7,-13,863,237033,7,237026
84911,10,5,420,790202,10,790192
84912,14,-19,772,60022,14,60008
84913,17,15,337,1119258,17,1119241
84914,5,-17,230,98288,5,98283
84915,14,-5,961,498086,14,498072
84916,7,6,709,828384,7,828377
84917,12,1,384,682944,12,682932
84918,6,12,716,1014787,6,1014781
84919,18,-9,494,370587,18,370569
84920,6,4,704,765747,6,765741
84921,18,-3,195,555143,18,555125
84922,20,-14,89,210027,20,210007
84923,9,-19,833,49680,9,49671
84924,8,-10,240,317779,8,317771
84925,14,-14,851,216166,14,216152
84926,5,-5,796,485087,5,485082
84927,18,3,763,747625,18,747607
84928,12,-2,73,585673,12,585661
84929,20,-14,273,211566,20,211546
84930,11,-10,692,340313,11,340302
84931,14,-9,682,371823,14,371809
84932,11,4,472,776650,11,776639
84933,19,9,326,931408,19,931389
84934,9,10,549,949213,9,949204
84935,16,-2,326,587556,16,587540
84936,14,-18,924,91930,14,91916
84937,6,8,250,880677,6,880671
84938,20,-4,846,528281,20,528261
84939,17,-8,509,401423,17,401406
84940,12,-4,961,529312,12,529300
84941,14,-16,478,150556,14,150542
84942,18,16,675,1151953,18,1151935
84943,19,16,756,1152465,19,1152446
84944,18,13,754,1058843,18,1058825
84945,7,-1,422,603172,7,603165
84946,11,12,440,1025285,11,1025274
84947,5,5,623,794576,5,794571
84948,14,-20,862,29428,14,29414
84949,20,14,800,1091717,20,1091697
84950,9,15,916,1113956,9,1113947
84951,13,2,262,712536,13,712523
84952,14,1,484,683697,14,683683
84953,12,-9,257,368477,12,368465
84954,17,18,17,1209030,17,1209013
84955,19,18,960,1216047,19,1216028
84956,12,-2,111,585973,12,585961
84957,19,-19,726,59654,19,59635
84958,15,-3,328,556188,15,556173
84959,8,12,583,1011600,8,1011592
84960,11,15,969,1123933,11,1123922
84961,15,-11,709,309278,15,309263
84962,11,0,426,651350,11,651339
84963,8,-18,885,81547,8,81539
84964,18,-18,986,92382,18,92364
84965,19,7,760,872501,19,872482
84966,12,-9,906,373772,12,373760
84967,8,13,383,1038966,8,1038958
84968,8,-16,403,132689,8,132681
84969,13,-7,188,429699,13,429686
84970,15,-4,553,526281,15,526266
84971,15,-14,981,217134,15,217119
84972,10,-9,728,359645,10,359635
84973,10,-7,373,414004,10,413994
84974,15,14,215,1087085,15,1087070
84975,7,-16,62,125167,7,125160
84976,13,16,396,1149996,13,1149983
84977,20,-3,739,559646,20,559626
84978,15,19,543,1245266,15,1245251
84979,14,-10,661,340074,14,340060
84980,5,-12,585,262178,5,262173
84981,15,-4,387,525107,15,525092
84982,19,-1,164,617778,19,617759
84983,10,-10,282,318613,10,318603
84984,20,17,276,1179992,20,1179972
84985,9,8,924,895227,9,895218
84986,20,-9,515,370732,20,370712
84987,8,7,505,855640,8,855632
84988,20,8,708,903592,20,903572
84989,19,2,711,715968,19,715949
84990,5,0,662,639851,5,639846
84991,19,3,716,747305,19,747286
84992,20,1,621,684731,20,684711
84993,12,-5,375,493812,12,493800
84994,18,-8,303,400014,18,399996
84995,12,-4,185,523508,12,523496
84996,10,-17,613,106715,10,106705
84997,6,-7,618,418979,6,418973
84998,5,-17,511,104569,5,104564
84999,19,8,221,899733,19,899714
85000,11,15,229,1118518,11,1118507
85001,11,6,79,836306,11,836295
85002,6,0,2,625211,6,625205
85003,12,-19,730,59713,12,59701
85004,15,-13,846,247341,15,247326
85005,10,-18,176,66374,10,66364
85006,5,11,737,984191,5,984186
85007,7,-3,622,544386,7,544379
85008,13,-17,282,117598,13,117585
85009,13,-17,390,118371,13,118358
85010,5,14,872,1081381,5,1081376
85011,14,-5,955,498050,14,498036
85012,12,-6,684,464371,12,464359
85013,9,13,652,1044818,9,1044809
85014,5,-8,553,387052,5,387047
85015,14,16,214,1148680,14,1148666
85016,11,2,957,717643,11,717632
85017,18,18,216,1210728,18,1210710
85018,15,-3,703,559403,15,559388
85019,13,18,683,1213914,13,1213901
85020,5,-1,200,598032,5,598027
85021,11,-6,636,464033,11,464022
85022,20,-17,862,121914,20,121894
85023,8,6,565,825033,8,825025
85024,17,13,987,1060512,17,1060495
85025,17,-12,902,279310,17,279293
85026,9,-4,49,500362,9,500353
85027,19,-3,266,555659,19,555640
85028,8,16,939,1144739,8,1144731
85029,5,17,80,1157035,5,1157030
85030,20,-10,654,339995,20,339975
85031,15,6,688,841307,15,841292
85032,15,9,970,936371,15,936356
85033,13,19,671,1246212,13,1246199
85034,15,9,687,934114,15,934099
85035,11,11,361,993503,11,993492
85036,9,4,979,771880,9,771871
85037,10,-14,392,195407,10,195397
85038,17,9,171,930348,17,930331
85039,11,-14,703,215018,11,215007
85040,15,-8,386,400613,15,400598
85041,16,-9,326,368997,16,368981
85042,12,7,992,874061,12,874049
85043,9,10,751,953609,9,953600
85044,19,-12,60,272962,19,272943
85045,18,6,912,843060,18,843042
85046,14,-20,867,29474,14,29460
85047,9,-10,350,320213,9,320204
85048,8,-12,960,270497,8,270489
85049,15,1,724,685504,15,685489
85050,16,-15,887,184486,16,184470
85051,7,-11,567,293689,7,293682
85052,9,-8,625,388681,9,388672
85053,17,-10,495,338753,17,338736
85054,13,4,521,777046,13,777033
85055,15,0,486,651848,15,651833
85056,16,-3,65,554229,16,554213
85057,14,-15,526,181622,14,181608
85058,15,-16,10,146803,15,146788
85059,18,17,832,1184212,18,1184194
85060,11,19,853,1247661,11,1247650
85061,20,-9,605,371395,20,371375
85062,13,-15,171,178998,13,178985
85063,15,14,471,1089107,15,1089092
85064,15,17,205,1179438,15,1179423
85065,18,-15,571,181995,18,181977
85066,10,7,822,862258,10,862248
85067,12,1,423,683153,12,683141
85068,11,-15,357,180368,11,180357
85069,9,8,717,891083,9,891074
85070,13,1,411,683101,13,683088
85071,17,-19,425,57269,17,57252
85072,17,12,537,1025992,17,1025975
85073,13,4,199,774684,13,774671
85074,16,18,1,1208916,16,1208900
85075,16,11,274,992833,16,992817
85076,16,-8,633,402327,16,402311
85077,20,18,691,1213965,20,1213945
85078,9,-13,821,236159,9,236150
85079,6,5,602,794159,6,794153
85080,15,19,220,1242490,15,1242475
85081,15,-5,638,495694,15,495679
85082,10,12,254,1004739,10,1004729
85083,17,-9,367,369410,17,369393
85084,14,-11,964,311288,14,311274
85085,9,8,395,883867,9,883858
85086,16,4,762,778885,16,778869
85087,17,18,574,1213116,17,1213099
85088,19,4,95,773995,19,773976
85089,16,-18,794,91017,16,91001
85090,5,-9,569,356490,5,356485
85091,9,13,596,1043607,9,1043598
85092,14,-11,967,311293,14,311279
85093,17,8,879,904766,17,904749
85094,8,3,850,737215,8,737207
85095,19,15,483,1120232,19,1120213
85096,8,-18,747,78601,8,78593
85097,17,14,911,1092554,17,1092537
85098,11,18,71,1209519,11,1209508
85099,18,-7,272,430361,18,430343
85100,10,-14,267,192615,10,192605
85101,5,-15,455,165261,5,165256
85102,8,-18,567,74576,8,74568
85103,20,10,975,967304,20,967284
85104,10,0,69,626784,10,626774
85105,9,-14,870,205399,9,205390
85106,15,7,438,870292,15,870277
85107,15,9,744,934493,15,934478
85108,15,1,627,684780,15,684765
85109,5,8,23,875616,5,875611
85110,7,-19,758,48221,7,48214
85111,7,14,90,1063794,7,1063787
85112,11,-10,795,341070,11,341059
85113,16,-8,401,400769,16,400753
85114,8,11,516,979526,8,979518
85115,16,-6,265,461238,16,461222
85116,15,19,332,1243461,15,1243446
85117,10,-18,886,81602,10,81592
85118,12,1,276,682072,12,682060
85119,14,5,686,808811,14,808797
85120,15,-1,651,621623,15,621608
85121,16,4,467,776619,16,776603
85122,20,3,626,746554,20,746534
85123,8,-19,98,33646,8,33638
85124,5,19,102,1219745,5,1219740
85125,15,-14,664,214710,15,214695
85126,5,4,843,769190,5,769185
85127,7,-15,514,166534,7,166527
85128,12,5,176,805099,12,805087
85129,14,18,263,1211100,14,1211086
85130,9,14,421,1071245,9,1071236
85131,5,14,388,1070368,5,1070363
85132,7,14,405,1070824,7,1070817
85133,18,-6,507,463087,18,463069
85134,12,19,753,1246886,12,1246874
85135,6,18,637,1200271,6,1200265
85136,14,-14,171,210611,14,210597
85137,19,6,444,839303,19,839284
85138,6,-12,69,251108,6,251102
85139,6,-19,452,41223,6,41217
85140,14,-10,276,337076,14,337062
85141,8,-4,566,511634,8,511626
85142,9,18,819,1204053,9,1204044
85143,8,2,732,704095,8,704087
85144,13,-13,183,242402,13,242389
85145,15,-20,838,29297,15,29282
85146,19,-18,621,89727,19,89708
85147,14,-13,294,243286,14,243272
85148,7,14,690,1077603,7,1077596
85149,17,-20,280,24979,17,24962
85150,6,-3,859,549636,6,549630
85151,17,5,167,805007,17,804990
85152,20,11,610,995236,20,995216
85153,19,11,554,994827,19,994808
85154,11,1,666,685113,11,685102
85155,8,-2,980,583810,8,583802
85156,12,4,794,779094,12,779082
85157,12,14,14,1085491,12,1085479
85158,13,-5,829,497020,13,497007
85159,18,-3,867,560744,18,560726
85160,9,1,99,659254,9,659245
85161,17,2,85,711179,17,711162
85162,20,8,275,900133,20,900113
85163,10,12,272,1005275,10,1005265
85164,13,-6,811,465364,13,465351
85165,14,5,934,810652,14,810638
85166,11,5,645,808498,11,808487
85167,20,-13,613,245614,20,245594
85168,15,-10,244,336843,15,336828
85169,11,-13,709,246244,11,246233
85170,11,0,11,648268,11,648257
85171,18,-2,957,592458,18,592440
85172,7,-9,929,364440,7,364433
85173,6,9,91,908653,6,908647
85174,15,-13,611,245578,15,245563
85175,12,-18,31,85437,12,85425
85176,20,13,688,1058404,20,1058384
85177,7,11,67,969930,7,969923
85178,9,-19,402,40283,9,40274
85179,6,-12,487,260088,6,260082
85180,20,7,528,870945,20,870925
85181,15,-20,894,29691,15,29676
85182,14,17,937,1184916,14,1184902
85183,5,16,155,1128363,5,1128358
85184,11,-7,506,432126,11,432115
85185,10,11,544,980119,10,980109
85186,11,-6,478,462836,11,462825
85187,6,19,681,1232610,6,1232604
85188,18,3,534,745741,18,745723
85189,16,-2,431,588404,16,588388
85190,17,-14,645,214579,17,214562
85191,12,4,842,779534,12,779522
85192,15,-3,777,560047,15,560032
85193,9,2,180,692612,9,692603
85194,8,-19,389,39942,8,39934
85195,19,6,104,836533,19,836514
85196,16,-2,138,586145,16,586129
85197,5,-17,372,101474,5,101469
85198,19,-15,96,178508,19,178489
85199,10,-12,965,270655,10,270645
85200,9,7,393,853288,9,853279
85201,14,-7,704,433437,14,433423
85202,10,-2,359,570367,10,570357
85203,13,-18,71,85755,13,85742
85204,11,-14,582,214108,11,214097
85205,12,-4,908,528901,12,528889
85206,5,-19,793,48815,5,48810
85207,15,-17,832,121730,15,121715
85208,9,19,950,1238528,9,1238519
85209,9,-19,87,33325,9,33316
85210,5,-18,522,73686,5,73681
85211,7,10,867,956166,7,956159
85212,17,5,443,807003,17,806986
85213,7,7,797,861642,7,861635
85214,14,-7,563,432550,14,432536
85215,14,13,360,1055891,14,1055877
85216,5,-9,483,354541,5,354536
85217,14,3,71,742357,14,742343
85218,7,-13,718,233697,7,233690
85219,15,-16,752,152441,15,152426
85220,7,-11,740,297140,7,297133
85221,14,-12,920,279474,14,279460
85222,5,14,529,1073631,5,1073626
85223,20,13,545,1057349,20,1057329
85224,11,12,494,1025694,11,1025683
85225,10,-15,305,162027,10,162017
85226,7,-3,167,533978,7,533971
85227,16,-14,104,210143,16,210127
85228,16,0,329,650520,16,650504
85229,11,17,667,1182837,11,1182826
85230,9,14,461,1072098,9,1072089
85231,6,11,538,980010,6,980004
85232,12,2,599,715062,12,715050
85233,15,-2,751,590739,15,590724
85234,12,-13,707,246227,12,246215
85235,17,13,372,1055973,17,1055956
85236,11,6,686,841285,11,841274
85237,11,15,38,1117088,11,1117077
85238,10,-12,47,250540,10,250530
85239,20,1,602,684578,20,684558
85240,20,4,36,773549,20,773529
85241,6,18,74,1188402,6,1188396
85242,15,4,302,775370,15,775355
85243,11,14,671,1090715,11,1090704
85244,20,-2,51,585549,20,585529
85245,7,3,821,736533,7,736526
85246,9,9,567,918711,9,918702
85247,11,2,176,711920,11,711909
85248,9,-12,149,252801,9,252792
85249,16,-15,426,180959,16,180943
85250,19,-20,648,27744,19,27725
85251,15,-14,367,212312,15,212297
85252,18,13,325,1055601,18,1055583
85253,8,-17,884,112187,8,112179
85254,20,19,560,1245373,20,1245353
85255,7,-14,741,202809,7,202802
85256,16,1,171,681227,16,681211
85257,5,-3,522,542226,5,542221
85258,9,-19,853,50165,9,50156
85259,7,-19,633,45435,7,45428
85260,5,11,926,988527,5,988522
85261,18,4,834,779453,18,779435
85262,12,-6,132,460093,12,460081
85263,5,9,528,917947,5,917942
85264,18,10,721,965408,18,965390
85265,7,-13,412,226912,7,226905
85266,13,-14,116,210212,13,210199
85267,11,-8,436,400908,11,400897
85268,14,-3,720,559499,14,559485
85269,11,-20,95,23471,11,23460
85270,16,-13,514,244842,16,244826
85271,10,-19,835,49728,10,49718
85272,12,-6,917,466092,12,466080
85273,13,17,622,1182482,13,1182469
85274,13,-18,418,88417,13,88404
85275,8,18,457,1196590,8,1196582
85276,19,16,204,1148584,19,1148565
85277,19,19,887,1247982,19,1247963
85278,5,-14,457,196570,5,196565
85279,5,9,959,927159,5,927154
85280,11,-18,487,88896,11,88885
85281,9,-17,488,103929,9,103920
85282,11,11,348,993410,11,993399
85283,18,-4,320,524595,18,524577
85284,16,-12,333,275015,16,274999
85285,17,-4,974,529448,17,529431
85286,15,-18,560,89332,15,89317
85287,8,-17,372,101482,8,101474
85288,5,4,762,767213,5,767208
85289,8,14,638,1076214,8,1076206
85290,13,-18,905,91789,13,91776
85291,18,16,295,1149259,18,1149241
85292,12,-5,525,494939,12,494927
85293,10,9,787,923369,10,923359
85294,18,12,623,1026678,18,1026660
85295,11,9,990,936451,11,936440
85296,6,5,218,786263,6,786257
85297,6,-18,475,72659,6,72653
85298,15,-2,156,586238,15,586223
85299,19,15,705,1121979,19,1121960
85300,18,3,927,748872,18,748854
85301,17,-12,661,277411,17,277394
85302,13,-5,178,492314,13,492301
85303,15,6,339,838429,15,838414
85304,11,-5,205,492448,11,492437
85305,12,17,811,1184035,12,1184023
85306,8,11,832,986213,8,986205
85307,13,15,582,1120997,13,1120984
85308,5,19,928,1238058,5,1238053
85309,6,-19,640,45626,6,45620
85310,6,-11,477,291769,6,291763
85311,19,19,767,1247017,19,1246998
85312,10,14,438,1071625,10,1071615
85313,12,16,655,1151805,12,1151793
85314,12,-19,353,56771,12,56759
85315,20,17,806,1183976,20,1183956
85316,19,2,671,715650,19,715631
85317,9,10,431,946787,9,946778
85318,14,14,50,1085815,14,1085801
85319,18,-19,388,57034,18,57016
85320,8,-13,149,221555,8,221547
85321,7,12,584,1011646,7,1011639
85322,12,4,524,777060,12,777048
85323,8,-6,117,439215,8,439207
85324,17,-16,522,150853,17,150836
85325,8,10,753,953669,8,953661
85326,14,6,734,841724,14,841710
85327,7,-11,547,293335,7,293328
85328,6,17,86,1157100,6,1157094
85329,14,-18,955,92170,14,92156
85330,19,18,353,1211651,19,1211632
85331,5,3,345,726388,5,726383
85332,19,17,0,1177875,19,1177856
85333,9,-15,533,166964,9,166955
85334,20,10,470,963449,20,963429
85335,15,-10,879,341724,15,341709
85336,19,-14,408,212732,19,212713
85337,15,-2,56,585585,15,585570
85338,14,17,871,1184534,14,1184520
85339,8,5,932,801275,8,801267
85340,18,17,945,1184981,18,1184963
85341,18,2,938,717467,18,717449
85342,12,-19,816,60265,12,60253
85343,20,0,902,655139,20,655119
85344,17,-2,426,588331,17,588314
85345,17,16,223,1148717,17,1148700
85346,16,-13,128,241940,16,241924
85347,20,13,264,1055145,20,1055125
85348,16,-2,200,586591,16,586575
85349,17,-20,342,25495,17,25478
85350,6,-2,490,573264,6,573258
85351,19,2,283,712690,19,712671
85352,10,-19,24,32040,10,32030
85353,15,19,751,1246862,15,1246847
85354,5,-20,632,13809,5,13804
85355,12,18,445,1212300,12,1212288
85356,20,13,524,1057106,20,1057086
85357,18,9,62,929517,18,929499
85358,8,3,884,737872,8,737864
85359,7,-2,0,562788,7,562781
85360,10,-17,284,99587,10,99577
85361,13,3,844,748181,13,748168
85362,18,-11,926,310931,18,310913
85363,7,19,933,1238126,7,1238119
85364,13,-19,158,55316,13,55303
85365,12,-6,371,462020,12,462008
85366,16,-20,918,29823,16,29807
85367,13,-15,730,183234,13,183221
85368,11,15,425,1119785,11,1119774
85369,18,3,348,744524,18,744506
85370,6,4,520,761850,6,761844
85371,11,0,126,649217,11,649206
85372,5,15,457,1104124,5,1104119
85373,16,-19,670,59199,16,59183
85374,10,17,226,1159999,10,1159989
85375,15,4,31,773487,15,773472
85376,14,7,462,870469,14,870455
85377,14,0,883,654994,14,654980
85378,5,19,815,1235561,5,1235556
85379,8,6,574,825298,8,825290
85380,13,11,682,995709,13,995696
85381,8,-15,11,155555,8,155547
85382,6,-8,545,386839,6,386833
85383,5,2,453,698300,5,698295
85384,10,15,107,1096796,10,1096786
85385,9,3,87,720668,9,720659
85386,5,4,526,761992,5,761987
85387,7,-10,638,326460,7,326453
85388,12,4,455,776516,12,776504
85389,7,-12,591,262290,7,262283
85390,19,13,353,1055835,19,1055816
85391,9,8,247,880654,9,880645
85392,12,-11,305,306191,12,306179
85393,13,18,600,1213216,13,1213203
85394,6,-20,290,6478,6,6472
85395,16,18,665,1213783,16,1213767
85396,8,7,786,861426,8,861418
85397,12,11,242,992579,12,992567
85398,17,-10,494,338738,17,338721
85399,11,-17,423,118576,11,118565
85400,11,-7,478,431922,11,431911
85401,20,-9,941,374032,20,374012
85402,18,-13,790,246913,18,246895
85403,10,-3,417,539676,10,539666
85404,17,0,673,653392,17,653375
85405,8,3,992,740601,8,740593
85406,9,1,426,666441,9,666432
85407,9,-20,769,16931,9,16922
85408,17,-20,795,28974,17,28957
85409,10,-15,97,157524,10,157514
85410,7,-19,5,31572,7,31565
85411,19,-11,618,308658,19,308639
85412,7,-4,948,519738,7,519731
85413,5,0,272,631228,5,631223
85414,8,-10,536,324184,8,324176
85415,14,13,181,1054570,14,1054556
85416,13,-7,151,429403,13,429390
85417,18,-10,113,335938,18,335920
85418,9,4,621,764089,9,764080
85419,11,18,631,1213496,11,1213485
85420,6,0,372,633352,6,633346
85421,12,-20,243,24642,12,24630
85422,8,12,773,1015855,8,1015847
85423,10,-2,998,584088,10,584078
85424,8,-2,926,582662,8,582654
85425,18,-13,885,247649,18,247631
85426,7,-11,679,296084,7,296077
85427,17,-16,253,148830,17,148813
85428,19,-20,221,24488,19,24469
85429,16,0,641,653109,16,653093
85430,15,2,483,714266,15,714251
85431,5,0,511,636422,5,636417
85432,5,6,771,829639,5,829634
85433,12,-18,124,86167,12,86155
85434,13,15,365,1119440,13,1119427
85435,17,0,864,654799,17,654782
85436,14,-3,646,558930,14,558916
85437,20,-17,700,120750,20,120730
85438,17,0,913,655228,17,655211
85439,8,0,837,643548,8,643540
85440,7,-1,227,598837,7,598830
85441,10,9,726,921996,10,921986
85442,6,10,128,940471,6,940465
85443,19,-17,890,122134,19,122115
85444,12,-13,693,246033,12,246021
85445,16,13,142,1054250,16,1054234
85446,10,0,320,632026,10,632016
85447,5,-8,523,386378,5,386373
85448,15,19,213,1242441,15,1242426
85449,6,3,863,737537,6,737531
85450,8,-14,463,196707,8,196699
85451,5,-10,847,330762,5,330757
85452,19,-15,336,180215,19,180196
85453,18,-8,41,398220,18,398202
85454,20,1,890,686754,20,686734
85455,14,7,645,871750,14,871736
85456,16,6,91,836434,16,836418
85457,19,14,802,1091742,19,1091723
85458,19,-6,93,459783,19,459764
85459,9,7,832,862473,9,862464
85460,15,8,887,904820,15,904805
85461,5,-12,777,266314,5,266309
85462,10,18,775,1203133,10,1203123
85463,19,7,106,867804,19,867785
85464,19,-3,227,555349,19,555330
85465,19,-2,356,587784,19,587765
85466,20,18,664,1213778,20,1213758
85467,13,11,478,994339,13,994326
85468,7,0,544,637095,7,637088
85469,7,2,604,701347,7,701340
85470,12,-17,633,120242,12,120230
85471,13,15,574,1120952,13,1120939
85472,14,-15,151,178926,14,178912
85473,16,-11,803,309959,16,309943
85474,14,1,519,683953,14,683939
85475,13,16,933,1153778,13,1153765
85476,14,2,358,713315,14,713301
85477,20,-7,147,429359,20,429339
85478,13,-12,205,273949,13,273936
85479,12,6,556,840235,12,840223
85480,18,6,396,838968,18,838950
85481,5,-20,752,16567,5,16562
85482,10,-16,656,138209,10,138199
85483,12,15,173,1118101,12,1118089
85484,7,-12,240,254699,7,254692
85485,6,-17,508,104475,6,104469
85486,5,-20,295,6608,5,6603
85487,7,4,462,760558,7,760551
85488,8,-1,138,596792,8,596784
85489,8,-10,185,316656,8,316648
85490,5,-8,310,381987,5,381982
85491,13,-7,620,432858,13,432845
85492,14,5,361,806427,14,806413
85493,10,-8,71,377064,10,377054
85494,15,18,839,1215046,15,1215031
85495,18,11,587,995104,18,995086
85496,7,4,570,762866,7,762859
85497,9,-13,87,220247,9,220238
85498,13,1,41,680113,13,680100
85499,12,-9,415,369813,12,369801
85500,15,17,62,1178358,15,1178343
85501,17,9,436,932220,17,932203
85502,6,1,100,659299,6,659293
85503,11,-13,652,245791,11,245780
85504,7,16,531,1136475,7,1136468
85505,17,-16,393,149766,17,149749
85506,7,0,138,628466,7,628459
85507,5,16,184,1129096,5,1129091
85508,6,-6,175,440669,6,440663
85509,11,6,474,839570,11,839559
85510,10,-19,911,51127,10,51117
85511,20,-1,164,617788,20,617768
85512,18,9,627,933736,18,933718
85513,12,18,837,1215034,12,1215022
85514,13,-13,242,242829,13,242816
85515,19,8,288,900262,19,900243
85516,15,1,760,685787,15,685772
85517,5,-9,771,360823,5,360818
85518,5,-11,350,288870,5,288865
85519,8,2,208,693132,8,693124
85520,17,8,14,898032,17,898015
85521,5,-7,525,417125,5,417120
85522,17,-20,931,29886,17,29869
85523,5,9,529,917951,5,917946
85524,14,-20,471,26322,14,26308
85525,20,12,943,1029364,20,1029344
85526,6,17,381,1163479,6,1163473
85527,12,-18,618,89695,12,89683
85528,8,18,553,1198607,8,1198599
85529,19,-16,578,151256,19,151237
85530,9,-13,869,237183,9,237174
85531,13,-15,286,179842,13,179829
85532,20,-3,470,557395,20,557375
85533,19,-11,704,309243,19,309224
85534,15,-6,1000,466720,15,466705
85535,12,-16,285,149046,12,149034
85536,11,14,724,1091142,11,1091131
85537,18,-1,897,623426,18,623408
85538,12,-18,739,90660,12,90648
85539,9,-20,617,13501,9,13492
85540,18,-16,561,151130,18,151112
85541,16,17,157,1179021,16,1179005
85542,8,2,989,709354,8,709346
85543,12,6,935,843189,12,843177
85544,19,-14,0,209359,19,209340
85545,11,-7,425,431503,11,431492
85546,5,7,788,861516,5,861511
85547,15,-4,379,525057,15,525042
85548,10,-18,779,79352,10,79342
85549,6,17,678,1169836,6,1169830
85550,10,-5,895,487554,10,487544
85551,8,3,426,727958,8,727950
85552,18,10,189,961296,18,961278
85553,8,10,621,950928,8,950920
85554,11,-9,393,369645,11,369634
85555,20,19,614,1245776,20,1245756
85556,11,-14,868,216279,11,216268
85557,7,2,954,708612,7,708605
85558,5,14,743,1078663,5,1078658
85559,13,14,40,1085734,13,1085721
85560,16,5,153,804905,16,804889
85561,20,1,573,684439,20,684419
85562,17,16,821,1153002,17,1152985
85563,17,10,464,963400,17,963383
85564,16,-17,285,117607,16,117591
85565,17,-5,784,496693,17,496676
85566,20,-10,949,342225,20,342205
85567,12,-14,477,213193,12,213181
85568,18,-5,153,492141,18,492123
85569,8,-19,124,34330,8,34322
85570,17,-4,831,528138,17,528121
85571,8,3,943,739331,8,739323
85572,5,2,392,697087,5,697082
85573,13,12,429,1025194,13,1025181
85574,6,16,324,1132059,6,1132053
85575,13,1,264,682012,13,681999
85576,19,-6,891,465865,19,465846
85577,13,16,22,1147252,13,1147239
85578,6,10,151,940861,6,940855
85579,15,-11,449,307358,15,307343
85580,7,-14,640,200857,7,200850
85581,15,-14,297,211714,15,211699
85582,8,-5,713,483401,8,483393
85583,15,6,200,837225,15,837210
85584,12,-10,992,342647,12,342635
85585,14,6,316,838207,14,838193
85586,12,-8,268,399748,12,399736
85587,10,4,911,770638,10,770628
85588,17,-9,312,368896,17,368879
85589,5,-17,696,108414,5,108409
85590,9,0,25,625839,9,625830
85591,12,17,287,1180072,12,1180060
85592,15,12,369,1024809,15,1024794
85593,10,-2,55,564086,10,564076
85594,13,13,4,1053276,13,1053263
85595,8,1,44,658045,8,658037
85596,9,13,926,1050584,9,1050575
85597,20,17,711,1183191,20,1183171
85598,8,-11,140,284215,8,284207
85599,18,3,247,743734,18,743716
85600,11,-14,145,210426,11,210415
85601,15,4,716,778532,15,778517
85602,10,-1,718,609348,10,609338
85603,6,2,277,694558,6,694552
85604,18,3,258,743812,18,743794
85605,12,-16,358,149531,12,149519
85606,5,-1,645,607771,5,607766
85607,12,-2,641,589930,12,589918
85608,20,18,395,1211965,20,1211945
85609,14,9,474,932464,14,932450
85610,13,17,367,1180705,13,1180692
85611,11,15,826,1122835,11,1122824
85612,5,0,951,646005,5,646000
85613,8,-1,871,612570,8,612562
85614,7,7,270,850591,7,850584
85615,15,-5,246,492828,15,492813
85616,5,18,243,1192135,5,1192130
85617,18,-17,823,121665,18,121647
85618,6,-19,324,38561,6,38555
85619,5,15,222,1099274,5,1099269
85620,8,-4,512,510597,8,510589
85621,6,-4,45,500236,6,500230
85622,14,-10,467,338552,14,338538
85623,20,8,568,902425,20,902405
85624,9,-18,91,64538,9,64529
85625,12,1,764,685825,12,685813
85626,13,-16,540,150982,13,150969
85627,7,1,16,657371,7,657364
85628,18,-11,757,309620,18,309602
85629,7,-15,333,162649,7,162642
85630,5,-7,613,418881,5,418876
85631,13,-6,355,461895,13,461882
85632,12,-11,366,306701,12,306689
85633,15,14,36,1085698,15,1085683
85634,17,-6,632,463989,17,463972
85635,20,-19,617,58871,20,58851
85636,14,18,881,1215356,14,1215342
85637,7,0,464,635477,7,635470
85638,14,14,259,1087457,14,1087443
85639,20,10,279,961934,20,961914
85640,10,-16,889,143040,10,143030
85641,13,13,769,1058990,13,1058977
85642,11,-3,709,559440,11,559429
85643,13,11,218,992391,13,992378
85644,8,2,386,696988,8,696980
85645,18,-8,97,398621,18,398603
85646,18,7,169,868227,18,868209
85647,13,-3,169,554957,13,554944
85648,13,3,533,745726,13,745713
85649,9,14,379,1070184,9,1070175
85650,19,18,667,1213813,19,1213794
85651,7,0,447,635092,7,635085
85652,10,-14,732,202668,10,202658
85653,15,10,187,961277,15,961262
85654,13,-1,764,622424,13,622411
85655,12,-15,425,180948,12,180936
85656,13,13,467,1056680,13,1056667
85657,7,14,748,1078796,7,1078789
85658,7,-2,642,576431,7,576424
85659,6,-13,353,225772,6,225766
85660,19,18,411,1212082,19,1212063
85661,14,-5,485,494654,14,494640
85662,10,-6,706,452006,10,451996
85663,13,6,473,839560,13,839547
85664,15,4,838,779498,15,779483
85665,7,15,52,1095607,7,1095600
85666,6,-3,169,534033,6,534027
85667,19,-16,682,151907,19,151888
85668,20,2,660,715549,20,715529
85669,9,-6,594,449583,9,449574
85670,10,10,430,946738,10,946728
85671,17,-16,583,151307,17,151290
85672,20,12,265,1024095,20,1024075
85673,7,1,83,658809,7,658802
85674,9,-18,378,70554,9,70545
85675,10,12,220,1003960,10,1003950
85676,11,-14,700,214994,11,214983
85677,14,-14,245,211338,14,211324
85678,20,-4,864,528469,20,528449
85679,9,4,859,769592,9,769583
85680,19,7,900,873465,19,873446
85681,5,2,860,706536,5,706531
85682,17,18,132,1209998,17,1209981
85683,10,15,581,1106791,10,1106781
85684,9,3,433,728139,9,728130
85685,16,-16,435,150208,16,150192
85686,11,-13,561,245161,11,245150
85687,17,8,197,899503,17,899486
85688,20,14,977,1093119,20,1093099
85689,9,1,737,673058,9,673049
85690,11,-17,291,117652,11,117641
85691,7,2,242,693818,7,693811
85692,16,9,930,936015,16,935999
85693,14,2,863,716928,14,716914
85694,9,14,622,1075764,9,1075755
85695,12,15,758,1122423,12,1122411
85696,5,17,234,1160175,5,1160170
85697,13,-11,226,305473,13,305460
85698,13,-1,16,616634,13,616621
85699,13,-2,177,586350,13,586337
85700,17,-11,642,308863,17,308846
85701,17,2,687,715789,17,715772
85702,10,-17,567,105748,10,105738
85703,17,12,547,1026087,17,1026070
85704,7,-5,788,484914,7,484907
85705,18,-15,572,182011,18,181993
85706,20,-17,88,116237,20,116217
85707,5,17,315,1162123,5,1162118
85708,17,14,611,1090154,17,1090137
85709,6,-18,268,68354,6,68348
85710,19,3,749,747500,19,747481
85711,5,-19,31,32190,5,32185
85712,12,-5,734,496415,12,496403
85713,10,3,567,730858,10,730848
85714,5,-10,605,325740,5,325735
85715,5,-6,334,444009,5,444004
85716,19,4,405,776115,19,776096
85717,20,4,826,779376,20,779356
85718,16,3,860,748340,16,748324
85719,16,17,73,1178433,16,1178417
85720,17,17,887,1184585,17,1184568
85721,14,11,484,994402,14,994388
85722,17,0,838,654641,17,654624
85723,8,15,745,1110370,8,1110362
85724,15,7,997,874107,15,874092
85725,12,11,200,992258,12,992246
85726,12,-7,91,428933,12,428921
85727,19,13,332,1055691,19,1055672
85728,18,6,455,839405,18,839387
85729,6,-10,122,315272,6,315266
85730,15,-13,421,244066,15,244051
85731,6,2,560,700462,6,700456
85732,9,19,935,1238170,9,1238161
85733,12,17,637,1182587,12,1182575
85734,14,0,183,649662,14,649648
85735,5,-2,612,575831,5,575826
85736,8,-6,461,446678,8,446670
85737,12,-18,500,88950,12,88938
85738,20,15,171,1118084,20,1118064
85739,17,-13,238,242806,17,242789
85740,9,4,600,763656,9,763647
85741,17,-14,185,210719,17,210702
85742,7,15,189,1098527,7,1098520
85743,10,-18,910,82225,10,82215
85744,14,0,759,654121,14,654107
85745,6,3,624,732158,6,732152
85746,10,-7,727,421262,10,421252
85747,19,3,479,745414,19,745395
85748,9,18,683,1201106,9,1201097
85749,10,-4,697,514449,10,514439
85750,12,15,623,1121362,12,1121350
85751,8,-1,517,605279,8,605271
85752,12,-8,322,400175,12,400163
85753,6,-19,487,41955,6,41949
85754,5,2,983,709226,5,709221
85755,16,1,691,685245,16,685229
85756,5,17,758,1171439,5,1171434
85757,7,-17,2,93553,7,93546
85758,15,-4,458,525543,15,525528
85759,13,-2,978,592602,13,592589
85760,20,5,330,806217,20,806197
85761,18,17,838,1184259,18,1184241
85762,17,-19,114,54905,17,54888
85763,9,9,106,909020,9,909011
85764,8,-1,411,602981,8,602973
85765,8,1,970,678149,8,678141
85766,19,-6,161,460375,19,460356
85767,5,-7,224,410576,5,410571
85768,9,-6,465,446746,9,446737
85769,20,7,373,869709,20,869689
85770,20,4,755,778832,20,778812
85771,15,0,394,651074,15,651059
85772,18,5,51,804200,18,804182
85773,11,14,639,1090413,11,1090402
85774,18,-11,983,311407,18,311389
85775,10,3,790,735883,10,735873
85776,16,-1,263,618601,16,618585
85777,6,-4,959,520062,6,520056
85778,7,-14,218,191424,7,191417
85779,20,0,241,650036,20,650016
85780,15,-14,503,213371,15,213356
85781,5,-6,530,448241,5,448236
85782,17,7,424,870168,17,870151
85783,6,16,468,1135247,6,1135241
85784,6,-8,814,392842,6,392836
85785,13,-2,568,589421,13,589408
85786,18,12,3,1022141,18,1022123
85787,15,-14,702,215018,15,215003
85788,16,-14,713,215091,16,215075
85789,17,14,406,1088635,17,1088618
85790,9,-17,678,108011,9,108002
85791,13,16,791,1152751,13,1152738
85792,11,-11,489,307650,11,307639
85793,6,-14,152,189792,6,189786
85794,7,-13,995,239896,7,239889
85795,15,-15,200,179186,15,179171
85796,15,-19,376,56939,15,56924
85797,7,10,968,958217,7,958210
85798,9,5,744,797175,9,797166
85799,15,-16,922,153715,15,153700
85800,12,-2,803,591152,12,591140
85801,6,15,9,1094639,6,1094633
85802,17,-12,979,279947,17,279930
85803,11,-20,872,29526,11,29515
85804,16,-14,790,215694,16,215678
85805,17,-5,857,497272,17,497255
85806,20,-17,504,119273,20,119253
85807,17,2,949,717556,17,717539
85808,19,-8,648,402434,19,402415
85809,17,6,938,843215,17,843198
85810,8,-4,314,506346,8,506338
85811,15,-8,683,402734,15,402719
85812,15,-8,868,404038,15,404023
85813,9,-16,741,139907,9,139898
85814,15,-2,302,587412,15,587397
85815,8,-20,144,3172,8,3164
85816,12,-19,10,53949,12,53937
85817,19,11,150,991912,19,991893
85818,20,1,173,681245,20,681225
85819,13,-7,56,428724,13,428711
85820,20,17,183,1179258,20,1179238
85821,14,-7,341,430945,14,430931
85822,13,10,791,965973,13,965960
85823,11,-3,999,561757,11,561746
85824,7,10,264,943078,7,943071
85825,7,-7,277,411736,7,411729
85826,10,5,92,783543,10,783533
85827,17,-14,244,211330,17,211313
85828,9,10,743,953506,9,953497
85829,17,8,511,902022,17,902005
85830,5,-5,297,474638,5,474633
85831,12,-14,374,212423,12,212411
85832,8,10,786,954460,8,954452
85833,11,2,746,716192,11,716181
85834,12,-20,797,28995,12,28983
85835,19,-12,948,279666,19,279647
85836,7,-17,136,96319,7,96312
85837,19,-1,541,620864,19,620845
85838,18,-12,689,277581,18,277563
85839,15,10,386,962730,15,962715
85840,16,-6,442,462491,16,462475
85841,17,3,480,745422,17,745405
85842,19,-9,517,370752,19,370733
85843,18,-19,626,58953,18,58935
85844,7,13,560,1042827,7,1042820
85845,17,-3,385,556662,17,556645
85846,18,-14,368,212341,18,212323
85847,18,-11,860,310468,18,310450
85848,14,18,798,1214784,14,1214770
85849,5,-15,572,167791,5,167786
85850,7,12,701,1014514,7,1014507
85851,8,-1,529,605613,8,605605
85852,10,16,202,1129435,10,1129425
85853,17,-14,255,211461,17,211444
85854,17,-16,963,154035,17,154018
85855,18,7,527,870931,18,870913
85856,5,13,701,1045817,5,1045812
85857,16,-14,854,216179,16,216163
85858,17,5,325,806169,17,806152
85859,14,14,222,1087147,14,1087133
85860,15,2,999,717863,15,717848
85861,6,-19,603,44734,6,44728
85862,14,2,907,717238,14,717224
85863,7,19,635,1231669,7,1231662
85864,13,14,564,1089838,13,1089825
85865,16,19,634,1245929,16,1245913
85866,5,6,812,830633,5,830628
85867,16,-2,172,586318,16,586302
85868,12,3,289,744094,12,744082
85869,6,0,688,640441,6,640435
85870,18,1,439,683286,18,683268
85871,14,-2,253,587040,14,587026
85872,12,-19,354,56772,12,56760
85873,16,-16,709,152102,16,152086
85874,20,18,187,1210514,20,1210494
85875,9,7,175,848493,9,848484
85876,20,8,715,903682,20,903662
85877,16,-1,70,617116,16,617100
85878,12,4,476,776690,12,776678
85879,20,-16,699,152055,20,152035
85880,16,5,736,809160,16,809144
85881,8,10,988,958622,8,958614
85882,8,17,920,1175047,8,1175039
85883,11,-17,557,119680,11,119669
85884,7,16,676,1139372,7,1139365
85885,19,-2,231,586875,19,586856
85886,12,-1,130,617547,12,617535
85887,13,10,17,959945,13,959932
85888,9,12,12,999330,9,999321
85889,17,-6,765,464964,17,464947
85890,15,4,611,777750,15,777735
85891,18,8,788,904174,18,904156
85892,15,18,907,1215579,15,1215564
85893,14,-2,243,586977,14,586963
85894,7,-7,102,408043,7,408036
85895,8,-6,235,442042,8,442034
85896,15,19,577,1245528,15,1245513
85897,6,-9,562,356288,6,356282
85898,13,-10,277,337078,13,337065
85899,17,10,744,965607,17,965590
85900,20,18,941,1215849,20,1215829
85901,9,-10,611,325880,9,325871
85902,10,9,191,910758,10,910748
85903,14,-19,327,56509,14,56495
85904,17,-18,681,90210,17,90193
85905,19,-18,856,91418,19,91399
85906,17,-16,427,150109,17,150092
85907,10,17,554,1167137,10,1167127
85908,11,-5,168,492256,11,492245
85909,11,-13,118,241890,11,241879
85910,5,-1,681,608531,5,608526
85911,12,11,497,994473,12,994461
85912,18,16,439,1150281,18,1150263
85913,16,-13,226,242709,16,242693
85914,15,-6,596,463688,15,463673
85915,8,14,819,1080299,8,1080291
85916,7,-20,223,5062,7,5055
85917,16,-7,688,433293,16,433277
85918,15,18,489,1212562,15,1212547
85919,13,14,518,1089497,13,1089484
85920,6,-7,604,418726,6,418720
85921,12,-9,896,373664,12,373652
85922,19,-5,852,497241,19,497222
85923,12,-3,842,560504,12,560492
85924,8,-16,299,130502,8,130494
85925,5,4,598,763549,5,763544
85926,9,1,566,669719,9,669710
85927,8,4,698,765597,8,765589
85928,10,-8,997,396778,10,396768
85929,19,1,958,687329,19,687310
85930,17,-19,117,54936,17,54919
85931,9,-15,898,174491,9,174482
85932,17,-5,393,493919,17,493902
85933,5,7,382,853068,5,853063
85934,5,18,493,1197276,5,1197271
85935,12,-14,810,215884,12,215872
85936,6,5,536,792745,6,792739
85937,12,-4,375,525029,12,525017
85938,9,11,342,975764,9,975755
85939,14,-1,637,621479,14,621465
85940,12,3,996,749519,12,749507
85941,12,-18,3,85213,12,85201
85942,10,-12,970,270783,10,270773
85943,15,10,340,962381,15,962366
85944,8,-2,605,575648,8,575640
85945,13,-17,443,118768,13,118755
85946,5,12,768,1015787,5,1015782
85947,10,1,732,672971,10,672961
85948,20,3,464,745317,20,745297
85949,5,18,903,1205840,5,1205835
85950,12,14,972,1093056,12,1093044
85951,13,13,818,1059388,13,1059375
85952,16,-12,84,273149,16,273133
85953,10,-8,99,377489,10,377479
85954,13,9,365,931719,13,931706
85955,18,-8,895,404263,18,404245
85956,14,-8,657,402539,14,402525
85957,19,-17,408,118461,19,118442
85958,6,9,736,922201,6,922195
85959,10,17,841,1173447,10,1173437
85960,5,17,272,1161155,5,1161150
85961,6,-13,730,233954,6,233948
85962,19,-17,332,117952,19,117933
85963,16,-7,174,429625,16,429609
85964,19,10,680,965183,19,965164
85965,12,4,236,775002,12,774990
85966,11,-1,818,622853,11,622842
85967,17,-1,69,617089,17,617072
85968,10,-6,113,439139,10,439129
85969,8,-10,326,319599,8,319591
85970,12,-14,997,217255,12,217243
85971,11,18,983,1216197,11,1216186
85972,5,-11,956,301763,5,301758
85973,20,18,205,1210667,20,1210647
85974,5,-9,199,347812,5,347807
85975,8,3,191,723030,8,723022
85976,18,0,83,648836,18,648818
85977,20,12,980,1029696,20,1029676
85978,20,2,209,712186,20,712166
85979,10,-14,993,208153,10,208143
85980,14,7,411,870082,14,870068
85981,14,-1,224,618333,14,618319
85982,13,0,191,649694,13,649681
85983,12,13,215,1054843,12,1054831
85984,10,-19,714,47196,10,47186
85985,19,19,822,1247410,19,1247391
85986,14,-17,209,117002,14,116988
85987,12,-5,942,497948,12,497936
85988,9,-14,541,198200,9,198191
85989,8,-19,291,37862,8,37854
85990,10,5,475,791474,10,791464
85991,19,-8,460,401055,19,401036
85992,16,-10,857,341539,16,341523
85993,8,17,315,1162131,8,1162123
85994,7,-20,393,8520,7,8513
85995,8,0,369,633267,8,633259
85996,8,-8,813,392819,8,392811
85997,5,-14,753,203135,5,203130
85998,11,-12,612,276948,11,276937
85999,17,7,657,871829,17,871812
86000,18,11,853,997053,18,997035
86001,16,19,843,1247598,16,1247582
86002,20,-3,876,560798,20,560778
86003,8,2,802,705310,8,705302
86004,6,-4,313,506301,6,506295
86005,19,-5,766,496602,19,496583
86006,10,-18,639,76121,10,76111
86007,16,-12,924,279490,16,279474
86008,19,-12,596,276858,19,276839
86009,16,17,235,1179602,16,1179586
86010,20,19,298,1243164,20,1243144
86011,7,-1,787,610777,7,610770
86012,10,17,482,1165690,10,1165680
86013,10,-6,368,444625,10,444615
86014,5,3,736,734822,5,734817
86015,15,0,216,649875,15,649860
86016,19,-2,159,586251,19,586232
86017,11,-8,88,398598,11,398587
86018,5,-13,501,228932,5,228927
86019,19,12,670,1027103,19,1027084
86020,16,18,114,1209896,16,1209880
86021,15,17,936,1184913,15,1184898
86022,16,17,716,1183240,16,1183224
86023,18,-11,920,310899,18,310881
86024,11,-10,561,339275,11,339264
86025,8,-7,828,423329,8,423321
86026,13,-19,482,57664,13,57651
86027,5,13,348,1038297,5,1038292
86028,12,12,462,1025444,12,1025432
86029,5,-11,63,282489,5,282484
86030,10,-10,993,333985,10,333975
86031,7,17,547,1166986,7,1166979
86032,15,-1,543,620884,15,620869
86033,19,-5,30,491054,19,491035
86034,17,4,337,775647,17,775630
86035,12,6,404,839028,12,839016
86036,17,17,42,1178217,17,1178200
86037,18,-7,11,428374,18,428356
86038,16,-8,490,401243,16,401227
86039,9,16,564,1137108,9,1137099
86040,18,6,57,836206,18,836188
86041,20,-4,961,529322,20,529302
86042,14,9,790,934908,14,934894
86043,16,-13,647,245773,16,245757
86044,19,-6,86,459706,19,459687
86045,11,2,406,713732,11,713721
86046,10,-11,496,292292,10,292282
86047,6,-8,166,379037,6,379031
86048,14,18,405,1212042,14,1212028
86049,14,0,475,651728,14,651714
86050,18,-1,118,617463,18,617445
86051,16,-11,252,305695,16,305679
86052,9,-17,585,106165,9,106156
86053,11,12,801,1028004,11,1027993
86054,9,-11,459,291402,9,291393
86055,14,-6,226,460894,14,460880
86056,10,8,282,881418,10,881408
86057,15,-15,717,183131,15,183116
86058,15,3,890,748514,15,748499
86059,5,-16,500,134938,5,134933
86060,19,-14,932,216733,19,216714
86061,16,15,8,1116811,16,1116795
86062,19,-3,613,558652,19,558633
86063,16,-20,278,24928,16,24912
86064,7,-1,558,606117,7,606110
86065,7,11,597,981288,7,981281
86066,20,-6,226,460904,20,460884
86067,13,4,132,774205,13,774192
86068,19,-17,675,120594,19,120575
86069,6,6,435,822256,6,822250
86070,20,-13,263,243019,20,242999
86071,11,-6,897,465929,11,465918
86072,10,-16,423,133153,10,133143
86073,12,13,175,1054485,12,1054473
86074,20,-17,69,116013,20,115993
86075,12,-5,869,497366,12,497354
86076,5,11,916,988266,5,988261
86077,19,-14,366,212308,19,212289
86078,11,4,399,776071,11,776060
86079,15,18,330,1211512,15,1211497
86080,7,-13,205,222767,7,222760
86081,14,-18,536,89166,14,89152
86082,18,-17,516,119393,18,119375
86083,6,0,116,627972,6,627966
86084,15,-8,149,398982,15,398967
86085,17,16,262,1149004,17,1148987
86086,11,19,120,1241769,11,1241758
86087,17,14,795,1091684,17,1091667
86088,10,-20,296,6645,10,6635
86089,6,-1,353,601838,6,601832
86090,10,0,689,640470,10,640460
86091,17,-9,875,373512,17,373495
86092,14,2,598,715057,14,715043
86093,13,19,206,1242406,13,1242393
86094,19,-1,802,622735,19,622716
86095,15,-15,259,179631,15,179616
86096,9,18,572,1198934,9,1198925
86097,17,6,942,843262,17,843245
86098,14,18,932,1215803,14,1215789
86099,14,-19,572,58542,14,58528
86100,8,-10,270,318381,8,318373
86101,14,17,199,1179391,14,1179377
86102,5,2,185,692696,5,692691
86103,9,-6,157,440147,9,440138
86104,18,-13,817,247097,18,247079
86105,13,-2,372,587861,13,587848
86106,6,-1,927,614018,6,614012
86107,14,18,840,1215082,14,1215068
86108,6,9,532,918029,6,918023
86109,17,-14,60,209769,17,209752
86110,16,-16,200,148411,16,148395
86111,20,-8,426,400854,20,400834
86112,14,-15,267,179692,14,179678
86113,12,4,842,779536,12,779524
86114,12,-18,854,91405,12,91393
86115,10,-17,213,98010,10,98000
86116,9,-12,940,270049,9,270040
86117,19,-14,100,210106,19,210087
86118,5,1,530,668976,5,668971
86119,16,-17,600,120041,16,120025
86120,19,4,619,777780,19,777761
86121,13,4,25,773448,13,773435
86122,20,-16,572,151226,20,151206
86123,20,8,496,901891,20,901871
86124,7,1,198,661509,7,661502
86125,17,-8,455,401038,17,401021
86126,10,-1,581,606597,10,606587
86127,15,-4,313,524533,15,524518
86128,15,7,987,874029,15,874014
86129,15,7,24,867171,15,867156
86130,6,18,621,1199875,6,1199869
86131,14,12,352,1024664,14,1024650
86132,7,-15,99,157599,7,157592
86133,11,-13,697,246102,11,246091
86134,9,3,261,724539,9,724530
86135,13,2,193,712039,13,712026
86136,16,-14,302,211760,16,211744
86137,15,-16,705,152091,15,152076
86138,18,0,955,655554,18,655536
86139,16,8,402,901170,16,901154
86140,6,-13,179,222200,6,222194
86141,6,7,878,863460,6,863454
86142,8,16,139,1128048,8,1128040
86143,17,2,666,715589,17,715572
86144,8,-7,322,412931,8,412923
86145,11,-5,380,493831,11,493820
86146,17,-20,495,26523,17,26506
86147,17,7,458,870453,17,870436
86148,8,-20,962,21177,8,21169
86149,18,-9,690,371905,18,371887
86150,9,1,91,658983,9,658974
86151,12,-1,126,617511,12,617499
86152,12,-1,234,618424,12,618412
86153,18,-2,1,585134,18,585116
86154,13,-19,686,59353,13,59340
86155,18,18,957,1216015,18,1215997
86156,9,11,434,977763,9,977754
86157,19,-14,432,212879,19,212860
86158,7,13,864,1049372,7,1049365
86159,16,-1,105,617369,16,617353
86160,10,15,377,1102471,10,1102461
86161,12,-2,233,586887,12,586875
86162,14,-14,963,216963,14,216949
86163,18,19,393,1243982,18,1243964
86164,5,0,363,633103,5,633098
86165,5,-9,238,348738,5,348733
86166,17,-10,603,339557,17,339540
86167,10,-19,704,46970,10,46960
86168,5,5,934,801351,5,801346
86169,8,-5,727,483739,8,483731
86170,16,-3,224,555331,16,555315
86171,13,19,348,1243586,13,1243573
86172,8,-6,328,443896,8,443888
86173,17,-1,609,621301,17,621284
86174,12,-14,584,214111,12,214099
86175,14,-20,347,25536,14,25522
86176,19,-13,706,246217,19,246198
86177,7,-10,577,325129,7,325122
86178,12,13,261,1055114,12,1055102
86179,6,11,364,976250,6,976244
86180,11,16,186,1148450,11,1148439
86181,5,-8,901,394678,5,394673
86182,10,5,180,785394,10,785384
86183,19,-14,540,213649,19,213630
86184,15,-13,594,245407,15,245392
86185,6,-17,394,101881,6,101875
86186,7,-6,48,437876,7,437869
86187,17,0,969,655704,17,655687
86188,12,3,264,743888,12,743876
86189,19,-10,207,336594,19,336575
86190,8,14,524,1073542,8,1073534
86191,5,-19,199,36039,5,36034
86192,19,-1,579,621119,19,621100
86193,16,-16,368,149617,16,149601
86194,8,8,651,889456,8,889448
86195,15,-12,219,274136,15,274121
86196,16,-10,861,341552,16,341536
86197,11,-1,642,621511,11,621500
86198,14,8,53,898285,14,898271
86199,10,18,31,1187240,10,1187230
86200,5,19,866,1236862,5,1236857
86201,19,7,368,869668,19,869649
86202,18,16,616,1151454,18,1151436
86203,11,-18,747,90703,11,90692
86204,17,-8,934,404491,17,404474
86205,12,16,879,1153342,12,1153330
86206,20,-6,800,465308,20,465288
86207,8,7,9,844963,8,844955
86208,17,-13,196,242504,17,242487
86209,8,-11,253,286597,8,286589
86210,15,17,449,1181311,15,1181296
86211,5,15,601,1107216,5,1107211
86212,5,5,123,784140,5,784135
86213,8,-20,941,20731,8,20723
86214,20,5,428,806883,20,806863
86215,7,1,221,662056,7,662049
86216,8,12,584,1011654,8,1011646
86217,5,12,630,1012751,5,1012746
86218,13,-6,649,464104,13,464091
86219,13,-7,202,429820,13,429807
86220,19,0,51,648636,19,648617
86221,11,5,575,807987,11,807976
86222,20,-17,230,117148,20,117128
86223,7,4,784,767743,7,767736
86224,14,9,536,932978,14,932964
86225,8,10,208,941965,8,941957
86226,8,14,129,1064781,8,1064773
86227,19,12,673,1027136,19,1027117
86228,14,0,923,655292,14,655278
86229,12,3,547,745842,12,745830
86230,10,4,1,750602,10,750592
86231,19,-18,992,92438,19,92419
86232,6,12,660,1013485,6,1013479
86233,10,-12,580,262093,10,262083
86234,19,2,125,711557,19,711538
86235,20,9,872,935522,20,935502
86236,15,-20,468,26305,15,26290
86237,9,13,858,1049228,9,1049219
86238,17,5,132,804731,17,804714
86239,18,-2,554,589331,18,589313
86240,16,-1,880,623330,16,623314
86241,10,11,488,978863,10,978853
86242,11,8,714,903660,11,903649
86243,5,-5,621,481463,5,481458
86244,7,-12,972,270816,7,270809
86245,19,15,41,1117111,19,1117092
86246,16,4,326,775570,16,775554
86247,14,-16,526,150878,14,150864
86248,5,4,373,758665,5,758660
86249,18,4,516,776995,18,776977
86250,20,-14,361,212208,20,212188
86251,5,-1,356,601940,5,601935
86252,10,3,688,733753,10,733743
86253,14,0,427,651357,14,651343
86254,19,0,238,650029,19,650010
86255,15,15,480,1120196,15,1120181
86256,18,4,365,775862,18,775844
86257,14,4,156,774391,14,774377
86258,11,-16,968,154075,11,154064
86259,7,13,907,1050138,7,1050131
86260,9,7,641,858360,9,858351
86261,14,9,899,935719,14,935705
86262,13,7,546,871059,13,871046
86263,5,16,187,1129174,5,1129169
86264,9,-3,160,533855,9,533846
86265,9,-12,310,256393,9,256384
86266,14,-2,601,589657,14,589643
86267,17,-15,135,178821,17,178804
86268,13,-7,460,431790,13,431777
86269,11,11,106,991626,11,991615
86270,9,3,729,734706,9,734697
86271,12,9,982,936414,12,936402
86272,5,15,64,1095842,5,1095837
86273,11,-5,351,493707,11,493696
86274,20,6,163,836980,20,836960
86275,20,-5,930,497874,20,497854
86276,12,4,40,773554,12,773542
86277,5,-19,832,49623,5,49618
86278,13,-4,84,522681,13,522668
86279,10,-7,690,420444,10,420434
86280,19,-2,493,588873,19,588854
86281,8,5,55,782845,8,782837
86282,11,11,392,993752,11,993741
86283,12,-6,599,463722,12,463710
86284,11,15,75,1117335,11,1117324
86285,8,2,149,691787,8,691779
86286,11,-11,153,304953,11,304942
86287,13,8,349,900741,13,900728
86288,10,-9,432,353128,10,353118
86289,8,12,543,1010835,8,1010827
86290,18,-1,128,617533,18,617515
86291,9,-15,519,166643,9,166634
86292,5,4,725,766338,5,766333
86293,13,3,552,745875,13,745862
86294,5,-9,855,362692,5,362687
86295,14,14,681,1090819,14,1090805
86296,20,-10,956,342259,20,342239
86297,17,-1,79,617204,17,617187
86298,10,-14,63,187919,10,187909
86299,9,11,335,975643,9,975634
86300,9,-6,582,449318,9,449309
86301,9,-1,226,598800,9,598791
86302,7,-7,827,423294,7,423287
86303,10,-18,231,67584,10,67574
86304,19,1,84,680447,19,680428
86305,8,-16,194,128311,8,128303
86306,10,-7,95,407868,10,407858
86307,8,15,36,1095239,8,1095231
86308,18,19,612,1245738,18,1245720
86309,18,10,213,961457,18,961439
86310,19,-2,706,590459,19,590440
86311,16,15,379,1119564,16,1119548
86312,14,-8,797,403582,14,403568
86313,10,7,31,845448,10,845438
86314,9,9,694,921373,9,921364
86315,13,-14,477,213196,13,213183
86316,9,-4,127,502169,9,502160
86317,16,-14,639,214562,16,214546
86318,14,5,453,807104,14,807090
86319,19,-11,311,306279,19,306260
86320,8,11,919,988378,8,988370
86321,19,-18,474,88824,19,88805
86322,10,-4,965,520199,10,520189
86323,7,2,924,707835,7,707828
86324,6,15,256,1100041,6,1100035
86325,18,2,942,717483,18,717465
86326,18,14,154,1086683,18,1086665
86327,8,8,175,878919,8,878911
86328,11,-8,606,402111,11,402100
86329,17,-1,245,618487,17,618470
86330,12,-13,137,242000,12,241988
86331,20,-18,625,89775,20,89755
86332,11,3,556,745926,11,745915
86333,16,11,230,992447,16,992431
86334,9,-11,74,282729,9,282720
86335,14,-3,512,557751,14,557737
86336,12,-16,519,150839,12,150827
86337,18,-10,936,342148,18,342130
86338,5,9,486,917007,5,917002
86339,12,-14,220,211075,12,211063
86340,13,-15,65,178237,13,178224
86341,8,13,556,1042736,8,1042728
86342,17,14,217,1087102,17,1087085
86343,19,-7,220,429956,19,429937
86344,12,-16,416,149989,12,149977
86345,15,-14,331,212020,15,212005
86346,6,4,443,760177,6,760171
86347,6,5,539,792837,6,792831
86348,17,-11,537,308067,17,308050
86349,8,2,778,704883,8,704875
86350,9,15,286,1100678,9,1100669
86351,10,10,502,948184,10,948174
86352,7,-15,437,164898,7,164891
86353,15,7,271,868972,15,868957
86354,16,-7,1,428278,16,428262
86355,12,-18,373,88084,12,88072
86356,14,-11,40,303948,14,303934
86357,16,15,25,1116982,16,1116966
86358,15,-13,268,243078,15,243063
86359,20,6,268,837813,20,837793
86360,19,11,65,991365,19,991346
86361,13,-18,798,91058,13,91045
86362,13,9,984,936418,13,936405
86363,8,9,695,921390,8,921382
86364,17,1,97,680564,17,680547
86365,20,-9,444,370114,20,370094
86366,5,-19,971,52330,5,52325
86367,18,-20,325,25375,18,25357
86368,6,1,441,666782,6,666776
86369,5,19,840,1236195,5,1236190
86370,7,-19,807,49074,7,49067
86371,8,11,820,985978,8,985970
86372,8,5,912,800808,8,800800
86373,8,8,145,878224,8,878216
86374,6,-9,984,365334,6,365328
86375,14,-8,336,400283,14,400269
86376,12,-16,795,152742,12,152730
86377,14,-13,826,247144,14,247130
86378,14,15,692,1121854,14,1121840
86379,6,-14,658,201098,6,201092
86380,19,-4,195,523577,19,523558
86381,5,7,221,849459,5,849454
86382,7,16,628,1138367,7,1138360
86383,8,4,239,755905,8,755897
86384,9,-7,275,411689,9,411680
86385,17,17,447,1181281,17,1181264
86386,10,15,942,1114520,10,1114510
86387,17,-3,468,557383,17,557366
86388,16,-6,212,460805,16,460789
86389,19,-15,690,182875,19,182856
86390,18,-12,616,276991,18,276973
86391,15,15,416,1119718,15,1119703
86392,13,-12,394,275400,13,275387
86393,10,-13,761,234770,10,234760
86394,20,12,197,1023475,20,1023455
86395,20,3,849,748250,20,748230
86396,17,-4,371,525011,17,524994
86397,17,0,692,653584,17,653567
86398,17,-12,790,278302,17,278285
86399,19,-11,911,310866,19,310847
86400,11,3,574,746120,11,746109
86401,18,9,610,933586,18,933568
86402,6,4,895,770300,6,770294
86403,6,13,331,1037871,6,1037865
86404,20,11,422,993958,20,993938
86405,11,-16,545,151009,11,150998
86406,7,-8,519,386246,7,386239
86407,16,-18,580,89467,16,89451
86408,15,17,544,1181944,15,1181929
86409,6,-4,334,506794,6,506788
86410,9,1,881,676120,9,676111
86411,15,-18,492,88921,15,88906
86412,5,0,507,636330,5,636325
86413,9,11,698,983277,9,983268
86414,9,18,231,1191835,9,1191826
86415,19,-15,345,180307,19,180288
86416,9,-17,284,99596,9,99587
86417,10,-19,355,39226,10,39216
86418,9,8,820,893038,9,893029
86419,20,-1,630,621448,20,621428
86420,10,-6,431,445975,10,445965
86421,18,-4,285,524281,18,524263
86422,10,18,249,1192279,10,1192269
86423,19,15,683,1121801,19,1121782
86424,9,-12,519,260889,9,260880
86425,5,-16,63,125186,5,125181
86426,15,5,441,806970,15,806955
86427,10,18,237,1192013,10,1192003
86428,6,11,456,978151,6,978145
86429,20,6,390,838858,20,838838
86430,5,-10,261,318259,5,318254
86431,16,-9,413,369786,16,369770
86432,11,5,75,804349,11,804338
86433,15,-13,444,244255,15,244240
86434,17,13,993,1060573,17,1060556
86435,19,14,713,1091102,19,1091083
86436,6,-12,454,259357,6,259351
86437,15,-14,669,214762,15,214747
86438,9,11,207,972624,9,972615
86439,17,5,60,804270,17,804253
86440,20,17,424,1181070,20,1181050
86441,15,18,195,1210600,15,1210585
86442,11,-19,700,59436,11,59425
86443,20,5,982,811009,20,810989
86444,20,-11,481,307578,20,307558
86445,11,-5,399,493954,11,493943
86446,11,16,448,1150373,11,1150362
86447,5,10,502,948189,5,948184
86448,19,12,892,1028790,19,1028771
86449,13,8,306,900385,13,900372
86450,11,9,781,934828,11,934817
86451,16,10,949,967121,16,967105
86452,5,5,153,784730,5,784725
86453,5,8,921,895174,5,895169
86454,10,-18,908,82182,10,82172
86455,13,-5,565,495196,13,495183
86456,19,-3,83,554358,19,554339
86457,5,18,806,1203810,5,1203805
86458,14,2,497,714384,14,714370
86459,11,10,906,966762,11,966751
86460,14,12,316,1024451,14,1024437
86461,9,3,205,723290,9,723281
86462,13,17,606,1182370,13,1182357
86463,14,-16,504,150737,14,150723
86464,17,1,558,684300,17,684283
86465,17,6,465,839511,17,839494
86466,12,-13,622,245668,12,245656
86467,7,16,894,1143668,7,1143661
86468,19,18,147,1210193,19,1210174
86469,9,1,726,672793,9,672784
86470,8,8,427,884551,8,884543
86471,6,15,209,1098931,6,1098925
86472,11,-19,573,58545,11,58534
86473,14,-5,937,497923,14,497909
86474,18,17,31,1178112,18,1178094
86475,13,15,508,1120446,13,1120433
86476,16,-3,470,557401,16,557385
86477,12,-19,953,61166,12,61154
86478,12,-9,634,371556,12,371544
86479,9,-11,966,301960,9,301951
86480,8,-19,875,50600,8,50592
86481,6,-1,555,606078,6,606072
86482,19,0,222,649924,19,649905
86483,19,2,599,715071,19,715052
86484,13,2,981,717749,13,717736
86485,12,-14,409,212759,12,212747
86486,12,-1,488,620475,12,620463
86487,19,17,88,1178499,19,1178480
86488,9,-14,568,198980,9,198971
86489,20,3,199,743419,20,743399
86490,12,-18,313,87691,12,87679
86491,17,18,850,1215167,17,1215150
86492,20,-9,766,372600,20,372580
86493,17,0,13,648287,17,648270
86494,12,17,965,1185175,12,1185163
86495,20,6,96,836477,20,836457
86496,7,-20,250,5586,7,5579
86497,18,-8,547,401732,18,401714
86498,13,8,770,904064,13,904051
86499,14,-2,955,592416,14,592402
86500,13,4,379,775975,13,775962
86501,5,-12,756,265920,5,265915
86502,17,10,580,964359,17,964342
86503,17,-2,584,589528,17,589511
86504,15,-12,24,272692,15,272677
86505,8,-3,908,550790,8,550782
86506,8,-10,311,319330,8,319322
86507,13,15,612,1121263,13,1121250
86508,12,18,81,1209570,12,1209558
86509,13,-12,805,278398,13,278385
86510,17,-6,767,464974,17,464957
86511,12,12,573,1026237,12,1026225
86512,8,10,976,958405,8,958397
86513,9,-5,202,472399,9,472390
86514,15,13,655,1058199,15,1058184
86515,18,-1,569,621038,18,621020
86516,7,16,859,1142951,7,1142944
86517,12,-15,953,185070,12,185058
86518,7,5,18,781995,7,781988
86519,8,16,330,1132177,8,1132169
86520,9,18,500,1197393,9,1197384
86521,20,13,958,1060370,20,1060350
86522,7,-11,269,286963,7,286956
86523,6,-13,361,225936,6,225930
86524,6,-14,604,199928,6,199922
86525,13,-6,240,461059,13,461046
86526,7,13,21,1031267,7,1031260
86527,9,-2,71,564377,9,564368
86528,5,-18,174,66341,5,66336
86529,6,-12,512,260745,6,260739
86530,7,17,642,1169055,7,1169048
86531,15,-7,230,430011,15,429996
86532,12,-11,540,308092,12,308080
86533,18,-8,785,403484,18,403466
86534,16,10,874,966531,16,966515
86535,8,-12,795,266654,8,266646
86536,8,12,429,1008292,8,1008284
86537,6,-10,81,314442,6,314436
86538,11,-5,789,496721,11,496710
86539,15,15,103,1117573,15,1117558
86540,18,16,14,1147197,18,1147179
86541,15,-2,39,585422,15,585407
86542,17,6,90,836429,17,836412
86543,17,16,660,1151851,17,1151834
86544,10,9,681,921086,10,921076
86545,19,-5,210,492527,19,492508
86546,17,0,993,655900,17,655883
86547,17,1,561,684335,17,684318
86548,8,-6,563,448965,8,448957
86549,9,13,450,1040439,9,1040430
86550,18,11,652,995481,18,995463
86551,9,12,580,1011513,9,1011504
86552,6,18,797,1203646,6,1203640
86553,8,-18,506,73346,8,73338
86554,11,-9,546,371046,11,371035
86555,10,5,387,789644,10,789634
86556,18,0,487,651879,18,651861
86557,18,-16,75,147422,18,147404
86558,15,14,159,1086742,15,1086727
86559,16,19,432,1244416,16,1244400
86560,14,13,973,1060444,14,1060430
86561,9,-14,665,201287,9,201278
86562,8,15,34,1095203,8,1095195
86563,6,2,683,703024,6,703018
86564,20,-5,21,490969,20,490949
86565,8,3,15,719179,8,719171
86566,13,7,994,874066,13,874053
86567,6,10,384,945684,6,945678
86568,12,-10,551,339174,12,339162
86569,6,14,483,1072594,6,1072588
86570,13,13,264,1055148,13,1055135
86571,16,11,742,996170,16,996154
86572,5,-3,500,541696,5,541691
86573,17,9,954,936192,17,936175
86574,9,19,218,1222366,9,1222357
86575,14,-10,946,342203,14,342189
86576,18,-10,963,342320,18,342302
86577,7,-11,443,291034,7,291027
86578,6,17,568,1167377,6,1167371
86579,15,-16,277,149027,15,149012
86580,8,-14,269,192668,8,192660
86581,14,19,102,1241587,14,1241573
86582,15,5,842,809912,15,809897
86583,9,-4,357,507404,9,507395
86584,20,12,908,1029005,20,1028985
86585,17,-20,152,23922,17,23905
86586,20,9,590,933453,20,933433
86587,7,-17,76,95013,7,95006
86588,19,-4,342,524758,19,524739
86589,9,9,101,908912,9,908903
86590,10,9,718,921896,10,921886
86591,15,-11,863,310490,15,310475
86592,11,19,115,1241731,11,1241720
86593,8,-19,992,52685,8,52677
86594,19,-20,834,29271,19,29252
86595,20,-5,568,495228,20,495208
86596,12,-8,973,404827,12,404815
86597,18,-7,971,435507,18,435489
86598,15,8,156,899202,15,899187
86599,9,-15,33,156046,9,156037
86600,12,-9,530,370914,12,370902
86601,20,-13,587,245379,20,245359
86602,17,14,246,1087366,17,1087349
86603,11,-11,396,306896,11,306885
86604,7,18,257,1192480,7,1192473
86605,18,1,843,686386,18,686368
86606,10,8,506,886364,10,886354
86607,19,-2,781,591018,19,590999
86608,20,19,712,1246540,20,1246520
86609,19,-10,902,341869,19,341850
86610,9,5,820,798783,9,798774
86611,17,13,577,1057643,17,1057626
86612,13,11,241,992576,13,992563
86613,16,11,394,993768,16,993752
86614,10,1,129,660033,10,660023
86615,8,15,22,1094955,8,1094947
86616,10,-19,650,45822,10,45812
86617,9,-16,655,138190,9,138181
86618,20,-7,97,428969,20,428949
86619,15,5,362,806431,15,806416
86620,13,-12,704,277682,13,277669
86621,6,-5,979,489363,6,489357
86622,10,11,213,972723,10,972713
86623,11,-3,751,559779,11,559768
86624,13,-19,102,54733,13,54720
86625,9,16,470,1135254,9,1135245
86626,6,-7,97,407933,6,407927
86627,15,11,977,997884,15,997869
86628,20,1,639,684896,20,684876
86629,19,17,678,1182907,19,1182888
86630,17,1,261,681992,17,681975
86631,19,8,29,898096,19,898077
86632,17,-16,303,149182,17,149165
86633,5,0,467,635545,5,635540
86634,12,-10,95,335844,12,335832
86635,11,4,741,778711,11,778700
86636,17,11,368,993562,17,993545
86637,11,0,288,650232,11,650221
86638,16,18,194,1210590,16,1210574
86639,15,-13,151,242128,15,242113
86640,6,-4,84,501198,6,501192
86641,12,2,920,717324,12,717312
86642,17,-18,804,91123,17,91106
86643,12,-8,121,398729,12,398717
86644,14,1,544,684211,14,684197
86645,11,13,893,1059909,11,1059898
86646,19,11,706,995861,19,995842
86647,17,13,867,1059730,17,1059713
86648,11,-14,108,210163,11,210152
86649,10,9,370,914552,10,914542
86650,9,-4,984,520652,9,520643
86651,12,7,256,868886,12,868874
86652,5,15,198,1098721,5,1098716
86653,11,-20,774,28783,11,28772
86654,9,-1,109,596170,9,596161
86655,12,-3,558,558186,12,558174
86656,16,3,225,743562,16,743546
86657,16,-7,670,433139,16,433123
86658,12,0,267,650152,12,650140
86659,8,-15,797,172390,8,172382
86660,20,8,19,898065,20,898045
86661,13,-18,624,89766,13,89753
86662,9,-14,852,205081,9,205072
86663,15,-3,524,557962,15,557947
86664,9,4,264,756307,9,756298
86665,6,-10,220,317464,6,317458
86666,17,-18,124,86174,17,86157
86667,14,12,426,1025169,14,1025155
86668,19,-4,180,523460,19,523441
86669,6,-14,328,193878,6,193872
86670,17,5,962,810922,17,810905
86671,12,9,808,935027,12,935015
86672,13,16,503,1150674,13,1150661
86673,13,-9,312,368899,13,368886
86674,7,11,747,984399,7,984392
86675,5,-4,786,516217,5,516212
86676,12,13,305,1055446,12,1055434
86677,7,5,979,802316,7,802309
86678,8,9,181,910586,8,910578
86679,9,-15,923,175070,9,175061
86680,15,-15,667,182744,15,182729
86681,8,2,335,695847,8,695839
86682,14,-15,478,181323,14,181309
86683,11,-8,291,399943,11,399932
86684,16,7,803,872805,16,872789
86685,10,-1,803,611134,10,611124
86686,20,6,175,837062,20,837042
86687,16,-18,115,86083,16,86067
86688,14,4,850,779648,14,779634
86689,7,12,358,1006957,7,1006950
86690,12,-9,6,366673,12,366661
86691,8,-2,690,577576,8,577568
86692,14,12,557,1026129,14,1026115
86693,9,-20,661,14564,9,14555
86694,8,8,991,896763,8,896755
86695,14,1,291,682150,14,682136
86696,10,5,491,791846,10,791836
86697,17,2,630,715328,17,715311
86698,10,-18,921,82440,10,82430
86699,5,8,668,889828,5,889823
86700,19,3,475,745388,19,745369
86701,5,-2,504,573520,5,573515
86702,20,6,293,838027,20,838007
86703,15,-11,492,307666,15,307651
86704,9,-13,146,221473,9,221464
86705,10,12,76,1000748,10,1000738
86706,9,-8,444,384478,9,384469
86707,12,2,481,714263,12,714251
86708,16,-19,17,54018,16,54002
86709,7,-5,626,481583,7,481576
86710,20,-12,795,278313,20,278293
86711,9,-20,54,1123,9,1114
86712,7,7,467,854802,7,854795
86713,14,-5,838,497103,14,497089
86714,11,-18,735,90627,11,90616
86715,10,8,947,895807,10,895797
86716,17,-10,402,337958,17,337941
86717,14,-12,445,275718,14,275704
86718,13,4,890,779851,13,779838
86719,5,-9,231,348564,5,348559
86720,9,13,869,1049449,9,1049440
86721,6,-1,24,594213,6,594207
86722,11,14,954,1092907,11,1092896
86723,13,-11,935,310986,13,310973
86724,8,12,300,1005785,8,1005777
86725,7,1,36,657867,7,657860
86726,16,-20,190,24328,16,24312
86727,15,1,125,680822,15,680807
86728,17,-6,29,459396,17,459379
86729,20,0,676,653438,20,653418
86730,6,12,254,1004745,6,1004739
86731,17,-15,497,181440,17,181423
86732,13,-5,968,498183,13,498170
86733,6,9,876,925297,6,925291
86734,14,-6,820,465410,14,465396
86735,20,18,183,1210471,20,1210451
86736,20,-18,557,89323,20,89303
86737,8,-16,180,127914,8,127906
86738,12,-5,140,492008,12,491996
86739,14,-11,375,306763,14,306749
86740,12,5,632,808420,12,808408
86741,19,-15,222,179346,19,179327
86742,12,-18,959,92202,12,92190
86743,18,11,14,990971,18,990953
86744,12,-9,133,367541,12,367529
86745,5,11,240,973329,5,973324
86746,17,-16,811,152870,17,152853
86747,11,-3,518,557803,11,557792
86748,12,5,523,807621,12,807609
86749,7,4,934,771057,7,771050
86750,13,-12,253,274364,13,274351
86751,15,1,661,685080,15,685065
86752,5,-20,415,8916,5,8911
86753,16,-1,60,617009,16,616993
86754,6,4,643,764560,6,764554
86755,11,16,4,1147122,11,1147111
86756,16,-16,361,149548,16,149532
86757,16,0,806,654457,16,654441
86758,11,-7,136,429278,11,429267
86759,9,-8,894,394467,9,394458
86760,6,-19,949,51937,6,51931
86761,15,18,76,1209546,15,1209531
86762,15,15,625,1121370,15,1121355
86763,15,-20,745,28530,15,28515
86764,18,12,211,1023628,18,1023610
86765,10,19,620,1231407,10,1231397
86766,14,-16,999,154308,14,154294
86767,6,-14,569,199010,6,199004
86768,18,2,75,711145,18,711127
86769,18,2,392,713581,18,713563
86770,9,-20,351,7745,9,7736
86771,5,-9,16,344024,5,344019
86772,13,10,864,966466,13,966453
86773,5,-20,195,4593,5,4588
86774,5,-12,724,265096,5,265091
86775,11,12,20,1022245,11,1022234
86776,17,1,554,684268,17,684251
86777,16,16,295,1149265,16,1149249
86778,20,17,159,1179061,20,1179041
86779,6,-11,225,285950,6,285944
86780,5,-17,283,99578,5,99573
86781,16,-11,204,305342,16,305326
86782,17,10,320,962272,17,962255
86783,8,13,931,1050662,8,1050654
86784,18,-2,327,587566,18,587548
86785,18,-9,244,368370,18,368352
86786,8,-3,441,540284,8,540276
86787,15,6,393,838898,15,838883
86788,5,-8,638,389051,5,389046
86789,17,6,583,840499,17,840482
86790,7,-9,449,353569,7,353562
86791,20,-6,412,462300,20,462280
86792,16,-5,524,494931,16,494915
86793,20,11,321,993216,20,993196
86794,5,0,858,643951,5,643946
86795,13,4,25,773451,13,773438
86796,8,16,182,1129055,8,1129047
86797,9,10,484,947824,9,947815
86798,13,18,623,1213407,13,1213394
86799,14,-14,720,215133,14,215119
86800,10,11,380,976593,10,976583
86801,7,-16,248,129456,7,129449
86802,16,-11,471,307520,16,307504
86803,17,-14,738,215243,17,215226
86804,15,-3,88,554391,15,554376
86805,12,6,980,843587,12,843575
86806,6,-9,970,365152,6,365146
86807,13,-6,806,465316,13,465303
86808,18,4,433,776389,18,776371
86809,15,-14,439,212921,15,212906
86810,8,-16,184,128020,8,128012
86811,7,2,974,709023,7,709016
86812,10,-17,975,114031,10,114021
86813,20,4,987,780493,20,780473
86814,19,-12,410,275532,19,275513
86815,16,-15,447,181074,16,181058
86816,9,12,828,1017078,9,1017069
86817,5,-17,272,99280,5,99275
86818,19,-13,472,244469,19,244450
86819,8,15,766,1110717,8,1110709
86820,20,-7,167,429563,20,429543
86821,6,-12,991,271229,6,271223
86822,11,-15,244,179527,11,179516
86823,10,-19,575,44200,10,44190
86824,6,6,591,825647,6,825641
86825,10,-9,535,355798,10,355788
86826,14,-1,877,623289,14,623275
86827,16,-15,223,179354,16,179338
86828,7,-10,487,323266,7,323259
86829,16,6,660,841074,16,841058
86830,12,8,634,903015,12,903003
86831,10,-9,357,351472,10,351462
86832,5,-12,555,261596,5,261591
86833,15,4,819,779287,15,779272
86834,13,-6,375,462038,13,462025
86835,15,-12,19,272643,15,272628
86836,12,13,231,1054932,12,1054920
86837,15,16,93,1147728,15,1147713
86838,5,10,646,951539,5,951534
86839,10,2,236,693634,10,693624
86840,8,-11,894,300302,8,300294
86841,10,1,477,667708,10,667698
86842,5,-14,887,205773,5,205768
86843,12,11,111,991646,12,991634
86844,11,-12,930,279508,11,279497
86845,16,-12,647,277265,16,277249
86846,10,-12,463,259621,10,259611
86847,13,11,11,990953,13,990940
86848,13,-7,689,433295,13,433282
86849,11,11,506,994521,11,994510
86850,12,8,932,905210,12,905198
86851,11,-5,845,497159,11,497148
86852,11,7,248,868818,11,868807
86853,16,2,55,710929,16,710913
86854,8,13,906,1050132,8,1050124
86855,9,17,579,1167587,9,1167578
86856,19,-10,381,337806,19,337787
86857,16,14,396,1088532,16,1088516
86858,9,-11,131,283957,9,283948
86859,16,14,955,1092923,16,1092907
86860,18,-15,696,182912,18,182894
86861,12,-4,973,529434,12,529422
86862,9,10,976,958414,9,958405
86863,5,-10,671,327255,5,327250
86864,20,-15,830,184038,20,184018
86865,8,10,243,942591,8,942583
86866,14,-9,22,366767,14,366753
86867,15,7,303,869207,15,869192
86868,14,18,818,1214877,14,1214863
86869,13,-11,899,310758,13,310745
86870,10,-10,705,327854,10,327844
86871,19,8,242,899949,19,899930
86872,9,3,992,740610,9,740601
86873,16,-19,876,60725,16,60709
86874,14,18,891,1215507,14,1215493
86875,16,4,899,779904,16,779888
86876,16,-1,853,623082,16,623066
86877,16,10,800,966122,16,966106
86878,10,-3,43,531467,10,531457
86879,9,-11,630,295094,9,295085
86880,5,-5,618,481395,5,481390
86881,10,14,379,1070194,10,1070184
86882,14,12,637,1026768,14,1026754
86883,6,14,861,1081131,6,1081125
86884,19,14,539,1089668,19,1089649
86885,20,2,691,715843,20,715823
86886,7,-4,163,502945,7,502938
86887,18,-15,971,185153,18,185135
86888,7,10,698,952597,7,952590
86889,14,-10,464,338503,14,338489
86890,9,17,660,1169478,9,1169469
86891,13,-14,231,211246,13,211233
86892,10,-11,89,282987,10,282977
86893,16,12,667,1027053,16,1027037
86894,14,-2,831,591460,14,591446
86895,11,14,305,1087820,11,1087809
86896,19,-5,875,497456,19,497437
86897,7,-6,799,454044,7,454037
86898,9,13,692,1045627,9,1045618
86899,8,9,758,922625,8,922617
86900,13,11,813,996758,13,996745
86901,12,-1,966,623884,12,623872
86902,10,-20,798,17690,10,17680
86903,18,19,306,1243244,18,1243226
86904,15,-1,45,616915,15,616900
86905,7,-8,868,393866,7,393859
86906,5,16,454,1134990,5,1134985
86907,13,19,312,1243300,13,1243287
86908,7,-9,895,363713,7,363706
86909,7,-4,467,509524,7,509517
86910,16,1,914,686987,16,686971
86911,12,8,412,901271,12,901259
86912,11,-9,131,367533,11,367522
86913,11,12,593,1026402,11,1026391
86914,20,-13,967,248347,20,248327
86915,7,-5,543,479767,7,479760
86916,9,-16,827,141787,9,141778
86917,16,-16,572,151232,16,151216
86918,9,15,623,1107712,9,1107703
86919,8,6,296,818931,8,818923
86920,18,9,311,931286,18,931268
86921,11,-2,914,592106,11,592095
86922,13,-13,84,241646,13,241633
86923,19,7,201,868429,19,868410
86924,14,3,419,745026,14,745012
86925,13,7,274,868979,13,868966
86926,5,18,641,1200330,5,1200325
86927,8,6,271,818327,8,818319
86928,13,9,392,931871,13,931858
86929,5,6,34,812968,5,812963
86930,11,-15,395,180655,11,180644
86931,18,6,316,838215,18,838197
86932,9,19,141,1220582,9,1220573
86933,14,9,158,930245,14,930231
86934,12,4,833,779446,12,779434
86935,12,-7,316,430754,12,430742
86936,9,-9,386,352102,9,352093
86937,18,7,438,870300,18,870282
86938,5,7,619,857908,5,857903
86939,9,-8,216,380122,9,380113
86940,14,-20,322,25337,14,25323
86941,6,2,867,706641,6,706635
86942,13,-9,277,368611,13,368598
86943,16,11,31,991121,16,991105
86944,12,-20,675,27990,12,27978
86945,16,5,417,806792,16,806776
86946,14,-8,221,399499,14,399485
86947,8,-14,850,205028,8,205020
86948,9,-12,938,269997,9,269988
86949,7,19,364,1225731,7,1225724
86950,8,-4,912,519021,8,519013
86951,12,17,813,1184058,12,1184046
86952,14,-14,131,210326,14,210312
86953,9,13,411,1039674,9,1039665
86954,13,3,904,748632,13,748619
86955,14,6,872,842729,14,842715
86956,11,-15,398,180671,11,180660
86957,7,11,902,987947,7,987940
86958,20,11,659,995534,20,995514
86959,9,-9,944,364779,9,364770
86960,18,-2,971,592521,18,592503
86961,18,12,883,1028725,18,1028707
86962,12,-8,839,403851,12,403839
86963,18,3,190,743326,18,743308
86964,13,3,956,749162,13,749149
86965,11,17,44,1178223,11,1178212
86966,20,15,715,1122103,20,1122083
86967,20,-6,891,465875,20,465855
86968,13,-10,541,339116,13,339103
86969,7,-14,858,205209,7,205202
86970,15,-10,638,339879,15,339864
86971,17,19,892,1248015,17,1247998
86972,18,-7,820,434272,18,434254
86973,10,1,254,662767,10,662757
86974,6,-19,789,48752,6,48746
86975,18,13,922,1060072,18,1060054
86976,7,19,263,1223261,7,1223254
86977,14,9,281,931000,14,930986
86978,15,8,405,901220,15,901205
86979,6,10,83,939320,6,939314
86980,17,8,899,904971,17,904954
86981,7,-12,474,259858,7,259851
86982,9,-13,914,238139,9,238130
86983,17,-12,879,279073,17,279056
86984,11,-16,946,153876,11,153865
86985,8,17,50,1156464,8,1156456
86986,17,-11,15,303801,17,303784
86987,17,13,348,1055794,17,1055777
86988,10,6,751,829201,10,829191
86989,13,-12,273,274550,13,274537
86990,15,2,383,713480,15,713465
86991,12,-17,80,116148,12,116136
86992,9,0,127,628294,9,628285
86993,12,6,63,836238,12,836226
86994,11,6,636,840916,11,840905
86995,17,6,830,842460,17,842443
86996,15,-1,283,618794,15,618779
86997,17,17,780,1183701,17,1183684
86998,10,-2,287,568955,10,568945
86999,16,11,593,995161,16,995145
87000,9,15,191,1098566,9,1098557
87001,5,8,766,892062,5,892057
87002,19,1,476,683619,19,683600
87003,17,-14,774,215583,17,215566
87004,9,10,50,938625,9,938616
87005,14,-11,511,307830,14,307816
87006,19,-16,626,151653,19,151634
87007,7,8,472,885471,7,885464
87008,13,17,428,1181114,13,1181101
87009,15,3,672,746935,15,746920
87010,16,11,715,995966,16,995950
87011,6,8,984,896612,6,896606
87012,13,19,665,1246159,13,1246146
87013,12,-4,450,525514,12,525502
87014,9,-18,666,76707,9,76698
87015,8,12,424,1008142,8,1008134
87016,19,0,482,651796,19,651777
87017,12,-3,565,558265,12,558253
87018,20,-16,47,147138,20,147118
87019,11,6,118,836678,11,836667
87020,5,10,581,950020,5,950015
87021,17,-18,156,86462,17,86445
87022,8,18,748,1202471,8,1202463
87023,12,18,406,1212046,12,1212034
87024,16,3,844,748187,16,748171
87025,16,13,317,1055517,16,1055501
87026,20,-20,477,26363,20,26343
87027,8,-6,83,438473,8,438465
87028,20,0,92,648942,20,648922
87029,19,2,365,713355,19,713336
87030,20,5,217,805473,20,805453
87031,5,-19,710,47133,5,47128
87032,13,2,240,712376,13,712363
87033,14,-19,706,59497,14,59483
87034,16,-12,533,276501,16,276485
87035,7,-3,98,532511,7,532504
87036,16,5,848,809938,16,809922
87037,20,15,334,1119238,20,1119218
87038,11,16,378,1149865,11,1149854
87039,5,2,31,689297,5,689292
87040,7,4,718,766132,7,766125
87041,11,17,418,1181037,11,1181026
87042,19,5,596,808150,19,808131
87043,12,14,114,1086373,12,1086361
87044,10,-15,849,173519,10,173509
87045,15,-3,499,557644,15,557629
87046,8,11,701,983379,8,983371
87047,7,13,120,1033338,7,1033331
87048,6,-10,290,318802,6,318796
87049,10,-13,638,231968,10,231958
87050,5,11,603,981393,5,981388
87051,5,14,972,1083544,5,1083539
87052,8,0,440,634848,8,634840
87053,16,-6,750,464894,16,464878
87054,19,10,527,963918,19,963899
87055,6,18,425,1195832,6,1195826
87056,14,-13,600,245466,14,245452
87057,19,15,23,1116955,19,1116936
87058,20,-4,630,526861,20,526841
87059,14,2,804,716467,14,716453
87060,12,13,301,1055417,12,1055405
87061,5,-15,579,167942,5,167937
87062,8,-4,202,503913,8,503905
87063,11,6,794,842118,11,842107
87064,7,-2,782,579443,7,579436
87065,14,-6,467,462741,14,462727
87066,19,-3,245,555482,19,555463
87067,16,-18,733,90592,16,90576
87068,19,14,244,1087336,19,1087317
87069,19,-2,753,590757,19,590738
87070,7,3,735,734808,7,734801
87071,11,-7,759,433822,11,433811
87072,15,-10,68,335693,15,335678
87073,6,8,1000,896913,6,896907
87074,13,-8,478,401158,13,401145
87075,13,15,323,1119147,13,1119134
87076,14,-6,807,465319,14,465305
87077,14,4,946,780219,14,780205
87078,5,15,692,1109151,5,1109146
87079,16,3,330,744401,16,744385
87080,17,9,405,931998,17,931981
87081,8,-5,106,470462,8,470454
87082,16,4,303,775382,16,775366
87083,17,-7,287,430495,17,430478
87084,17,-2,566,589392,17,589375
87085,9,6,766,829532,9,829523
87086,9,-14,728,202574,9,202565
87087,20,-7,207,429859,20,429839
87088,8,6,85,813995,8,813987
87089,9,9,251,911995,9,911986
87090,10,-14,472,196920,10,196910
87091,14,-6,769,465005,14,464991
87092,13,-9,742,372321,13,372308
87093,14,7,999,874121,14,874107
87094,15,6,572,840408,15,840393
87095,20,10,6,959871,20,959851
87096,13,7,289,869105,13,869092
87097,13,-9,66,367128,13,367115
87098,18,12,999,1029815,18,1029797
87099,12,-4,818,528098,12,528086
87100,19,-18,799,91066,19,91047
87101,6,12,662,1013540,6,1013534
87102,6,16,353,1132684,6,1132678
87103,17,9,762,934597,17,934580
87104,14,18,618,1213372,14,1213358
87105,19,-4,840,528211,19,528192
87106,14,16,531,1150872,14,1150858
87107,20,7,580,871305,20,871285
87108,7,-15,799,172418,7,172411
87109,11,-11,822,310124,11,310113
87110,13,6,333,838351,13,838338
87111,14,16,706,1152136,14,1152122
87112,15,8,801,904288,15,904273
87113,11,0,995,655909,11,655898
87114,13,1,170,681216,13,681203
87115,14,12,418,1025087,14,1025073
87116,8,-11,27,281633,8,281625
87117,11,-1,201,618066,11,618055
87118,19,0,646,653155,19,653136
87119,7,-8,842,393313,7,393306
87120,19,-17,871,121946,19,121927
87121,16,11,963,997749,16,997733
87122,12,11,544,994769,12,994757
87123,20,-2,514,589019,20,588999
87124,19,-19,519,57995,19,57976
87125,15,3,538,745767,15,745752
87126,13,11,403,993854,13,993841
87127,11,-5,444,494290,11,494279
87128,17,-11,417,307066,17,307049
87129,17,15,554,1120801,17,1120784
87130,18,8,976,905548,18,905530
87131,15,-10,341,337532,15,337517
87132,6,-8,321,382271,6,382265
87133,17,9,161,930273,17,930256
87134,15,-18,473,88815,15,88800
87135,19,-11,722,309369,19,309350
87136,7,-18,660,76601,7,76594
87137,11,-18,519,89079,11,89068
87138,9,-3,24,531089,9,531080
87139,12,-13,530,244952,12,244940
87140,7,-5,368,476196,7,476189
87141,12,10,987,967363,12,967351
87142,10,-3,564,543201,10,543191
87143,10,4,104,752901,10,752891
87144,19,-17,97,116318,19,116299
87145,19,13,578,1057670,19,1057651
87146,19,8,143,899070,19,899051
87147,20,-2,187,586465,20,586445
87148,9,-18,216,67092,9,67083
87149,19,11,41,991151,19,991132
87150,8,19,143,1220646,8,1220638
87151,7,19,452,1227918,7,1227911
87152,11,-12,294,274696,11,274685
87153,18,-6,97,459804,18,459786
87154,19,16,819,1152991,19,1152972
87155,14,-7,571,432597,14,432583
87156,8,4,719,766177,8,766169
87157,20,2,66,711054,20,711034
87158,14,-18,147,86368,14,86354
87159,20,7,726,872288,20,872268
87160,8,2,950,708459,8,708451
87161,6,7,912,864138,6,864132
87162,13,-14,918,216677,13,216664
87163,7,16,498,1135784,7,1135777
87164,18,14,838,1092009,18,1091991
87165,17,16,4,1147129,17,1147112
87166,18,-19,495,57795,18,57777
87167,7,3,965,739924,7,739917
87168,16,-10,553,339204,16,339188
87169,9,-17,280,99506,9,99497
87170,13,12,461,1025441,13,1025428
87171,17,11,294,993064,17,993047
87172,7,-12,274,255479,7,255472
87173,5,5,66,783061,5,783056
87174,7,-15,733,171165,7,171158
87175,8,15,217,1099128,8,1099120
87176,17,7,134,868024,17,868007
87177,17,18,451,1212332,17,1212315
87178,18,-12,78,273108,18,273090
87179,8,-11,970,302052,8,302044
87180,13,-17,9,115633,13,115620
87181,9,-7,7,406144,9,406135
87182,13,-15,877,184410,13,184397
87183,15,18,279,1211185,15,1211170
87184,9,15,425,1103417,9,1103408
87185,11,4,903,779942,11,779931
87186,5,-8,215,380084,5,380079
87187,20,-2,16,585252,20,585232
87188,5,14,943,1082972,5,1082967
87189,10,9,572,918836,10,918826
87190,15,5,678,808722,15,808707
87191,10,11,762,984814,10,984804
87192,6,-2,842,580819,6,580813
87193,11,-5,153,492142,11,492131
87194,11,-12,375,275304,11,275293
87195,11,1,65,680261,11,680250
87196,12,-9,698,371962,12,371950
87197,12,12,830,1028246,12,1028234
87198,14,-8,547,401736,14,401722
87199,12,3,330,744403,12,744391
87200,18,-7,463,431817,18,431799
87201,12,-12,935,279553,12,279541
87202,5,3,287,725163,5,725158
87203,14,5,65,804301,14,804287
87204,14,-18,920,91889,14,91875
87205,16,-3,660,559052,16,559036
87206,10,-6,910,456257,10,456247
87207,5,-13,673,232486,5,232481
87208,10,17,304,1161915,10,1161905
87209,16,8,620,902846,16,902830
87210,14,-11,50,304023,14,304009
87211,20,-4,760,527702,20,527682
87212,17,-16,543,150999,17,150982
87213,14,5,831,809844,14,809830
87214,9,7,405,853542,9,853533
87215,15,13,832,1059476,15,1059461
87216,15,-14,396,212652,15,212637
87217,15,19,386,1243926,15,1243911
87218,6,-7,958,426331,6,426325
87219,20,17,655,1182735,20,1182715
87220,13,-4,201,523650,13,523637
87221,17,18,602,1213237,17,1213220
87222,5,-12,72,251177,5,251172
87223,7,-4,882,518372,7,518365
87224,11,-13,3,241074,11,241063
87225,18,-13,485,244570,18,244552
87226,19,1,208,681529,19,681510
87227,12,-20,499,26559,12,26547
87228,20,7,804,872823,20,872803
87229,19,-15,935,184885,19,184866
87230,6,12,286,1005530,6,1005524
87231,10,14,656,1076682,10,1076672
87232,11,-7,950,435363,11,435352
87233,19,11,767,996409,19,996390
87234,6,15,925,1114156,6,1114150
87235,13,11,963,997752,13,997739
87236,19,-7,153,429427,19,429408
87237,20,6,479,839631,20,839611
87238,7,-11,799,298265,7,298258
87239,19,18,43,1209218,19,1209199
87240,16,6,504,839869,16,839853
87241,17,14,799,1091703,17,1091686
87242,13,-6,295,461479,13,461466
87243,10,-8,940,395457,10,395447
87244,9,11,45,969427,9,969418
87245,16,13,537,1057249,16,1057233
87246,20,-12,353,275175,20,275155
87247,6,3,546,730309,6,730303
87248,13,-2,829,591450,13,591437
87249,19,-19,227,55836,19,55817
87250,5,0,16,625568,5,625563
87251,6,5,769,797720,6,797714
87252,20,-4,965,529362,20,529342
87253,19,1,900,686837,19,686818
87254,10,5,24,782110,10,782100
87255,14,-15,373,180526,14,180512
87256,13,2,953,717598,13,717585
87257,10,-4,209,504116,10,504106
87258,18,19,23,1240900,18,1240882
87259,6,-14,214,191309,6,191303
87260,14,0,711,653725,14,653711
87261,18,12,668,1027068,18,1027050
87262,15,13,652,1058173,15,1058158
87263,8,6,814,830707,8,830699
87264,6,-5,869,486923,6,486917
87265,6,-19,559,43668,6,43662
87266,14,7,415,870119,14,870105
87267,17,9,159,930251,17,930234
87268,18,5,893,810268,18,810250
87269,15,13,794,1059202,15,1059187
87270,11,-6,374,462035,11,462024
87271,20,-16,50,147164,20,147144
87272,16,7,517,870890,16,870874
87273,9,2,701,703463,9,703454
87274,9,12,777,1015948,9,1015939
87275,12,14,445,1088922,12,1088910
87276,10,6,432,822125,10,822115
87277,18,8,777,904134,18,904116
87278,10,6,721,828623,10,828613
87279,14,-14,385,212568,14,212554
87280,19,17,665,1182829,19,1182810
87281,6,2,694,703282,6,703276
87282,10,16,330,1132187,10,1132177
87283,16,-18,813,91177,16,91161
87284,14,14,231,1087233,14,1087219
87285,11,-6,680,464303,11,464292
87286,5,-18,423,71502,5,71497
87287,9,-9,695,358924,9,358915
87288,15,13,613,1057924,15,1057909
87289,10,9,787,923379,10,923369
87290,11,0,578,652636,11,652625
87291,6,-5,689,482948,6,482942
87292,6,-8,967,396040,6,396034
87293,15,9,848,935366,15,935351
87294,9,18,364,1194602,9,1194593
87295,18,-20,764,28676,18,28658
87296,5,3,116,721357,5,721352
87297,8,12,227,1004091,8,1004083
87298,14,19,308,1243256,14,1243242
87299,9,11,844,986544,9,986535
87300,20,13,748,1058796,20,1058776
87301,14,9,302,931168,14,931154
87302,11,-12,974,279901,11,279890
87303,6,-13,727,233911,6,233905
87304,7,10,439,946970,7,946963
87305,20,-17,298,117753,20,117733
87306,11,-2,10,585186,11,585175
87307,5,-8,689,390273,5,390268
87308,20,-3,649,558981,20,558961
87309,20,-19,602,58745,20,58725
87310,16,11,24,991057,16,991041
87311,18,6,533,840095,18,840077
87312,13,-17,196,116912,13,116899
87313,11,-19,588,58669,11,58658
87314,16,-18,4,85238,16,85222
87315,9,-3,713,546498,9,546489
87316,13,-13,13,241150,13,241137
87317,10,12,508,1009962,10,1009952
87318,6,-9,877,363240,6,363234
87319,6,5,750,797298,6,797292
87320,14,6,792,842114,14,842100
87321,10,-6,7,437020,10,437010
87322,16,-13,901,247730,16,247714
87323,15,-1,627,621417,15,621402
87324,5,-8,913,394914,5,394909
87325,8,-1,150,597044,8,597036
87326,17,12,262,1024047,17,1024030
87327,13,-19,765,59975,13,59962
87328,7,-4,964,520160,7,520153
87329,10,5,99,783668,10,783658
87330,14,-9,597,371335,14,371321
87331,17,3,120,742750,17,742733
87332,8,0,358,632960,8,632952
87333,11,-13,719,246322,11,246311
87334,7,-15,217,159914,7,159907
87335,19,14,660,1090620,19,1090601
87336,10,18,271,1192832,10,1192822
87337,14,13,604,1057836,14,1057822
87338,15,7,984,874020,15,874005
87339,8,2,982,709192,8,709184
87340,10,-9,770,360799,10,360789
87341,12,6,256,837715,12,837703
87342,8,0,813,643083,8,643075
87343,16,-5,698,496138,16,496122
87344,19,12,491,1025683,19,1025664
87345,6,6,508,823883,6,823877
87346,20,3,596,746291,20,746271
87347,7,-17,401,101997,7,101990
87348,7,0,860,644011,7,644004
87349,13,-12,819,278531,13,278518
87350,6,-2,709,577965,6,577959
87351,20,-6,28,459390,20,459370
87352,20,-15,443,181054,20,181034
87353,11,5,241,805621,11,805610
87354,18,-19,58,54287,18,54269
87355,17,-11,949,311142,17,311125
87356,18,-2,989,592655,18,592637
87357,16,13,372,1055979,16,1055963
87358,10,-14,614,200174,10,200164
87359,7,9,468,916524,7,916517
87360,13,15,96,1117500,13,1117487
87361,7,10,607,950597,7,950590
87362,8,13,199,1035048,8,1035040
87363,8,-1,51,594912,8,594904
87364,17,14,188,1086891,17,1086874
87365,20,0,477,651736,20,651716
87366,10,0,701,640730,10,640720
87367,20,11,479,994364,20,994344
87368,7,-15,737,171287,7,171280
87369,18,2,655,715502,18,715484
87370,8,-11,342,288653,8,288645
87371,7,-6,135,439602,7,439595
87372,13,2,158,711799,13,711786
87373,9,15,490,1104837,9,1104828
87374,7,-16,461,134202,7,134195
87375,15,-7,553,432498,15,432483
87376,10,-3,128,533195,10,533185
87377,15,10,7,959891,15,959876
87378,15,-7,770,433922,15,433907
87379,9,-1,485,604671,9,604662
87380,6,-14,236,191898,6,191892
87381,16,-12,376,275309,16,275293
87382,14,3,280,744014,14,744000
87383,12,3,217,743500,12,743488
87384,14,18,168,1210305,14,1210291
87385,6,-1,680,608527,6,608521
87386,13,-15,487,181357,13,181344
87387,15,-1,15,616632,15,616617
87388,5,10,145,940750,5,940745
87389,16,-20,275,24907,16,24891
87390,19,-7,391,431312,19,431293
87391,6,4,56,751788,6,751782
87392,10,15,206,1098893,10,1098883
87393,10,16,449,1134911,10,1134901
87394,14,11,715,995970,14,995956
87395,17,14,886,1092398,17,1092381
87396,15,9,117,929909,15,929894
87397,11,-19,743,59870,11,59859
87398,17,1,224,681671,17,681654
87399,5,9,797,923694,5,923689
87400,8,-7,932,425760,8,425752
87401,12,-11,553,308173,12,308161
87402,5,-5,696,483065,5,483060
87403,18,14,611,1090162,18,1090144
87404,15,19,829,1247475,15,1247460
87405,9,10,677,952174,9,952165
87406,18,-16,201,148418,18,148400
87407,13,1,554,684271,13,684258
87408,9,-10,665,327136,9,327127
87409,11,13,437,1056513,11,1056502
87410,19,-10,893,341807,19,341788
87411,19,-18,90,85919,19,85900
87412,10,8,415,884359,10,884349
87413,7,-6,502,447675,7,447668
87414,11,4,173,774546,11,774535
87415,18,6,150,836909,18,836891
87416,15,19,643,1246011,15,1245996
87417,17,-12,545,276567,17,276550
87418,15,-1,202,618101,15,618086
87419,20,0,773,654189,20,654169
87420,6,-15,816,172878,6,172872
87421,18,6,373,838692,18,838674
87422,16,-9,755,372436,16,372420
87423,8,-18,430,71678,8,71670
87424,16,3,935,748933,16,748917
87425,20,19,257,1242807,20,1242787
87426,7,12,450,1008718,7,1008711
87427,7,16,311,1131779,7,1131772
87428,19,-5,589,495389,19,495370
87429,8,-10,982,333633,8,333625
87430,20,-16,988,154201,20,154181
87431,16,11,470,994292,16,994276
87432,12,-19,41,54171,12,54159
87433,11,-16,558,151098,11,151087
87434,15,10,757,965664,15,965649
87435,9,-1,660,608142,9,608133
87436,11,-18,390,88229,11,88218
87437,13,19,347,1243564,13,1243551
87438,7,-2,758,578946,7,578939
87439,12,-15,98,178539,12,178527
87440,18,2,336,713134,18,713116
87441,20,-20,659,27857,20,27837
87442,13,-15,449,181093,13,181080
87443,20,12,677,1027161,20,1027141
87444,16,-14,560,213843,16,213827
87445,13,6,708,841519,13,841506
87446,18,0,404,651133,18,651115
87447,14,-6,515,463155,14,463141
87448,12,17,344,1180555,12,1180543
87449,16,15,627,1121393,16,1121377
87450,8,-2,792,579646,8,579638
87451,10,-18,127,65324,10,65314
87452,12,-18,518,89073,12,89061
87453,6,0,815,643123,6,643117
87454,12,-2,177,586352,12,586340
87455,10,-11,964,301947,10,301937
87456,20,-3,416,556900,20,556880
87457,16,-2,832,591465,16,591449
87458,12,-12,442,275717,12,275705
87459,13,-4,215,523772,13,523759
87460,9,4,227,755613,9,755604
87461,10,2,851,706321,10,706311
87462,7,0,675,640107,7,640100
87463,6,4,753,767014,6,767008
87464,5,0,161,628921,5,628916
87465,16,-8,315,400112,16,400096
87466,6,3,949,739477,6,739471
87467,18,1,650,684988,18,684970
87468,7,10,45,938525,7,938518
87469,19,-18,133,86220,19,86201
87470,20,-1,370,619569,20,619549
87471,5,-16,840,141997,5,141992
87472,17,-1,913,623552,17,623535
87473,10,-10,447,322315,10,322305
87474,18,-7,445,431668,18,431650
87475,15,16,806,1152910,15,1152895
87476,11,5,801,809606,11,809595
87477,13,6,608,840665,13,840652
87478,20,7,11,867113,20,867093
87479,6,18,114,1189332,6,1189326
87480,20,6,722,841630,20,841610
87481,7,2,469,698625,7,698618
87482,14,-20,446,26189,14,26175
87483,20,3,858,748319,20,748299
87484,14,-4,705,527392,14,527378
87485,9,0,678,640203,9,640194
87486,8,13,194,1034866,8,1034858
87487,18,6,800,842171,18,842153
87488,13,-1,616,621360,13,621347
87489,9,14,200,1066167,9,1066158
87490,11,0,185,649661,11,649650
87491,8,-11,988,302504,8,302496
87492,6,2,281,694677,6,694671
87493,5,-3,695,546115,5,546110
87494,11,3,406,744932,11,744921
87495,15,-13,279,243176,15,243161
87496,20,-16,439,150253,20,150233
87497,8,10,259,942957,8,942949
87498,13,19,995,1248743,13,1248730
87499,18,-15,272,179752,18,179734
87500,18,5,953,810808,18,810790
87501,5,-12,829,267554,5,267549
87502,18,-14,507,213414,18,213396
87503,5,-4,748,515415,5,515410
87504,16,-5,579,495333,16,495317
87505,16,7,189,868379,16,868363
87506,7,-5,685,482831,7,482824
87507,15,14,12,1085469,15,1085454
87508,8,-5,759,484371,8,484363
87509,13,-7,10,428347,13,428334
87510,5,0,832,643415,5,643410
87511,13,-8,238,399594,13,399581
87512,16,9,473,932453,16,932437
87513,14,2,671,715654,14,715640
87514,16,-20,426,25981,16,25965
87515,17,-20,131,23757,17,23740
87516,11,5,940,810692,11,810681
87517,11,-3,293,555910,11,555899
87518,6,-10,53,313773,6,313767
87519,16,1,715,685394,16,685378
87520,8,-17,359,101178,8,101170
87521,17,14,969,1093030,17,1093013
87522,12,-12,786,278258,12,278246
87523,20,-7,633,432933,20,432913
87524,8,-15,226,160200,8,160192
87525,6,-12,843,267876,6,267870
87526,20,14,410,1088664,20,1088644
87527,17,18,477,1212503,17,1212486
87528,9,8,533,886935,9,886926
87529,20,-11,723,309386,20,309366
87530,10,10,217,942163,10,942153
87531,18,10,155,961058,18,961040
87532,16,5,135,804772,16,804756
87533,15,-1,298,618929,15,618914
87534,7,-8,146,378590,7,378583
87535,6,-11,709,296532,6,296526
87536,10,-7,993,427067,10,427057
87537,20,8,189,899436,20,899416
87538,20,8,662,903198,20,903178
87539,15,9,98,929796,15,929781
87540,10,0,6,625330,10,625320
87541,19,3,670,746901,19,746882
87542,8,11,532,979861,8,979853
87543,8,10,735,953343,8,953335
87544,8,16,28,1125793,8,1125785
87545,13,16,52,1147454,13,1147441
87546,17,-6,473,462773,17,462756
87547,18,-9,819,373043,18,373025
87548,8,-20,30,709,8,701
87549,5,16,392,1133555,5,1133550
87550,7,10,229,942380,7,942373
87551,16,-16,401,149831,16,149815
87552,13,9,858,935436,13,935423
87553,17,10,891,966634,17,966617
87554,17,12,290,1024265,17,1024248
87555,18,-15,926,184805,18,184787
87556,18,-18,66,85716,18,85698
87557,16,-16,524,150868,16,150852
87558,6,9,161,910213,6,910207
87559,13,3,822,748017,13,748004
87560,5,-20,915,20257,5,20252
87561,20,-20,790,28942,20,28922
87562,14,-5,295,493267,14,493253
87563,13,16,167,1148292,13,1148279
87564,19,-19,405,57160,19,57141
87565,5,4,533,762126,5,762121
87566,8,14,729,1078408,8,1078400
87567,12,14,124,1086434,12,1086422
87568,19,9,899,935728,19,935709
87569,8,-15,266,161090,8,161082
87570,18,0,324,650431,18,650413
87571,5,1,618,670712,5,670707
87572,15,3,748,747489,15,747474
87573,17,-17,596,119993,17,119976
87574,6,13,889,1049847,6,1049841
87575,12,6,273,837853,12,837841
87576,16,-12,724,277811,16,277795
87577,6,9,494,917153,6,917147
87578,16,-7,801,434109,16,434093
87579,18,-16,502,150704,18,150686
87580,5,6,525,824314,5,824309
87581,14,13,934,1060175,14,1060161
87582,13,1,897,686792,13,686779
87583,19,11,199,992257,19,992238
87584,12,-13,644,245734,12,245722
87585,11,-11,501,307757,11,307746
87586,13,2,905,717223,13,717210
87587,11,-5,948,498007,11,497996
87588,18,-2,896,591971,18,591953
87589,7,5,575,793529,7,793522
87590,15,10,545,964019,15,964004
87591,19,5,930,810618,19,810599
87592,14,15,51,1117181,14,1117167
87593,19,-10,246,336868,19,336849
87594,18,-16,527,150891,18,150873
87595,15,19,921,1248190,15,1248175
87596,11,-14,773,215577,11,215566
87597,17,-7,831,434327,17,434310
87598,9,0,896,644872,9,644863
87599,19,15,503,1120395,19,1120376
87600,11,4,728,778628,11,778617
87601,20,-16,889,153500,20,153480
87602,17,-4,761,527708,17,527691
87603,8,14,343,1069401,8,1069393
87604,16,-8,689,402786,16,402770
87605,20,-12,330,274998,20,274978
87606,6,-5,514,479135,6,479129
87607,15,3,447,745208,15,745193
87608,9,-18,808,79887,9,79878
87609,19,-19,694,59415,19,59396
87610,11,12,642,1026868,11,1026857
87611,19,-2,843,591552,19,591533
87612,6,-20,633,13814,6,13808
87613,15,0,559,652458,15,652443
87614,20,-8,452,401026,20,401006
87615,15,-16,384,149718,15,149703
87616,11,-15,139,178868,11,178857
87617,15,5,839,809901,15,809886
87618,14,-17,3,115581,14,115567
87619,5,-10,154,316012,5,316007
87620,14,-1,596,621231,14,621217
87621,6,13,687,1045523,6,1045517
87622,13,15,322,1119141,13,1119128
87623,14,17,708,1183161,14,1183147
87624,15,2,415,713779,15,713764
87625,11,16,95,1147728,11,1147717
87626,5,-5,123,470777,5,470772
87627,16,-1,193,618006,16,617990
87628,12,-5,733,496403,12,496391
87629,6,7,696,859554,6,859548
87630,14,-16,946,153880,14,153866
87631,19,-18,195,86814,19,86795
87632,19,19,381,1243857,19,1243838
87633,8,-9,661,358166,8,358158
87634,14,-4,498,525839,14,525825
87635,7,8,852,893668,7,893661
87636,19,-19,109,54825,19,54806
87637,11,-4,245,524027,11,524016
87638,15,16,259,1148989,15,1148974
87639,14,-4,652,527023,14,527009
87640,9,11,464,978357,9,978348
87641,20,7,633,871658,20,871638
87642,12,-12,186,273841,12,273829
87643,18,1,723,685500,18,685482
87644,12,-12,611,276935,12,276923
87645,8,19,504,1228991,8,1228983
87646,5,-6,943,456910,5,456905
87647,17,-15,23,177980,17,177963
87648,12,-14,391,212616,12,212604
87649,8,-2,754,578798,8,578790
87650,5,12,871,1018212,5,1018207
87651,6,-16,127,126868,6,126862
87652,11,-17,886,122088,11,122077
87653,8,-14,687,201807,8,201799
87654,14,9,976,936394,14,936380
87655,8,-4,142,502485,8,502477
87656,10,10,643,951409,10,951399
87657,10,-16,227,129063,10,129053
87658,5,14,336,1069264,5,1069259
87659,14,-8,413,400801,14,400787
87660,20,2,69,711078,20,711058
87661,10,12,672,1013847,10,1013837
87662,12,-19,120,54960,12,54948
87663,14,-2,844,591557,14,591543
87664,13,-20,808,29106,13,29093
87665,9,8,42,875987,9,875978
87666,18,5,464,807192,18,807174
87667,12,-15,303,179977,12,179965
87668,20,11,686,995717,20,995697
87669,8,-3,832,548968,8,548960
87670,11,10,859,966415,11,966404
87671,16,-19,680,59307,16,59291
87672,12,-8,149,398984,12,398972
87673,12,-3,635,558874,12,558862
87674,6,-13,812,235943,6,235937
87675,7,15,26,1095047,7,1095040
87676,8,7,672,859088,8,859080
87677,12,16,558,1151058,12,1151046
87678,17,14,648,1090513,17,1090496
87679,14,-5,692,496086,14,496072
87680,6,3,78,720469,6,720463
87681,10,0,805,642996,10,642986
87682,8,15,56,1095701,8,1095693
87683,15,13,287,1055335,15,1055320
87684,12,1,891,686764,12,686752
87685,13,-16,973,154093,13,154080
87686,15,-17,638,120275,15,120260
87687,15,-8,984,404908,15,404893
87688,5,6,789,830043,5,830038
87689,17,-1,492,620523,17,620506
87690,14,17,723,1183309,14,1183295
87691,19,-18,365,88036,19,88017
87692,16,-4,940,529124,16,529108
87693,8,-15,150,158662,8,158654
87694,10,-8,865,393836,10,393826
87695,18,11,986,997965,18,997947
87696,7,14,194,1066037,7,1066030
87697,10,-12,984,271099,10,271089
87698,11,-10,236,336800,11,336789
87699,16,12,843,1028428,16,1028412
87700,8,-17,390,101830,8,101822
87701,14,1,395,682991,14,682977
87702,19,-6,474,462795,19,462776
87703,5,12,23,999587,5,999582
87704,9,-5,731,483849,9,483840
87705,11,-2,838,591520,11,591509
87706,5,14,97,1063992,5,1063987
87707,14,-4,331,524660,14,524646
87708,7,-3,855,549529,7,549522
87709,19,-20,456,26256,19,26237
87710,12,-10,388,337835,12,337823
87711,9,7,515,855828,9,855819
87712,18,-20,487,26455,18,26437
87713,15,-8,64,398431,15,398416
87714,18,7,326,869418,18,869400
87715,16,10,235,961595,16,961579
87716,13,-9,616,371458,13,371445
87717,13,-15,564,181949,13,181936
87718,19,-20,807,29104,19,29085
87719,20,-7,629,432923,20,432903
87720,11,-13,960,248310,11,248299
87721,13,-9,904,373758,13,373745
87722,19,5,155,804915,19,804896
87723,7,-2,771,579193,7,579186
87724,5,14,179,1065749,5,1065744
87725,14,3,62,742298,14,742284
87726,11,-15,2,177854,11,177843
87727,14,14,663,1090636,14,1090622
87728,9,-13,888,237586,9,237577
87729,12,16,619,1151453,12,1151441
87730,8,-9,766,360662,8,360654
87731,11,6,538,840118,11,840107
87732,19,-15,805,183783,19,183764
87733,14,-10,874,341659,14,341645
87734,19,-11,72,304259,19,304240
87735,17,-11,609,308615,17,308598
87736,18,-12,32,272739,18,272721
87737,16,5,602,808206,16,808190
87738,9,4,496,761251,9,761242
87739,11,-16,41,147047,11,147036
87740,12,-2,607,589694,12,589682
87741,7,-8,870,393930,7,393923
87742,18,-18,539,89188,18,89170
87743,11,-17,83,116189,11,116178
87744,12,-15,245,179545,12,179533
87745,11,-3,395,556695,11,556684
87746,8,-1,580,606583,8,606575
87747,15,16,30,1147288,15,1147273
87748,19,-3,482,557484,19,557465
87749,20,1,816,686192,20,686172
87750,19,18,824,1214919,19,1214900
87751,12,4,809,779209,12,779197
87752,6,-5,666,482392,6,482386
87753,8,19,925,1238006,8,1237998
87754,13,8,704,903554,13,903541
87755,16,-4,896,528801,16,528785
87756,10,19,811,1235488,10,1235478
87757,10,4,4,750648,10,750638
87758,14,7,609,871513,14,871499
87759,19,-16,774,152591,19,152572
87760,5,-13,689,232900,5,232895
87761,10,-9,840,362302,10,362292
87762,13,-1,198,618035,13,618022
87763,18,13,873,1059788,18,1059770
87764,17,-6,684,464378,17,464361
87765,11,9,328,931414,11,931403
87766,18,-3,653,559006,18,558988
87767,17,-15,441,181039,17,181022
87768,17,-12,853,278851,17,278834
87769,5,5,278,787509,5,787504
87770,15,-11,820,310099,15,310084
87771,13,-20,250,24686,13,24673
87772,15,17,126,1178791,15,1178776
87773,15,-16,274,148999,15,148984
87774,13,0,163,649472,13,649459
87775,17,18,937,1215817,17,1215800
87776,11,-3,894,560954,11,560943
87777,10,-12,182,253364,10,253354
87778,19,0,43,648591,19,648572
87779,18,8,891,904865,18,904847
87780,20,-12,678,277503,20,277483
87781,20,9,249,930829,20,930809
87782,11,8,970,905491,11,905480
87783,12,17,379,1180772,12,1180760
87784,20,-3,722,559538,20,559518
87785,14,-5,625,495615,14,495601
87786,10,-18,713,77776,10,77766
87787,13,12,292,1024281,13,1024268
87788,11,10,533,963932,11,963921
87789,7,14,120,1064533,7,1064526
87790,19,0,212,649848,19,649829
87791,20,-11,975,311355,20,311335
87792,9,12,748,1015405,9,1015396
87793,10,8,154,878404,10,878394
87794,11,4,401,776104,11,776093
87795,16,14,813,1091851,16,1091835
87796,19,-16,684,151926,19,151907
87797,20,-16,456,150414,20,150394
87798,16,1,571,684403,16,684387
87799,15,-7,768,433899,15,433884
87800,10,-4,316,506443,10,506433
87801,12,-10,135,336141,12,336129
87802,10,-4,760,515610,10,515600
87803,20,2,673,715675,20,715655
87804,12,-9,262,368513,12,368501
87805,19,-1,575,621091,19,621072
87806,10,-20,729,16038,10,16028
87807,6,-13,89,220293,6,220287
87808,11,-19,765,59976,11,59965
87809,9,11,302,974861,9,974852
87810,10,19,582,1230661,10,1230651
87811,8,9,472,916595,8,916587
87812,11,-13,954,248265,11,248254
87813,18,-16,168,148141,18,148123
87814,13,-8,947,404607,13,404594
87815,6,-16,370,131953,6,131947
87816,6,-12,313,256440,6,256434
87817,19,13,696,1058462,19,1058443
87818,18,-12,230,274208,18,274190
87819,19,-10,837,341390,19,341371
87820,12,-20,142,23853,12,23841
87821,10,15,354,1102030,10,1102020
87822,11,18,835,1215027,11,1215016
87823,11,-6,50,459489,11,459478
87824,6,-7,975,426723,6,426717
87825,16,-18,92,85945,16,85929
87826,8,4,666,764921,8,764913
87827,18,-11,611,308635,18,308617
87828,12,0,447,651498,12,651486
87829,15,-13,584,245354,15,245339
87830,15,1,840,686345,15,686330
87831,9,-7,594,418582,9,418573
87832,11,14,578,1089912,11,1089901
87833,15,-9,331,369061,15,369046
87834,7,-5,521,479324,7,479317
87835,15,19,949,1248400,15,1248385
87836,16,0,134,649247,16,649231
87837,10,-4,568,511711,10,511701
87838,18,-2,305,587425,18,587407
87839,14,-7,633,432937,14,432923
87840,20,10,436,963136,20,963116
87841,13,-2,365,587813,13,587800
87842,10,-3,329,537645,10,537635
87843,17,2,749,716222,17,716205
87844,8,-3,106,532692,8,532684
87845,7,-19,989,52655,7,52648
87846,9,-3,107,532725,9,532716
87847,9,15,446,1103916,9,1103907
87848,9,4,182,754496,9,754487
87849,20,9,423,932115,20,932095
87850,14,2,141,711685,14,711671
87851,6,-1,637,607635,6,607629
87852,11,-6,322,461663,11,461652
87853,19,14,922,1092628,19,1092609
87854,18,6,559,840262,18,840244
87855,5,-16,43,124730,5,124725
87856,6,-7,952,426176,6,426170
87857,9,-7,371,413939,9,413930
87858,7,17,918,1175031,7,1175024
87859,15,4,667,778119,15,778104
87860,14,2,824,716628,14,716614
87861,10,-16,635,137757,10,137747
87862,13,-16,2,146733,13,146720
87863,20,16,318,1149428,20,1149408
87864,18,1,133,680894,18,680876
87865,7,15,133,1097401,7,1097394
87866,19,14,55,1085862,19,1085843
87867,7,19,663,1232214,7,1232207
87868,15,-12,941,279602,15,279587
87869,12,12,272,1024157,12,1024145
87870,7,15,570,1106575,7,1106568
87871,20,7,226,868605,20,868585
87872,19,-1,229,618390,19,618371
87873,15,14,921,1092620,15,1092605
87874,7,-15,101,157637,7,157630
87875,5,-14,478,197029,5,197024
87876,17,-1,863,623175,17,623158
87877,19,4,86,773883,19,773864
87878,18,-12,473,276002,18,275984
87879,18,-10,290,337139,18,337121
87880,14,8,944,905319,14,905305
87881,20,-17,858,121884,20,121864
87882,20,9,358,931663,20,931643
87883,14,11,915,997534,14,997520
87884,13,18,769,1214540,13,1214527
87885,19,10,504,963704,19,963685
87886,7,-13,603,231256,7,231249
87887,6,-15,402,164104,6,164098
87888,7,-7,11,406304,7,406297
87889,20,-11,377,306782,20,306762
87890,11,6,151,836915,11,836904
87891,16,-17,343,118056,16,118040
87892,13,3,308,744268,13,744255
87893,14,13,763,1058970,14,1058956
87894,14,-10,462,338481,14,338467
87895,14,16,200,1148554,14,1148540
87896,5,5,362,789029,5,789024
87897,13,0,59,648688,13,648675
87898,11,0,168,649512,11,649501
87899,12,0,636,653053,12,653041
87900,15,-19,491,57746,15,57731
87901,9,7,824,862322,9,862313
87902,5,-13,324,225251,5,225246
87903,7,3,232,723889,7,723882
87904,14,11,524,994663,14,994649
87905,11,-4,420,525371,11,525360
87906,7,-18,276,68524,7,68517
87907,13,11,915,997537,13,997524
87908,13,7,775,872611,13,872598
87909,7,14,933,1082676,7,1082669
87910,16,2,940,717471,16,717455
87911,15,-20,462,26281,15,26266
87912,6,-17,996,114434,6,114428
87913,13,1,451,683395,13,683382
87914,17,4,516,777002,17,776985
87915,13,1,983,687483,13,687470
87916,16,-18,167,86550,16,86534
87917,5,-3,876,550028,5,550023
87918,8,-12,958,270472,8,270464
87919,20,-12,55,272920,20,272900
87920,13,10,113,960759,13,960746
87921,17,6,293,838034,17,838017
87922,18,-1,769,622478,18,622460
87923,15,-19,119,54958,15,54943
87924,13,-16,523,150856,13,150843
87925,5,-5,885,487305,5,487300
87926,9,-4,998,520996,9,520987
87927,12,18,947,1215926,12,1215914
87928,6,4,621,764095,6,764089
87929,11,18,725,1214129,11,1214118
87930,9,13,554,1042667,9,1042658
87931,7,-4,511,510565,7,510558
87932,16,7,347,869555,16,869539
87933,13,-18,163,86503,13,86490
87934,20,-17,182,116796,20,116776
87935,18,7,371,869692,18,869674
87936,14,14,511,1089445,14,1089431
87937,16,19,557,1245333,16,1245317
87938,15,6,701,841473,15,841458
87939,9,-18,265,68291,9,68282
87940,20,2,821,716605,20,716585
87941,19,-18,805,91139,19,91120
87942,20,17,740,1183409,20,1183389
87943,10,18,1000,1207909,10,1207899
87944,14,-9,225,368205,14,368191
87945,19,-18,634,89852,19,89833
87946,5,4,337,757807,5,757802
87947,12,7,807,872857,12,872845
87948,11,-6,502,463037,11,463026
87949,16,-16,376,149661,16,149645
87950,6,19,879,1237132,6,1237126
87951,14,-16,118,147796,14,147782
87952,14,2,819,716585,14,716571
87953,16,-13,871,247537,16,247521
87954,17,17,268,1179935,17,1179918
87955,16,18,168,1210311,16,1210295
87956,17,16,751,1152415,17,1152398
87957,7,-17,15,93938,7,93931
87958,15,9,73,929604,15,929589
87959,18,15,211,1118390,18,1118372
87960,18,-11,660,308999,18,308981
87961,6,-14,141,189570,6,189564
87962,18,14,169,1086775,18,1086757
87963,11,-1,289,618865,11,618854
87964,8,5,58,782920,8,782912
87965,16,-11,8,303775,16,303759
87966,16,-7,432,431569,16,431553
87967,16,-11,63,304179,16,304163
87968,20,16,557,1151054,20,1151034
87969,16,-17,871,121952,16,121936
87970,10,13,521,1041883,10,1041873
87971,8,-14,454,196551,8,196543
87972,12,-3,402,556751,12,556739
87973,20,14,420,1088757,20,1088737
87974,6,-15,646,169404,6,169398
87975,10,18,112,1189254,10,1189244
87976,16,-7,391,431318,16,431302
87977,13,-12,604,276894,13,276881
87978,20,-13,111,241859,20,241839
87979,12,-5,406,494000,12,493988
87980,18,0,635,653052,18,653034
87981,12,-6,216,460828,12,460816
87982,17,-3,160,554920,17,554903
87983,6,-15,617,168689,6,168683
87984,20,-7,20,428461,20,428441
87985,16,13,511,1057050,16,1057034
87986,14,3,102,742607,14,742593
87987,14,-8,103,398641,14,398627
87988,16,-19,798,60178,16,60162
87989,19,18,741,1214291,19,1214272
87990,15,13,82,1053832,15,1053817
87991,20,3,942,749021,20,749001
87992,10,10,734,953306,10,953296
87993,8,19,559,1230149,8,1230141
87994,19,-1,143,617622,19,617603
87995,12,2,953,717600,12,717588
87996,17,-15,98,178546,17,178529
87997,17,-11,285,305956,17,305939
87998,5,16,110,1127373,5,1127368
87999,8,12,471,1009207,8,1009199
88000,5,4,691,765479,5,765474
88001,8,-11,305,287871,8,287863
88002,18,1,585,684513,18,684495
88003,14,-11,715,309293,14,309279
88004,6,15,396,1102842,6,1102836
88005,8,-9,216,348163,8,348155
88006,6,13,386,1039024,6,1039018
88007,19,-11,898,310738,19,310719
88008,20,12,387,1024888,20,1024868
88009,15,18,360,1211702,15,1211687
88010,11,5,221,805513,11,805502
88011,7,12,419,1008039,7,1008032
88012,11,-17,757,121274,11,121263
88013,16,-1,854,623095,16,623079
88014,11,-15,137,178847,11,178836
88015,9,17,329,1162462,9,1162453
88016,13,6,255,837699,13,837686
88017,15,-9,336,369127,15,369112
88018,14,-10,207,336598,14,336584
88019,13,-13,847,247346,13,247333
88020,18,-6,61,459549,18,459531
88021,6,1,798,674410,6,674404
88022,10,-4,608,512481,10,512471
88023,7,11,830,986160,7,986153
88024,20,7,664,871891,20,871871
88025,11,-1,45,616916,11,616905
88026,11,15,380,1119577,11,1119566
88027,15,14,384,1088414,15,1088399
88028,18,5,210,805407,18,805389
88029,15,-11,224,305457,15,305442
88030,11,-11,866,310518,11,310507
88031,15,-9,147,367648,15,367633
88032,14,-9,627,371499,14,371485
88033,18,13,2,1053273,18,1053255
88034,8,17,945,1175559,8,1175551
88035,5,14,869,1081313,5,1081308
88036,13,-1,928,623670,13,623657
88037,9,-18,987,83900,9,83891
88038,19,8,943,905305,19,905286
88039,14,-1,333,619243,14,619229
88040,11,19,125,1241804,11,1241793
88041,9,-1,979,614960,9,614951
88042,6,0,735,641538,6,641532
88043,10,-11,41,281933,10,281923
88044,14,16,680,1151973,14,1151959
88045,10,10,286,943597,10,943587
88046,13,1,927,687126,13,687113
88047,7,-10,478,323122,7,323115
88048,13,10,401,962880,13,962867
88049,6,19,918,1237870,6,1237864
88050,20,6,603,840621,20,840601
88051,7,12,85,1001030,7,1001023
88052,12,7,768,872575,12,872563
88053,16,9,685,934090,16,934074
88054,10,1,775,673883,10,673873
88055,17,-1,0,616508,17,616491
88056,6,-16,184,128026,6,128020
88057,5,6,197,816498,5,816493
88058,6,-9,511,355210,6,355204
88059,9,-17,457,103235,9,103226
88060,15,-7,26,428520,15,428505
88061,16,11,705,995846,16,995830
88062,10,-3,63,531839,10,531829
88063,18,6,883,842800,18,842782
88064,17,-12,963,279809,17,279792
88065,5,14,712,1078031,5,1078026
88066,5,0,354,632868,5,632863
88067,20,-13,72,241580,20,241560
88068,20,-5,504,494755,20,494735
88069,10,1,970,678159,10,678149
88070,20,-20,47,23131,20,23111
88071,11,-10,84,335820,11,335809
88072,14,-6,651,464125,14,464111
88073,10,-6,463,446706,10,446696
88074,10,1,571,669825,10,669815
88075,5,-3,853,549485,5,549480
88076,11,15,534,1120672,11,1120661
88077,17,1,849,686425,17,686408
88078,7,-1,925,613934,7,613927
88079,10,-3,79,532186,10,532176
88080,5,-10,687,327525,5,327520
88081,17,17,291,1180145,17,1180128
88082,15,-5,986,498267,15,498252
88083,9,-13,329,225328,9,225319
88084,11,-11,876,310605,11,310594
88085,18,2,615,715168,18,715150
88086,18,-16,154,148083,18,148065
88087,16,-9,383,369521,16,369505
88088,5,2,863,706568,5,706563
88089,6,2,813,705540,6,705534
88090,11,8,72,898453,11,898442
88091,16,-14,729,215186,16,215170
88092,5,-3,778,547956,5,547951
88093,18,18,886,1215464,18,1215446
88094,10,-10,93,314593,10,314583
88095,14,-1,225,618352,14,618338
88096,19,-16,393,149775,19,149756
88097,10,-2,949,583193,10,583183
88098,10,-11,927,300979,10,300969
88099,12,10,404,962901,12,962889
88100,18,19,418,1244290,18,1244272
88101,9,17,24,1155798,9,1155789
88102,15,13,834,1059483,15,1059468
88103,5,15,774,1110874,5,1110869
88104,10,-7,754,421794,10,421784
88105,12,-15,347,180316,12,180304
88106,15,16,968,1154059,15,1154044
88107,13,1,887,686715,13,686702
88108,20,-7,55,428703,20,428683
88109,18,4,910,779992,18,779974
88110,10,-2,568,574868,10,574858
88111,10,4,987,772061,10,772051
88112,9,-17,403,102034,9,102025
88113,7,-16,980,145093,7,145086
88114,15,12,728,1027532,15,1027517
88115,19,13,679,1058337,19,1058318
88116,17,-3,100,554489,17,554472
88117,7,-7,871,424392,7,424385
88118,5,5,979,802321,5,802316
88119,18,2,408,713758,18,713740
88120,19,2,375,713456,19,713437
88121,16,-5,84,491534,16,491518
88122,17,-17,880,122036,17,122019
88123,10,9,41,907660,10,907650
88124,9,15,476,1104488,9,1104479
88125,9,10,935,957651,9,957642
88126,10,3,102,721068,10,721058
88127,13,-19,469,57583,13,57570
88128,6,16,918,1144321,6,1144315
88129,15,-10,838,341394,15,341379
88130,18,-10,524,338927,18,338909
88131,18,15,834,1122898,18,1122880
88132,6,-16,587,136763,6,136757
88133,18,-11,834,310227,18,310209
88134,17,16,758,1152475,17,1152458
88135,13,-11,188,305232,13,305219
88136,6,-11,217,285776,6,285770
88137,15,-2,769,590887,15,590872
88138,10,0,482,635841,10,635831
88139,18,-19,73,54456,18,54438
88140,19,-12,461,275853,19,275834
88141,7,-7,775,422312,7,422305
88142,11,-1,966,623885,11,623874
88143,9,16,611,1137998,9,1137989
88144,13,6,582,840490,13,840477
88145,12,-11,405,306964,12,306952
88146,5,-3,342,537948,5,537943
88147,5,-6,659,450899,5,450894
88148,11,19,855,1247717,11,1247706
88149,8,16,533,1136522,8,1136514
88150,10,-7,901,425237,10,425227
88151,12,-10,662,340104,12,340092
88152,11,6,678,841209,11,841198
88153,13,-19,560,58394,13,58381
88154,5,-2,985,583900,5,583895
88155,6,14,431,1071493,6,1071487
88156,6,6,417,821807,6,821801
88157,17,-17,423,118583,17,118566
88158,8,-11,560,293595,8,293587
88159,6,6,900,832489,6,832483
88160,19,-16,691,151995,19,151976
88161,7,5,179,785365,7,785358
88162,9,5,836,799143,9,799134
88163,8,-2,17,563127,8,563119
88164,10,-8,64,376860,10,376850
88165,13,18,801,1214795,13,1214782
88166,16,3,649,746760,16,746744
88167,11,4,63,773710,11,773699
88168,5,-3,374,538604,5,538599
88169,15,-14,791,215705,15,215690
88170,8,-11,42,281940,8,281932
88171,19,15,729,1122200,19,1122181
88172,9,4,325,757574,9,757565
88173,17,-2,382,587937,17,587920
88174,8,6,88,814075,8,814067
88175,7,-8,479,385269,7,385262
88176,10,14,802,1079911,10,1079901
88177,19,-18,241,87219,19,87200
88178,6,17,479,1165587,6,1165581
88179,18,-11,303,306166,18,306148
88180,5,3,454,728574,5,728569
88181,8,-8,131,378207,8,378199
88182,19,-8,969,404793,19,404774
88183,7,-12,289,255765,7,255758
88184,16,1,325,682494,16,682478
88185,19,-20,629,27565,19,27546
88186,15,11,55,991286,15,991271
88187,18,1,673,685143,18,685125
88188,10,8,359,883068,10,883058
88189,9,8,191,879284,9,879275
88190,19,13,693,1058431,19,1058412
88191,8,-10,769,329032,8,329024
88192,12,-19,491,57748,12,57736
88193,20,11,939,997664,20,997644
88194,16,12,58,1022503,16,1022487
88195,5,6,525,824319,5,824314
88196,16,4,17,773372,16,773356
88197,5,10,274,943352,5,943347
88198,6,0,400,634017,6,634011
88199,17,14,912,1092560,17,1092543
88200,12,9,640,933806,12,933794
88201,19,15,76,1117355,19,1117336
88202,16,-9,80,367255,16,367239
88203,16,-13,317,243414,16,243398
88204,10,17,279,1161332,10,1161322
88205,20,-13,50,241439,20,241419
88206,9,7,848,862769,9,862760
88207,7,-16,997,145591,7,145584
88208,13,4,668,778127,13,778114
88209,5,-19,786,48710,5,48705
88210,8,11,372,976435,8,976427
88211,20,17,973,1185255,20,1185235
88212,18,-5,114,491801,18,491783
88213,10,0,847,643748,10,643738
88214,16,-7,701,433416,16,433400
88215,8,-4,854,517617,8,517609
88216,9,13,631,1044371,9,1044362
88217,17,19,113,1241713,17,1241696
88218,16,17,841,1184303,16,1184287
88219,13,2,136,711624,13,711611
88220,17,15,414,1119714,17,1119697
88221,8,3,593,731464,8,731456
88222,14,-7,55,428707,14,428693
88223,18,3,0,741836,18,741818
88224,20,19,471,1244680,20,1244660
88225,14,-16,955,153937,14,153923
88226,15,-1,452,620150,15,620135
88227,12,4,910,779994,12,779982
88228,15,3,11,741894,15,741879
88229,12,5,457,807120,12,807108
88230,18,11,521,994620,18,994602
88231,6,-9,296,350032,6,350026
88232,11,11,487,994413,11,994402
88233,14,-16,751,152423,14,152409
88234,13,-3,642,558916,13,558903
88235,6,16,133,1127928,6,1127922
88236,14,-19,260,56044,14,56030
88237,12,-17,107,116367,12,116355
88238,6,15,459,1104178,6,1104172
88239,9,-4,592,512199,9,512190
88240,16,19,274,1242960,16,1242944
88241,10,-20,680,15071,10,15061
88242,12,-5,8,490818,12,490806
88243,16,-15,70,178281,16,178265
88244,14,2,444,713991,14,713977
88245,5,10,288,943626,5,943621
88246,19,15,896,1123327,19,1123308
88247,8,-6,644,450678,8,450670
88248,11,6,394,838908,11,838897
88249,15,8,282,900230,15,900215
88250,16,13,26,1053401,16,1053385
88251,9,4,615,763979,9,763970
88252,12,-19,133,55079,12,55067
88253,7,8,618,888732,7,888725
88254,16,-18,733,90598,16,90582
88255,7,-10,422,321816,7,321809
88256,15,-17,861,121905,15,121890
88257,11,-2,595,589590,11,589579
88258,14,0,814,654472,14,654458
88259,10,-7,395,414517,10,414507
88260,16,0,636,653059,16,653043
88261,19,4,358,775824,19,775805
88262,16,-4,736,527585,16,527569
88263,14,-6,19,459300,14,459286
88264,9,13,137,1033616,9,1033607
88265,20,4,100,774029,20,774009
88266,20,-3,767,559951,20,559931
88267,7,-16,561,136234,7,136227
88268,5,9,965,927356,5,927351
88269,5,13,196,1034930,5,1034925
88270,5,-18,496,73128,5,73123
88271,17,6,276,837906,17,837889
88272,17,-3,199,555180,17,555163
88273,17,-3,586,558427,17,558410
88274,17,15,183,1118193,17,1118176
88275,18,-11,300,306116,18,306098
88276,5,12,296,1005732,5,1005727
88277,7,-19,901,50933,7,50926
88278,20,-14,684,214900,20,214880
88279,9,-2,549,574406,9,574397
88280,11,-9,577,371264,11,371253
88281,6,16,12,1125465,6,1125459
88282,10,-15,960,175974,10,175964
88283,9,4,288,756795,9,756786
88284,11,-8,821,403755,11,403744
88285,7,8,879,894245,7,894238
88286,18,2,438,713926,18,713908
88287,14,1,21,679962,14,679948
88288,10,-18,218,67170,10,67160
88289,12,11,986,997967,12,997955
88290,19,7,215,868527,19,868508
88291,16,-5,849,497201,16,497185
88292,13,8,656,903137,13,903124
88293,12,-4,981,529478,12,529466
88294,7,-17,473,103551,7,103544
88295,18,5,503,807469,18,807451
88296,20,18,144,1210149,20,1210129
88297,5,-5,524,479420,5,479415
88298,14,8,664,903207,14,903193
88299,13,-15,71,178296,13,178283
88300,17,-19,707,59503,17,59486
88301,12,2,123,711533,12,711521
88302,7,3,279,724928,7,724921
88303,12,-4,664,527116,12,527104
88304,14,-9,205,367991,14,367977
88305,6,-6,678,451286,6,451280
88306,11,16,228,1148739,11,1148728
88307,19,-14,729,215195,19,215176
88308,11,-4,776,527830,11,527819
88309,5,9,459,916328,5,916323
88310,6,-11,214,285715,6,285709
88311,11,8,832,904426,11,904415
88312,20,-16,961,154028,20,154008
88313,7,16,836,1142571,7,1142564
88314,6,13,800,1047967,6,1047961
88315,5,7,487,855307,5,855302
88316,17,15,880,1123202,17,1123185
88317,8,-1,834,611803,8,611795
88318,15,-20,955,30023,15,30008
88319,17,-4,624,526801,17,526784
88320,17,18,122,1209918,17,1209901
88321,11,-4,898,528825,11,528814
88322,13,3,407,744934,13,744921
88323,13,11,794,996624,13,996611
88324,13,16,964,1154014,13,1154001
88325,15,6,324,838304,15,838289
88326,15,11,169,992049,15,992034
88327,5,-20,846,18823,5,18818
88328,14,-19,461,57508,14,57494
88329,6,10,113,940079,6,940073
88330,9,-1,856,612213,9,612204
88331,15,-7,883,434797,15,434782
88332,11,-15,477,181320,11,181309
88333,20,-12,905,279357,20,279337
88334,11,15,749,1122366,11,1122355
88335,9,-18,808,79896,9,79887
88336,16,19,402,1244089,16,1244073
88337,14,16,548,1150979,14,1150965
88338,16,-18,618,89701,16,89685
88339,17,-1,873,623243,17,623226
88340,13,-20,289,25057,13,25044
88341,12,14,995,1093286,12,1093274
88342,20,-5,439,494265,20,494245
88343,20,4,644,777961,20,777941
88344,19,-10,66,335674,19,335655
88345,10,-13,8,218446,10,218436
88346,6,-13,351,225748,6,225742
88347,7,10,410,946303,7,946296
88348,7,-2,831,580625,7,580618
88349,11,16,719,1152229,11,1152218
88350,5,5,12,781862,5,781857
88351,20,-10,251,336942,20,336922
88352,20,0,647,653178,20,653158
88353,12,-16,448,150340,12,150328
88354,8,-6,212,441536,8,441528
88355,14,-12,421,275581,14,275567
88356,18,0,197,649764,18,649746
88357,7,6,396,821332,7,821325
88358,20,3,34,742073,20,742053
88359,13,-13,26,241269,13,241256
88360,18,-2,828,591438,18,591420
88361,13,15,643,1121482,13,1121469
88362,15,14,83,1086096,15,1086081
88363,15,2,843,716802,15,716787
88364,13,-2,715,590532,13,590519
88365,7,-7,200,410068,7,410061
88366,8,-1,340,601550,8,601542
88367,16,10,135,960944,16,960928
88368,11,-6,829,465447,11,465436
88369,8,-19,763,48344,8,48336
88370,15,-4,565,526352,15,526337
88371,14,16,20,1147225,14,1147211
88372,9,-13,665,232413,9,232404
88373,18,-2,965,592483,18,592465
88374,14,-16,419,150007,14,149993
88375,18,4,672,778158,18,778140
88376,7,-4,678,514121,7,514114
88377,13,-9,970,374151,13,374138
88378,20,8,461,901625,20,901605
88379,7,18,249,1192286,7,1192279
88380,11,-12,41,272801,11,272790
88381,19,8,577,902490,19,902471
88382,7,18,606,1199491,7,1199484
88383,7,-17,758,109769,7,109762
88384,18,-8,884,404131,18,404113
88385,19,-4,245,524036,19,524017
88386,6,0,383,633663,6,633657
88387,6,15,122,1097188,6,1097182
88388,6,-20,11,294,6,288
88389,9,15,876,1113109,9,1113100
88390,15,-6,412,462305,15,462290
88391,13,15,971,1123943,13,1123930
88392,9,-20,527,11378,9,11369
88393,7,14,985,1083905,7,1083898
88394,20,-2,447,588510,20,588490
88395,20,-2,200,586601,20,586581
88396,8,3,924,738895,8,738887
88397,13,-20,63,23268,13,23255
88398,15,2,789,716409,15,716394
88399,14,-20,322,25341,14,25327
88400,19,13,803,1059302,19,1059283
88401,13,5,165,804992,13,804979
88402,20,-10,867,341596,20,341576
88403,15,-1,104,617357,15,617342
88404,15,19,964,1248516,15,1248501
88405,13,-1,908,623520,13,623507
88406,18,2,70,711094,18,711076
88407,18,16,614,1151445,18,1151427
88408,6,-14,434,196173,6,196167
88409,9,16,617,1138128,9,1138119
88410,20,-20,243,24652,20,24632
88411,17,-8,666,402612,17,402595
88412,20,17,154,1178994,20,1178974
88413,14,-18,51,85585,14,85571
88414,16,6,753,841821,16,841805
88415,19,-2,878,591848,19,591829
88416,6,0,6,625336,6,625330
88417,20,-7,730,433613,20,433593
88418,17,2,63,711006,17,710989
88419,7,-17,417,102288,7,102281
88420,10,3,459,728666,10,728656
88421,7,-3,926,551235,7,551228
88422,10,-8,565,387340,10,387330
88423,6,10,419,946522,6,946516
88424,15,-14,615,214362,15,214347
88425,11,10,388,962750,11,962739
88426,15,11,237,992516,15,992501
88427,14,5,517,807586,14,807572
88428,19,-17,804,121584,19,121565
88429,14,12,603,1026484,14,1026470
88430,16,-6,782,465132,16,465116
88431,5,-20,59,1272,5,1267
88432,11,1,68,680298,11,680287
88433,16,17,879,1184563,16,1184547
88434,18,-13,41,241363,18,241345
88435,9,10,876,956353,9,956344
88436,11,-7,512,432184,11,432173
88437,8,3,761,735342,8,735334
88438,19,17,448,1181296,19,1181277
88439,11,-13,89,241677,11,241666
88440,19,15,598,1121159,19,1121140
88441,14,14,742,1091259,14,1091245
88442,19,0,101,649042,19,649023
88443,8,15,435,1103638,8,1103630
88444,8,-8,105,377597,8,377589
88445,20,14,961,1092959,20,1092939
88446,20,-10,852,341492,20,341472
88447,8,-14,464,196742,8,196734
88448,16,-5,226,492653,16,492637
88449,5,-10,841,330666,5,330661
88450,11,16,951,1153877,11,1153866
88451,18,19,857,1247745,18,1247727
88452,18,-10,794,341057,18,341039
88453,15,-13,749,246570,15,246555
88454,12,-5,824,496977,12,496965
88455,15,-3,782,560089,15,560074
88456,7,-20,247,5536,7,5529
88457,12,8,40,898175,12,898163
88458,17,-5,733,496410,17,496393
88459,11,-9,39,366905,11,366894
88460,6,-10,232,317617,6,317611
88461,12,5,832,809863,12,809851
88462,14,0,783,654222,14,654208
88463,8,-7,395,414525,8,414517
88464,12,17,524,1181792,12,1181780
88465,6,-13,30,219053,6,219047
88466,12,-18,623,89751,12,89739
88467,18,13,240,1054991,18,1054973
88468,15,-8,730,403054,15,403039
88469,14,3,622,746497,14,746483
88470,12,-13,25,241255,12,241243
88471,19,-8,618,402225,19,402206
88472,13,10,244,961645,13,961632
88473,9,8,262,880853,9,880844
88474,5,3,479,729097,5,729092
88475,13,18,499,1212603,13,1212590
88476,19,-12,410,275541,19,275522
88477,5,-16,151,127329,5,127324
88478,5,-6,958,457207,5,457202
88479,17,-4,103,522819,17,522802
88480,11,2,691,715844,11,715833
88481,20,-1,298,618939,20,618919
88482,11,-8,674,402689,11,402678
88483,18,-2,247,586998,18,586980
88484,20,-9,32,366865,20,366845
88485,20,-6,971,466464,20,466444
88486,7,-1,324,601078,7,601071
88487,8,1,323,664318,8,664310
88488,10,11,147,971543,10,971533
88489,11,-4,887,528731,11,528720
88490,10,-18,546,74197,10,74187
88491,11,4,874,779784,11,779773
88492,13,4,353,775781,13,775768
88493,8,-12,218,254264,8,254256
88494,11,-18,312,87690,11,87679
88495,17,-14,943,216815,17,216798
88496,8,17,861,1173938,8,1173930
88497,18,14,210,1087046,18,1087028
88498,16,2,184,711968,16,711952
88499,19,17,130,1178827,19,1178808
88500,8,2,694,703290,8,703282
88501,16,4,847,779615,16,779599
88502,12,14,249,1087395,12,1087383
88503,5,1,936,677379,5,677374
88504,7,-8,828,393085,7,393078
88505,15,-1,990,624101,15,624086
88506,14,-13,916,247932,14,247918
88507,11,14,326,1088002,11,1087991
88508,17,3,273,743953,17,743936
88509,20,0,613,652902,20,652882
88510,9,-17,371,101440,9,101431
88511,18,-15,623,182346,18,182328
88512,5,14,272,1067863,5,1067858
88513,5,-5,283,474296,5,474291
88514,7,3,200,723220,7,723213
88515,7,6,116,814743,7,814736
88516,12,-16,72,147352,12,147340
88517,7,19,774,1234661,7,1234654
88518,19,-12,634,277124,19,277105
88519,17,-8,130,398801,17,398784
88520,13,14,371,1088323,13,1088310
88521,5,11,778,985126,5,985121
88522,11,17,30,1178094,11,1178083
88523,19,-4,622,526775,19,526756
88524,7,18,178,1190776,7,1190769
88525,11,-7,506,432127,11,432116
88526,8,-2,42,563793,8,563785
88527,14,3,518,745656,14,745642
88528,7,11,138,971348,7,971341
88529,5,1,472,667506,5,667501
88530,7,4,251,756120,7,756113
88531,9,19,276,1223620,9,1223611
88532,10,-20,571,12446,10,12436
88533,12,-20,612,27446,12,27434
88534,13,1,361,682747,13,682734
88535,5,-17,658,107693,5,107688
88536,6,0,882,644513,6,644507
88537,17,-5,384,493857,17,493840
88538,15,2,884,717087,15,717072
88539,19,17,49,1178276,19,1178257
88540,10,0,324,632095,10,632085
88541,5,5,291,787790,5,787785
88542,10,10,649,951612,10,951602
88543,8,3,577,731164,8,731156
88544,11,11,903,997434,11,997423
88545,9,9,170,910441,9,910432
88546,11,16,183,1148435,11,1148424
88547,17,-15,529,181668,17,181651
88548,9,-4,924,519221,9,519212
88549,18,14,243,1087328,18,1087310
88550,16,19,765,1246967,16,1246951
88551,6,14,280,1068080,6,1068074
88552,14,-12,407,275493,14,275479
88553,18,5,978,810980,18,810962
88554,15,-6,172,460443,15,460428
88555,7,-14,961,207431,7,207424
88556,9,-14,501,197485,9,197476
88557,10,14,591,1074939,10,1074929
88558,11,-11,784,309852,11,309841
88559,20,9,768,934690,20,934670
88560,20,-1,847,623057,20,623037
88561,8,11,270,974030,8,974022
88562,6,8,666,889769,6,889763
88563,18,7,392,869927,18,869909
88564,7,19,605,1231051,7,1231044
88565,17,8,760,903962,17,903945
88566,18,-10,488,338704,18,338686
88567,17,6,693,841370,17,841353
88568,12,-17,820,121630,12,121618
88569,8,11,686,983055,8,983047
88570,18,-5,898,497615,18,497597
88571,20,6,394,838918,20,838898
88572,16,-8,216,399435,16,399419
88573,8,16,4,1125252,8,1125244
88574,13,15,9,1116826,13,1116813
88575,10,-12,806,266966,10,266956
88576,9,6,415,821766,9,821757
88577,19,13,502,1056951,19,1056932
88578,16,18,723,1214113,16,1214097
88579,17,-14,668,214749,17,214732
88580,11,1,567,684370,11,684359
88581,19,-18,861,91466,19,91447
88582,17,-8,381,400573,17,400556
88583,18,4,748,778777,18,778759
88584,13,-16,232,148694,13,148681
88585,16,-18,400,88300,16,88284
88586,17,-7,518,432264,17,432247
88587,14,0,617,652925,14,652911
88588,7,-1,816,611399,7,611392
88589,18,-9,599,371350,18,371332
88590,13,-8,538,401658,13,401645
88591,8,-2,611,575797,8,575789
88592,15,15,358,1119402,15,1119387
88593,13,16,961,1153976,13,1153963
88594,9,-16,338,131197,9,131188
88595,8,16,385,1133346,8,1133338
88596,15,-1,669,621699,15,621684
88597,8,2,292,694961,8,694953
88598,11,14,38,1085722,11,1085711
88599,12,-8,312,400084,12,400072
88600,10,2,352,696290,10,696280
88601,16,13,680,1058356,16,1058340
88602,19,6,964,843432,19,843413
88603,8,-4,593,512224,8,512216
88604,6,1,568,669743,6,669737
88605,19,5,457,807129,19,807110
88606,19,19,38,1241006,19,1240987
88607,7,16,800,1141817,7,1141810
88608,5,-9,240,348806,5,348801
88609,7,-14,947,207085,7,207078
88610,14,-1,421,619908,14,619894
88611,7,17,135,1158108,7,1158101
88612,9,4,312,757246,9,757237
88613,8,3,24,719328,8,719320
88614,9,-10,898,331795,9,331786
88615,8,15,543,1106056,8,1106048
88616,7,-14,38,187361,7,187354
88617,5,-9,940,364687,5,364682
88618,11,-4,597,526571,11,526560
88619,7,7,993,865852,7,865845
88620,8,-1,41,594720,8,594712
88621,15,-17,473,118989,15,118974
88622,18,-15,195,179155,18,179137
88623,12,-13,902,247739,12,247727
88624,12,9,993,936483,12,936471
88625,13,-12,424,275591,13,275578
88626,20,-3,19,553959,20,553939
88627,7,-19,751,48076,7,48069
88628,14,6,872,842733,14,842719
88629,18,-3,436,557100,18,557082
88630,17,19,866,1247808,17,1247791
88631,20,-20,37,21398,20,21378
88632,8,11,44,969391,8,969383
88633,8,-16,238,129267,8,129259
88634,16,-19,611,58794,16,58778
88635,16,-6,445,462517,16,462501
88636,7,-5,432,477337,7,477330
88637,15,-7,663,433082,15,433067
88638,16,-7,159,429467,16,429451
88639,20,-16,863,153307,20,153287
88640,10,6,274,818428,10,818418
88641,13,-4,624,526804,13,526791
88642,9,-13,156,221695,9,221686
88643,17,-12,1000,280129,17,280112
88644,18,12,280,1024197,18,1024179
88645,9,13,405,1039515,9,1039506
88646,10,9,628,920150,10,920140
88647,9,-1,498,604924,9,604915
88648,20,-6,558,463487,20,463467
88649,10,17,615,1168402,10,1168392
88650,15,17,368,1180719,15,1180704
88651,12,8,110,898807,12,898795
88652,19,10,560,964170,19,964151
88653,18,-18,461,88752,18,88734
88654,10,14,193,1066021,10,1066011
88655,15,-11,956,311200,15,311185
88656,20,14,274,1087553,20,1087533
88657,7,4,741,766777,7,766770
88658,19,-8,295,399959,19,399940
88659,14,-5,466,494498,14,494484
88660,18,-7,223,429970,18,429952
88661,15,-20,410,25914,15,25899
88662,12,-8,507,401397,12,401385
88663,18,-8,192,399255,18,399237
88664,7,7,793,861594,7,861587
88665,8,-10,978,333558,8,333550
88666,19,17,405,1180929,19,1180910
88667,18,-5,405,493985,18,493967
88668,19,-17,633,120251,19,120232
88669,12,-11,338,306441,12,306429
88670,20,7,398,869984,20,869964
88671,19,-1,809,622789,19,622770
88672,16,-13,981,248442,16,248426
88673,11,5,763,809328,11,809317
88674,6,5,314,788119,6,788113
88675,19,-17,455,118875,19,118856
88676,15,-12,456,275808,15,275793
88677,8,5,684,795867,8,795859
88678,6,-14,229,191768,6,191762
88679,11,17,89,1178505,11,1178494
88680,8,6,610,826093,8,826085
88681,5,19,490,1228668,5,1228663
88682,9,-3,45,531533,9,531524
88683,17,17,41,1178196,17,1178179
88684,20,0,647,653188,20,653168
88685,11,-11,275,305877,11,305866
88686,9,-15,364,163308,9,163299
88687,7,17,388,1163638,7,1163631
88688,13,-16,787,152705,13,152692
88689,12,12,615,1026580,12,1026568
88690,18,19,82,1241452,18,1241434
88691,8,9,159,910133,8,910125
88692,8,-14,147,189669,8,189661
88693,15,2,713,715990,15,715975
88694,13,8,240,899933,13,899920
88695,15,-14,436,212907,15,212892
88696,17,-18,2,85212,17,85195
88697,19,-2,761,590820,19,590801
88698,16,17,16,1177972,16,1177956
88699,7,13,24,1031319,7,1031312
88700,6,11,780,985166,6,985160
88701,14,1,522,684002,14,683988
88702,20,-3,834,560471,20,560451
88703,7,16,273,1130984,7,1130977
88704,8,2,463,698546,8,698538
88705,18,-2,955,592424,18,592406
88706,8,-3,320,537383,8,537375
88707,15,-5,734,496420,15,496405
88708,9,-12,576,262044,9,262035
88709,8,4,457,760475,8,760467
88710,7,-13,391,226564,7,226557
88711,6,-11,996,302616,6,302610
88712,13,-5,200,492419,13,492406
88713,13,7,859,873210,13,873197
88714,9,11,991,989682,9,989673
88715,10,-15,585,168035,10,168025
88716,14,-1,306,619012,14,618998
88717,5,3,578,731192,5,731187
88718,19,-2,600,589641,19,589622
88719,5,-3,987,552535,5,552530
88720,11,7,89,867659,11,867648
88721,9,11,419,977452,9,977443
88722,13,-18,541,89223,13,89210
88723,19,15,771,1122482,19,1122463
88724,18,3,426,745055,18,745037
88725,9,5,255,786969,9,786960
88726,16,-12,870,279020,16,279004
88727,17,14,417,1088716,17,1088699
88728,16,-15,864,184326,16,184310
88729,7,-12,939,270022,7,270015
88730,7,9,848,924842,7,924835
88731,18,-10,583,339407,18,339389
88732,17,-19,309,56379,17,56362
88733,14,-8,937,404518,14,404504
88734,10,-2,415,571567,10,571557
88735,14,6,241,837578,14,837564
88736,5,-11,366,289282,5,289277
88737,8,-3,914,550964,8,550956
88738,14,-19,685,59342,14,59328
88739,7,3,778,735566,7,735559
88740,17,4,995,780531,17,780514
88741,6,15,551,1106176,6,1106170
88742,17,3,842,748169,17,748152
88743,15,-14,355,212165,15,212150
88744,8,16,95,1127135,8,1127127
88745,17,16,680,1151980,17,1151963
88746,9,-6,188,441001,9,440992
88747,15,-2,735,590652,15,590637
88748,14,-11,281,305925,14,305911
88749,18,-5,308,493359,18,493341
88750,8,3,475,729000,8,728992
88751,17,6,573,840423,17,840406
88752,7,-19,791,48777,7,48770
88753,20,-2,182,586398,20,586378
88754,5,-4,275,505573,5,505568
88755,20,2,815,716543,20,716523
88756,18,-9,97,367347,18,367329
88757,11,14,272,1087527,11,1087516
88758,20,7,722,872259,20,872239
88759,5,12,660,1013490,5,1013485
88760,20,6,460,839432,20,839412
88761,14,19,713,1246559,14,1246545
88762,13,-7,167,429566,13,429553
88763,16,16,726,1152306,16,1152290
88764,7,-4,8,499533,7,499526
88765,12,-17,546,119609,12,119597
88766,10,19,170,1221271,10,1221261
88767,5,-19,394,40093,5,40088
88768,8,-18,983,83823,8,83815
88769,10,17,880,1174247,10,1174237
88770,13,5,110,804597,13,804584
88771,14,9,206,930588,14,930574
88772,17,-16,416,149996,17,149979
88773,19,-6,461,462714,19,462695
88774,5,-11,432,290774,5,290769
88775,13,2,120,711494,13,711481
88776,18,-12,551,276611,18,276593
88777,17,-12,378,275321,17,275304
88778,13,-3,470,557404,13,557391
88779,11,-18,991,92423,11,92412
88780,9,-18,875,81354,9,81345
88781,12,-7,913,435053,12,435041
88782,11,5,142,804824,11,804813
88783,13,-5,232,492681,13,492668
88784,11,14,595,1090028,11,1090017
88785,9,18,821,1204100,9,1204091
88786,12,-18,884,91608,12,91596
88787,6,13,699,1045775,6,1045769
88788,12,13,160,1054386,12,1054374
88789,9,10,309,944054,9,944045
88790,10,19,484,1228581,10,1228571
88791,8,0,546,637149,8,637141
88792,9,-3,708,546410,9,546401
88793,19,13,290,1055366,19,1055347
88794,7,-15,171,159063,7,159056
88795,9,-1,844,612003,9,611994
88796,7,5,661,795272,7,795265
88797,15,8,305,900383,15,900368
88798,16,3,685,747067,16,747051
88799,6,8,675,890031,6,890025
88800,17,-14,90,210058,17,210041
88801,18,16,477,1150546,18,1150528
88802,10,-6,632,450368,10,450358
88803,20,18,159,1210264,20,1210244
88804,7,9,564,918647,7,918640
88805,13,-10,69,335706,13,335693
88806,13,-7,383,431256,13,431243
88807,19,-16,690,151979,19,151960
88808,7,13,829,1048572,7,1048565
88809,11,16,243,1148831,11,1148820
88810,9,-18,867,81107,9,81098
88811,18,19,142,1241921,18,1241903
88812,5,13,640,1044520,5,1044515
88813,6,11,674,982788,6,982782
88814,11,-3,109,554569,11,554558
88815,14,5,191,805265,14,805251
88816,14,-4,985,529537,14,529523
88817,5,-16,791,141029,5,141024
88818,11,5,600,808194,11,808183
88819,12,7,195,868398,12,868386
88820,13,-1,237,618455,13,618442
88821,14,16,449,1150376,14,1150362
88822,8,-4,537,511088,8,511080
88823,9,15,769,1110797,9,1110788
88824,5,18,428,1195880,5,1195875
88825,10,-7,842,423733,10,423723
88826,6,-9,440,353361,6,353355
88827,7,16,388,1133415,7,1133408
88828,17,16,442,1150320,17,1150303
88829,10,0,343,632676,10,632666
88830,5,1,889,676299,5,676294
88831,5,-4,544,511274,5,511269
88832,17,16,603,1151362,17,1151345
88833,8,-4,470,509607,8,509599
88834,13,-6,919,466106,13,466093
88835,20,17,290,1180120,20,1180100
88836,10,-15,358,163158,10,163148
88837,20,-17,266,117446,20,117426
88838,12,0,800,654402,12,654390
88839,14,2,273,712607,14,712593
88840,17,10,941,967065,17,967048
88841,20,15,299,1119029,20,1119009
88842,6,-2,381,570795,6,570789
88843,10,11,948,988776,10,988766
88844,12,-19,452,57461,12,57449
88845,17,3,13,741911,17,741894
88846,7,-9,990,365392,7,365385
88847,6,13,255,1036035,6,1036029
88848,13,-10,597,339526,13,339513
88849,7,14,930,1082647,7,1082640
88850,17,-9,224,368171,17,368154
88851,13,12,3,1022144,13,1022131
88852,10,19,283,1223780,10,1223770
88853,5,8,450,885038,5,885033
88854,11,-4,433,525424,11,525413
88855,13,-6,763,464959,13,464946
88856,6,-16,164,127576,6,127570
88857,11,5,796,809555,11,809544
88858,9,-19,896,50894,9,50885
88859,14,-8,510,401441,14,401427
88860,12,-4,710,527424,12,527412
88861,6,3,954,739561,6,739555
88862,9,6,271,818336,9,818327
88863,10,16,353,1132694,10,1132684
88864,13,-19,388,57037,13,57024
88865,19,-3,821,560369,19,560350
88866,14,2,562,714815,14,714801
88867,16,6,624,840792,16,840776
88868,16,7,507,870778,16,870762
88869,7,-2,524,573904,7,573897
88870,18,17,892,1184664,18,1184646
88871,13,-16,176,148204,13,148191
88872,10,7,515,855838,10,855828
88873,18,-15,355,180368,18,180350
88874,16,16,574,1151148,16,1151132
88875,9,-20,20,522,9,513
88876,18,-7,666,433094,18,433076
88877,12,10,264,961818,12,961806
88878,14,7,977,873957,14,873943
88879,6,-12,384,257923,6,257917
88880,16,8,169,899299,16,899283
88881,18,3,963,749220,18,749202
88882,20,-16,197,148396,20,148376
88883,6,13,105,1032974,6,1032968
88884,11,9,929,936000,11,935989
88885,19,-13,951,248226,19,248207
88886,14,18,963,1216060,14,1216046
88887,18,14,597,1090048,18,1090030
88888,7,-8,925,395119,7,395112
88889,19,-9,49,367021,19,367002
88890,8,2,196,692918,8,692910
88891,14,15,341,1119291,14,1119277
88892,15,4,405,776120,15,776105
88893,15,16,291,1149238,15,1149223
88894,9,11,614,981624,9,981615
88895,19,-16,802,152791,19,152772
88896,15,-16,989,154217,15,154202
88897,15,8,570,902439,15,902424
88898,14,-19,406,57166,14,57152
88899,15,-1,227,618369,15,618354
88900,18,11,91,991527,18,991509
88901,19,-2,950,592379,19,592360
88902,5,2,6,688644,5,688639
88903,9,-2,77,564497,9,564488
88904,7,-11,414,290347,7,290340
88905,12,-18,101,86001,12,85989
88906,12,2,216,712216,12,712204
88907,13,-16,601,151440,13,151427
88908,17,19,201,1242375,17,1242358
88909,9,-12,509,260716,9,260707
88910,14,16,232,1148762,14,1148748
88911,20,-11,991,311459,20,311439
88912,8,13,173,1034358,8,1034350
88913,13,10,108,960709,13,960696
88914,11,7,245,868766,11,868755
88915,6,7,258,850354,6,850348
88916,16,10,704,965328,16,965312
88917,11,6,224,837442,11,837431
88918,12,11,649,995458,12,995446
88919,10,0,69,626794,10,626784
88920,5,-11,375,289516,5,289511
88921,18,-16,642,151728,18,151710
88922,6,-3,199,534665,6,534659
88923,7,1,174,660989,7,660982
88924,9,-17,973,113968,9,113959
88925,12,-1,118,617465,12,617453
88926,6,-16,724,139587,6,139581
88927,6,16,326,1132109,6,1132103
88928,15,-7,104,429054,15,429039
88929,7,13,90,1032690,7,1032683
88930,12,-4,383,525078,12,525066
88931,17,-9,28,366805,17,366788
88932,17,-18,222,87010,17,86993
88933,11,-2,96,585847,11,585836
88934,18,0,863,654790,18,654772
88935,8,4,812,768314,8,768306
88936,12,-16,751,152425,12,152413
88937,7,-9,728,359652,7,359645
88938,6,8,817,893004,6,892998
88939,7,-17,489,103965,7,103958
88940,14,-16,173,148162,14,148148
88941,9,17,473,1165449,9,1165440
88942,10,-7,315,412723,10,412713
88943,12,-9,165,367752,12,367740
88944,7,14,417,1071160,7,1071153
88945,9,-19,23,32004,9,31995
88946,5,6,134,815113,5,815108
88947,18,4,495,776795,18,776777
88948,18,3,955,749135,18,749117
88949,8,11,624,981811,8,981803
88950,17,-19,867,60675,17,60658
88951,17,6,21,835983,17,835966
88952,6,18,885,1205472,6,1205466
88953,13,-14,783,215662,13,215649
88954,15,-17,762,121280,15,121265
88955,16,11,41,991157,16,991141
88956,18,-13,509,244803,18,244785
88957,13,-14,373,212420,13,212407
88958,20,-15,854,184253,20,184233
88959,17,-13,355,243649,17,243632
88960,19,19,719,1246617,19,1246598
88961,8,-4,56,500511,8,500503
88962,19,15,551,1120781,19,1120762
88963,13,-16,966,154056,13,154043
88964,17,15,902,1123365,17,1123348
88965,8,12,152,1002413,8,1002405
88966,8,-3,441,540292,8,540284
88967,18,19,197,1242313,18,1242295
88968,17,-19,257,56023,17,56006
88969,15,13,411,1056314,15,1056299
88970,9,-18,168,66160,9,66151
88971,18,15,67,1117266,18,1117248
88972,15,0,822,654494,15,654479
88973,18,-9,29,366836,18,366818
88974,18,-6,649,464112,18,464094
88975,20,15,464,1120072,20,1120052
88976,16,11,873,997204,16,997188
88977,10,-13,343,225631,10,225621
88978,9,8,844,893510,9,893501
88979,18,-20,664,27922,18,27904
88980,7,-12,803,266853,7,266846
88981,7,17,19,1155652,7,1155645
88982,6,3,40,719681,6,719675
88983,7,-4,128,502204,7,502197
88984,6,5,510,792159,6,792153
88985,10,-10,25,313160,10,313150
88986,12,-2,453,588574,12,588562
88987,14,-11,718,309298,14,309284
88988,9,-10,899,331826,9,331817
88989,19,-10,608,339627,19,339608
88990,12,8,446,901539,12,901527
88991,14,19,34,1240985,14,1240971
88992,12,8,983,905591,12,905579
88993,17,-19,328,56515,17,56498
88994,12,0,82,648821,12,648809
88995,6,3,804,736180,6,736174
88996,7,-8,238,380589,7,380582
88997,6,-17,133,96211,6,96205
88998,10,-6,466,446785,10,446775
88999,19,7,321,869374,19,869355
89000,16,-1,905,623509,16,623493
89001,15,-15,722,183172,15,183157
89002,8,-10,113,315014,8,315006
89003,10,-10,834,330502,10,330492
89004,19,16,392,1149977,19,1149958
89005,9,10,0,937528,9,937519
89006,10,-11,372,289428,10,289418
89007,14,-10,412,338080,14,338066
89008,5,-9,480,354442,5,354437
89009,6,-10,104,314809,6,314803
89010,15,9,155,930209,15,930194
89011,19,-13,906,247801,19,247782
89012,11,-13,506,244775,11,244764
89013,12,-1,360,619509,12,619497
89014,11,10,379,962650,11,962639
89015,10,7,734,860342,10,860332
89016,5,1,388,665694,5,665689
89017,13,-13,706,246220,13,246207
89018,10,-17,828,111056,10,111046
89019,16,-15,732,183249,16,183233
89020,12,15,607,1121227,12,1121215
89021,6,0,682,640281,6,640275
89022,11,7,410,870077,11,870066
89023,15,-20,62,23262,15,23247
89024,13,-10,607,339608,13,339595
89025,13,-4,687,527279,13,527266
89026,6,-20,248,5561,6,5555
89027,19,-18,482,88876,19,88857
89028,16,7,230,868637,16,868621
89029,10,19,80,1219274,10,1219264
89030,8,-19,345,39009,8,39001
89031,8,-4,184,503466,8,503458
89032,11,-10,460,338452,11,338441
89033,9,5,270,787342,9,787333
89034,15,13,647,1058126,15,1058111
89035,7,-3,50,531635,7,531628
89036,15,-4,20,522201,15,522186
89037,8,-5,448,477643,8,477635
89038,7,-9,638,357725,7,357718
89039,9,2,107,690939,9,690930
89040,7,2,322,695593,7,695586
89041,5,-14,666,201328,5,201323
89042,14,-3,773,560010,14,559996
89043,17,-11,495,307701,17,307684
89044,13,-17,486,119102,13,119089
89045,9,6,326,819639,9,819630
89046,15,-5,434,494224,15,494209
89047,7,6,444,822474,7,822467
89048,6,10,144,940716,6,940710
89049,12,1,187,681373,12,681361
89050,14,13,211,1054810,14,1054796
89051,7,1,292,663513,7,663506
89052,18,14,570,1089874,18,1089856
89053,12,-13,567,245239,12,245227
89054,15,-4,714,527444,15,527429
89055,9,-15,493,166184,9,166175
89056,5,-16,918,143722,5,143717
89057,11,-10,514,338900,11,338889
89058,6,-15,224,160134,6,160128
89059,18,10,515,963830,18,963812
89060,12,-19,349,56724,12,56712
89061,16,-14,311,211812,16,211796
89062,14,-14,433,212890,14,212876
89063,11,-17,594,119976,11,119965
89064,18,1,149,681054,18,681036
89065,10,-3,983,552449,10,552439
89066,9,13,970,1051503,9,1051494
89067,19,6,207,837274,19,837255
89068,10,0,595,638275,10,638265
89069,17,-9,658,371693,17,371676
89070,14,1,990,687486,14,687472
89071,20,4,214,774822,20,774802
89072,14,4,736,778678,14,778664
89073,12,18,364,1211759,12,1211747
89074,18,5,312,806058,18,806040
89075,15,7,399,870003,15,869988
89076,18,1,942,687208,18,687190
89077,18,-12,656,277372,18,277354
89078,20,-15,995,185318,20,185298
89079,18,-7,247,430114,18,430096
89080,16,11,134,991783,16,991767
89081,20,-10,721,340490,20,340470
89082,7,-11,36,281822,7,281815
89083,7,0,332,632374,7,632367
89084,8,18,441,1196186,8,1196178
89085,6,-18,12,62720,6,62714
89086,14,-9,254,368445,14,368431
89087,18,16,918,1153712,18,1153694
89088,9,16,877,1143313,9,1143304
89089,17,12,514,1025806,17,1025789
89090,8,3,106,721189,8,721181
89091,17,8,874,904728,17,904711
89092,18,-5,616,495563,18,495545
89093,7,-12,646,263498,7,263491
89094,9,-7,154,409041,9,409032
89095,12,11,878,997238,12,997226
89096,18,-5,784,496701,18,496683
89097,10,15,343,1101856,10,1101846
89098,8,10,611,950699,8,950691
89099,18,-7,995,435725,18,435707
89100,16,-8,66,398452,16,398436
89101,14,2,505,714423,14,714409
89102,12,15,954,1123790,12,1123778
89103,12,16,905,1153566,12,1153554
89104,13,2,102,711354,13,711341
89105,19,-9,228,368230,19,368211
89106,10,-9,440,353371,10,353361
89107,17,-15,888,184500,17,184483
89108,20,13,947,1060254,20,1060234
89109,6,18,526,1198090,6,1198084
89110,8,-8,977,396387,8,396379
89111,7,8,127,877779,7,877772
89112,16,19,438,1244452,16,1244436
89113,13,16,441,1150304,13,1150291
89114,10,-6,991,457975,10,457965
89115,7,-7,657,419700,7,419693
89116,11,13,29,1053425,11,1053414
89117,15,-1,776,622547,15,622532
89118,14,4,247,775054,14,775040
89119,19,-17,672,120587,19,120568
89120,14,2,320,713011,14,712997
89121,10,-13,188,222448,10,222438
89122,5,-13,518,229367,5,229362
89123,9,-20,426,9092,9,9083
89124,9,-7,808,422911,9,422902
89125,6,9,105,908972,6,908966
89126,10,14,859,1081079,10,1081069
89127,11,-15,688,182856,11,182845
89128,15,3,282,744044,15,744029
89129,11,-2,391,587992,11,587981
89130,16,-20,322,25347,16,25331
89131,18,13,37,1053507,18,1053489
89132,7,-20,527,11385,7,11378
89133,16,-19,274,56130,16,56114
89134,10,14,706,1077884,10,1077874
89135,12,-8,121,398731,12,398719
89136,11,-11,223,305453,11,305442
89137,5,13,183,1034627,5,1034622
89138,6,-8,504,385906,6,385900
89139,9,-1,595,606889,9,606880
89140,11,-10,247,336876,11,336865
89141,20,-5,945,497964,20,497944
89142,18,18,311,1211344,18,1211326
89143,15,5,463,807185,15,807170
89144,11,6,931,843167,11,843156
89145,8,-1,700,608949,8,608941
89146,5,12,94,1001172,5,1001167
89147,15,-20,876,29548,15,29533
89148,5,-4,193,503642,5,503637
89149,7,-19,588,44432,7,44425
89150,11,-8,129,398787,11,398776
89151,19,-5,921,497803,19,497784
89152,13,-8,314,400092,13,400079
89153,17,-19,709,59526,17,59509
89154,17,-8,346,400339,17,400322
89155,18,-19,928,60996,18,60978
89156,13,-19,680,59310,13,59297
89157,9,15,828,1112030,9,1112021
89158,13,14,855,1092081,13,1092068
89159,19,-1,352,619418,19,619399
89160,15,-10,557,339222,15,339207
89161,20,-12,119,273427,20,273407
89162,13,-4,668,527146,13,527133
89163,14,4,46,773586,14,773572
89164,15,12,31,1022328,15,1022313
89165,8,-17,416,102265,8,102257
89166,11,-9,421,369870,11,369859
89167,20,14,158,1086736,20,1086716
89168,8,8,207,879723,8,879715
89169,8,13,397,1039323,8,1039315
89170,19,18,86,1209613,19,1209594
89171,5,-3,111,532837,5,532832
89172,11,5,707,808960,11,808949
89173,16,18,192,1210581,16,1210565
89174,14,-13,86,241665,14,241651
89175,14,10,522,963895,14,963881
89176,11,-1,691,621887,11,621876
89177,18,-18,623,89759,18,89741
89178,15,-15,515,181567,15,181552
89179,18,8,524,902139,18,902121
89180,18,7,536,870973,18,870955
89181,15,1,357,682720,15,682705
89182,9,-7,825,423253,9,423244
89183,15,-17,113,116411,15,116396
89184,5,14,55,1063045,5,1063040
89185,14,-2,388,587969,14,587955
89186,20,4,83,773856,20,773836
89187,6,7,424,853914,6,853908
89188,9,-5,79,469704,9,469695
89189,13,-5,716,496275,13,496262
89190,15,-3,452,557270,15,557255
89191,6,-12,335,256899,6,256893
89192,6,-2,465,572682,6,572676
89193,15,-18,444,88588,15,88573
89194,13,-15,715,183106,13,183093
89195,9,4,483,760948,9,760939
89196,10,13,649,1044736,10,1044726
89197,15,-9,482,370487,15,370472
89198,20,-13,897,247713,20,247693
89199,12,-20,834,29273,12,29261
89200,8,-2,783,579478,8,579470
89201,14,-16,609,151497,14,151483
89202,15,0,205,649803,15,649788
89203,20,-7,684,433276,20,433256
89204,16,15,512,1120508,16,1120492
89205,13,-1,438,620019,13,620006
89206,14,-3,468,557387,14,557373
89207,17,18,520,1212803,17,1212786
89208,10,-10,996,334070,10,334060
89209,7,13,498,1041468,7,1041461
89210,5,3,487,729269,5,729264
89211,19,6,691,841342,19,841323
89212,7,5,775,797805,7,797798
89213,18,-20,662,27903,18,27885
89214,11,3,941,749002,11,748991
89215,16,-5,401,493978,16,493962
89216,19,-11,804,309986,19,309967
89217,11,6,721,841619,11,841608
89218,14,-20,603,27386,14,27372
89219,12,4,353,775783,12,775771
89220,6,-18,289,68755,6,68749
89221,15,12,598,1026439,15,1026424
89222,12,-18,997,92467,12,92455
89223,17,-8,173,399153,17,399136
89224,11,-6,988,466667,11,466656
89225,13,13,561,1057464,13,1057451
89226,9,-17,505,104404,9,104395
89227,13,-2,938,592298,13,592285
89228,13,9,89,929692,13,929679
89229,14,-7,404,431407,14,431393
89230,6,11,985,989577,6,989571
89231,6,9,476,916680,6,916674
89232,12,-14,725,215158,12,215146
89233,20,14,771,1091519,20,1091499
89234,14,14,647,1090494,14,1090480
89235,13,17,505,1181698,13,1181685
89236,18,2,715,716007,18,715989
89237,10,19,726,1233663,10,1233653
89238,5,11,723,983937,5,983932
89239,14,-13,435,244203,14,244189
89240,20,-16,374,149655,20,149635
89241,10,-3,954,551926,10,551916
89242,10,8,896,894641,10,894631
89243,5,11,404,977209,5,977204
89244,19,-8,697,402844,19,402825
89245,13,18,21,1209041,13,1209028
89246,16,-1,281,618753,16,618737
89247,16,-17,112,116386,16,116370
89248,20,19,18,1240824,20,1240804
89249,13,2,775,716333,13,716320
89250,8,17,712,1170486,8,1170478
89251,7,8,954,895908,7,895901
89252,15,12,741,1027585,15,1027570
89253,19,-3,869,560759,19,560740
89254,13,-9,274,368581,13,368568
89255,19,-20,501,26588,19,26569
89256,20,11,968,997799,20,997779
89257,19,4,133,774213,19,774194
89258,19,-9,739,372283,19,372264
89259,11,-5,594,495436,11,495425
89260,16,-2,522,589093,16,589077
89261,15,9,479,932528,15,932513
89262,10,-4,170,503111,10,503101
89263,11,10,430,963115,11,963104
89264,19,-17,717,120923,19,120904
89265,6,-14,912,206399,6,206393
89266,19,-4,608,526663,19,526644
89267,18,-3,394,556687,18,556669
89268,9,-11,399,289996,9,289987
89269,14,14,498,1089361,14,1089347
89270,14,-1,272,618686,14,618672
89271,8,8,512,886484,8,886476
89272,17,9,907,935829,17,935812
89273,9,-18,114,64976,9,64967
89274,18,3,782,747715,18,747697
89275,17,2,57,710967,17,710950
89276,18,-5,456,494404,18,494386
89277,12,5,893,810270,12,810258
89278,6,-12,95,251600,6,251594
89279,15,-17,270,117478,15,117463
89280,10,-13,541,229831,10,229821
89281,11,14,576,1089911,11,1089900
89282,10,-2,664,576953,10,576943
89283,13,-4,383,525081,13,525068
89284,15,-17,541,119556,15,119541
89285,19,2,440,713959,19,713940
89286,19,-18,206,86900,19,86881
89287,11,3,331,744416,11,744405
89288,20,8,93,898664,20,898644
89289,13,16,906,1153584,13,1153571
89290,15,-17,290,117652,15,117637
89291,10,-16,396,132497,10,132487
89292,16,6,313,838159,16,838143
89293,9,8,971,896320,9,896311
89294,15,-17,518,119408,15,119393
89295,8,18,269,1192759,8,1192751
89296,6,-5,838,486135,6,486129
89297,6,6,509,823898,6,823892
89298,13,17,663,1182783,13,1182770
89299,7,5,327,788339,7,788332
89300,6,10,415,946416,6,946410
89301,14,-18,261,87340,14,87326
89302,10,18,18,1186949,10,1186939
89303,7,18,488,1197177,7,1197170
89304,5,8,464,885379,5,885374
89305,12,10,457,963307,12,963295
89306,12,7,319,869343,12,869331
89307,9,-6,786,453716,9,453707
89308,10,-10,202,317006,10,316996
89309,16,-11,331,306409,16,306393
89310,6,17,123,1157890,6,1157884
89311,9,5,362,789038,9,789029
89312,9,0,1,625199,9,625190
89313,11,2,514,714524,11,714513
89314,14,-13,440,244218,14,244204
89315,5,-18,684,77035,5,77030
89316,14,9,945,936126,14,936112
89317,18,9,109,929841,18,929823
89318,7,2,655,702470,7,702463
89319,9,1,829,674949,9,674940
89320,20,-4,303,524447,20,524427
89321,10,-4,336,506828,10,506818
89322,6,-5,581,480654,6,480648
89323,11,-20,186,24271,11,24260
89324,6,-9,259,349310,6,349304
89325,14,1,8,679803,14,679789
89326,19,-4,953,529248,19,529229
89327,6,0,372,633358,6,633352
89328,8,-13,63,219737,8,219729
89329,12,9,232,930728,12,930716
89330,10,-13,695,233032,10,233022
89331,12,12,633,1026732,12,1026720
89332,7,7,65,846243,7,846236
89333,6,-4,273,505519,6,505513
89334,19,-5,96,491662,19,491643
89335,19,12,136,1023039,19,1023020
89336,5,-17,319,100378,5,100373
89337,16,13,266,1055152,16,1055136
89338,19,-19,815,60261,19,60242
89339,17,-19,630,58985,17,58968
89340,18,-17,715,120891,18,120873
89341,20,-10,473,338644,20,338624
89342,5,12,187,1003264,5,1003259
89343,17,-1,340,619314,17,619297
89344,18,7,782,872665,18,872647
89345,6,14,658,1076703,6,1076697
89346,14,-20,133,23762,14,23748
89347,14,-4,745,527629,14,527615
89348,15,7,629,871617,15,871602
89349,12,-6,872,465680,12,465668
89350,17,-20,40,22932,17,22915
89351,20,10,904,966738,20,966718
89352,9,-10,382,320834,9,320825
89353,12,1,649,684974,12,684962
89354,14,8,384,901000,14,900986
89355,16,-19,198,55645,16,55629
89356,18,8,338,900647,18,900629
89357,20,16,825,1153038,20,1153018
89358,13,-17,904,122195,13,122182
89359,12,13,276,1055227,12,1055215
89360,10,4,719,766187,10,766177
89361,15,4,798,779108,15,779093
89362,8,4,199,754951,8,754943
89363,12,0,662,653309,12,653297
89364,19,-18,622,89741,19,89722
89365,14,14,344,1088115,14,1088101
89366,15,-3,94,554438,15,554423
89367,17,-17,553,119646,17,119629
89368,18,12,983,1029703,18,1029685
89369,5,16,409,1133975,5,1133970
89370,20,-2,165,586274,20,586254
89371,16,3,155,742992,16,742976
89372,10,16,454,1135000,10,1134990
89373,7,-14,709,202255,7,202248
89374,19,5,138,804789,19,804770
89375,6,19,621,1231422,6,1231416
89376,5,12,820,1016896,5,1016891
89377,17,-1,591,621188,17,621171
89378,20,1,883,686675,20,686655
89379,16,-3,197,555165,16,555149
89380,8,3,866,737594,8,737586
89381,7,-4,948,519745,7,519738
89382,6,-19,573,44108,6,44102
89383,14,10,563,964202,14,964188
89384,20,5,336,806257,20,806237
89385,5,-15,285,161500,5,161495
89386,8,-17,974,113995,8,113987
89387,13,5,273,805835,13,805822
89388,17,-3,933,561262,17,561245
89389,11,15,829,1122859,11,1122848
89390,12,18,76,1209548,12,1209536
89391,19,1,738,685614,19,685595
89392,17,-1,814,622827,17,622810
89393,15,-11,509,307812,15,307797
89394,17,9,631,933764,17,933747
89395,8,14,901,1081999,8,1081991
89396,15,-9,359,369339,15,369324
89397,14,-6,90,459754,14,459740
89398,13,-16,486,150593,13,150580
89399,16,-6,111,459920,16,459904
89400,19,-19,933,61022,19,61003
89401,17,8,900,904988,17,904971
89402,12,5,856,809985,12,809973
89403,5,-1,117,596334,5,596329
89404,7,7,818,862152,7,862145
89405,10,-15,303,161943,10,161933
89406,11,-18,519,89080,11,89069
89407,13,-5,64,491325,13,491312
89408,20,-8,967,404778,20,404758
89409,17,7,956,873788,17,873771
89410,6,-13,701,233206,6,233200
89411,6,0,11,625436,6,625430
89412,17,-2,766,590844,17,590827
89413,17,-15,139,178875,17,178858
89414,15,-19,729,59704,15,59689
89415,6,5,945,801672,6,801666
89416,18,0,393,651070,18,651052
89417,17,-18,315,87714,17,87697
89418,10,14,290,1068259,10,1068249
89419,16,9,147,930139,16,930123
89420,14,18,655,1213695,14,1213681
89421,11,7,298,869153,11,869142
89422,7,16,220,1129906,7,1129899
89423,11,-19,295,56292,11,56281
89424,9,-9,117,346081,9,346072
89425,16,15,749,1122372,16,1122356
89426,7,-7,186,409836,7,409829
89427,13,13,783,1059095,13,1059082
89428,20,-20,959,30048,20,30028
89429,10,3,788,735806,10,735796
89430,9,15,992,1115586,9,1115577
89431,20,-20,276,24921,20,24901
89432,13,-19,902,60837,13,60824
89433,12,-12,799,278364,12,278352
89434,16,-8,107,398660,16,398644
89435,8,0,618,638787,8,638779
89436,16,15,224,1118500,16,1118484
89437,18,-3,725,559553,18,559535
89438,18,14,628,1090329,18,1090311
89439,10,-11,953,301703,10,301693
89440,18,7,537,870988,18,870970
89441,15,3,261,743876,15,743861
89442,15,-18,649,89975,15,89960
89443,10,-2,421,571715,10,571705
89444,12,-11,142,304853,12,304841
89445,17,18,31,1209127,17,1209110
89446,20,12,859,1028524,20,1028504
89447,20,18,399,1212011,20,1211991
89448,12,-11,621,308684,12,308672
89449,7,14,300,1068462,7,1068455
89450,17,-16,67,147313,17,147296
89451,11,18,636,1213548,11,1213537
89452,15,10,908,966784,15,966769
89453,19,-6,769,465014,19,464995
89454,18,-16,843,153074,18,153056
89455,8,10,975,958391,8,958383
89456,12,10,698,965286,12,965274
89457,9,8,270,881051,9,881042
89458,20,17,875,1184545,20,1184525
89459,20,4,101,774038,20,774018
89460,9,-12,672,264089,9,264080
89461,15,13,590,1057733,15,1057718
89462,12,15,574,1120954,12,1120942
89463,15,-9,494,370592,15,370577
89464,8,11,507,979332,8,979324
89465,7,0,385,633717,7,633710
89466,17,-20,674,27989,17,27972
89467,17,-17,393,118380,17,118363
89468,8,15,857,1112715,8,1112707
89469,10,15,529,1105721,10,1105711
89470,13,-6,945,466303,13,466290
89471,9,-12,907,269434,9,269425
89472,14,13,738,1058730,14,1058716
89473,14,14,333,1088062,14,1088048
89474,5,-14,223,191548,5,191543
89475,20,-12,96,273222,20,273202
89476,8,-18,978,83725,8,83717
89477,13,3,438,745136,13,745123
89478,10,17,403,1163865,10,1163855
89479,11,-4,218,523792,11,523781
89480,11,-15,329,180147,11,180136
89481,18,-11,299,306095,18,306077
89482,5,-20,68,1483,5,1478
89483,7,-1,347,601718,7,601711
89484,14,12,184,1023397,14,1023383
89485,14,-16,38,147021,14,147007
89486,6,11,848,986640,6,986634
89487,16,12,571,1026222,16,1026206
89488,18,-11,422,307124,18,307106
89489,5,12,854,1017795,5,1017790
89490,8,-5,303,474791,8,474783
89491,9,13,375,1038772,9,1038763
89492,13,-16,519,150842,13,150829
89493,12,15,582,1120999,12,1120987
89494,15,15,945,1123708,15,1123693
89495,17,9,506,932767,17,932750
89496,18,8,595,902631,18,902613
89497,7,-13,67,219794,7,219787
89498,12,-14,679,214841,12,214829
89499,16,-5,480,494593,16,494577
89500,14,7,630,871623,14,871609
89501,9,6,907,832666,9,832657
89502,20,-18,896,91721,20,91701
89503,19,-7,439,431612,19,431593
89504,18,15,182,1118167,18,1118149
89505,5,7,985,865668,5,865663
89506,10,19,210,1222152,10,1222142
89507,16,15,647,1121528,16,1121512
89508,11,3,966,749261,11,749250
89509,19,0,501,651977,19,651958
89510,12,-4,565,526354,12,526342
89511,15,16,740,1152379,15,1152364
89512,11,6,299,838058,11,838047
89513,9,10,10,937711,9,937702
89514,6,-18,605,75393,6,75387
89515,6,14,41,1062746,6,1062740
89516,5,-15,495,166206,5,166201
89517,16,14,590,1089957,16,1089941
89518,13,-12,246,274312,13,274299
89519,11,1,279,682090,11,682079
89520,6,8,708,890847,6,890841
89521,12,19,547,1245268,12,1245256
89522,13,8,931,905203,13,905190
89523,16,-4,16,522171,16,522155
89524,13,-13,334,243514,13,243501
89525,16,-18,483,88893,16,88877
89526,8,-19,777,48596,8,48588
89527,17,-20,375,25695,17,25678
89528,10,17,954,1175751,10,1175741
89529,7,-9,484,354571,7,354564
89530,11,10,191,961305,11,961294
89531,5,6,543,824581,5,824576
89532,9,10,249,942715,9,942706
89533,5,-14,778,203685,5,203680
89534,16,-5,460,494448,16,494432
89535,12,-18,436,88525,12,88513
89536,7,5,47,782638,7,782631
89537,8,11,44,969399,8,969391
89538,20,0,122,649183,20,649163
89539,5,6,189,816308,5,816303
89540,18,-4,122,522972,18,522954
89541,19,10,939,967050,19,967031
89542,18,-20,795,28982,18,28964
89543,10,-9,868,363046,10,363036
89544,6,17,455,1165118,6,1165112
89545,13,-16,547,151025,13,151012
89546,16,12,119,1022917,16,1022901
89547,18,-9,413,369794,18,369776
89548,19,6,733,841720,19,841701
89549,5,9,891,925599,5,925594
89550,14,-20,539,26923,14,26909
89551,18,9,507,932784,18,932766
89552,17,8,720,903704,17,903687
89553,8,-17,462,103361,8,103353
89554,14,-17,786,121463,14,121449
89555,7,-13,522,229456,7,229449
89556,14,16,911,1153633,14,1153619
89557,16,-18,796,91033,16,91017
89558,20,-12,222,274153,20,274133
89559,15,8,683,903402,15,903387
89560,5,-10,234,317660,5,317655
89561,13,9,31,929294,13,929281
89562,11,-13,797,246961,11,246950
89563,5,3,410,727626,5,727621
89564,12,-11,60,304148,12,304136
89565,18,-18,955,92178,18,92160
89566,15,7,708,872165,15,872150
89567,13,-17,240,117241,13,117228
89568,17,-1,706,622017,17,622000
89569,17,19,52,1241157,17,1241140
89570,16,-16,979,154129,16,154113
89571,14,8,830,904415,14,904401
89572,11,19,169,1242106,11,1242095
89573,18,-9,339,369174,18,369156
89574,5,-18,913,82346,5,82341
89575,17,10,66,960345,17,960328
89576,5,18,229,1191781,5,1191776
89577,17,-4,90,522743,17,522726
89578,13,-19,78,54490,13,54477
89579,10,15,112,1096918,10,1096908
89580,11,5,627,808399,11,808388
89581,17,2,563,714823,17,714806
89582,9,17,449,1164952,9,1164943
89583,10,-5,561,480198,10,480188
89584,19,-10,494,338747,19,338728
89585,20,-2,776,590953,20,590933
89586,15,-7,762,433837,15,433822
89587,5,15,38,1095328,5,1095323
89588,11,-18,83,85850,11,85839
89589,16,5,367,806506,16,806490
89590,17,16,775,1152606,17,1152589
89591,20,0,338,650611,20,650591
89592,16,7,853,873154,16,873138
89593,13,-13,624,245698,13,245685
89594,20,-11,976,311369,20,311349
89595,11,5,671,808664,11,808653
89596,9,5,621,794553,9,794544
89597,11,6,292,837996,11,837985
89598,18,18,995,1216277,18,1216259
89599,13,-10,550,339173,13,339160
89600,6,-15,290,161643,6,161637
89601,17,-8,642,402369,17,402352
89602,12,-4,941,529140,12,529128
89603,15,-16,426,150078,15,150063
89604,15,13,924,1060100,15,1060085
89605,8,2,570,700642,8,700634
89606,14,5,147,804873,14,804859
89607,17,19,119,1241757,17,1241740
89608,18,-6,83,459665,18,459647
89609,19,14,443,1088922,19,1088903
89610,6,16,593,1137675,6,1137669
89611,5,-1,744,609817,5,609812
89612,5,-20,528,11418,5,11413
89613,13,-7,511,432177,13,432164
89614,8,12,162,1002658,8,1002650
89615,19,2,837,716766,19,716747
89616,17,0,15,648299,17,648282
89617,19,-4,696,527340,19,527321
89618,9,-7,833,423448,9,423439
89619,19,-6,580,463600,19,463581
89620,10,4,131,753419,10,753409
89621,5,13,398,1039327,5,1039322
89622,7,1,357,665033,7,665026
89623,18,2,282,712672,18,712654
89624,16,15,140,1117865,16,1117849
89625,17,-10,57,335607,17,335590
89626,16,-15,909,184658,16,184642
89627,18,9,634,933795,18,933777
89628,12,11,818,996782,12,996770
89629,18,-5,50,491229,18,491211
89630,10,4,219,755422,10,755412
89631,16,-7,60,428756,16,428740
89632,15,-10,250,336912,15,336897
89633,14,-3,997,561729,14,561715
89634,8,7,975,865391,8,865383
89635,12,-17,133,116468,12,116456
89636,15,-17,999,122764,15,122749
89637,8,16,952,1144985,8,1144977
89638,5,-9,571,356571,5,356566
89639,6,17,268,1161015,6,1161009
89640,12,-14,547,213709,12,213697
89641,13,-6,312,461598,13,461585
89642,12,9,51,929472,12,929460
89643,5,8,632,889066,5,889061
89644,9,6,488,823425,9,823416
89645,11,6,360,838546,11,838535
89646,5,7,903,863926,5,863921
89647,14,-16,862,153287,14,153273
89648,10,18,974,1207452,10,1207442
89649,7,12,698,1014442,7,1014435
89650,7,-2,678,577251,7,577244
89651,12,-11,414,307057,12,307045
89652,12,-1,462,620258,12,620246
89653,16,-1,869,623192,16,623176
89654,11,1,209,681540,11,681529
89655,11,-13,949,248217,11,248206
89656,15,17,398,1180899,15,1180884
89657,19,-15,351,180349,19,180330
89658,6,-13,899,237750,6,237744
89659,11,-9,646,371637,11,371626
89660,16,-14,377,212475,16,212459
89661,17,11,473,994321,17,994304
89662,9,19,58,1218705,9,1218696
89663,6,-19,243,36912,6,36906
89664,10,7,567,856859,10,856849
89665,9,-1,317,600960,9,600951
89666,8,-1,165,597286,8,597278
89667,13,-19,509,57926,13,57913
89668,19,-16,989,154226,19,154207
89669,15,-15,630,182435,15,182420
89670,5,19,13,1217720,5,1217715
89671,9,-14,36,187308,9,187299
89672,15,-3,26,554005,15,553990
89673,19,14,222,1087156,19,1087137
89674,7,16,195,1129332,7,1129325
89675,13,17,519,1181792,13,1181779
89676,20,10,293,962030,20,962010
89677,6,-17,128,96119,6,96113
89678,9,-15,339,162807,9,162798
89679,14,10,113,960763,14,960749
89680,7,-20,747,16449,7,16442
89681,19,-20,436,26098,19,26079
89682,19,1,536,684150,19,684131
89683,5,1,432,666591,5,666586
89684,9,7,406,853570,9,853561
89685,16,-16,249,148812,16,148796
89686,12,18,863,1215235,12,1215223
89687,14,12,204,1023526,14,1023512
89688,10,-3,910,550841,10,550831
89689,16,11,233,992461,16,992445
89690,18,-18,870,91548,18,91530
89691,8,-7,361,413781,8,413773
89692,18,5,808,809679,18,809661
89693,12,-1,22,616694,12,616682
89694,11,-2,91,585819,11,585808
89695,14,18,44,1209243,14,1209229
89696,16,12,457,1025399,16,1025383
89697,10,12,766,1015744,10,1015734
89698,8,-4,362,507520,8,507512
89699,10,-7,593,418574,10,418564
89700,10,-18,745,78516,10,78506
89701,12,-8,452,401028,12,401016
89702,17,2,553,714764,17,714747
89703,12,-14,103,210126,12,210114
89704,18,-8,448,400982,18,400964
89705,5,5,721,796664,5,796659
89706,11,9,174,930357,11,930346
89707,6,17,407,1163936,6,1163930
89708,13,-3,330,556207,13,556194
89709,13,14,937,1092798,13,1092785
89710,14,6,813,842312,14,842298
89711,10,12,326,1006325,10,1006315
89712,12,4,539,777166,12,777154
89713,6,-5,88,470014,6,470008
89714,14,-7,415,431453,14,431439
89715,8,-13,755,234546,8,234538
89716,20,9,909,935837,20,935817
89717,6,18,366,1194656,6,1194650
89718,20,-10,819,341246,20,341226
89719,12,-17,207,116992,12,116980
89720,12,13,334,1055709,12,1055697
89721,9,17,791,1172220,9,1172211
89722,15,12,81,1022654,15,1022639
89723,8,4,68,752111,8,752103
89724,6,17,342,1162761,6,1162755
89725,11,6,475,839588,11,839577
89726,8,1,932,677332,8,677324
89727,12,11,235,992502,12,992490
89728,15,1,7,679800,15,679785
89729,6,16,201,1129416,6,1129410
89730,5,18,518,1197906,5,1197901
89731,8,13,405,1039523,8,1039515
89732,13,-20,191,24348,13,24335
89733,6,11,789,985348,6,985342
89734,8,-10,776,329171,8,329163
89735,18,-13,158,242192,18,242174
89736,19,14,413,1088691,19,1088672
89737,18,14,199,1086975,18,1086957
89738,7,-4,887,518484,7,518477
89739,18,-13,314,243392,18,243374
89740,18,11,399,993837,18,993819
89741,12,12,74,1022575,12,1022563
89742,14,-11,342,306468,14,306454
89743,8,1,388,665702,8,665694
89744,17,-17,830,121716,17,121699
89745,6,4,735,766601,6,766595
89746,7,7,542,856366,7,856359
89747,17,11,712,995933,17,995916
89748,12,14,148,1086622,12,1086610
89749,14,5,161,804978,14,804964
89750,12,-10,257,336992,12,336980
89751,16,-2,878,591854,16,591838
89752,19,19,599,1245659,19,1245640
89753,5,-13,421,227103,5,227098
89754,8,-16,654,138162,8,138154
89755,17,0,4,648217,17,648200
89756,5,-16,102,126224,5,126219
89757,9,13,802,1048061,9,1048052
89758,12,14,502,1089390,12,1089378
89759,17,13,748,1058803,17,1058786
89760,15,2,565,714846,15,714831
89761,20,13,633,1058046,20,1058026
89762,8,14,579,1074714,8,1074706
89763,5,2,329,695727,5,695722
89764,12,16,310,1149381,12,1149369
89765,11,-6,895,465922,11,465911
89766,15,19,765,1246972,15,1246957
89767,15,7,61,867471,15,867456
89768,9,15,555,1106272,9,1106263
89769,18,-10,604,339600,18,339582
89770,6,16,431,1134510,6,1134504
89771,11,-7,509,432159,11,432148
89772,17,6,663,841110,17,841093
89773,7,-12,538,261292,7,261285
89774,17,-2,269,587149,17,587132
89775,16,17,45,1178228,16,1178212
89776,14,-14,588,214155,14,214141
89777,12,-11,791,309879,12,309867
89778,12,12,855,1028497,12,1028485
89779,16,15,313,1119098,16,1119082
89780,19,8,193,899467,19,899448
89781,10,-7,207,410273,10,410263
89782,14,12,491,1025687,14,1025673
89783,19,-12,845,278765,19,278746
89784,19,-13,183,242411,19,242392
89785,13,12,866,1028598,13,1028585
89786,17,14,819,1091881,17,1091864
89787,12,-8,651,402461,12,402449
89788,11,9,727,934387,11,934376
89789,5,4,545,762325,5,762320
89790,16,-9,352,369279,16,369263
89791,7,4,947,771321,7,771314
89792,20,-9,821,373054,20,373034
89793,7,-6,557,448882,7,448875
89794,19,8,983,905600,19,905581
89795,5,10,21,937959,5,937954
89796,14,18,169,1210314,14,1210300
89797,9,-19,88,33367,9,33358
89798,19,13,213,1054825,19,1054806
89799,5,-13,630,231842,5,231837
89800,5,-12,935,269910,5,269905
89801,19,3,708,747231,19,747212
89802,14,12,530,1025926,14,1025912
89803,5,-14,996,208195,5,208190
89804,12,-1,250,618501,12,618489
89805,10,-3,814,548633,10,548623
89806,5,-6,847,454893,5,454888
89807,11,5,597,808161,11,808150
89808,12,-15,707,183037,12,183025
89809,5,-18,336,69750,5,69745
89810,6,15,249,1099883,6,1099877
89811,14,-6,466,462731,14,462717
89812,17,-6,260,461209,17,461192
89813,6,4,25,751124,6,751118
89814,14,18,738,1214256,14,1214242
89815,5,-8,234,380481,5,380476
89816,8,18,611,1199669,8,1199661
89817,16,9,272,930916,16,930900
89818,17,11,928,997638,17,997621
89819,6,9,436,915880,6,915874
89820,15,18,843,1215101,15,1215086
89821,17,-19,404,57152,17,57135
89822,5,18,736,1202108,5,1202103
89823,20,14,37,1085713,20,1085693
89824,9,-4,792,516325,9,516316
89825,13,-17,261,117405,13,117392
89826,20,-1,710,622086,20,622066
89827,10,9,272,912342,10,912332
89828,20,5,984,811023,20,811003
89829,11,-12,801,278363,11,278352
89830,6,18,67,1188260,6,1188254
89831,6,19,677,1232505,6,1232499
89832,5,6,354,820268,5,820263
89833,20,6,456,839422,20,839402
89834,8,-3,967,552195,8,552187
89835,14,-10,417,338124,14,338110
89836,16,12,323,1024501,16,1024485
89837,19,-19,122,54994,19,54975
89838,16,-16,324,149362,16,149346
89839,11,19,75,1241389,11,1241378
89840,11,-16,178,148219,11,148208
89841,20,13,314,1055506,20,1055486
89842,6,0,2,625217,6,625211
89843,10,17,134,1158087,10,1158077
89844,9,-1,77,595464,9,595455
89845,14,6,489,839705,14,839691
89846,16,-3,749,559753,16,559737
89847,6,2,530,699843,6,699837
89848,14,-20,820,29162,14,29148
89849,20,5,298,806002,20,805982
89850,20,6,170,837030,20,837010
89851,18,-9,897,373691,18,373673
89852,12,-20,621,27506,12,27494
89853,8,13,347,1038278,8,1038270
89854,17,3,343,744492,17,744475
89855,20,-1,712,622108,20,622088
89856,17,1,76,680339,17,680322
89857,17,-1,888,623374,17,623357
89858,18,19,154,1242020,18,1242002
89859,6,2,160,692051,6,692045
89860,6,-11,24,281591,6,281585
89861,16,-9,815,373010,16,372994
89862,9,-12,778,266346,9,266337
89863,13,19,299,1243167,13,1243154
89864,14,-19,919,60931,14,60917
89865,11,7,868,873288,11,873277
89866,12,-9,683,371824,12,371812
89867,6,-2,581,575109,6,575103
89868,20,-4,438,525452,20,525432
89869,19,-16,74,147398,19,147379
89870,13,-8,668,402630,13,402617
89871,14,-12,967,279853,14,279839
89872,8,7,157,848172,8,848164
89873,6,7,467,854808,6,854802
89874,8,3,373,726895,8,726887
89875,18,5,919,810484,18,810466
89876,10,-3,825,548799,10,548789
89877,8,6,311,819221,8,819213
89878,10,-5,869,486933,10,486923
89879,20,-11,852,310391,20,310371
89880,13,17,837,1184241,13,1184228
89881,17,-8,670,402654,17,402637
89882,17,-15,625,182387,17,182370
89883,9,7,741,860497,9,860488
89884,10,-19,692,46739,10,46729
89885,13,-11,769,309730,13,309717
89886,18,-18,283,87448,18,87430
89887,8,11,774,985087,8,985079
89888,5,9,930,926541,5,926536
89889,15,-13,851,247374,15,247359
89890,11,-1,227,618370,11,618359
89891,18,14,559,1089816,18,1089798
89892,12,-11,344,306480,12,306468
89893,13,-19,99,54724,13,54711
89894,14,16,658,1151829,14,1151815
89895,8,-1,629,607499,8,607491
89896,19,-14,289,211663,19,211644
89897,8,-9,821,361898,8,361890
89898,8,-20,805,17904,8,17896
89899,8,1,452,667078,8,667070
89900,14,1,163,681151,14,681137
89901,8,17,122,1157865,8,1157857
89902,20,13,923,1060089,20,1060069
89903,7,9,20,907147,7,907140
89904,9,-6,339,444100,9,444091
89905,18,5,895,810283,18,810265
89906,9,1,300,663708,9,663699
89907,10,-2,324,569722,10,569712
89908,13,7,467,870483,13,870470
89909,12,15,313,1119100,12,1119088
89910,16,-6,300,461507,16,461491
89911,18,9,484,932613,18,932595
89912,7,-2,931,582777,7,582770
89913,6,18,803,1203758,6,1203752
89914,6,13,185,1034637,6,1034631
89915,5,-16,102,126229,5,126224
89916,13,14,355,1088185,13,1088172
89917,11,18,554,1213019,11,1213008
89918,9,-15,303,161952,9,161943
89919,10,-5,666,482402,10,482392
89920,10,14,469,1072278,10,1072268
89921,18,17,659,1182774,18,1182756
89922,6,18,360,1194481,6,1194475
89923,9,-10,32,313356,9,313347
89924,13,-3,919,561147,13,561134
89925,9,19,235,1222706,9,1222697
89926,11,-18,357,88001,11,87990
89927,17,-1,127,617526,17,617509
89928,5,-8,915,394935,5,394930
89929,16,2,637,715351,16,715335
89930,16,0,707,653677,16,653661
89931,10,4,668,765003,10,764993
89932,20,18,108,1209857,20,1209837
89933,18,5,178,805135,18,805117
89934,19,17,958,1185096,19,1185077
89935,5,-2,543,574228,5,574223
89936,14,-12,534,276514,14,276500
89937,17,10,496,963607,17,963590
89938,15,16,218,1148707,15,1148692
89939,19,19,507,1244967,19,1244948
89940,14,-15,895,184534,14,184520
89941,12,15,243,1118594,12,1118582
89942,6,-18,379,70581,6,70575
89943,6,4,20,750949,6,750943
89944,5,-12,383,257911,5,257906
89945,11,3,423,745038,11,745027
89946,20,3,950,749104,20,749084
89947,5,-6,162,440285,5,440280
89948,9,-10,962,333104,9,333095
89949,9,-9,4,343806,9,343797
89950,20,-13,52,241475,20,241455
89951,8,2,117,691111,8,691103
89952,8,-5,442,477559,8,477551
89953,8,-17,847,111404,8,111396
89954,16,-13,676,245905,16,245889
89955,20,-14,225,211129,20,211109
89956,12,19,235,1242574,12,1242562
89957,18,14,690,1090916,18,1090898
89958,12,-1,297,618923,12,618911
89959,16,-15,341,180282,16,180266
89960,10,-10,443,322238,10,322228
89961,16,16,402,1150019,16,1150003
89962,10,-18,755,78805,10,78795
89963,13,-8,624,402248,13,402235
89964,6,-15,771,171901,6,171895
89965,9,1,218,661989,9,661980
89966,8,-13,925,238362,8,238354
89967,11,12,174,1023312,11,1023301
89968,16,2,617,715186,16,715170
89969,18,2,985,717787,18,717769
89970,11,12,535,1025969,11,1025958
89971,14,5,146,804870,14,804856
89972,11,14,407,1088636,11,1088625
89973,7,3,600,731652,7,731645
89974,17,1,793,686032,17,686015
89975,7,-14,616,200251,7,200244
89976,14,5,330,806221,14,806207
89977,14,10,161,961129,14,961115
89978,19,8,538,902210,19,902191
89979,12,3,198,743383,12,743371
89980,19,-7,577,432672,19,432653
89981,16,-9,110,367404,16,367388
89982,19,-2,567,589417,19,589398
89983,7,-6,618,450122,7,450115
89984,15,11,998,998004,15,997989
89985,11,0,546,652362,11,652351
89986,11,-11,131,304737,11,304726
89987,14,-11,321,306323,14,306309
89988,13,-4,405,525265,13,525252
89989,11,0,125,649199,11,649188
89990,5,16,815,1142105,5,1142100
89991,15,19,641,1245996,15,1245981
89992,14,10,911,966856,14,966842
89993,14,-11,530,307987,14,307973
89994,13,16,708,1152144,13,1152131
89995,11,-16,202,148425,11,148414
89996,14,15,907,1123395,14,1123381
89997,7,-6,135,439609,7,439602
89998,17,-6,740,464831,17,464814
89999,14,12,279,1024184,14,1024170
90000,8,7,662,858805,8,858797
90001,12,-7,134,429265,12,429253
90002,10,9,647,920428,10,920418
90003,11,-18,207,86903,11,86892
90004,8,0,59,626567,8,626559
90005,9,-19,773,48547,9,48538
90006,18,-5,225,492634,18,492616
90007,19,-9,194,367930,19,367911
90008,6,7,382,853074,6,853068
90009,8,14,412,1071014,8,1071006
90010,18,-18,93,85961,18,85943
90011,6,-3,275,536348,6,536342
90012,6,-16,170,127624,6,127618
90013,14,-14,592,214213,14,214199
90014,18,0,324,650439,18,650421
90015,14,-5,472,494537,14,494523
90016,14,5,417,806796,14,806782
90017,6,-17,319,100384,6,100378
90018,18,14,532,1089620,18,1089602
90019,12,-18,232,87147,12,87135
90020,11,-19,367,56845,11,56834
90021,5,3,530,729942,5,729937
90022,9,-6,314,443612,9,443603
90023,17,0,122,649190,17,649173
90024,18,-1,906,623516,18,623498
90025,5,-7,284,411954,5,411949
90026,9,2,895,707242,9,707233
90027,15,14,729,1091175,15,1091160
90028,8,-5,486,478520,8,478512
90029,7,12,640,1013104,7,1013097
90030,13,14,515,1089480,13,1089467
90031,18,-7,1,428286,18,428268
90032,9,2,680,702982,9,702973
90033,6,13,837,1048772,6,1048766
90034,12,-2,48,585518,12,585506
90035,19,4,148,774358,19,774339
90036,19,-15,475,181297,19,181278
90037,17,-15,647,182604,17,182587
90038,8,0,942,645802,8,645794
90039,9,9,224,911588,9,911579
90040,20,15,933,1123596,20,1123576
90041,15,7,305,869233,15,869218
90042,5,-20,829,18406,5,18401
90043,5,-13,996,239947,5,239942
90044,6,3,641,732594,6,732588
90045,13,2,324,713045,13,713032
90046,11,-6,150,460266,11,460255
90047,10,2,982,709202,10,709192
90048,5,-13,953,239055,5,239050
90049,14,0,736,653943,14,653929
90050,10,-15,770,171896,10,171886
90051,20,18,250,1211007,20,1210987
90052,8,1,470,667471,8,667463
90053,18,4,439,776415,18,776397
90054,15,-6,540,463343,15,463328
90055,15,-7,17,428424,15,428409
90056,6,9,41,907666,6,907660
90057,14,10,332,962345,14,962331
90058,9,16,313,1131843,9,1131834
90059,16,-14,563,213909,16,213893
90060,8,12,998,1021079,8,1021071
90061,14,6,241,837582,14,837568
90062,10,-1,770,610397,10,610387
90063,7,17,179,1159014,7,1159007
90064,6,16,103,1127271,6,1127265
90065,16,14,541,1089701,16,1089685
90066,10,4,368,758527,10,758517
90067,5,16,882,1143437,5,1143432
90068,5,10,391,945853,5,945848
90069,19,16,203,1148566,19,1148547
90070,7,-17,498,104235,7,104228
90071,16,6,503,839858,16,839842
90072,13,-1,330,619198,13,619185
90073,11,6,550,840208,11,840197
90074,15,13,505,1056993,15,1056978
90075,5,12,834,1017233,5,1017228
90076,13,-18,8,85285,13,85272
90077,8,7,105,847093,8,847085
90078,9,-4,782,516166,9,516157
90079,20,4,277,775188,20,775168
90080,11,17,454,1181338,11,1181327
90081,9,17,558,1167187,9,1167178
90082,15,1,127,680847,15,680832
90083,9,19,940,1238334,9,1238325
90084,6,-4,244,504980,6,504974
90085,8,12,983,1020778,8,1020770
90086,16,-1,194,618011,16,617995
90087,10,8,678,890134,10,890124
90088,8,-8,435,384319,8,384311
90089,19,-11,541,308100,19,308081
90090,10,-15,735,171243,10,171233
90091,6,-9,381,351952,6,351946
90092,20,-9,736,372261,20,372241
90093,5,6,893,832347,5,832342
90094,12,19,971,1248567,12,1248555
90095,7,18,252,1192359,7,1192352
90096,18,-1,876,623283,18,623265
90097,18,-19,726,59662,18,59644
90098,9,-17,581,106081,9,106072
90099,8,10,407,946249,8,946241
90100,5,10,497,948091,5,948086
90101,5,6,141,815224,5,815219
90102,20,-3,882,560849,20,560829
90103,18,-10,45,335511,18,335493
90104,10,11,957,988925,10,988915
90105,9,14,819,1080318,9,1080309
90106,12,-4,45,522373,12,522361
90107,10,10,687,952370,10,952360
90108,5,16,897,1143757,5,1143752
90109,9,-18,740,78398,9,78389
90110,18,5,810,809696,18,809678
90111,6,8,83,876798,6,876792
90112,13,15,218,1118461,13,1118448
90113,10,-6,248,442244,10,442234
90114,10,-2,756,578854,10,578844
90115,19,-9,506,370661,19,370642
90116,5,-12,209,253989,5,253984
90117,17,19,256,1242788,17,1242771
90118,10,16,737,1140399,10,1140389
90119,5,0,858,643956,5,643951
90120,16,-7,36,428599,16,428583
90121,17,3,162,743044,17,743027
90122,18,-19,620,58891,18,58873
90123,18,14,935,1092761,18,1092743
90124,5,-7,325,412961,5,412956
90125,20,-3,337,556275,20,556255
90126,13,13,507,1057011,13,1056998
90127,8,-6,180,440844,8,440836
90128,17,17,443,1181246,17,1181229
90129,5,3,262,724553,5,724548
90130,18,2,36,710772,18,710754
90131,9,2,976,709060,9,709051
90132,10,-8,402,383827,10,383817
90133,17,-7,515,432224,17,432207
90134,14,-10,632,339762,14,339748
90135,7,-1,930,614057,7,614050
90136,15,-2,632,589883,15,589868
90137,11,-20,991,30376,11,30365
90138,16,-10,801,341162,16,341146
90139,12,2,647,715421,12,715409
90140,6,-17,135,96276,6,96270
90141,8,5,941,801497,8,801489
90142,15,-16,617,151600,15,151585
90143,8,3,127,721585,8,721577
90144,15,-1,410,619830,15,619815
90145,14,-11,931,310964,14,310950
90146,11,-19,72,54431,11,54420
90147,12,-9,650,371653,12,371641
90148,7,-4,705,514582,7,514575
90149,13,12,385,1024871,13,1024858
90150,13,13,762,1058958,13,1058945
90151,10,-18,699,77361,10,77351
90152,13,-10,732,340591,13,340578
90153,8,-7,852,423942,8,423934
90154,7,1,777,673914,7,673907
90155,13,16,10,1147163,13,1147150
90156,20,-20,597,27339,20,27319
90157,19,-4,273,524209,19,524190
90158,20,-13,1,241062,20,241042
90159,19,-13,26,241278,19,241259
90160,10,14,704,1077858,10,1077848
90161,17,6,512,839943,17,839926
90162,7,17,524,1166553,7,1166546
90163,11,16,847,1153167,11,1153156
90164,17,-15,743,183323,17,183306
90165,12,-14,70,209852,12,209840
90166,6,-20,525,11290,6,11284
90167,14,7,375,869759,14,869745
90168,19,3,317,744339,19,744320
90169,19,15,410,1119690,19,1119671
90170,11,5,426,806847,11,806836
90171,6,17,702,1170303,6,1170297
90172,11,13,68,1053745,11,1053734
90173,16,12,888,1028772,16,1028756
90174,7,-6,645,450684,7,450677
90175,12,5,79,804390,12,804378
90176,14,-20,305,25202,14,25188
90177,19,17,514,1181763,19,1181744
90178,18,-3,486,557551,18,557533
90179,14,-1,88,617245,14,617231
90180,6,-10,723,328219,6,328213
90181,20,-10,633,339809,20,339789
90182,7,12,839,1017396,7,1017389
90183,17,-8,26,398095,17,398078
90184,17,12,616,1026596,17,1026579
90185,8,-17,424,102473,8,102465
90186,18,-1,337,619273,18,619255
90187,12,5,383,806601,12,806589
90188,8,2,876,706833,8,706825
90189,15,13,112,1054053,15,1054038
90190,11,15,688,1121805,11,1121794
90191,15,-10,112,335931,15,335916
90192,19,-4,873,528608,19,528589
90193,9,18,471,1196842,9,1196833
90194,9,9,779,923188,9,923179
90195,8,12,684,1014174,8,1014166
90196,10,4,885,770129,10,770119
90197,11,-9,99,367357,11,367346
90198,12,2,322,713032,12,713020
90199,13,-10,457,338442,13,338429
90200,10,-8,43,376324,10,376314
90201,6,10,491,947937,6,947931
90202,10,-11,349,288836,10,288826
90203,14,0,514,652063,14,652049
90204,5,-13,893,237660,5,237655
90205,7,4,563,762728,7,762721
90206,14,19,243,1242638,14,1242624
90207,15,-18,833,91284,15,91269
90208,15,6,434,839246,15,839231
90209,12,4,477,776691,12,776679
90210,7,-20,959,21105,7,21098
90211,6,-3,702,546264,6,546258
90212,6,8,386,883609,6,883603
90213,20,10,881,966574,20,966554
90214,5,-11,350,288875,5,288870
90215,11,-15,806,183788,11,183777
90216,20,8,322,900511,20,900491
90217,9,-17,905,112679,9,112670
90218,13,5,217,805476,13,805463
90219,13,16,223,1148720,13,1148707
90220,18,-18,979,92336,18,92318
90221,13,-6,558,463490,13,463477
90222,9,-17,105,95683,9,95674
90223,17,-7,635,432975,17,432958
90224,18,-19,552,58347,18,58329
90225,6,1,128,660014,6,660008
90226,17,-14,310,211791,17,211774
90227,5,17,524,1166558,5,1166553
90228,9,17,478,1165565,9,1165556
90229,5,13,126,1033408,5,1033403
90230,6,-20,478,10253,6,10247
90231,9,-8,524,386410,9,386401
90232,6,-3,332,537736,6,537730
90233,8,-14,627,200539,8,200531
90234,5,3,248,724234,5,724229
90235,20,-19,792,60138,20,60118
90236,18,7,258,868905,18,868887
90237,7,-20,778,17157,7,17150
90238,16,19,110,1241658,16,1241642
90239,6,-16,137,127021,6,127015
90240,8,5,725,796758,8,796750
90241,6,-3,184,534338,6,534332
90242,8,-6,391,445167,8,445159
90243,10,3,666,733133,10,733123
90244,7,0,731,641436,7,641429
90245,10,8,857,893786,10,893776
90246,15,-13,717,246315,15,246300
90247,12,7,158,868198,12,868186
90248,9,6,783,829900,9,829891
90249,9,7,78,846498,9,846489
90250,13,6,840,842524,13,842511
90251,5,2,794,705156,5,705151
90252,14,16,309,1149369,14,1149355
90253,8,8,552,887328,8,887320
90254,6,16,744,1140608,6,1140602
90255,6,-9,458,353761,6,353755
90256,10,-12,278,255590,10,255580
90257,9,-3,43,531476,9,531467
90258,18,10,164,961146,18,961128
90259,13,1,50,680184,13,680171
90260,13,-14,827,215954,13,215941
90261,6,7,929,864432,6,864426
90262,14,-18,987,92385,14,92371
90263,13,16,391,1149969,13,1149956
90264,17,14,448,1088954,17,1088937
90265,12,-10,683,340223,12,340211
90266,12,-3,139,554776,12,554764
90267,20,-4,410,525304,20,525284
90268,14,-19,18,54027,14,54013
90269,11,-7,324,430806,11,430795
90270,6,13,100,1032886,6,1032880
90271,5,12,712,1014708,5,1014703
90272,7,-17,809,110727,7,110720
90273,9,0,623,638882,9,638873
90274,17,5,764,809345,17,809328
90275,16,-20,436,26104,16,26088
90276,8,-4,94,501436,8,501428
90277,6,0,226,630369,6,630363
90278,15,15,463,1120048,15,1120033
90279,9,8,272,881113,9,881104
90280,17,2,907,717245,17,717228
90281,17,-7,87,428911,17,428894
90282,16,7,13,867139,16,867123
90283,17,18,614,1213357,17,1213340
90284,5,-14,223,191553,5,191548
90285,15,3,78,742411,15,742396
90286,17,-2,770,590896,17,590879
90287,12,7,919,873583,12,873571
90288,14,-6,583,463609,14,463595
90289,9,2,508,699454,9,699445
90290,15,2,129,711592,15,711577
90291,10,-5,236,473232,10,473222
90292,17,0,16,648328,17,648311
90293,14,-5,804,496836,14,496822
90294,17,16,407,1150065,17,1150048
90295,16,-8,559,401774,16,401758
90296,8,-9,886,363482,8,363474
90297,13,-15,111,178614,13,178601
90298,11,11,356,993446,11,993435
90299,16,-14,781,215654,16,215638
90300,13,6,220,837368,13,837355
90301,11,-16,484,150587,11,150576
90302,12,-1,25,616707,12,616695
90303,9,-2,804,579996,9,579987
90304,18,10,73,960408,18,960390
90305,16,-4,192,523544,16,523528
90306,6,13,233,1035735,6,1035729
90307,20,19,44,1241071,20,1241051
90308,17,-9,310,368871,17,368854
90309,10,17,378,1163427,10,1163417
90310,16,15,719,1122134,16,1122118
90311,20,-11,559,308205,20,308185
90312,14,9,90,929695,14,929681
90313,18,-3,633,558864,18,558846
90314,10,-14,877,205582,10,205572
90315,20,3,444,745183,20,745163
90316,17,-13,211,242585,17,242568
90317,14,1,603,684591,14,684577
90318,9,-12,514,260805,9,260796
90319,13,2,321,713016,13,713003
90320,11,16,147,1148138,11,1148127
90321,16,9,356,931648,16,931632
90322,7,19,680,1232585,7,1232578
90323,20,-5,624,495596,20,495576
90324,16,-15,855,184258,16,184242
90325,11,-9,401,369678,11,369667
90326,15,1,831,686271,15,686256
90327,9,6,129,814942,9,814933
90328,14,16,231,1148759,14,1148745
90329,15,-10,330,337413,15,337398
90330,18,-10,932,342089,18,342071
90331,7,12,56,1000343,7,1000336
90332,19,-16,403,149859,19,149840
90333,14,1,579,684475,14,684461
90334,13,-14,960,216924,13,216911
90335,11,-9,598,371335,11,371324
90336,17,-10,122,336012,17,335995
90337,15,-4,656,527060,15,527045
90338,6,-16,960,144718,6,144712
90339,13,19,177,1242162,13,1242149
90340,15,-19,783,60078,15,60063
90341,13,-15,990,185261,13,185248
90342,6,18,73,1188375,6,1188369
90343,9,-1,278,599939,9,599930
90344,5,-2,97,564918,5,564913
90345,16,-17,143,116525,16,116509
90346,7,-6,495,447523,7,447516
90347,8,13,707,1045913,8,1045905
90348,13,-11,941,311060,13,311047
90349,14,-19,32,54130,14,54116
90350,12,7,225,868587,12,868575
90351,5,-14,377,195056,5,195051
90352,18,-14,630,214464,18,214446
90353,13,16,428,1150228,13,1150215
90354,14,3,970,749296,14,749282
90355,8,8,205,879661,8,879653
90356,13,-17,34,115802,13,115789
90357,17,-16,740,152316,17,152299
90358,16,-17,455,118881,16,118865
90359,18,-7,750,433709,18,433691
90360,8,-3,376,538670,8,538662
90361,20,-19,574,58565,20,58545
90362,8,-5,359,476010,8,476002
90363,6,-8,15,375700,6,375694
90364,13,17,415,1181014,13,1181001
90365,20,19,315,1243316,20,1243296
90366,17,6,172,837035,17,837018
90367,17,-3,456,557293,17,557276
90368,6,17,284,1161486,6,1161480
90369,12,19,77,1241411,12,1241399
90370,20,17,262,1179851,20,1179831
90371,18,-13,488,244622,18,244604
90372,5,6,694,828019,5,828014
90373,5,11,242,973433,5,973428
90374,12,-20,914,29794,12,29782
90375,19,-4,873,528617,19,528598
90376,12,-7,810,434198,12,434186
90377,14,2,689,715803,14,715789
90378,12,11,339,993342,12,993330
90379,12,-17,446,118791,12,118779
90380,7,7,871,863362,7,863355
90381,6,2,441,698066,6,698060
90382,6,-14,791,203890,6,203884
90383,11,-12,369,275266,11,275255
90384,5,-14,754,203164,5,203159
90385,9,19,75,1219167,9,1219158
90386,11,17,68,1178384,11,1178373
90387,10,13,794,1047827,10,1047817
90388,19,16,658,1151838,19,1151819
90389,19,7,280,869008,19,868989
90390,11,14,3,1085372,11,1085361
90391,14,11,724,996045,14,996031
90392,13,-7,306,430633,13,430620
90393,20,-6,938,466249,20,466229
90394,7,3,308,725673,7,725666
90395,12,-13,80,241623,12,241611
90396,20,-3,113,554595,20,554575
90397,17,-13,754,246614,17,246597
90398,10,-20,335,7443,10,7433
90399,20,-14,961,216942,20,216922
90400,16,-9,237,368295,16,368279
90401,14,-8,631,402320,14,402306
90402,13,11,989,997971,13,997958
90403,15,-15,811,183833,15,183818
90404,11,-9,151,367669,11,367658
90405,11,-20,176,24152,11,24141
90406,11,-17,115,116423,11,116412
90407,8,-7,482,416177,8,416169
90408,18,-7,36,428607,18,428589
90409,5,-4,105,501681,5,501676
90410,15,-6,958,466390,15,466375
90411,18,-4,803,528027,18,528009
90412,10,-4,79,501083,10,501073
90413,6,-18,119,65089,6,65083
90414,6,0,381,633612,6,633606
90415,5,-11,637,295210,5,295205
90416,10,-4,929,519310,10,519300
90417,9,-6,532,448288,9,448279
90418,19,1,28,680007,19,679988
90419,18,4,670,778133,18,778115
90420,19,7,456,870444,19,870425
90421,12,-5,291,493232,12,493220
90422,8,-10,383,320849,8,320841
90423,20,-9,689,371884,20,371864
90424,9,3,66,720208,9,720199
90425,5,-18,849,80696,5,80691
90426,11,13,248,1055028,11,1055017
90427,10,-19,188,35760,10,35750
90428,11,-18,883,91598,11,91587
90429,17,-17,513,119366,17,119349
90430,14,8,92,898630,14,898616
90431,6,14,544,1073948,6,1073942
90432,8,-1,856,612221,8,612213
90433,18,2,705,715944,18,715926
90434,8,-17,788,110345,8,110337
90435,12,-1,917,623581,12,623569
90436,18,18,250,1211015,18,1210997
90437,17,-9,467,370311,17,370294
90438,17,-10,467,338559,17,338542
90439,11,16,348,1149660,11,1149649
90440,13,14,97,1086247,13,1086234
90441,10,9,735,922189,10,922179
90442,9,10,50,938634,9,938625
90443,18,-6,744,464863,18,464845
90444,10,10,811,955098,10,955088
90445,17,6,783,842045,17,842028
90446,17,-17,453,118862,17,118845
90447,17,11,334,993331,17,993314
90448,16,-2,590,589556,16,589540
90449,8,12,47,1000139,8,1000131
90450,7,-7,123,408430,7,408423
90451,18,-12,506,276326,18,276308
90452,7,17,418,1164214,7,1164207
90453,11,17,561,1182019,11,1182008
90454,13,11,898,997406,13,997393
90455,10,-7,240,410874,10,410864
90456,18,-10,108,335911,18,335893
90457,5,18,691,1201237,5,1201232
90458,17,-4,584,526498,17,526481
90459,11,4,740,778704,11,778693
90460,19,-18,903,91776,19,91757
90461,15,7,75,867557,15,867542
90462,11,-3,480,557461,11,557450
90463,9,-20,292,6529,9,6520
90464,12,3,545,745837,12,745825
90465,18,-20,32,18865,18,18847
90466,13,10,557,964149,13,964136
90467,15,-18,238,87194,15,87179
90468,13,11,499,994478,13,994465
90469,18,-13,542,245021,18,245003
90470,14,-18,8,85289,14,85275
90471,10,-4,230,504626,10,504616
90472,11,18,508,1212687,11,1212676
90473,19,-11,202,305326,19,305307
90474,10,19,788,1234974,10,1234964
90475,7,6,325,819626,7,819619
90476,7,12,212,1003798,7,1003791
90477,19,14,303,1087778,19,1087759
90478,18,-2,255,587050,18,587032
90479,17,-5,802,496808,17,496791
90480,18,19,138,1241878,18,1241860
90481,13,-11,920,310902,13,310889
90482,14,-10,694,340331,14,340317
90483,9,-17,719,108919,9,108910
90484,8,4,223,755502,8,755494
90485,7,-11,510,292570,7,292563
90486,8,-7,348,413451,8,413443
90487,9,3,567,730867,9,730858
90488,7,-20,602,13183,7,13176
90489,14,-4,950,529181,14,529167
90490,12,-4,656,527062,12,527050
90491,5,-4,271,505495,5,505490
90492,16,0,776,654208,16,654192
90493,10,-10,72,314226,10,314216
90494,6,-14,71,188129,6,188123
90495,9,-8,451,384644,9,384635
90496,8,-12,595,262387,8,262379
90497,10,-17,607,106574,10,106564
90498,9,13,162,1034107,9,1034098
90499,20,12,14,1022198,20,1022178
90500,19,-4,219,523803,19,523784
90501,11,19,204,1242392,11,1242381
90502,9,-8,617,388482,9,388473
90503,6,0,64,626688,6,626682
90504,9,14,832,1080564,9,1080555
90505,9,11,870,987201,9,987192
90506,15,7,541,871045,15,871030
90507,13,1,429,683203,13,683190
90508,17,12,501,1025752,17,1025735
90509,16,-15,370,180498,16,180482
90510,18,-3,380,556634,18,556616
90511,19,7,688,872054,19,872035
90512,20,0,573,652605,20,652585
90513,9,11,188,972271,9,972262
90514,20,13,956,1060346,20,1060326
90515,6,-14,736,202726,6,202720
90516,17,12,483,1025618,17,1025601
90517,20,-11,155,304968,20,304948
90518,19,19,629,1245915,19,1245896
90519,6,-11,796,298208,6,298202
90520,9,19,712,1233274,9,1233265
90521,13,9,645,933831,13,933818
90522,5,-8,787,392203,5,392198
90523,9,-14,12,186723,9,186714
90524,14,4,34,773533,14,773519
90525,17,0,408,651161,17,651144
90526,11,-15,523,181589,11,181578
90527,13,-8,103,398644,13,398631
90528,13,-14,585,214121,13,214108
90529,9,-4,772,515936,9,515927
90530,6,-3,112,532842,6,532836
90531,8,18,300,1193308,8,1193300
90532,5,6,15,812536,5,812531
90533,16,-18,117,86096,16,86080
90534,6,14,357,1069681,6,1069675
90535,10,6,263,818126,10,818116
90536,10,-14,381,195119,10,195109
90537,15,8,407,901231,15,901216
90538,9,4,391,759078,9,759069
90539,15,19,111,1241685,15,1241670
90540,13,2,440,713962,13,713949
90541,14,-4,346,524819,14,524805
90542,12,7,977,873959,12,873947
90543,18,-16,13,146863,18,146845
90544,9,2,237,693680,9,693671
90545,17,-1,468,620316,17,620299
90546,14,-20,751,28597,14,28583
90547,10,16,535,1136573,10,1136563
90548,10,7,278,850731,10,850721
90549,5,6,165,815772,5,815767
90550,15,-20,408,25911,15,25896
90551,7,-7,943,425988,7,425981
90552,6,5,151,784680,6,784674
90553,9,-3,436,540123,9,540114
90554,19,3,306,744237,19,744218
90555,11,-17,83,116190,11,116179
90556,11,-15,906,184639,11,184628
90557,16,3,832,748063,16,748047
90558,10,-5,428,477254,10,477244
90559,17,4,594,777604,17,777587
90560,7,6,345,820143,7,820136
90561,9,9,192,910786,9,910777
90562,7,10,595,950343,7,950336
90563,18,-13,429,244172,18,244154
90564,9,-15,743,171379,9,171370
90565,8,-14,587,199500,8,199492
90566,16,19,618,1245821,16,1245805
90567,12,17,628,1182511,12,1182499
90568,8,9,905,926018,8,926010
90569,11,6,781,842020,11,842009
90570,8,-4,638,513166,8,513158
90571,18,10,912,966872,18,966854
90572,11,19,81,1241438,11,1241427
90573,8,6,130,814963,8,814955
90574,11,-4,367,524973,11,524962
90575,8,-14,228,191699,8,191691
90576,19,11,233,992470,19,992451
90577,13,2,317,712951,13,712938
90578,7,-20,322,7209,7,7202
90579,20,-18,734,90615,20,90595
90580,19,18,287,1211226,19,1211207
90581,8,-14,767,203482,8,203474
90582,8,14,276,1068010,8,1068002
90583,20,-7,463,431827,20,431807
90584,19,8,106,898771,19,898752
90585,15,12,25,1022273,15,1022258
90586,11,-8,611,402159,11,402148
90587,16,16,337,1149544,16,1149528
90588,13,-16,135,147939,13,147926
90589,10,-12,295,255976,10,255966
90590,9,3,309,725726,9,725717
90591,10,17,800,1172464,10,1172454
90592,15,3,827,748040,15,748025
90593,7,-10,855,330921,7,330914
90594,8,-12,703,264688,8,264680
90595,6,1,125,659929,6,659923
90596,19,-20,312,25299,19,25280
90597,17,16,959,1153920,17,1153903
90598,18,10,726,965464,18,965446
90599,12,-3,95,554469,12,554457
90600,5,1,192,661385,5,661380
90601,6,-20,147,3272,6,3266
90602,6,5,323,788296,6,788290
90603,17,-11,118,304662,17,304645
90604,9,-5,208,472558,9,472549
90605,9,-18,547,74215,9,74206
90606,10,3,793,735940,10,735930
90607,12,5,326,806170,12,806158
90608,20,-9,282,368656,20,368636
90609,7,-11,879,300014,7,300007
90610,17,6,673,841173,17,841156
90611,7,19,427,1227453,7,1227446
90612,9,14,844,1080789,9,1080780
90613,18,12,677,1027169,18,1027151
90614,15,-2,820,591345,15,591330
90615,8,1,952,677743,8,677735
90616,15,17,970,1185230,15,1185215
90617,18,-4,419,525365,18,525347
90618,12,-5,574,495257,12,495245
90619,20,-16,864,153332,20,153312
90620,7,-1,362,602046,7,602039
90621,20,-14,554,213766,20,213746
90622,7,-3,953,551897,7,551890
90623,7,-3,18,530956,7,530949
90624,20,13,497,1056926,20,1056906
90625,19,-20,695,28176,19,28157
90626,10,-9,789,361264,10,361254
90627,8,9,220,911501,8,911493
90628,15,-11,865,310506,15,310491
90629,12,-18,587,89502,12,89490
90630,6,2,535,700004,6,699998
90631,14,13,649,1058140,14,1058126
90632,19,-13,432,244199,19,244180
90633,18,-12,150,273661,18,273643
90634,5,-20,747,16454,5,16449
90635,18,-20,261,24773,18,24755
90636,8,-20,263,5817,8,5809
90637,14,19,900,1248087,14,1248073
90638,19,-8,786,403493,19,403474
90639,11,-6,300,461508,11,461497
90640,7,-8,209,379954,7,379947
90641,9,2,591,701059,9,701050
90642,16,-1,64,617028,16,617012
90643,12,-3,877,560799,12,560787
90644,14,5,91,804481,14,804467
90645,5,19,973,1239088,5,1239083
90646,5,-20,581,12688,5,12683
90647,14,-1,31,616781,14,616767
90648,11,18,979,1216177,11,1216166
90649,5,-20,550,12045,5,12040
90650,15,4,533,777122,15,777107
90651,15,19,454,1244562,15,1244547
90652,15,-16,211,148508,15,148493
90653,5,-2,797,579756,5,579751
90654,16,13,633,1058052,16,1058036
90655,9,-9,712,359268,9,359259
90656,8,-16,241,129348,8,129340
90657,10,1,136,660188,10,660178
90658,15,-17,233,117167,15,117152
90659,18,-15,463,181209,18,181191
90660,15,19,744,1246834,15,1246819
90661,11,-9,251,368430,11,368419
90662,17,6,698,841442,17,841425
90663,13,8,242,899952,13,899939
90664,17,6,567,840379,17,840362
90665,12,0,241,650038,12,650026
90666,15,-4,922,528970,15,528955
90667,11,10,12,959928,11,959917
90668,7,-14,884,205690,7,205683
90669,6,-1,793,610918,6,610912
90670,10,10,563,949569,10,949559
90671,18,2,996,717834,18,717816
90672,15,17,888,1184595,15,1184580
90673,18,-10,849,341476,18,341458
90674,14,-2,400,588087,14,588073
90675,15,-12,330,275003,15,274988
90676,13,-11,547,308127,13,308114
90677,20,-8,613,402186,20,402166
90678,5,13,932,1050691,5,1050686
90679,15,7,20,867164,15,867149
90680,11,-1,711,622086,11,622075
90681,8,-1,757,610062,8,610054
90682,6,9,980,927673,6,927667
90683,13,5,978,810983,13,810970
90684,19,-11,796,309921,19,309902
90685,15,-9,201,367985,15,367970
90686,10,12,484,1009526,10,1009516
90687,13,-8,207,399354,13,399341
90688,6,-15,483,165931,6,165925
90689,12,-9,314,368915,12,368903
90690,12,-8,223,399504,12,399492
90691,10,-19,726,47463,10,47453
90692,17,-19,364,56820,17,56803
90693,6,-9,492,354815,6,354809
90694,18,-11,86,304362,18,304344
90695,17,3,705,747207,17,747190
90696,17,19,889,1247987,17,1247970
90697,13,6,911,843046,13,843033
90698,15,-4,857,528387,15,528372
90699,17,3,919,748773,17,748756
90700,10,-7,147,408895,10,408885
90701,19,-19,243,55956,19,55937
90702,20,16,539,1150928,20,1150908
90703,12,19,740,1246808,12,1246796
90704,15,10,814,966195,15,966180
90705,11,-2,42,585472,11,585461
90706,17,10,568,964264,17,964247
90707,17,-1,776,622554,17,622537
90708,20,-16,861,153278,20,153258
90709,16,-7,992,435663,16,435647
90710,7,17,887,1174359,7,1174352
90711,6,-18,49,63430,6,63424
90712,19,1,906,686917,19,686898
90713,17,-3,648,558953,17,558936
90714,8,5,44,782533,8,782525
90715,13,16,240,1148819,13,1148806
90716,17,5,666,808647,17,808630
90717,17,19,331,1243454,17,1243437
90718,6,-6,602,449808,6,449802
90719,6,13,220,1035461,6,1035455
90720,6,3,550,730398,6,730392
90721,13,18,26,1209085,13,1209072
90722,20,14,669,1090690,20,1090670
90723,9,-3,62,531810,9,531801
90724,13,-6,606,463774,13,463761
90725,16,-20,763,28669,16,28653
90726,13,11,180,992089,13,992076
90727,10,8,831,893255,10,893245
90728,14,-1,392,619692,14,619678
90729,20,2,860,716918,20,716898
90730,6,0,391,633876,6,633870
90731,7,-14,764,203363,7,203356
90732,6,-13,155,221661,6,221655
90733,8,1,344,664767,8,664759
90734,20,6,486,839679,20,839659
90735,14,-8,245,399659,14,399645
90736,11,6,478,839605,11,839594
90737,7,7,668,858999,7,858992
90738,13,-8,128,398777,13,398764
90739,13,1,176,681256,13,681243
90740,8,4,417,759660,8,759652
90741,12,8,321,900484,12,900472
90742,15,2,51,710911,15,710896
90743,15,-14,62,209776,15,209761
90744,13,-17,830,121719,13,121706
90745,16,-3,909,561082,16,561066
90746,16,-20,587,27269,16,27253
90747,20,0,420,651313,20,651293
90748,11,-10,621,339701,11,339690
90749,17,-8,812,403713,17,403696
90750,20,17,692,1183055,20,1183035
90751,11,19,668,1246191,11,1246180
90752,7,6,162,815684,7,815677
90753,15,0,15,648304,15,648289
90754,16,14,786,1091648,16,1091632
90755,18,-9,686,371836,18,371818
90756,17,-9,660,371703,17,371686
90757,7,13,800,1047974,7,1047967
90758,15,18,87,1209617,15,1209602
90759,16,8,201,899569,16,899553
90760,12,-7,64,428763,12,428751
90761,20,-4,316,524569,20,524549
90762,20,-10,612,339661,20,339641
90763,10,1,564,669655,10,669645
90764,19,19,259,1242814,19,1242795
90765,9,-13,89,220312,9,220303
90766,12,-3,998,561730,12,561718
90767,9,-13,61,219712,9,219703
90768,9,17,437,1164639,9,1164630
90769,18,-14,320,211893,18,211875
90770,8,1,606,670489,8,670481
90771,9,-16,178,127856,9,127847
90772,12,15,874,1123169,12,1123157
90773,17,12,296,1024339,17,1024322
90774,18,-10,336,337501,18,337483
90775,12,12,822,1028182,12,1028170
90776,18,8,532,902182,18,902164
90777,19,-10,764,340843,19,340824
90778,12,-9,871,373487,12,373475
90779,6,-19,996,52792,6,52786
90780,13,-3,512,557754,13,557741
90781,5,-19,224,36508,5,36503
90782,10,-14,91,188601,10,188591
90783,18,-8,489,401231,18,401213
90784,6,-1,828,611671,6,611665
90785,11,3,818,747993,11,747982
90786,14,-16,869,153388,14,153374
90787,8,0,361,633070,8,633062
90788,19,7,108,867824,19,867805
90789,14,-5,697,496121,14,496107
90790,15,18,81,1209575,15,1209560
90791,17,-15,585,182096,17,182079
90792,19,19,852,1247654,19,1247635
90793,5,10,858,955984,5,955979
90794,8,2,325,695665,8,695657
90795,16,18,840,1215088,16,1215072
90796,17,6,423,839158,17,839141
90797,15,-18,495,88927,15,88912
90798,16,11,274,992839,16,992823
90799,11,19,176,1242146,11,1242135
90800,13,-10,798,341130,13,341117
90801,6,-3,145,533555,6,533549
90802,6,18,735,1202059,6,1202053
90803,20,-19,430,57298,20,57278
90804,6,-9,890,363614,6,363608
90805,12,-18,839,91301,12,91289
90806,16,-5,216,492572,16,492556
90807,7,-16,639,137891,7,137884
90808,19,1,528,684043,19,684024
90809,12,19,129,1241814,12,1241802
90810,15,3,946,749067,15,749052
90811,15,9,556,933156,15,933141
90812,17,12,893,1028816,17,1028799
90813,18,17,327,1180442,18,1180424
90814,8,16,169,1128688,8,1128680
90815,18,18,706,1214049,18,1214031
90816,7,-3,53,531676,7,531669
90817,14,0,146,649311,14,649297
90818,13,-19,996,61430,13,61417
90819,11,-12,545,276568,11,276557
90820,8,7,39,845671,8,845663
90821,7,-20,533,11543,7,11536
90822,15,18,678,1213856,15,1213841
90823,18,-14,376,212454,18,212436
90824,8,-8,587,387711,8,387703
90825,19,-18,704,90368,19,90349
90826,8,2,353,696326,8,696318
90827,18,9,576,933316,18,933298
90828,15,18,997,1216289,15,1216274
90829,15,4,360,775833,15,775818
90830,12,8,261,900012,12,900000
90831,5,-13,252,223720,5,223715
90832,5,-13,74,219997,5,219992
90833,6,12,79,1000808,6,1000802
90834,13,-20,873,29532,13,29519
90835,10,-9,365,351661,10,351651
90836,10,11,506,979292,10,979282
90837,7,-9,104,345804,7,345797
90838,6,12,248,1004572,6,1004566
90839,20,18,577,1213147,20,1213127
90840,16,19,803,1247294,16,1247278
90841,5,-13,349,225721,5,225716
90842,10,1,882,676164,10,676154
90843,19,-12,698,277646,19,277627
90844,9,-3,470,541036,9,541027
90845,18,1,388,682967,18,682949
90846,5,8,153,878375,5,878370
90847,12,-15,981,185234,12,185222
90848,7,1,451,667021,7,667014
90849,14,-4,384,525086,14,525072
90850,10,1,699,672258,10,672248
90851,18,-3,339,556298,18,556280
90852,19,-8,138,398874,19,398855
90853,5,19,244,1222883,5,1222878
90854,6,13,292,1037019,6,1037013
90855,12,10,788,965933,12,965921
90856,12,-6,447,462542,12,462530
90857,17,19,497,1244871,17,1244854
90858,16,-18,575,89429,16,89413
90859,5,-10,13,312828,5,312823
90860,10,-12,946,270185,10,270175
90861,8,19,312,1224575,8,1224567
90862,15,14,966,1092975,15,1092960
90863,5,-2,237,567850,5,567845
90864,6,10,909,957062,6,957056
90865,20,-18,729,90573,20,90553
90866,8,11,658,982479,8,982471
90867,20,-18,20,85367,20,85347
90868,18,9,698,934209,18,934191
90869,6,8,869,894031,6,894025
90870,10,18,784,1203331,10,1203321
90871,6,13,753,1046921,6,1046915
90872,8,2,966,708870,8,708862
90873,10,-10,388,320946,10,320936
90874,11,-7,614,432835,11,432824
90875,14,8,862,904664,14,904650
90876,18,12,742,1027592,18,1027574
90877,19,-20,292,25079,19,25060
90878,10,-4,527,510927,10,510917
90879,14,9,329,931417,14,931403
90880,17,-1,449,620126,17,620109
90881,5,4,886,770151,5,770146
90882,7,6,37,813057,7,813050
90883,10,2,427,697819,10,697809
90884,18,14,363,1088262,18,1088244
90885,19,13,366,1055927,19,1055908
90886,15,-7,673,433164,15,433149
90887,12,18,404,1212031,12,1212019
90888,18,6,498,839780,18,839762
90889,9,11,121,971011,9,971002
90890,9,-15,262,160999,9,160990
90891,6,11,855,986822,6,986816
90892,6,16,184,1129102,6,1129096
90893,12,19,662,1246141,12,1246129
90894,6,-2,997,584063,6,584057
90895,8,-9,888,363538,8,363530
90896,18,-12,958,279757,18,279739
90897,13,-11,695,309190,13,309177
90898,5,-13,686,232833,5,232828
90899,18,-9,784,372764,18,372746
90900,6,5,415,790082,6,790076
90901,12,-17,742,121150,12,121138
90902,13,-15,21,177965,13,177952
90903,8,-15,255,160886,8,160878
90904,11,13,682,1058369,11,1058358
90905,13,-1,579,621122,13,621109
90906,12,-20,795,28984,12,28972
90907,12,0,801,654410,12,654398
90908,16,12,991,1029738,16,1029722
90909,17,9,648,933841,17,933824
90910,16,-11,658,308975,16,308959
90911,12,-4,677,527208,12,527196
90912,19,2,141,711694,19,711675
90913,11,-6,0,459145,11,459134
90914,11,2,509,714465,11,714454
90915,7,-14,849,204991,7,204984
90916,13,-20,753,28609,13,28596
90917,5,-17,691,108309,5,108304
90918,13,19,379,1243850,13,1243837
90919,17,-3,208,555251,17,555234
90920,17,6,488,839699,17,839682
90921,13,-6,53,459504,13,459491
90922,8,1,692,672120,8,672112
90923,15,-10,134,336140,15,336125
90924,10,-16,413,132926,10,132916
90925,17,-5,609,495535,17,495518
90926,12,6,278,837923,12,837911
90927,5,-8,178,379334,5,379329
90928,11,-16,827,152979,11,152968
90929,16,17,267,1179925,16,1179909
90930,6,-15,82,157142,6,157136
90931,11,-18,375,88110,11,88099
90932,12,-13,814,247089,12,247077
90933,5,13,575,1043151,5,1043146
90934,15,-10,595,339508,15,339493
90935,5,19,30,1218093,5,1218088
90936,17,12,499,1025724,17,1025707
90937,5,-20,187,4416,5,4411
90938,15,-11,57,304131,15,304116
90939,8,1,849,675474,8,675466
90940,7,-1,520,605380,7,605373
90941,16,-17,256,117365,16,117349
90942,6,-2,965,583491,6,583485
90943,17,-11,734,309415,17,309398
90944,11,-15,823,183943,11,183932
90945,10,-20,70,1559,10,1549
90946,15,2,921,717328,15,717313
90947,15,-8,999,405028,15,405013
90948,8,-18,467,72495,8,72487
90949,15,-17,78,116108,15,116093
90950,19,-2,26,585331,19,585312
90951,20,4,830,779432,20,779412
90952,20,-8,564,401836,20,401816
90953,19,-11,638,308812,19,308793
90954,9,13,364,1038560,9,1038551
90955,8,-10,504,323657,8,323649
90956,19,-19,714,59561,19,59542
90957,10,2,170,692329,10,692319
90958,15,-14,409,212764,15,212749
90959,11,-6,557,463478,11,463467
90960,19,-14,575,214066,19,214047
90961,6,17,152,1158408,6,1158402
90962,7,-9,771,360830,7,360823
90963,7,-4,76,501008,7,501001
90964,14,-5,960,498068,14,498054
90965,8,-9,494,354901,8,354893
90966,6,-9,54,344811,6,344805
90967,17,19,112,1241691,17,1241674
90968,20,10,340,962391,20,962371
90969,10,-4,68,500821,10,500811
90970,20,-9,176,367792,20,367772
90971,16,-3,898,561002,16,560986
90972,7,11,33,969212,7,969205
90973,15,-2,691,590360,15,590345
90974,15,19,215,1242452,15,1242437
90975,5,-12,662,263937,5,263932
90976,5,-9,82,345439,5,345434
90977,13,-12,627,277074,13,277061
90978,6,-8,197,379699,6,379693
90979,20,-9,259,368500,20,368480
90980,19,-3,607,558585,19,558566
90981,6,-10,155,316027,6,316021
90982,14,-2,86,585789,14,585775
90983,5,16,109,1127361,5,1127356
90984,8,3,723,734556,8,734548
90985,12,-13,342,243589,12,243577
90986,15,6,323,838297,15,838282
90987,6,-12,118,252128,6,252122
90988,16,-2,693,590375,16,590359
90989,11,-17,731,121044,11,121033
90990,19,-15,852,184231,19,184212
90991,20,-13,679,245945,20,245925
90992,14,0,62,648694,14,648680
90993,13,9,298,931133,13,931120
90994,5,5,43,782521,5,782516
90995,15,-18,150,86409,15,86394
90996,12,3,49,742189,12,742177
90997,5,-4,613,512636,5,512631
90998,13,5,79,804393,13,804380
90999,18,2,548,714739,18,714721
91000,10,7,818,862162,10,862152
91001,11,9,901,935755,11,935744
91002,15,-5,1,490765,15,490750
91003,14,2,179,711951,14,711937
91004,7,7,406,853577,7,853570
91005,5,6,967,834042,5,834037
91006,14,-8,345,400328,14,400314
91007,20,-15,686,182850,20,182830
91008,9,-15,979,176306,9,176297
91009,19,9,49,929448,19,929429
91010,10,2,824,705805,10,705795
91011,19,8,409,901256,19,901237
91012,17,15,806,1122663,17,1122646
91013,12,-1,201,618068,12,618056
91014,5,14,424,1071336,5,1071331
91015,20,1,608,684645,20,684625
91016,6,6,109,814589,6,814583
91017,7,-5,5,467883,7,467876
91018,17,-13,319,243433,17,243416
91019,6,2,815,705580,6,705574
91020,12,-6,776,465089,12,465077
91021,6,14,248,1067354,6,1067348
91022,9,3,747,735012,9,735003
91023,16,-6,956,466370,16,466354
91024,13,17,43,1178221,13,1178208
91025,6,-15,657,169636,6,169630
91026,10,-3,545,542794,10,542784
91027,14,-4,906,528891,14,528877
91028,10,-20,346,7635,10,7625
91029,5,5,702,796254,5,796249
91030,19,7,165,868213,19,868194
91031,6,-4,943,519686,6,519680
91032,18,-17,84,116199,18,116181
91033,14,16,971,1154087,14,1154073
91034,15,-5,642,495718,15,495703
91035,9,3,56,720025,9,720016
91036,9,11,317,975167,9,975158
91037,8,13,64,1032148,8,1032140
91038,15,5,193,805274,15,805259
91039,9,7,105,847102,9,847093
91040,11,5,869,810100,11,810089
91041,10,-17,583,106098,10,106088
91042,13,-2,464,588635,13,588622
91043,12,-14,401,212702,12,212690
91044,18,13,683,1058381,18,1058363
91045,13,13,474,1056730,13,1056717
91046,16,-13,906,247807,16,247791
91047,5,-10,249,317994,5,317989
91048,18,-12,10,272604,18,272586
91049,5,-8,584,387636,5,387631
91050,8,0,634,639158,8,639150
91051,15,-8,460,401060,15,401045
91052,18,-4,300,524415,18,524397
91053,11,-18,67,85732,11,85721
91054,5,7,320,851686,5,851681
91055,19,-5,706,496194,19,496175
91056,16,15,349,1119362,16,1119346
91057,13,4,627,777836,13,777823
91058,16,19,824,1247426,16,1247410
91059,6,0,691,640506,6,640500
91060,12,-2,87,585790,12,585778
91061,15,-17,428,118611,15,118596
91062,9,0,181,629485,9,629476
91063,8,19,436,1227644,8,1227636
91064,6,-14,210,191192,6,191186
91065,18,-7,727,433601,18,433583
91066,14,18,104,1209787,14,1209773
91067,13,9,449,932298,13,932285
91068,6,0,401,634037,6,634031
91069,18,-10,331,337437,18,337419
91070,17,10,249,961683,17,961666
91071,17,13,597,1057785,17,1057768
91072,13,-11,449,307361,13,307348
91073,5,-3,449,540505,5,540500
91074,18,13,506,1057009,18,1056991
91075,11,-11,878,310622,11,310611
91076,20,-7,883,434807,20,434787
91077,17,2,304,712871,17,712854
91078,10,4,440,760116,10,760106
91079,9,-15,717,170797,9,170788
91080,12,-8,749,403193,12,403181
91081,10,13,636,1044434,10,1044424
91082,17,9,557,933162,17,933145
91083,17,5,582,808042,17,808025
91084,20,2,21,710640,20,710620
91085,11,6,378,838729,11,838718
91086,19,6,106,836564,19,836545
91087,15,-11,850,310366,15,310351
91088,7,0,442,634916,7,634909
91089,9,-6,148,439938,9,439929
91090,13,-13,913,247903,13,247890
91091,15,-10,33,335415,15,335400
91092,16,3,393,744844,16,744828
91093,8,-13,980,239544,8,239536
91094,18,15,279,1118855,18,1118837
91095,8,-11,577,293970,8,293962
91096,7,1,560,669600,7,669593
91097,19,10,573,964317,19,964298
91098,13,8,703,903552,13,903539
91099,18,-2,310,587453,18,587435
91100,6,-10,284,318683,6,318677
91101,9,-17,156,96739,9,96730
91102,16,2,441,713979,16,713963
91103,17,15,378,1119559,17,1119542
91104,18,-14,471,213164,18,213146
91105,6,19,411,1226911,6,1226905
91106,6,7,734,860348,6,860342
91107,17,1,898,686805,17,686788
91108,11,-12,307,274804,11,274793
91109,20,-8,71,398523,20,398503
91110,12,6,694,841392,12,841380
91111,19,5,775,809398,19,809379
91112,14,-20,64,23276,14,23262
91113,6,-13,606,231349,6,231343
91114,19,19,112,1241700,19,1241681
91115,7,1,351,664905,7,664898
91116,10,0,774,642313,10,642303
91117,10,14,205,1066235,10,1066225
91118,13,0,786,654233,13,654220
91119,20,19,477,1244716,20,1244696
91120,7,10,846,955693,7,955686
91121,9,3,504,729628,9,729619
91122,13,7,106,867807,13,867794
91123,18,7,139,868055,18,868037
91124,10,6,447,822538,10,822528
91125,19,10,786,965933,19,965914
91126,18,-7,250,430141,18,430123
91127,19,0,350,650703,19,650684
91128,18,8,215,899664,18,899646
91129,7,-19,675,46309,7,46302
91130,6,-20,119,2681,6,2675
91131,16,9,922,935973,16,935957
91132,20,-5,143,492027,20,492007
91133,6,-8,727,390987,6,390981
91134,14,11,916,997544,14,997530
91135,5,-14,237,191902,5,191897
91136,9,13,933,1050729,9,1050720
91137,15,11,838,996917,15,996902
91138,9,10,91,939575,9,939566
91139,8,18,746,1202420,8,1202412
91140,11,-17,682,120626,11,120615
91141,8,6,277,818542,8,818534
91142,10,-19,506,42436,10,42426
91143,15,-13,715,246304,15,246289
91144,18,10,81,960459,18,960441
91145,9,12,15,999419,9,999410
91146,15,-3,106,554542,15,554527
91147,11,-8,545,401693,11,401682
91148,9,6,629,826515,9,826506
91149,12,-14,176,210640,12,210628
91150,15,-19,508,57923,15,57908
91151,6,6,612,826147,6,826141
91152,17,-6,206,460752,17,460735
91153,10,13,325,1037701,10,1037691
91154,18,-16,369,149634,18,149616
91155,6,-15,464,165509,6,165503
91156,11,19,152,1241980,11,1241969
91157,20,-20,380,25743,20,25723
91158,5,7,49,845940,5,845935
91159,19,-8,218,399471,19,399452
91160,9,-20,717,15729,9,15720
91161,15,-17,456,118898,15,118883
91162,16,0,679,653466,16,653450
91163,10,-16,88,125857,10,125847
91164,10,13,492,1041279,10,1041269
91165,10,4,641,764479,10,764469
91166,11,1,550,684239,11,684228
91167,5,18,286,1193059,5,1193054
91168,20,-3,218,555313,20,555293
91169,14,-17,222,117110,14,117096
91170,19,-6,163,460396,19,460377
91171,8,-17,175,97092,8,97084
91172,8,5,155,784779,8,784771
91173,15,-17,875,121994,15,121979
91174,6,-7,692,420532,6,420526
91175,17,-8,16,398011,17,397994
91176,6,18,348,1194238,6,1194232
91177,13,-13,647,245776,13,245763
91178,15,3,773,747668,15,747653
91179,19,17,264,1179888,19,1179869
91180,13,-2,914,592109,13,592096
91181,9,-12,927,269729,9,269720
91182,11,-20,587,27270,11,27259
91183,9,12,751,1015455,9,1015446
91184,12,-7,8,428313,12,428301
91185,20,6,815,842338,20,842318
91186,9,18,170,1190533,9,1190524
91187,14,-17,578,119895,14,119881
91188,6,12,881,1018432,6,1018426
91189,18,-11,423,307145,18,307127
91190,18,2,712,715986,18,715968
91191,13,-7,798,434088,13,434075
91192,8,-7,769,422194,8,422186
91193,19,-9,830,373125,19,373106
91194,18,-11,33,303898,18,303880
91195,17,-6,670,464255,17,464238
91196,8,10,880,956413,8,956405
91197,10,-2,972,583605,10,583595
91198,19,-2,662,590111,19,590092
91199,19,12,517,1025814,19,1025795
91200,16,19,832,1247509,16,1247493
91201,12,7,132,867989,12,867977
91202,10,-5,302,474774,10,474764
91203,20,-3,608,558607,20,558587
91204,5,-20,532,11517,5,11512
91205,5,2,307,695227,5,695222
91206,5,4,237,755864,5,755859
91207,13,17,179,1179218,13,1179205
91208,11,-11,639,308820,11,308809
91209,10,17,441,1164744,10,1164734
91210,8,9,97,908789,8,908781
91211,20,17,773,1183609,20,1183589
91212,20,0,951,655501,20,655481
91213,11,-4,661,527098,11,527087
91214,14,8,491,901848,14,901834
91215,20,-20,382,25769,20,25749
91216,7,-13,100,220645,7,220638
91217,14,-17,420,118530,14,118516
91218,9,-20,945,20796,9,20787
91219,8,7,585,857256,8,857248
91220,14,1,143,680985,14,680971
91221,12,13,256,1055068,12,1055056
91222,8,-8,876,394053,8,394045
91223,12,19,638,1245965,12,1245953
91224,9,-5,958,488823,9,488814
91225,15,-1,486,620460,15,620445
91226,5,3,807,736236,5,736231
91227,15,-6,530,463233,15,463218
91228,17,1,631,684838,17,684821
91229,11,-17,187,116819,11,116808
91230,14,-2,752,590749,14,590735
91231,6,15,442,1103806,6,1103800
91232,15,-14,581,214100,15,214085
91233,11,-9,154,367688,11,367677
91234,14,-13,293,243264,14,243250
91235,5,-7,273,411638,5,411633
91236,8,-14,673,201502,8,201494
91237,9,18,949,1206853,9,1206844
91238,8,-14,671,201426,8,201418
91239,11,8,416,901303,11,901292
91240,13,4,822,779324,13,779311
91241,11,-2,228,586862,11,586851
91242,6,-17,858,111616,6,111610
91243,9,2,744,704330,9,704321
91244,10,18,532,1198241,10,1198231
91245,13,12,857,1028515,13,1028502
91246,9,8,599,888291,9,888282
91247,5,-12,578,262085,5,262080
91248,14,14,2,1085372,14,1085358
91249,14,13,52,1053625,14,1053611
91250,17,-16,428,150115,17,150098
91251,10,11,727,984019,10,984009
91252,12,-15,858,184279,12,184267
91253,7,-9,525,355507,7,355500
91254,5,18,536,1198325,5,1198320
91255,8,4,64,752005,8,751997
91256,15,-3,893,560948,15,560933
91257,10,-10,499,323487,10,323477
91258,6,15,354,1102036,6,1102030
91259,15,-9,665,371722,15,371707
91260,7,-3,46,531558,7,531551
91261,18,-11,828,310178,18,310160
91262,14,-20,626,27528,14,27514
91263,5,-17,235,98440,5,98435
91264,19,-1,975,623956,19,623937
91265,20,-2,204,586641,20,586621
91266,6,-6,339,444106,6,444100
91267,15,13,198,1054702,15,1054687
91268,15,10,437,963151,15,963136
91269,12,-8,734,403082,12,403070
91270,7,-4,246,505050,7,505043
91271,14,-11,275,305881,14,305867
91272,15,9,827,935184,15,935169
91273,5,1,235,662364,5,662359
91274,9,14,287,1068159,9,1068150
91275,6,18,993,1207756,6,1207750
91276,10,-16,748,140089,10,140079
91277,11,-11,687,309168,11,309157
91278,16,6,158,836947,16,836931
91279,17,16,337,1149551,17,1149534
91280,11,-2,764,590829,11,590818
91281,19,17,542,1181918,19,1181899
91282,15,0,886,655024,15,655009
91283,20,14,395,1088504,20,1088484
91284,5,-6,391,445172,5,445167
91285,13,10,386,962733,13,962720
91286,12,8,939,905261,12,905249
91287,5,7,590,857333,5,857328
91288,9,0,551,637253,9,637244
91289,7,17,298,1161763,7,1161756
91290,10,-12,957,270455,10,270445
91291,18,-9,908,373791,18,373773
91292,11,5,511,807513,11,807502
91293,8,14,110,1064323,8,1064315
91294,7,-3,450,540538,7,540531
91295,14,-18,950,92116,14,92102
91296,6,-13,472,228285,6,228279
91297,5,0,887,644653,5,644648
91298,17,-20,24,14285,17,14268
91299,12,1,189,681373,12,681361
91300,9,18,530,1198183,9,1198174
91301,14,-16,400,149818,14,149804
91302,15,2,177,711937,15,711922
91303,5,-12,345,257151,5,257146
91304,5,5,830,798963,5,798958
91305,7,-18,847,80620,7,80613
91306,17,14,890,1092427,17,1092410
91307,13,-5,148,492095,13,492082
91308,9,-1,835,611831,9,611822
91309,9,9,150,909905,9,909896
91310,19,-1,332,619228,19,619209
91311,18,-5,143,492035,18,492017
91312,7,-10,824,330289,7,330282
91313,7,-13,962,239251,7,239244
91314,8,-12,746,265634,8,265626
91315,12,-11,720,309325,12,309313
91316,16,-9,841,373205,16,373189
91317,20,14,654,1090588,20,1090568
91318,16,-14,891,216455,16,216439
91319,7,16,961,1145241,7,1145234
91320,17,-13,219,242645,17,242628
91321,6,0,125,628201,6,628195
91322,18,-17,942,122434,18,122416
91323,20,8,435,901444,20,901424
91324,11,11,382,993649,11,993638
91325,6,-11,108,283456,6,283450
91326,18,17,939,1184948,18,1184930
91327,14,1,73,680329,14,680315
91328,13,5,782,809483,13,809470
91329,15,-6,778,465103,15,465088
91330,5,18,360,1194486,5,1194481
91331,8,8,172,878857,8,878849
91332,20,-2,888,591936,20,591916
91333,13,-7,771,433924,13,433911
91334,7,-16,47,124856,7,124849
91335,7,-17,14,93922,7,93915
91336,5,1,755,673407,5,673402
91337,12,1,986,687482,12,687470
91338,14,7,870,873305,14,873291
91339,19,16,840,1153153,19,1153134
91340,7,7,463,854737,7,854730
91341,6,-3,96,532472,6,532466
91342,7,5,523,792537,7,792530
91343,9,-15,57,156563,9,156554
91344,16,13,320,1055543,16,1055527
91345,10,13,744,1046712,10,1046702
91346,20,9,39,929336,20,929316
91347,20,-14,569,214011,20,213991
91348,17,7,188,868370,17,868353
91349,11,2,824,716629,11,716618
91350,13,4,460,776556,13,776543
91351,19,10,219,961493,19,961474
91352,9,13,626,1044266,9,1044257
91353,9,0,747,641779,9,641770
91354,18,-3,774,560045,18,560027
91355,18,-7,243,430105,18,430087
91356,5,-3,695,546120,5,546115
91357,13,3,375,744690,13,744677
91358,13,-11,976,311372,13,311359
91359,5,-19,491,42065,5,42060
91360,10,1,233,662328,10,662318
91361,18,-20,225,24518,18,24500
91362,5,10,774,954196,5,954191
91363,16,3,508,745613,16,745597
91364,14,0,338,650615,14,650601
91365,9,-6,370,444696,9,444687
91366,12,-11,403,306935,12,306923
91367,9,15,477,1104504,9,1104495
91368,14,-7,166,429545,14,429531
91369,17,7,283,869055,17,869038
91370,19,10,178,961228,19,961209
91371,14,-18,246,87253,14,87239
91372,5,-17,575,105960,5,105955
91373,5,-7,554,417783,5,417778
91374,6,14,0,1061683,6,1061677
91375,18,-12,487,276095,18,276077
91376,10,-4,896,518653,10,518643
91377,8,4,563,762736,8,762728
91378,9,-19,606,44826,9,44817
91379,18,19,899,1248076,18,1248058
91380,5,-8,423,384082,5,384077
91381,10,5,627,794682,10,794672
91382,10,9,949,926918,10,926908
91383,9,5,526,792567,9,792558
91384,5,-15,883,174225,5,174220
91385,16,-10,73,335755,16,335739
91386,8,18,149,1190123,8,1190115
91387,16,9,854,935408,16,935392
91388,11,18,193,1210582,11,1210571
91389,11,15,523,1120563,11,1120552
91390,17,1,833,686296,17,686279
91391,14,-8,557,401769,14,401755
91392,8,19,499,1228880,8,1228872
91393,12,8,652,903131,12,903119
91394,5,2,469,698630,5,698625
91395,16,2,369,713389,16,713373
91396,6,-7,605,418751,6,418745
91397,17,9,918,935913,17,935896
91398,15,-1,626,621413,15,621398
91399,19,2,166,711865,19,711846
91400,6,10,778,954310,6,954304
91401,12,-12,772,278180,12,278168
91402,15,9,340,931501,15,931486
91403,20,12,200,1023499,20,1023479
91404,11,12,183,1023382,11,1023371
91405,17,5,897,810309,17,810292
91406,16,18,39,1209193,16,1209177
91407,12,1,194,681401,12,681389
91408,9,18,440,1196159,9,1196150
91409,9,3,370,726840,9,726831
91410,6,-13,627,231774,6,231768
91411,10,9,13,907026,10,907016
91412,18,3,575,746143,18,746125
91413,20,-13,421,244076,20,244056
91414,20,10,779,965881,20,965861
91415,13,-9,767,372612,13,372599
91416,15,9,481,932574,15,932559
91417,9,-9,741,360006,9,359997
91418,14,1,368,682812,14,682798
91419,12,1,713,685353,12,685341
91420,5,12,24,999601,5,999596
91421,14,17,218,1179484,14,1179470
91422,14,-15,418,180854,14,180840
91423,13,-13,483,244532,13,244519
91424,19,2,415,713788,19,713769
91425,13,10,901,966693,13,966680
91426,11,1,968,687405,11,687394
91427,15,-15,621,182319,15,182304
91428,12,-15,393,180632,12,180620
91429,17,-11,406,306970,17,306953
91430,17,-16,914,153664,17,153647
91431,8,-6,916,456334,8,456326
91432,15,7,841,873097,15,873082
91433,15,-10,915,341932,15,341917
91434,17,-11,5,303717,17,303700
91435,17,-10,296,337195,17,337178
91436,9,-19,692,46748,9,46739
91437,6,5,631,794732,6,794726
91438,12,-6,768,464984,12,464972
91439,14,-17,244,117285,14,117271
91440,15,-5,792,496770,15,496755
91441,19,-15,957,185082,19,185063
91442,10,-16,972,144928,10,144918
91443,6,-17,176,97122,6,97116
91444,11,7,422,870143,11,870132
91445,10,14,91,1063823,10,1063813
91446,10,-12,50,250633,10,250623
91447,14,8,199,899517,14,899503
91448,15,19,163,1242074,15,1242059
91449,9,3,683,733613,9,733604
91450,6,17,522,1166532,6,1166526
91451,16,-11,666,309039,16,309023
91452,7,-2,161,566185,7,566178
91453,15,0,42,648583,15,648568
91454,8,3,443,728377,8,728369
91455,13,-11,221,305439,13,305426
91456,11,0,0,648199,11,648188
91457,12,4,348,775727,12,775715
91458,7,-1,377,602266,7,602259
91459,12,8,555,902321,12,902309
91460,11,12,839,1028358,11,1028347
91461,14,0,325,650457,14,650443
91462,11,-12,571,276737,11,276726
91463,12,13,437,1056515,12,1056503
91464,7,-16,544,135860,7,135853
91465,12,-19,633,58994,12,58982
91466,17,7,280,869015,17,868998
91467,12,-10,398,337931,12,337919
91468,13,-2,737,590656,13,590643
91469,17,-19,94,54664,17,54647
91470,11,15,530,1120627,11,1120616
91471,10,0,858,643966,10,643956
91472,8,16,242,1130361,8,1130353
91473,12,-20,950,29984,12,29972
91474,19,-5,440,494273,19,494254
91475,13,6,807,842276,13,842263
91476,17,-12,216,274089,17,274072
91477,20,10,250,961692,20,961672
91478,16,-18,898,91736,16,91720
91479,8,10,880,956421,8,956413
91480,20,-15,8,177887,20,177867
91481,19,17,165,1179111,19,1179092
91482,11,15,160,1117954,11,1117943
91483,14,-14,280,211630,14,211616
91484,15,0,513,652060,15,652045
91485,11,16,739,1152363,11,1152352
91486,18,1,156,681130,18,681112
91487,13,-19,823,60316,13,60303
91488,5,16,426,1134375,5,1134370
91489,15,14,242,1087308,15,1087293
91490,11,-1,855,623095,11,623084
91491,16,-18,625,89781,16,89765
91492,11,17,239,1179676,11,1179665
91493,17,-12,201,273925,17,273908
91494,7,-19,461,41422,7,41415
91495,14,-11,880,310643,14,310629
91496,15,0,647,653193,15,653178
91497,20,2,516,714547,20,714527
91498,10,12,337,1006571,10,1006561
91499,5,-5,503,478910,5,478905
91500,16,14,944,1092863,16,1092847
91501,9,10,460,947371,9,947362
91502,14,-1,21,616691,14,616677
91503,6,-11,516,292646,6,292640
91504,10,14,70,1063405,10,1063395
91505,7,-4,815,516777,7,516770
91506,17,15,275,1118826,17,1118809
91507,19,4,607,777715,19,777696
91508,10,-5,78,469646,10,469636
91509,17,-14,581,214107,17,214090
91510,15,-16,841,153054,15,153039
91511,8,-18,570,74680,8,74672
91512,5,4,190,754697,5,754692
91513,15,-5,514,494832,15,494817
91514,12,2,31,710739,12,710727
91515,5,9,283,912597,5,912592
91516,9,11,670,982731,9,982722
91517,9,-14,563,198776,9,198767
91518,17,-18,389,88222,17,88205
91519,18,-19,263,56088,18,56070
91520,17,-4,36,522315,17,522298
91521,15,-3,153,554844,15,554829
91522,7,-7,209,410327,7,410320
91523,5,14,140,1064974,5,1064969
91524,10,5,478,791570,10,791560
91525,13,-16,88,147537,13,147524
91526,13,-6,987,466665,13,466652
91527,18,-9,237,368303,18,368285
91528,19,-20,973,30205,19,30186
91529,18,-10,310,337325,18,337307
91530,6,-3,224,535186,6,535180
91531,13,-12,364,275244,13,275231
91532,18,-3,947,561388,18,561370
91533,8,-2,918,582507,8,582499
91534,14,-4,50,522400,14,522386
91535,9,-20,260,5769,9,5760
91536,17,16,784,1152672,17,1152655
91537,16,-3,447,557210,16,557194
91538,15,-4,87,522698,15,522683
91539,11,0,388,651027,11,651016
91540,5,-3,845,549292,5,549287
91541,10,-1,774,610487,10,610477
91542,20,19,346,1243554,20,1243534
91543,9,4,921,770850,9,770841
91544,9,4,272,756511,9,756502
91545,5,-1,744,609822,5,609817
91546,19,-13,58,241513,19,241494
91547,14,-4,817,528085,14,528071
91548,7,-4,608,512498,7,512491
91549,18,7,204,868445,18,868427
91550,18,13,726,1058642,18,1058624
91551,11,-11,982,311388,11,311377
91552,18,3,776,747688,18,747670
91553,15,5,190,805255,15,805240
91554,11,-4,657,527071,11,527060
91555,5,-18,668,76730,5,76725
91556,15,-11,776,309814,15,309799
91557,5,16,652,1138920,5,1138915
91558,10,-4,675,513965,10,513955
91559,7,4,763,767238,7,767231
91560,14,-13,100,241819,14,241805
91561,14,-17,162,116672,14,116658
91562,18,-14,742,215271,18,215253
91563,13,-19,515,57962,13,57949
91564,16,6,208,837279,16,837263
91565,19,-3,292,555890,19,555871
91566,14,-6,696,464486,14,464472
91567,5,-5,27,468432,5,468427
91568,6,-9,204,347916,6,347910
91569,11,1,474,683579,11,683568
91570,18,-4,39,522341,18,522323
91571,6,17,327,1162402,6,1162396
91572,19,17,983,1185334,19,1185315
91573,13,18,947,1215929,13,1215916
91574,14,-10,246,336872,14,336858
91575,14,18,825,1214928,14,1214914
91576,16,-13,730,246416,16,246400
91577,17,14,727,1091166,17,1091149
91578,12,15,218,1118463,12,1118451
91579,11,-20,635,27609,11,27598
91580,13,-13,622,245671,13,245658
91581,20,2,946,717530,20,717510
91582,8,18,103,1189034,8,1189026
91583,18,-1,283,618802,18,618784
91584,14,10,702,965322,14,965308
91585,15,2,730,716092,15,716077
91586,12,-13,410,243998,12,243986
91587,8,-18,513,73494,8,73486
91588,8,-10,148,315913,8,315905
91589,9,12,519,1010193,9,1010184
91590,16,18,521,1212813,16,1212797
91591,20,9,659,933923,20,933903
91592,17,4,926,780096,17,780079
91593,10,-20,525,11300,10,11290
91594,10,-15,599,168303,10,168293
91595,5,-10,539,324270,5,324265
91596,19,-2,742,590693,19,590674
91597,11,9,521,932877,11,932866
91598,7,2,455,698350,7,698343
91599,16,-2,634,589890,16,589874
91600,5,15,391,1102757,5,1102752
91601,14,16,352,1149697,14,1149683
91602,17,-10,308,337281,17,337264
91603,20,-14,128,210280,20,210260
91604,13,19,396,1244036,13,1244023
91605,10,-13,925,238372,10,238362
91606,17,13,429,1056437,17,1056420
91607,8,5,639,794858,8,794850
91608,15,-18,420,88445,15,88430
91609,16,-18,421,88459,16,88443
91610,15,12,157,1023192,15,1023177
91611,16,6,805,842237,16,842221
91612,15,7,392,869932,15,869917
91613,20,1,163,681161,20,681141
91614,10,-7,506,416693,10,416683
91615,7,1,84,658854,7,658847
91616,14,11,916,997548,14,997534
91617,12,-6,130,460084,12,460072
91618,12,16,559,1151075,12,1151063
91619,17,1,195,681414,17,681397
91620,17,-15,891,184527,17,184510
91621,20,0,600,652799,20,652779
91622,15,-10,540,339092,15,339077
91623,15,-16,294,149127,15,149112
91624,10,-10,937,332633,10,332623
91625,20,-20,180,24192,20,24172
91626,10,-18,626,75855,10,75845
91627,6,-1,64,595116,6,595110
91628,17,-14,573,214033,17,214016
91629,18,5,833,809877,18,809859
91630,14,-16,118,147800,14,147786
91631,13,5,516,807568,13,807555
91632,8,17,997,1176784,8,1176776
91633,9,-13,855,236912,9,236903
91634,14,11,880,997270,14,997256
91635,16,3,652,746780,16,746764
91636,5,8,726,891263,5,891258
91637,10,9,410,915293,10,915283
91638,12,-7,363,431121,12,431109
91639,13,3,891,748524,13,748511
91640,16,-19,357,56787,16,56771
91641,8,16,568,1137179,8,1137171
91642,15,-11,345,306501,15,306486
91643,11,-20,378,25712,11,25701
91644,20,3,802,747896,20,747876
91645,19,12,668,1027077,19,1027058
91646,7,17,609,1168284,7,1168277
91647,11,-1,908,623521,11,623510
91648,15,-6,281,461381,15,461366
91649,9,-13,735,234058,9,234049
91650,20,-6,640,464086,20,464066
91651,8,-19,16,31804,8,31796
91652,6,-13,676,232582,6,232576
91653,8,-3,293,536798,8,536790
91654,11,3,85,742460,11,742449
91655,14,-13,89,241681,14,241667
91656,18,9,891,935664,18,935646
91657,5,-12,614,262734,5,262729
91658,17,6,394,838925,17,838908
91659,16,-14,35,209592,16,209576
91660,16,-5,818,496930,16,496914
91661,19,12,257,1024012,19,1023993
91662,7,-19,683,46547,7,46540
91663,13,7,561,871152,13,871139
91664,5,4,612,763926,5,763921
91665,17,-14,905,216553,17,216536
91666,12,4,515,776986,12,776974
91667,11,-13,572,245267,11,245256
91668,7,12,454,1008786,7,1008779
91669,5,14,382,1070261,5,1070256
91670,13,0,256,650098,13,650085
91671,11,0,729,653913,11,653902
91672,10,-10,415,321642,10,321632
91673,7,2,404,697439,7,697432
91674,20,11,67,991392,20,991372
91675,17,-18,719,90504,17,90487
91676,8,4,356,758249,8,758241
91677,14,-10,875,341678,14,341664
91678,5,17,687,1169984,5,1169979
91679,9,17,796,1172409,9,1172400
91680,14,-7,95,428945,14,428931
91681,5,2,498,699243,5,699238
91682,12,14,602,1090105,12,1090093
91683,13,-20,680,28040,13,28027
91684,16,-16,424,150060,16,150044
91685,16,0,675,653411,16,653395
91686,15,-13,25,241260,15,241245
91687,7,3,269,724697,7,724690
91688,13,-16,528,150893,13,150880
91689,18,-9,584,371294,18,371276
91690,6,7,2,844819,6,844813
91691,10,-9,231,348574,10,348564
91692,9,14,341,1069358,9,1069349
91693,16,-10,341,337538,16,337522
91694,19,11,185,992129,19,992110
91695,11,15,500,1120326,11,1120315
91696,11,-8,739,403094,11,403083
91697,9,13,545,1042454,9,1042445
91698,7,18,179,1190822,7,1190815
91699,5,16,900,1143829,5,1143824
91700,10,-16,4,123887,10,123877
91701,7,-2,844,580888,7,580881
91702,15,7,149,868112,15,868097
91703,11,-8,737,403093,11,403082
91704,19,4,340,775682,19,775663
91705,15,1,628,684793,15,684778
91706,16,19,264,1242869,16,1242853
91707,10,11,259,973758,10,973748
91708,13,7,558,871129,13,871116
91709,16,-6,136,460127,16,460111
91710,14,17,36,1178140,14,1178126
91711,18,4,773,778950,18,778932
91712,19,-13,371,243759,19,243740
91713,18,7,306,869240,18,869222
91714,20,-16,115,147781,20,147761
91715,19,-6,428,462431,19,462412
91716,10,11,580,980895,10,980885
91717,7,-19,403,40295,7,40288
91718,6,19,549,1229897,6,1229891
91719,12,-15,325,180121,12,180109
91720,6,-11,289,287398,6,287392
91721,12,14,361,1088235,12,1088223
91722,6,-20,148,3296,6,3290
91723,17,1,392,682979,17,682962
91724,12,1,467,683547,12,683535
91725,20,-12,795,278323,20,278303
91726,16,-1,210,618179,16,618163
91727,19,-11,411,307011,19,306992
91728,13,-15,212,179272,13,179259
91729,13,-16,202,148428,13,148415
91730,18,13,402,1056243,18,1056225
91731,15,-14,989,217194,15,217179
91732,15,-15,76,178315,15,178300
91733,15,-8,285,399884,15,399869
91734,8,-6,743,452801,8,452793
91735,12,10,108,960711,12,960699
91736,10,18,376,1194841,10,1194831
91737,14,-15,515,181571,14,181557
91738,5,7,376,852957,5,852952
91739,5,-16,971,144899,5,144894
91740,16,-6,459,462664,16,462648
91741,9,-8,735,391125,9,391116
91742,17,-18,222,87017,17,87000
91743,17,-10,813,341229,17,341212
91744,5,5,486,791704,5,791699
91745,14,13,71,1053769,14,1053755
91746,10,1,914,676912,10,676902
91747,19,15,933,1123605,19,1123586
91748,13,0,124,649197,13,649184
91749,11,-11,173,305120,11,305109
91750,20,-16,357,149529,20,149509
91751,5,7,411,853679,5,853674
91752,17,3,749,747507,17,747490
91753,17,6,915,843083,17,843066
91754,17,19,251,1242728,17,1242711
91755,7,17,176,1158980,7,1158973
91756,15,2,595,715043,15,715028
91757,6,12,553,1010971,6,1010965
91758,13,-5,71,491393,13,491380
91759,9,-12,444,259159,9,259150
91760,10,-17,682,108112,10,108102
91761,7,12,565,1011206,7,1011199
91762,10,-8,215,380094,10,380084
91763,9,-17,229,98255,9,98246
91764,6,-7,669,419968,6,419962
91765,18,4,256,775069,18,775051
91766,5,5,821,798812,5,798807
91767,9,-15,676,169921,9,169912
91768,8,-7,886,424868,8,424860
91769,5,3,133,721721,5,721716
91770,19,-14,542,213668,19,213649
91771,13,9,6,929094,13,929081
91772,5,12,777,1015953,5,1015948
91773,9,2,811,705508,9,705499
91774,14,3,902,748601,14,748587
91775,12,-20,932,29887,12,29875
91776,6,2,131,691462,6,691456
91777,8,11,76,970101,8,970093
91778,16,5,97,804514,16,804498
91779,7,3,62,720142,7,720135
91780,10,0,645,639417,10,639407
91781,18,10,307,962128,18,962110
91782,10,-7,64,407329,10,407319
91783,11,16,666,1151919,11,1151908
91784,16,-1,682,621813,16,621797
91785,20,12,254,1023963,20,1023943
91786,17,14,1000,1093354,17,1093337
91787,6,-9,77,345277,6,345271
91788,20,-20,890,29668,20,29648
91789,18,-13,628,245705,18,245687
91790,15,-13,951,248231,15,248216
91791,10,-12,388,258008,10,257998
91792,20,-16,554,151066,20,151046
91793,5,-18,69,63944,5,63939
91794,17,-14,446,212986,17,212969
91795,11,13,275,1055220,11,1055209
91796,15,12,269,1024127,15,1024112
91797,11,-13,625,245700,11,245689
91798,17,15,74,1117330,17,1117313
91799,5,-20,74,1688,5,1683
91800,9,-10,50,313697,9,313688
91801,15,-5,173,492287,15,492272
91802,14,-9,433,370008,14,369994
91803,14,-9,393,369649,14,369635
91804,10,-3,509,541920,10,541910
91805,13,-6,489,462937,13,462924
91806,18,-12,364,275252,18,275234
91807,10,18,414,1195583,10,1195573
91808,12,2,658,715535,12,715523
91809,13,10,669,965077,13,965064
91810,15,-8,154,399008,15,398993
91811,16,9,141,930107,16,930091
91812,7,15,318,1101304,7,1101297
91813,12,-12,608,276927,12,276915
91814,6,-10,753,328792,6,328786
91815,18,-10,532,339021,18,339003
91816,8,-11,47,282021,8,282013
91817,16,-20,144,23867,16,23851
91818,19,-19,704,59478,19,59459
91819,14,15,50,1117166,14,1117152
91820,8,-15,968,176075,8,176067
91821,11,13,222,1054870,11,1054859
91822,18,16,774,1152581,18,1152563
91823,9,-8,872,393965,9,393956
91824,19,9,157,930233,19,930214
91825,15,-5,410,494043,15,494028
91826,7,6,574,825305,7,825298
91827,5,10,574,949875,5,949870
91828,5,16,252,1130566,5,1130561
91829,20,3,225,743572,20,743552
91830,17,16,142,1148104,17,1148087
91831,15,-4,136,523107,15,523092
91832,11,-13,768,246754,11,246743
91833,19,0,100,649024,19,649005
91834,15,-12,17,272631,15,272616
91835,14,16,613,1151429,14,1151415
91836,11,2,708,715942,11,715931
91837,20,12,693,1027295,20,1027275
91838,16,17,158,1179048,16,1179032
91839,13,6,354,838518,13,838505
91840,20,10,18,959965,20,959945
91841,18,18,885,1215441,18,1215423
91842,7,-19,191,35820,7,35813
91843,15,-17,272,117501,15,117486
91844,19,-10,67,335685,19,335666
91845,20,-20,368,25641,20,25621
91846,20,-19,322,56502,20,56482
91847,7,0,77,626925,7,626918
91848,8,-17,155,96701,8,96693
91849,13,7,713,872205,13,872192
91850,12,8,161,899223,12,899211
91851,12,8,915,905116,12,905104
91852,5,-20,220,4993,5,4988
91853,17,19,124,1241797,17,1241780
91854,7,7,439,854261,7,854254
91855,15,-9,564,371138,15,371123
91856,9,14,299,1068446,9,1068437
91857,6,-12,469,259771,6,259765
91858,12,13,729,1058675,12,1058663
91859,15,6,921,843108,15,843093
91860,20,-1,857,623125,20,623105
91861,13,5,775,809401,13,809388
91862,18,-14,439,212929,18,212911
91863,17,1,358,682735,17,682718
91864,7,18,12,1186848,7,1186841
91865,7,14,155,1065341,7,1065334
91866,15,15,975,1123972,15,1123957
91867,13,15,326,1119195,13,1119182
91868,18,-13,445,244269,18,244251
91869,18,6,71,836292,18,836274
91870,11,-16,248,148791,11,148780
91871,5,-14,262,192533,5,192528
91872,18,0,876,654893,18,654875
91873,8,0,599,638289,8,638281
91874,11,6,606,840651,11,840640
91875,14,-16,291,149096,14,149082
91876,8,1,678,671905,8,671897
91877,6,-9,59,344910,6,344904
91878,15,-18,514,89036,15,89021
91879,5,-2,577,574997,5,574992
91880,10,-7,8,406173,10,406163
91881,6,7,230,849701,6,849695
91882,17,-13,529,244950,17,244933
91883,12,9,791,934916,12,934904
91884,12,18,843,1215103,12,1215091
91885,19,8,843,904512,19,904493
91886,14,-5,42,491170,14,491156
91887,9,-11,32,281733,9,281724
91888,5,-16,942,144289,5,144284
91889,7,-12,861,268367,7,268360
91890,7,-12,991,271236,7,271229
91891,13,8,95,898688,13,898675
91892,16,-13,797,246967,16,246951
91893,10,-12,403,258359,10,258349
91894,17,-20,142,23860,17,23843
91895,16,6,760,841873,16,841857
91896,13,-8,158,399035,13,399022
91897,6,-16,910,143627,6,143621
91898,20,-10,895,341823,20,341803
91899,20,-20,976,30243,20,30223
91900,16,17,482,1181542,16,1181526
91901,15,-17,677,120599,15,120584
91902,15,14,460,1089054,15,1089039
91903,11,-8,139,398874,11,398863
91904,17,-11,544,308122,17,308105
91905,13,-9,896,373667,13,373654
91906,9,14,335,1069230,9,1069221
91907,12,-9,482,370489,12,370477
91908,9,9,264,912190,9,912181
91909,15,15,72,1117302,15,1117287
91910,18,19,758,1246925,18,1246907
91911,6,19,828,1235826,6,1235820
91912,15,-15,429,180985,15,180970
91913,14,-13,406,243975,14,243961
91914,5,-4,459,509400,5,509395
91915,9,-5,440,477518,9,477509
91916,10,-7,375,414062,10,414052
91917,5,-1,672,608342,5,608337
91918,6,-3,176,534153,6,534147
91919,19,18,187,1210523,19,1210504
91920,5,-9,763,360593,5,360588
91921,10,5,133,784313,10,784303
91922,13,12,538,1025994,13,1025981
91923,13,-19,59,54294,13,54281
91924,7,19,17,1217806,7,1217799
91925,17,-7,994,435690,17,435673
91926,12,10,584,964406,12,964394
91927,20,-12,950,279699,20,279679
91928,6,-16,566,136358,6,136352
91929,5,10,643,951414,5,951409
91930,14,5,894,810274,14,810260
91931,14,-1,382,619623,14,619609
91932,9,15,246,1099813,9,1099804
91933,20,4,834,779463,20,779443
91934,10,6,765,829514,10,829504
91935,17,12,569,1026215,17,1026198
91936,9,14,408,1070896,9,1070887
91937,5,5,933,801319,5,801314
91938,15,-20,269,24837,15,24822
91939,8,16,222,1129952,8,1129944
91940,20,-9,155,367715,20,367695
91941,17,-1,695,621927,17,621910
91942,20,-1,131,617558,20,617538
91943,8,18,890,1205646,8,1205638
91944,20,18,586,1213168,20,1213148
91945,10,6,331,819754,10,819744
91946,16,8,200,899522,16,899506
91947,15,9,670,933985,15,933970
91948,19,-4,220,523845,19,523826
91949,13,-3,25,554001,13,553988
91950,9,0,99,627612,9,627603
91951,16,5,202,805370,16,805354
91952,14,9,523,932881,14,932867
91953,14,-13,819,247131,14,247117
91954,18,-19,822,60305,18,60287
91955,7,-14,378,195072,7,195065
91956,9,-5,636,481770,9,481761
91957,10,0,878,644351,10,644341
91958,13,-7,232,430027,13,430014
91959,12,-9,232,368256,12,368244
91960,16,2,804,716473,16,716457
91961,20,5,201,805356,20,805336
91962,6,15,604,1107310,6,1107304
91963,5,17,775,1171761,5,1171756
91964,11,-3,772,559990,11,559979
91965,13,14,439,1088900,13,1088887
91966,11,-6,350,461889,11,461878
91967,10,18,742,1202320,10,1202310
91968,20,12,716,1027426,20,1027406
91969,13,-13,995,248553,13,248540
91970,14,17,793,1183840,14,1183826
91971,16,-2,615,589780,16,589764
91972,11,11,529,994685,11,994674
91973,9,14,516,1073344,9,1073335
91974,14,-10,164,336322,14,336308
91975,19,2,252,712475,19,712456
91976,15,17,293,1180172,15,1180157
91977,18,11,623,995313,18,995295
91978,12,-18,751,90757,12,90745
91979,16,13,347,1055788,16,1055772
91980,13,8,194,899480,13,899467
91981,5,18,235,1191938,5,1191933
91982,6,-6,679,451311,6,451305
91983,5,10,237,942535,5,942530
91984,5,-3,617,544288,5,544283
91985,5,-4,293,505910,5,505905
91986,8,-1,422,603180,8,603172
91987,8,17,583,1167701,8,1167693
91988,19,14,757,1091390,19,1091371
91989,10,-2,689,577539,10,577529
91990,9,18,346,1194204,9,1194195
91991,6,14,712,1078037,6,1078031
91992,7,-7,745,421611,7,421604
91993,11,-19,592,58681,11,58670
91994,13,15,128,1117777,13,1117764
91995,8,1,653,671467,8,671459
91996,8,-5,562,480225,8,480217
91997,10,-7,172,409467,10,409457
91998,20,5,538,807720,20,807700
91999,8,0,384,633701,8,633693
92000,8,4,241,755938,8,755930
92001,20,-15,707,183047,20,183027
92002,6,10,529,948827,6,948821
92003,9,12,762,1015622,9,1015613
92004,18,16,780,1152666,18,1152648
92005,8,-14,519,197855,8,197847
92006,11,3,224,743554,11,743543
92007,15,-15,485,181342,15,181327
92008,6,-16,313,130764,6,130758
92009,18,-6,892,465892,18,465874
92010,20,-16,244,148776,20,148756
92011,5,-13,906,237917,5,237912
92012,19,14,963,1092966,19,1092947
92013,9,5,498,791943,9,791934
92014,13,-8,721,402995,13,402982
92015,12,-8,564,401838,12,401826
92016,10,-10,355,320302,10,320292
92017,16,15,244,1118614,16,1118598
92018,14,19,712,1246544,14,1246530
92019,14,9,566,933242,14,933228
92020,13,-18,822,91241,13,91228
92021,17,18,356,1211668,17,1211651
92022,12,7,669,871972,12,871960
92023,8,-2,583,575125,8,575117
92024,8,-18,374,70418,8,70410
92025,10,-3,116,532939,10,532929
92026,5,15,836,1112240,5,1112235
92027,13,-15,235,179449,13,179436
92028,19,3,812,747952,19,747933
92029,16,3,674,746979,16,746963
92030,14,13,286,1055301,14,1055287
92031,15,13,543,1057297,15,1057282
92032,11,14,683,1090841,11,1090830
92033,5,-20,429,9156,5,9151
92034,15,-4,211,523751,15,523736
92035,13,16,862,1153244,13,1153231
92036,7,17,832,1173228,7,1173221
92037,19,2,677,715723,19,715704
92038,11,-15,258,179627,11,179616
92039,9,7,188,848767,9,848758
92040,12,-11,368,306716,12,306704
92041,16,11,906,997462,16,997446
92042,16,8,779,904150,16,904134
92043,5,7,494,855433,5,855428
92044,5,-2,269,568586,5,568581
92045,13,-1,39,616891,13,616878
92046,19,14,678,1090763,19,1090744
92047,16,4,633,777891,16,777875
92048,9,18,267,1192716,9,1192707
92049,12,7,666,871938,12,871926
92050,8,-10,425,321882,8,321874
92051,18,11,116,991676,18,991658
92052,12,-14,69,209847,12,209835
92053,20,2,816,716566,20,716546
92054,18,-20,28,16088,18,16070
92055,18,0,358,650746,18,650728
92056,6,18,948,1206787,6,1206781
92057,16,-17,230,117154,16,117138
92058,18,-13,739,246493,18,246475
92059,9,16,367,1132999,9,1132990
92060,19,-7,428,431538,19,431519
92061,18,4,649,778004,18,777986
92062,13,18,314,1211370,13,1211357
92063,14,11,117,991680,14,991666
92064,6,-10,937,332639,6,332633
92065,10,-9,171,347204,10,347194
92066,7,17,946,1175585,7,1175578
92067,16,-4,509,525965,16,525949
92068,17,-5,72,491400,17,491383
92069,16,-9,120,367488,16,367472
92070,18,-10,535,339060,18,339042
92071,5,-9,480,354447,5,354442
92072,7,-3,397,539186,7,539179
92073,7,-3,671,545610,7,545603
92074,20,-19,115,54914,20,54894
92075,12,-9,75,367204,12,367192
92076,9,-5,507,478993,9,478984
92077,15,-3,402,556756,15,556741
92078,11,-15,907,184643,11,184632
92079,5,-13,563,230341,5,230336
92080,14,-19,24,54078,14,54064
92081,11,-18,269,87374,11,87363
92082,18,-1,33,616829,18,616811
92083,11,-5,707,496205,11,496194
92084,10,-2,253,568205,10,568195
92085,17,-18,139,86261,17,86244
92086,15,1,576,684454,15,684439
92087,17,5,913,810451,17,810434
92088,14,16,656,1151812,14,1151798
92089,6,14,293,1068317,6,1068311
92090,13,-9,840,373186,13,373173
92091,9,-4,675,513974,9,513965
92092,18,14,230,1087219,18,1087201
92093,11,1,847,686414,11,686403
92094,16,-3,142,554799,16,554783
92095,6,-17,543,105186,6,105180
92096,7,-18,921,82447,7,82440
92097,7,-14,521,197898,7,197891
92098,5,11,54,969647,5,969642
92099,13,-6,285,461416,13,461403
92100,7,-9,847,362452,7,362445
92101,15,9,415,932037,15,932022
92102,8,6,247,817753,8,817745
92103,5,19,362,1225616,5,1225611
92104,17,13,104,1053994,17,1053977
92105,11,9,263,930848,11,930837
92106,18,-9,44,366957,18,366939
92107,13,4,717,778542,13,778529
92108,18,-4,310,524508,18,524490
92109,17,18,402,1212026,17,1212009
92110,7,3,767,735430,7,735423
92111,19,-12,842,278724,19,278705
92112,12,10,645,964922,12,964910
92113,14,-12,268,274514,14,274500
92114,18,14,678,1090771,18,1090753
92115,19,11,6,990907,19,990888
92116,14,-20,530,26809,14,26795
92117,14,-17,383,118321,14,118307
92118,20,9,478,932507,20,932487
92119,17,10,286,961987,17,961970
92120,18,-14,786,215686,18,215668
92121,16,1,457,683462,16,683446
92122,10,11,709,983548,10,983538
92123,11,-18,381,88158,11,88147
92124,14,-19,339,56675,14,56661
92125,11,2,295,712820,11,712809
92126,14,14,11,1085465,14,1085451
92127,18,-19,787,60110,18,60092
92128,18,-13,156,242170,18,242152
92129,17,-4,172,523382,17,523365
92130,10,14,131,1064804,10,1064794
92131,18,-9,858,373375,18,373357
92132,19,-15,557,181893,19,181874
92133,15,-11,67,304213,15,304198
92134,12,-4,569,526390,12,526378
92135,9,-13,547,229989,9,229980
92136,13,5,514,807537,13,807524
92137,6,4,687,765412,6,765406
92138,11,-12,54,272911,11,272900
92139,11,-10,866,341587,11,341576
92140,20,15,352,1119386,20,1119366
92141,11,-17,294,117677,11,117666
92142,19,3,68,742327,19,742308
92143,5,-5,291,474493,5,474488
92144,10,10,593,950265,10,950255
92145,13,0,172,649530,13,649517
92146,7,12,922,1019434,7,1019427
92147,10,1,332,664517,10,664507
92148,18,6,876,842769,18,842751
92149,18,13,871,1059750,18,1059732
92150,11,6,334,838373,11,838362
92151,15,11,768,996413,15,996398
92152,12,12,201,1023504,12,1023492
92153,9,-1,657,608062,9,608053
92154,5,19,831,1235928,5,1235923
92155,15,-15,873,184395,15,184380
92156,9,1,212,661876,9,661867
92157,14,-16,804,152817,14,152803
92158,15,-14,683,214883,15,214868
92159,8,0,276,631290,8,631282
92160,10,-11,258,286712,10,286702
92161,14,16,937,1153810,14,1153796
92162,15,-15,793,183650,15,183635
92163,6,-13,326,225289,6,225283
92164,12,-17,304,117783,12,117771
92165,6,-6,828,454560,6,454554
92166,16,10,973,967278,16,967262
92167,14,-4,111,522880,14,522866
92168,7,-10,588,325356,7,325349
92169,17,-15,201,179201,17,179184
92170,9,17,416,1164144,9,1164135
92171,13,6,559,840265,13,840252
92172,14,15,177,1118136,14,1118122
92173,17,-20,865,29462,17,29445
92174,13,14,796,1091686,13,1091673
92175,13,-1,302,618973,13,618960
92176,20,-12,941,279612,20,279592
92177,20,-14,267,211504,20,211484
92178,11,0,311,650386,11,650375
92179,13,17,498,1181619,13,1181606
92180,6,-10,806,329897,6,329891
92181,14,-9,143,367616,14,367602
92182,17,1,186,681370,17,681353
92183,16,10,983,967347,16,967331
92184,17,-8,773,403382,17,403365
92185,8,-15,662,169689,8,169681
92186,16,1,664,685093,16,685077
92187,19,-12,842,278733,19,278714
92188,10,16,989,1145856,10,1145846
92189,10,-5,567,480327,10,480317
92190,12,1,629,684802,12,684790
92191,8,-1,24,594221,8,594213
92192,8,-1,381,602338,8,602330
92193,17,-6,342,461830,17,461813
92194,6,-8,657,389494,6,389488
92195,7,18,788,1203478,7,1203471
92196,13,-3,544,558114,13,558101
92197,10,-2,35,563602,10,563592
92198,14,-5,529,494968,14,494954
92199,5,-1,918,613773,5,613768
92200,8,16,561,1137065,8,1137057
92201,5,-15,399,164019,5,164014
92202,18,-19,522,58049,18,58031
92203,11,-3,511,557748,11,557737
92204,14,-14,272,211547,14,211533
92205,7,9,613,919808,7,919801
92206,20,19,454,1244572,20,1244552
92207,15,4,175,774551,15,774536
92208,14,-12,504,276306,14,276292
92209,13,5,425,806847,13,806834
92210,7,13,721,1046177,7,1046170
92211,16,7,50,867433,16,867417
92212,8,5,357,788903,8,788895
92213,17,-5,726,496352,17,496335
92214,19,-13,738,246485,19,246466
92215,20,-10,765,340853,20,340833
92216,14,-12,196,273899,14,273885
92217,8,-20,32,787,8,779
92218,7,1,298,663668,7,663661
92219,15,-11,845,310315,15,310300
92220,5,11,94,970481,5,970476
92221,7,2,896,707268,7,707261
92222,15,5,165,804997,15,804982
92223,5,0,274,631257,5,631252
92224,14,14,685,1090861,14,1090847
92225,11,-13,978,248416,11,248405
92226,11,-4,153,523240,11,523229
92227,19,16,26,1147281,19,1147262
92228,7,17,618,1168471,7,1168464
92229,16,7,688,872060,16,872044
92230,17,-15,504,181485,17,181468
92231,7,-7,840,423640,7,423633
92232,12,0,164,649480,12,649468
92233,7,6,727,828838,7,828831
92234,18,-20,604,27402,18,27384
92235,7,15,711,1109612,7,1109605
92236,7,-2,145,565954,7,565947
92237,13,-2,248,587000,13,586987
92238,11,18,803,1214813,11,1214802
92239,16,-2,865,591739,16,591723
92240,12,19,64,1241252,12,1241240
92241,6,13,644,1044633,6,1044627
92242,16,7,296,869149,16,869133
92243,5,-18,926,82601,5,82596
92244,16,-15,898,184558,16,184542
92245,15,17,855,1184428,15,1184413
92246,9,-7,848,423869,9,423860
92247,15,-19,153,55294,15,55279
92248,5,-4,34,500026,5,500021
92249,19,10,568,964273,19,964254
92250,6,4,444,760192,6,760186
92251,8,-4,478,509754,8,509746
92252,5,-3,477,541179,5,541174
92253,17,8,438,901486,17,901469
92254,6,7,468,854841,6,854835
92255,13,-9,840,373189,13,373176
92256,20,-13,616,245636,20,245616
92257,11,13,989,1060525,11,1060514
92258,12,5,447,807079,12,807067
92259,5,-6,997,458079,5,458074
92260,11,-8,754,403239,11,403228
92261,20,5,661,808617,20,808597
92262,10,14,137,1064914,10,1064904
92263,8,14,588,1074870,8,1074862
92264,20,-6,298,461503,20,461483
92265,7,-19,61,32758,7,32751
92266,8,7,646,858469,8,858461
92267,10,-15,608,168496,10,168486
92268,11,-18,373,88085,11,88074
92269,17,3,415,744988,17,744971
92270,8,16,223,1129984,8,1129976
92271,12,7,857,873179,12,873167
92272,7,6,964,833912,7,833905
92273,17,-12,478,276032,17,276015
92274,6,-12,144,252671,6,252665
92275,18,16,703,1152104,18,1152086
92276,12,10,380,962660,12,962648
92277,18,-15,294,179927,18,179909
92278,9,0,726,641345,9,641336
92279,15,-17,217,117069,15,117054
92280,12,-8,973,404829,12,404817
92281,17,16,194,1148543,17,1148526
92282,5,-2,589,575284,5,575279
92283,12,16,923,1153734,12,1153722
92284,12,11,730,996087,12,996075
92285,14,-7,933,435227,14,435213
92286,7,8,310,882041,7,882034
92287,10,8,735,891480,10,891470
92288,13,-5,103,491709,13,491696
92289,19,9,29,929285,19,929266
92290,11,13,412,1056320,11,1056309
92291,15,-15,761,183423,15,183408
92292,16,10,601,964566,16,964550
92293,7,-4,108,501714,7,501707
92294,12,19,944,1248376,12,1248364
92295,20,5,546,807783,20,807763
92296,5,9,542,918222,5,918217
92297,20,-18,375,88120,20,88100
92298,19,-7,500,432092,19,432073
92299,11,1,958,687330,11,687319
92300,10,-1,581,606607,10,606597
92301,13,9,274,930954,13,930941
92302,8,-14,705,202148,8,202140
92303,6,-8,65,376895,6,376889
92304,16,6,829,842427,16,842411
92305,11,5,407,806742,11,806731
92306,8,-15,536,166989,8,166981
92307,19,0,888,655031,19,655012
92308,15,5,516,807573,15,807558
92309,15,-7,731,433620,15,433605
92310,15,-2,665,590145,15,590130
92311,6,9,933,926581,6,926575
92312,20,-16,348,149489,20,149469
92313,10,-18,820,80214,10,80204
92314,17,-10,740,340662,17,340645
92315,15,19,940,1248348,15,1248333
92316,20,-4,95,522775,20,522755
92317,17,11,647,995449,17,995432
92318,7,11,879,987436,7,987429
92319,10,-11,359,289122,10,289112
92320,20,-15,526,181632,20,181612
92321,8,7,407,853604,8,853596
92322,13,10,637,964847,13,964834
92323,6,-20,465,9956,6,9950
92324,7,11,416,977400,7,977393
92325,6,12,432,1008365,6,1008359
92326,7,-8,214,380070,7,380063
92327,10,12,813,1016738,10,1016728
92328,11,8,246,899955,11,899944
92329,5,-16,62,125172,5,125167
92330,10,-6,871,455389,10,455379
92331,6,17,459,1165176,6,1165170
92332,11,3,19,741930,11,741919
92333,19,14,968,1093024,19,1093005
92334,7,7,596,857462,7,857455
92335,10,16,795,1141660,10,1141650
92336,15,17,12,1177924,15,1177909
92337,16,-10,481,338669,16,338653
92338,13,-18,988,92405,13,92392
92339,10,7,972,865305,10,865295
92340,10,-8,609,388312,10,388302
92341,9,10,482,947780,9,947771
92342,18,9,140,930097,18,930079
92343,11,12,707,1027393,11,1027382
92344,14,-11,612,308638,14,308624
92345,18,8,911,905080,18,905062
92346,7,11,493,978989,7,978982
92347,10,-7,727,421282,10,421272
92348,17,18,919,1215654,17,1215637
92349,15,2,463,714143,15,714128
92350,17,19,698,1246461,17,1246444
92351,9,9,876,925306,9,925297
92352,15,-13,863,247474,15,247459
92353,8,12,3,999138,8,999130
92354,19,-2,294,587382,19,587363
92355,18,-12,529,276482,18,276464
92356,10,-5,833,485985,10,485975
92357,6,19,179,1221491,6,1221485
92358,16,9,506,932773,16,932757
92359,12,12,485,1025660,12,1025648
92360,14,-12,403,275462,14,275448
92361,15,-17,7,115620,15,115605
92362,8,-13,528,229521,8,229513
92363,19,-1,318,619118,19,619099
92364,14,-20,995,30416,14,30402
92365,17,-17,459,118925,17,118908
92366,20,-20,140,23831,20,23811
92367,19,-1,192,617988,19,617969
92368,5,4,811,768278,5,768273
92369,8,-17,124,96034,8,96026
92370,5,4,74,752216,5,752211
92371,20,4,791,779074,20,779054
92372,17,-13,959,248294,17,248277
92373,12,-19,58,54289,12,54277
92374,9,-12,982,271074,9,271065
92375,19,15,267,1118786,19,1118767
92376,5,12,427,1008240,5,1008235
92377,16,15,479,1120185,16,1120169
92378,14,5,652,808527,14,808513
92379,5,10,801,954982,5,954977
92380,13,0,174,649558,13,649545
92381,19,-2,869,591758,19,591739
92382,7,0,185,629577,7,629570
92383,16,2,852,716849,16,716833
92384,9,-10,299,319023,9,319014
92385,16,8,493,901880,16,901864
92386,19,4,126,774148,19,774129
92387,5,3,260,724476,5,724471
92388,6,-16,979,145048,6,145042
92389,12,-7,398,431377,12,431365
92390,5,-4,356,507350,5,507345
92391,20,-9,331,369071,20,369051
92392,17,13,931,1060156,17,1060139
92393,14,-6,963,466429,14,466415
92394,8,-7,742,421569,8,421561
92395,6,8,984,896618,6,896612
92396,17,6,422,839143,17,839126
92397,16,9,307,931250,16,931234
92398,10,-6,384,445044,10,445034
92399,17,-11,905,310827,17,310810
92400,18,4,716,778540,18,778522
92401,13,-18,984,92364,13,92351
92402,8,2,144,691693,8,691685
92403,9,3,77,720464,9,720455
92404,15,16,610,1151427,15,1151412
92405,10,5,608,794267,10,794257
92406,12,-18,781,90954,12,90942
92407,6,15,838,1112277,6,1112271
92408,20,15,820,1122782,20,1122762
92409,20,12,282,1024211,20,1024191
92410,16,8,871,904719,16,904703
92411,20,-5,876,497484,20,497464
92412,19,0,20,648372,19,648353
92413,6,3,256,724359,6,724353
92414,15,-16,582,151297,15,151282
92415,9,16,424,1134337,9,1134328
92416,8,-13,599,231124,8,231116
92417,9,14,987,1083952,9,1083943
92418,6,7,837,862584,6,862578
92419,7,6,470,823072,7,823065
92420,20,17,145,1178944,20,1178924
92421,17,12,668,1027084,17,1027067
92422,13,-12,159,273704,13,273691
92423,8,-10,403,321367,8,321359
92424,16,-20,660,27881,16,27865
92425,19,-16,209,148486,19,148467
92426,13,-7,828,434302,13,434289
92427,13,6,375,838700,13,838687
92428,18,-14,133,210342,18,210324
92429,12,19,152,1241982,12,1241970
92430,18,-17,334,117974,18,117956
92431,19,14,777,1091570,19,1091551
92432,13,-9,794,372850,13,372837
92433,5,-4,977,520426,5,520421
92434,12,-15,760,183409,12,183397
92435,14,-16,293,149115,14,149101
92436,20,4,81,773837,20,773817
92437,19,-7,515,432233,19,432214
92438,17,-1,108,617394,17,617377
92439,11,18,200,1210631,11,1210620
92440,7,-3,991,552649,7,552642
92441,13,-5,702,496169,13,496156
92442,15,13,990,1060531,15,1060516
92443,20,13,755,1058863,20,1058843
92444,7,-18,551,74301,7,74294
92445,6,-8,249,380785,6,380779
92446,11,4,507,776887,11,776876
92447,16,-13,168,242276,16,242260
92448,12,1,525,684018,12,684006
92449,9,-1,693,608830,9,608821
92450,20,-13,111,241869,20,241849
92451,7,-10,255,318113,7,318106
92452,12,-14,632,214487,12,214475
92453,10,3,244,724120,10,724110
92454,9,5,904,800686,9,800677
92455,10,7,700,859634,10,859624
92456,10,-16,369,131933,10,131923
92457,12,-12,539,276540,12,276528
92458,8,5,406,789910,8,789902
92459,5,-3,427,539890,5,539885
92460,16,6,673,841179,16,841163
92461,18,3,573,746103,18,746085
92462,13,-4,955,529256,13,529243
92463,11,-19,612,58803,11,58792
92464,18,18,361,1211718,18,1211700
92465,5,12,640,1013109,5,1013104
92466,11,-4,949,529178,11,529167
92467,10,9,802,923771,10,923761
92468,17,16,794,1152776,17,1152759
92469,17,13,324,1055582,17,1055565
92470,5,-5,760,484385,5,484380
92471,7,14,995,1084187,7,1084180
92472,16,8,94,898678,16,898662
92473,10,0,384,633711,10,633701
92474,20,15,324,1119177,20,1119157
92475,19,10,788,965942,19,965923
92476,17,-13,546,245049,17,245032
92477,19,3,338,744454,19,744435
92478,7,-16,297,130471,7,130464
92479,7,11,958,988931,7,988924
92480,9,9,582,919029,9,919020
92481,15,11,359,993477,15,993462
92482,11,7,267,868935,11,868924
92483,8,6,703,828284,8,828276
92484,16,5,655,808550,16,808534
92485,17,-15,564,181956,17,181939
92486,12,6,433,839222,12,839210
92487,17,16,886,1153374,17,1153357
92488,10,-2,554,574578,10,574568
92489,7,-2,37,563617,7,563610
92490,18,0,675,653419,18,653401
92491,12,1,811,686172,12,686160
92492,9,-18,633,75999,9,75990
92493,14,-9,489,370526,14,370512
92494,6,15,404,1102941,6,1102935
92495,16,-1,325,619140,16,619124
92496,8,-20,613,13397,8,13389
92497,16,-3,653,559012,16,558996
92498,7,9,713,921772,7,921765
92499,17,-14,246,211350,17,211333
92500,16,19,283,1243012,16,1242996
92501,18,4,981,780465,18,780447
92502,12,-10,639,339880,12,339868
92503,18,12,685,1027237,18,1027219
92504,9,7,581,857162,9,857153
92505,11,-9,315,368917,11,368906
92506,16,6,475,839594,16,839578
92507,17,8,685,903421,17,903404
92508,6,2,806,705425,6,705419
92509,6,10,903,956918,6,956912
92510,19,-6,597,463713,19,463694
92511,16,13,513,1057058,16,1057042
92512,17,2,817,716572,17,716555
92513,14,2,178,711941,14,711927
92514,10,-14,31,187144,10,187134
92515,15,-8,975,404848,15,404833
92516,8,-18,237,67721,8,67713
92517,7,-11,286,287320,7,287313
92518,8,-18,786,79497,8,79489
92519,10,-8,921,395021,10,395011
92520,10,-12,302,256231,10,256221
92521,20,19,585,1245559,20,1245539
92522,15,12,832,1028271,15,1028256
92523,13,-7,247,430117,13,430104
92524,10,-15,245,160652,10,160642
92525,8,16,311,1131787,8,1131779
92526,8,-4,985,520705,8,520697
92527,8,-19,846,50056,8,50048
92528,6,13,873,1049566,6,1049560
92529,17,18,270,1211155,17,1211138
92530,10,1,461,667277,10,667267
92531,20,-1,300,618968,20,618948
92532,9,-16,934,144135,9,144126
92533,11,-16,855,153178,11,153167
92534,20,18,763,1214478,20,1214458
92535,9,1,364,665247,9,665238
92536,8,1,31,657729,8,657721
92537,13,-8,335,400280,13,400267
92538,10,-17,556,105449,10,105439
92539,15,-5,575,495274,15,495259
92540,10,-3,207,534837,10,534827
92541,18,2,359,713322,18,713304
92542,9,8,154,878413,9,878404
92543,16,12,100,1022764,16,1022748
92544,15,0,602,652814,15,652799
92545,5,5,542,792892,5,792887
92546,8,8,510,886425,8,886417
92547,20,14,619,1090232,20,1090212
92548,13,13,998,1060636,13,1060623
92549,9,-10,761,328934,9,328925
92550,17,19,364,1243743,17,1243726
92551,9,11,522,979635,9,979626
92552,20,-2,827,591409,20,591389
92553,20,-16,146,148015,20,147995
92554,14,4,469,776638,14,776624
92555,16,18,122,1209924,16,1209908
92556,12,9,431,932160,12,932148
92557,19,-16,845,153108,19,153089
92558,12,8,964,905441,12,905429
92559,10,6,50,813292,10,813282
92560,9,16,404,1133854,9,1133845
92561,13,-11,210,305363,13,305350
92562,11,17,976,1185261,11,1185250
92563,15,5,405,806731,15,806716
92564,5,5,307,787952,5,787947
92565,12,18,535,1212907,12,1212895
92566,10,18,219,1191576,10,1191566
92567,5,-7,979,426783,5,426778
92568,17,9,653,933882,17,933865
92569,10,-1,782,610683,10,610673
92570,11,-19,508,57924,11,57913
92571,18,-7,326,430812,18,430794
92572,6,12,136,1002079,6,1002073
92573,5,-20,710,15687,5,15682
92574,18,1,971,687417,18,687399
92575,8,-4,76,501016,8,501008
92576,17,9,943,936121,17,936104
92577,14,13,519,1057086,14,1057072
92578,8,-17,292,99765,8,99757
92579,19,11,224,992419,19,992400
92580,13,-13,542,245024,13,245011
92581,15,-3,888,560902,15,560887
92582,17,-20,833,29263,17,29246
92583,15,13,761,1058931,15,1058916
92584,20,-11,404,306963,20,306943
92585,15,11,259,992704,15,992689
92586,10,0,386,633752,10,633742
92587,14,3,310,744281,14,744267
92588,20,-13,363,243699,20,243679
92589,12,-4,45,522375,12,522363
92590,7,10,446,947079,7,947072
92591,15,-18,884,91613,15,91598
92592,11,-15,793,183651,11,183640
92593,19,8,598,902648,19,902629
92594,8,19,214,1222276,8,1222268
92595,6,5,112,783899,6,783893
92596,12,-20,643,27687,12,27675
92597,8,-8,459,384773,8,384765
92598,20,19,854,1247685,20,1247665
92599,5,3,100,720983,5,720978
92600,6,-11,849,299333,6,299327
92601,16,-18,779,90938,16,90922
92602,14,9,991,936469,14,936455
92603,19,-16,372,149644,19,149625
92604,7,-17,258,99008,7,99001
92605,19,2,383,713489,19,713470
92606,5,15,412,1103060,5,1103055
92607,14,19,946,1248381,14,1248367
92608,19,19,91,1241528,19,1241509
92609,7,18,229,1191788,7,1191781
92610,5,19,84,1219382,5,1219377
92611,20,-20,267,24821,20,24801
92612,6,-5,347,475765,6,475759
92613,17,18,741,1214298,17,1214281
92614,20,-17,764,121308,20,121288
92615,11,1,124,680803,11,680792
92616,9,-6,61,438103,9,438094
92617,14,-9,948,374067,14,374053
92618,9,3,272,724745,9,724736
92619,17,-9,40,366916,17,366899
92620,10,0,644,639398,10,639388
92621,5,9,884,925463,5,925458
92622,16,15,60,1117239,16,1117223
92623,9,17,865,1174033,9,1174024
92624,8,3,647,732778,8,732770
92625,16,-11,741,309470,16,309454
92626,16,-1,218,618263,16,618247
92627,15,-9,298,368755,15,368740
92628,5,-20,474,10155,5,10150
92629,19,-4,955,529265,19,529246
92630,15,7,560,871140,15,871125
92631,16,19,242,1242631,16,1242615
92632,9,0,819,643163,9,643154
92633,14,1,458,683465,14,683451
92634,7,-10,823,330246,7,330239
92635,13,-19,120,54963,13,54950
92636,9,19,181,1221535,9,1221526
92637,18,19,855,1247725,18,1247707
92638,6,-11,159,284661,6,284655
92639,16,-5,86,491579,16,491563
92640,6,0,388,633825,6,633819
92641,12,13,754,1058845,12,1058833
92642,8,15,370,1102303,8,1102295
92643,13,6,725,841670,13,841657
92644,17,13,861,1059688,17,1059671
92645,9,15,119,1097121,9,1097112
92646,15,-9,698,371967,15,371952
92647,14,9,610,933590,14,933576
92648,12,-16,796,152745,12,152733
92649,15,-16,926,153735,15,153720
92650,17,0,962,655631,17,655614
92651,15,-10,988,342580,15,342565
92652,17,15,95,1117485,17,1117468
92653,12,2,591,715021,12,715009
92654,16,-11,853,310406,16,310390
92655,12,-2,616,589785,12,589773
92656,6,-15,462,165415,6,165409
92657,18,-20,558,27066,18,27048
92658,17,0,1000,655951,17,655934
92659,20,8,274,900113,20,900093
92660,8,4,106,752931,8,752923
92661,12,-18,263,87343,12,87331
92662,7,5,899,800570,7,800563
92663,12,14,490,1089268,12,1089256
92664,5,-7,330,413043,5,413038
92665,13,7,997,874110,13,874097
92666,9,5,618,794519,9,794510
92667,6,-6,99,438904,6,438898
92668,5,10,554,949292,5,949287
92669,15,16,237,1148810,15,1148795
92670,17,9,120,929940,17,929923
92671,19,-10,328,337403,19,337384
92672,14,-19,680,59314,14,59300
92673,14,-11,550,308162,14,308148
92674,14,12,212,1023640,14,1023626
92675,8,15,2,1094418,8,1094410
92676,15,0,957,655576,15,655561
92677,14,-10,796,341074,14,341060
92678,14,18,24,1209076,14,1209062
92679,19,18,43,1209227,19,1209208
92680,9,15,825,1111924,9,1111915
92681,11,-6,296,461490,11,461479
92682,11,19,372,1243786,11,1243775
92683,14,-11,580,308378,14,308364
92684,14,-9,125,367517,14,367503
92685,18,15,428,1119798,18,1119780
92686,14,-14,909,216616,14,216602
92687,16,13,402,1056249,16,1056233
92688,5,-9,740,359978,5,359973
92689,13,-20,92,23469,13,23456
92690,13,0,24,648404,13,648391
92691,12,-3,759,559848,12,559836
92692,5,-5,705,483252,5,483247
92693,18,-1,262,618595,18,618577
92694,5,2,839,706145,5,706140
92695,15,7,550,871087,15,871072
92696,19,-6,200,460708,19,460689
92697,20,15,79,1117391,20,1117371
92698,13,16,341,1149606,13,1149593
92699,18,11,632,995360,18,995342
92700,20,-13,180,242389,20,242369
92701,14,-3,935,561288,14,561274
92702,19,3,108,742680,19,742661
92703,9,3,209,723408,9,723399
92704,17,-4,448,525506,17,525489
92705,5,16,699,1139702,5,1139697
92706,18,0,396,651086,18,651068
92707,17,1,260,681977,17,681960
92708,5,-16,361,131688,5,131683
92709,6,-13,983,239637,6,239631
92710,12,-19,592,58683,12,58671
92711,5,-4,506,510431,5,510426
92712,6,1,565,669680,6,669674
92713,10,1,789,674129,10,674119
92714,13,19,364,1243746,13,1243733
92715,17,12,417,1025084,17,1025067
92716,8,-6,847,454901,8,454893
92717,13,3,165,743077,13,743064
92718,11,2,82,711160,11,711149
92719,5,-18,719,77941,5,77936
92720,12,1,266,682014,12,682002
92721,15,-17,930,122351,15,122336
92722,19,-19,204,55702,19,55683
92723,17,7,767,872574,17,872557
92724,13,0,859,654753,13,654740
92725,17,5,482,807351,17,807334
92726,5,-12,142,252625,5,252620
92727,17,-14,697,214984,17,214967
92728,10,12,50,1000191,10,1000181
92729,14,-1,299,618942,14,618928
92730,15,-1,671,621715,15,621700
92731,14,-5,264,492979,14,492965
92732,6,5,695,796070,6,796064
92733,11,16,506,1150696,11,1150685
92734,6,5,71,783156,6,783150
92735,8,14,984,1083869,8,1083861
92736,11,-10,681,340217,11,340206
92737,13,-12,695,277616,13,277603
92738,14,17,72,1178413,14,1178399
92739,20,-6,349,461862,20,461842
92740,7,12,423,1008135,7,1008128
92741,19,3,45,742159,19,742140
92742,19,13,522,1057096,19,1057077
92743,16,-10,865,341587,16,341571
92744,8,-7,975,426731,8,426723
92745,15,3,89,742475,15,742460
92746,11,8,980,905586,11,905575
92747,18,-6,178,460578,18,460560
92748,11,7,83,867645,11,867634
92749,18,-9,845,373250,18,373232
92750,7,-15,638,169236,7,169229
92751,19,14,783,1091630,19,1091611
92752,15,-20,311,25289,15,25274
92753,14,9,30,929292,14,929278
92754,6,16,663,1139134,6,1139128
92755,16,5,251,805672,16,805656
92756,19,12,829,1028241,19,1028222
92757,18,7,379,869801,18,869783
92758,7,11,912,988149,7,988142
92759,17,17,785,1183739,17,1183722
92760,5,-5,467,478113,5,478108
92761,15,-1,138,617601,15,617586
92762,19,-14,363,212262,19,212243
92763,8,-19,139,34680,8,34672
92764,8,19,135,1220388,8,1220380
92765,16,2,873,717007,16,716991
92766,5,-17,821,110908,5,110903
92767,6,-12,46,250523,6,250517
92768,15,-1,974,623948,15,623933
92769,10,14,822,1080367,10,1080357
92770,18,-12,173,273790,18,273772
92771,18,14,408,1088651,18,1088633
92772,17,10,504,963711,17,963694
92773,6,-10,558,324713,6,324707
92774,15,-19,217,55788,15,55773
92775,6,-7,603,418704,6,418698
92776,6,13,81,1032475,6,1032469
92777,5,17,946,1175590,5,1175585
92778,7,2,402,697346,7,697339
92779,16,-6,924,466143,16,466127
92780,19,-8,302,399996,19,399977
92781,17,4,607,777722,17,777705
92782,17,-6,234,460996,17,460979
92783,12,-8,969,404795,12,404783
92784,19,-7,236,430042,19,430023
92785,8,1,44,658053,8,658045
92786,17,3,927,748879,17,748862
92787,8,-8,436,384380,8,384372
92788,8,-11,350,288883,8,288875
92789,11,-10,433,338237,11,338226
92790,13,-7,367,431135,13,431122
92791,14,16,532,1150875,14,1150861
92792,12,-13,187,242440,12,242428
92793,17,8,869,904706,17,904689
92794,7,19,337,1225135,7,1225128
92795,5,3,709,734301,5,734296
92796,19,-3,795,560191,19,560172
92797,8,1,463,667331,8,667323
92798,8,10,384,945692,8,945684
92799,14,1,151,681066,14,681052
92800,13,7,343,869525,13,869512
92801,8,-18,443,71942,8,71934
92802,11,-2,757,590784,11,590773
92803,8,17,62,1156695,8,1156687
92804,13,-6,486,462896,13,462883
92805,6,11,847,986625,6,986619
92806,20,-9,221,368149,20,368129
92807,19,-5,363,493767,19,493748
92808,6,10,649,951618,6,951612
92809,20,-4,580,526473,20,526453
92810,15,-11,807,310009,15,309994
92811,9,19,24,1218006,9,1217997
92812,20,10,597,964529,20,964509
92813,20,14,321,1087954,20,1087934
92814,17,-7,572,432610,17,432593
92815,7,-9,845,362430,7,362423
92816,7,3,10,719055,7,719048
92817,14,14,377,1088385,14,1088371
92818,7,7,746,860553,7,860546
92819,15,-12,124,273489,15,273474
92820,7,-2,645,576488,7,576481
92821,16,-4,567,526380,16,526364
92822,12,17,749,1183460,12,1183448
92823,19,-13,12,241125,19,241106
92824,20,-5,101,491708,20,491688
92825,5,2,129,691411,5,691406
92826,16,-10,915,341938,16,341922
92827,17,-3,520,557824,17,557807
92828,18,-19,268,56117,18,56099
92829,6,-12,930,269784,6,269778
92830,11,-3,955,561452,11,561441
92831,6,10,57,938759,6,938753
92832,10,-14,36,187318,10,187308
92833,13,-12,801,278366,13,278353
92834,18,-6,726,464706,18,464688
92835,20,7,875,873338,20,873318
92836,10,19,838,1236148,10,1236138
92837,15,18,976,1216165,15,1216150
92838,20,-3,483,557502,20,557482
92839,17,-18,656,90070,17,90053
92840,6,-10,39,313503,6,313497
92841,12,-20,18,11049,12,11037
92842,18,6,555,840225,18,840207
92843,13,8,308,900396,13,900383
92844,7,15,609,1107397,7,1107390
92845,18,17,789,1183790,18,1183772
92846,7,-10,546,324470,7,324463
92847,17,-18,60,85657,17,85640
92848,5,-9,156,346962,5,346957
92849,11,14,585,1089944,11,1089933
92850,10,-19,89,33406,10,33396
92851,8,17,33,1155994,8,1155986
92852,13,7,779,872639,13,872626
92853,10,-10,963,333148,10,333138
92854,20,-9,529,370892,20,370872
92855,18,19,247,1242704,18,1242686
92856,19,-2,812,591233,19,591214
92857,8,-17,994,114368,8,114360
92858,11,5,99,804521,11,804510
92859,16,19,841,1247588,16,1247572
92860,12,17,856,1184429,12,1184417
92861,17,4,27,773458,17,773441
92862,19,-12,527,276466,19,276447
92863,15,7,576,871280,15,871265
92864,11,-15,114,178648,11,178637
92865,12,-5,881,497498,12,497486
92866,11,15,747,1122362,11,1122351
92867,14,9,367,931742,14,931728
92868,18,-10,114,335955,18,335937
92869,19,-12,773,278196,19,278177
92870,18,18,350,1211642,18,1211624
92871,7,-15,438,164914,7,164907
92872,14,-17,244,117289,14,117275
92873,12,19,23,1240902,12,1240890
92874,19,6,426,839180,19,839161
92875,13,6,929,843162,13,843149
92876,11,0,891,655053,11,655042
92877,17,0,227,649931,17,649914
92878,18,-13,405,243972,18,243954
92879,7,8,320,882254,7,882247
92880,6,-19,631,45415,6,45409
92881,11,2,248,712446,11,712435
92882,5,19,361,1225602,5,1225597
92883,13,1,396,683002,13,682989
92884,11,10,173,961203,11,961192
92885,20,-18,581,89476,20,89456
92886,9,-19,262,37307,9,37298
92887,6,-6,179,440817,6,440811
92888,9,3,378,726987,9,726978
92889,6,-9,446,353498,6,353492
92890,17,1,982,687478,17,687461
92891,20,6,24,836026,20,836006
92892,11,-2,134,586108,11,586097
92893,15,9,334,931466,15,931451
92894,15,5,486,807372,15,807357
92895,7,-12,660,263895,7,263888
92896,13,0,324,650442,13,650429
92897,8,6,777,829715,8,829707
92898,14,17,546,1181953,14,1181939
92899,19,-20,353,25563,19,25544
92900,18,-15,509,181514,18,181496
92901,19,8,889,904835,19,904816
92902,12,-8,369,400482,12,400470
92903,7,5,723,796718,7,796711
92904,9,3,574,731045,9,731036
92905,12,1,486,683701,12,683689
92906,8,-11,627,295044,8,295036
92907,13,11,555,994833,13,994820
92908,12,-12,781,278234,12,278222
92909,12,8,546,902247,12,902235
92910,5,-10,289,318778,5,318773
92911,7,7,235,849793,7,849786
92912,5,-13,356,225828,5,225823
92913,18,3,643,746684,18,746666
92914,9,-20,84,1916,9,1907
92915,12,-6,181,460586,12,460574
92916,17,-17,78,116115,17,116098
92917,20,7,861,873240,20,873220
92918,11,18,94,1209685,11,1209674
92919,18,-17,135,116476,18,116458
92920,17,19,665,1246166,17,1246149
92921,6,-1,582,606632,6,606626
92922,18,14,91,1086168,18,1086150
92923,11,-14,194,210809,11,210798
92924,10,8,453,885108,10,885098
92925,11,-6,378,462064,11,462053
92926,10,-11,291,287416,10,287406
92927,8,13,441,1040270,8,1040262
92928,16,-20,685,28082,16,28066
92929,17,-5,630,495664,17,495647
92930,15,-2,799,591136,15,591121
92931,11,6,423,839159,11,839148
92932,20,-1,472,620354,20,620334
92933,7,1,779,673950,7,673943
92934,7,-11,387,289687,7,289680
92935,11,-11,985,311429,11,311418
92936,13,-11,659,308992,13,308979
92937,13,-6,617,463870,13,463857
92938,6,-10,901,331850,6,331844
92939,14,10,406,962924,14,962910
92940,14,3,800,747872,14,747858
92941,18,-3,616,558691,18,558673
92942,16,-10,538,339073,16,339057
92943,12,8,324,900537,12,900525
92944,10,-9,78,345325,10,345315
92945,12,15,304,1119043,12,1119031
92946,12,-1,644,621511,12,621499
92947,19,2,121,711514,19,711495
92948,13,15,829,1122862,13,1122849
92949,6,-13,16,218645,6,218639
92950,16,-9,518,370781,16,370765
92951,15,-17,527,119434,15,119419
92952,17,2,399,713647,17,713630
92953,19,-10,958,342285,19,342266
92954,7,-4,565,511588,7,511581
92955,13,7,962,873826,13,873813
92956,10,18,714,1201581,10,1201571
92957,14,19,418,1244294,14,1244280
92958,14,19,47,1241103,14,1241089
92959,13,5,588,808080,13,808067
92960,13,2,872,717002,13,716989
92961,16,-11,879,310633,16,310617
92962,16,-16,404,149888,16,149872
92963,16,-18,332,87799,16,87783
92964,7,-9,103,345798,7,345791
92965,10,18,678,1200962,10,1200952
92966,11,13,603,1057829,11,1057818
92967,14,-1,748,622316,14,622302
92968,9,14,841,1080700,9,1080691
92969,18,-5,188,492364,18,492346
92970,18,0,837,654635,18,654617
92971,14,12,294,1024310,14,1024296
92972,12,18,229,1210809,12,1210797
92973,13,-13,807,247051,13,247038
92974,18,10,586,964422,18,964404
92975,11,-12,172,273776,11,273765
92976,10,-9,221,348308,10,348298
92977,7,8,181,879018,7,879011
92978,10,5,126,784192,10,784182
92979,7,-15,801,172522,7,172515
92980,18,11,60,991331,18,991313
92981,16,6,545,840164,16,840148
92982,14,-12,295,274704,14,274690
92983,18,18,108,1209865,18,1209847
92984,19,18,786,1214683,19,1214664
92985,17,5,285,805946,17,805929
92986,9,-4,138,502416,9,502407
92987,13,17,102,1178555,13,1178542
92988,17,14,322,1087960,17,1087943
92989,5,9,584,919090,5,919085
92990,5,9,625,920080,5,920075
92991,6,-13,890,237620,6,237614
92992,8,-18,74,64144,8,64136
92993,11,17,866,1184510,11,1184499
92994,15,0,552,652395,15,652380
92995,5,-8,622,388642,5,388637
92996,10,-17,234,98401,10,98391
92997,6,6,795,830240,6,830234
92998,11,6,952,843323,11,843312
92999,14,10,184,961274,14,961260
93000,14,-6,717,464612,14,464598
93001,7,-12,679,264217,7,264210
93002,20,-12,207,273967,20,273947
93003,18,-20,524,26759,18,26741
93004,9,-2,323,569689,9,569680
93005,7,-18,259,68099,7,68092
93006,8,-11,395,289916,8,289908
93007,9,-10,241,317807,9,317798
93008,6,-7,408,414753,6,414747
93009,20,16,558,1151068,20,1151048
93010,15,10,615,964652,15,964637
93011,5,-17,463,103385,5,103380
93012,8,-12,801,266820,8,266812
93013,13,1,52,680203,13,680190
93014,14,5,677,808714,14,808700
93015,13,-9,195,367942,13,367929
93016,14,17,682,1182917,14,1182903
93017,10,16,23,1125688,10,1125678
93018,19,-1,403,619774,19,619755
93019,5,-11,141,284219,5,284214
93020,14,-10,890,341789,14,341775
93021,17,-6,899,465959,17,465942
93022,14,-8,975,404852,14,404838
93023,10,-11,372,289438,10,289428
93024,15,-13,346,243615,15,243600
93025,19,10,563,964211,19,964192
93026,7,-19,545,43373,7,43366
93027,8,1,682,671977,8,671969
93028,12,-2,917,592122,12,592110
93029,5,1,280,663280,5,663275
93030,5,6,670,827437,5,827432
93031,18,-11,737,309429,18,309411
93032,16,5,762,809314,16,809298
93033,18,-13,984,248462,18,248444
93034,14,-6,269,461285,14,461271
93035,18,15,524,1120585,18,1120567
93036,10,6,971,834173,10,834163
93037,16,-11,84,304322,16,304306
93038,20,2,225,712287,20,712267
93039,16,-12,715,277779,16,277763
93040,8,15,72,1095987,8,1095979
93041,11,1,37,680088,11,680077
93042,5,10,3,937577,5,937572
93043,5,-1,702,609015,5,609010
93044,5,3,439,728288,5,728283
93045,12,16,952,1153885,12,1153873
93046,13,-4,674,527167,13,527154
93047,18,-16,716,152159,18,152141
93048,19,-9,113,367423,19,367404
93049,10,5,553,793084,10,793074
93050,20,3,249,743768,20,743748
93051,7,0,777,642401,7,642394
93052,12,18,426,1212189,12,1212177
93053,12,12,850,1028482,12,1028470
93054,7,-20,150,3354,7,3347
93055,6,7,126,847513,6,847507
93056,18,-6,410,462285,18,462267
93057,9,9,590,919309,9,919300
93058,9,-12,633,263180,9,263171
93059,14,9,268,930887,14,930873
93060,17,-9,116,367464,17,367447
93061,14,9,415,932041,14,932027
93062,13,-11,295,306045,13,306032
93063,15,18,741,1214303,15,1214288
93064,19,13,400,1056219,19,1056200
93065,14,13,277,1055234,14,1055220
93066,14,1,840,686349,14,686335
93067,13,-14,211,210967,13,210954
93068,6,11,594,981237,6,981231
93069,13,12,158,1023205,13,1023192
93070,17,-16,547,151032,17,151015
93071,17,1,884,686681,17,686664
93072,5,1,30,657689,5,657684
93073,11,-2,85,585772,11,585761
93074,18,-10,832,341342,18,341324
93075,10,9,35,907559,10,907549
93076,20,-17,182,116806,20,116786
93077,17,16,709,1152150,17,1152133
93078,8,-16,476,134484,8,134476
93079,7,19,967,1238908,7,1238901
93080,9,10,823,955329,9,955320
93081,7,17,497,1165963,7,1165956
93082,10,11,137,971322,10,971312
93083,17,-7,934,435233,17,435216
93084,6,11,865,987028,6,987022
93085,6,9,371,914574,6,914568
93086,9,5,277,787475,9,787466
93087,19,8,623,902888,19,902869
93088,18,-13,914,247918,18,247900
93089,19,11,59,991322,19,991303
93090,17,-1,336,619266,17,619249
93091,7,5,699,796181,7,796174
93092,15,14,633,1090361,15,1090346
93093,10,-11,28,281668,10,281658
93094,16,-1,609,621307,16,621291
93095,13,15,267,1118789,13,1118776
93096,20,3,260,743852,20,743832
93097,15,3,333,744419,15,744404
93098,8,-17,356,101093,8,101085
93099,17,-14,660,214662,17,214645
93100,9,9,784,923287,9,923278
93101,19,-12,313,274861,19,274842
93102,20,-12,407,275503,20,275483
93103,15,11,968,997804,15,997789
93104,12,-14,573,214035,12,214023
93105,20,-9,221,368159,20,368139
93106,9,7,849,862792,9,862783
93107,7,2,854,706353,7,706346
93108,7,5,217,786248,7,786241
93109,12,6,286,837957,12,837945
93110,12,-1,123,617494,12,617482
93111,7,-13,831,236364,7,236357
93112,5,6,35,812992,5,812987
93113,8,-2,992,583981,8,583973
93114,13,15,224,1118503,13,1118490
93115,9,-2,908,582309,9,582300
93116,14,-4,897,528804,14,528790
93117,13,-7,691,433310,13,433297
93118,5,6,387,821040,5,821035
93119,5,0,527,636728,5,636723
93120,13,-2,309,587445,13,587432
93121,15,18,411,1212087,15,1212072
93122,12,6,144,836847,12,836835
93123,17,13,453,1056626,17,1056609
93124,13,1,951,687296,13,687283
93125,10,0,819,643173,10,643163
93126,11,11,829,996830,11,996819
93127,16,-1,947,623779,16,623763
93128,20,17,145,1178954,20,1178934
93129,8,-15,568,167661,8,167653
93130,17,4,273,775172,17,775155
93131,20,-15,14,177946,20,177926
93132,13,-18,304,87601,13,87588
93133,12,2,634,715330,12,715318
93134,6,-14,943,207002,6,206996
93135,8,2,187,692732,8,692724
93136,13,18,586,1213171,13,1213158
93137,15,-8,584,401935,15,401920
93138,10,18,836,1204411,10,1204401
93139,8,-6,532,448296,8,448288
93140,10,-6,712,452088,10,452078
93141,5,-2,588,575241,5,575236
93142,5,-6,206,441394,5,441389
93143,16,-5,224,492624,16,492608
93144,16,16,478,1150551,16,1150535
93145,8,1,43,657998,8,657990
93146,13,-12,669,277458,13,277445
93147,12,-13,949,248219,12,248207
93148,13,-3,700,559357,13,559344
93149,17,9,797,934971,17,934954
93150,17,12,429,1025201,17,1025184
93151,7,-13,52,219549,7,219542
93152,13,-16,394,149780,13,149767
93153,12,15,101,1117554,12,1117542
93154,7,-12,553,261517,7,261510
93155,9,10,643,951423,9,951414
93156,20,2,30,710709,20,710689
93157,12,-10,634,339838,12,339826
93158,8,-9,810,361670,8,361662
93159,11,2,792,716412,11,716401
93160,17,13,550,1057389,17,1057372
93161,8,12,673,1013901,8,1013893
93162,5,-16,551,136031,5,136026
93163,5,9,516,917705,5,917700
93164,6,7,288,850985,6,850979
93165,14,0,628,652990,14,652976
93166,20,1,569,684390,20,684370
93167,13,12,783,1027891,13,1027878
93168,5,-14,139,189550,5,189545
93169,20,3,789,747800,20,747780
93170,7,-12,462,259582,7,259575
93171,16,0,799,654401,16,654385
93172,13,-18,994,92439,13,92426
93173,16,-2,458,588582,16,588566
93174,17,-6,920,466116,17,466099
93175,9,-5,657,482247,9,482238
93176,7,15,864,1112883,7,1112876
93177,15,0,658,653291,15,653276
93178,12,-14,655,214629,12,214617
93179,20,-20,105,23564,20,23544
93180,12,-2,262,587104,12,587092
93181,14,-7,48,428657,14,428643
93182,18,15,84,1117431,18,1117413
93183,5,-18,348,70024,5,70019
93184,20,-18,188,86750,20,86730
93185,14,2,800,716460,14,716446
93186,20,-9,926,373920,20,373900
93187,9,11,454,978127,9,978118
93188,15,-10,869,341616,15,341601
93189,9,7,112,847262,9,847253
93190,9,16,403,1133822,9,1133813
93191,16,-12,478,276038,16,276022
93192,18,16,297,1149287,18,1149269
93193,19,4,367,775885,19,775866
93194,16,-10,596,339513,16,339497
93195,15,9,467,932421,15,932406
93196,8,-8,190,379581,8,379573
93197,6,-6,115,439163,6,439157
93198,16,16,225,1148725,16,1148709
93199,13,-19,468,57581,13,57568
93200,11,7,67,867504,11,867493
93201,8,-10,170,316378,8,316370
93202,14,0,558,652443,14,652429
93203,10,-4,73,500960,10,500950
93204,19,-10,685,340270,19,340251
93205,12,11,723,996042,12,996030
93206,19,2,486,714285,19,714266
93207,9,0,126,628249,9,628240
93208,10,-20,275,6147,10,6137
93209,19,-4,215,523781,19,523762
93210,13,-20,406,25908,13,25895
93211,8,-2,844,580896,8,580888
93212,14,-18,848,91319,14,91305
93213,16,1,244,681810,16,681794
93214,5,-4,836,517156,5,517151
93215,13,12,145,1023087,13,1023074
93216,12,-6,93,459785,12,459773
93217,11,11,320,993207,11,993196
93218,17,18,221,1210758,17,1210741
93219,19,1,161,681149,19,681130
93220,17,-11,165,305058,17,305041
93221,16,3,246,743727,16,743711
93222,15,4,275,775180,15,775165
93223,12,14,275,1087561,12,1087549
93224,15,13,727,1058648,15,1058633
93225,18,10,633,964811,18,964793
93226,8,-1,293,600356,8,600348
93227,20,-19,568,58493,20,58473
93228,7,-18,879,81418,7,81411
93229,13,6,947,843314,13,843301
93230,13,16,991,1154217,13,1154204
93231,20,1,479,683645,20,683625
93232,11,17,184,1179278,11,1179267
93233,9,-5,40,468762,9,468753
93234,18,6,561,840294,18,840276
93235,9,14,355,1069618,9,1069609
93236,18,-6,236,461022,18,461004
93237,19,-13,515,244852,19,244833
93238,10,-3,756,547377,10,547367
93239,15,13,830,1059455,15,1059440
93240,7,3,454,728581,7,728574
93241,17,-20,939,29929,17,29912
93242,10,-11,224,285915,10,285905
93243,15,6,884,842830,15,842815
93244,6,19,255,1223127,6,1223121
93245,13,16,472,1150483,13,1150470
93246,20,14,884,1092378,20,1092358
93247,17,-15,704,183006,17,182989
93248,17,19,721,1246632,17,1246615
93249,17,12,375,1024819,17,1024802
93250,18,14,548,1089757,18,1089739
93251,15,0,645,653140,15,653125
93252,13,-3,36,554077,13,554064
93253,16,19,192,1242284,16,1242268
93254,5,-5,143,471198,5,471193
93255,9,-14,260,192490,9,192481
93256,19,-3,503,557672,19,557653
93257,5,-15,674,169855,5,169850
93258,19,5,143,804842,19,804823
93259,16,11,240,992549,16,992533
93260,6,13,723,1046231,6,1046225
93261,14,9,496,932657,14,932643
93262,10,11,736,984172,10,984162
93263,7,-20,162,3583,7,3576
93264,7,-20,985,21787,7,21780
93265,18,3,125,742802,18,742784
93266,18,12,124,1022974,18,1022956
93267,11,10,192,961323,11,961312
93268,18,-12,39,272786,18,272768
93269,10,10,990,958675,10,958665
93270,11,3,472,745373,11,745362
93271,17,8,752,903888,17,903871
93272,6,-15,593,168183,6,168177
93273,6,-12,4,249734,6,249728
93274,15,-10,966,342350,15,342335
93275,8,10,557,949425,8,949417
93276,15,15,419,1119735,15,1119720
93277,15,15,347,1119349,15,1119334
93278,5,4,362,758373,5,758368
93279,10,16,633,1138523,10,1138513
93280,13,15,444,1119940,13,1119927
93281,14,8,254,899975,14,899961
93282,18,-6,210,460786,18,460768
93283,16,10,712,965356,16,965340
93284,7,5,516,792372,7,792365
93285,17,8,661,903180,17,903163
93286,11,16,311,1149389,11,1149378
93287,12,-10,399,337939,12,337927
93288,16,0,8,648247,16,648231
93289,13,-12,208,274002,13,273989
93290,10,-12,785,266460,10,266450
93291,9,15,703,1109379,9,1109370
93292,17,-20,362,25599,17,25582
93293,9,-15,281,161402,9,161393
93294,5,-16,627,137661,5,137656
93295,9,-3,53,531685,9,531676
93296,11,-19,111,54867,11,54856
93297,20,-15,655,182693,20,182673
93298,6,-4,976,520405,6,520399
93299,13,17,309,1180305,13,1180292
93300,11,-19,755,59910,11,59899
93301,8,-18,421,71477,8,71469
93302,18,5,602,808214,18,808196
93303,11,11,356,993447,11,993436
93304,8,2,641,702151,8,702143
93305,6,-12,488,260113,6,260107
93306,17,5,119,804672,17,804655
93307,10,14,550,1074129,10,1074119
93308,16,-9,727,372124,16,372108
93309,10,4,71,752155,10,752145
93310,16,18,671,1213832,16,1213816
93311,10,-7,762,422010,10,422000
93312,15,2,301,712857,15,712842
93313,13,17,556,1182013,13,1182000
93314,6,12,671,1013813,6,1013807
93315,16,-11,699,309217,16,309201
93316,14,-4,525,526096,14,526082
93317,8,-12,360,257494,8,257486
93318,17,7,771,872587,17,872570
93319,13,4,962,780321,13,780308
93320,14,17,870,1184528,14,1184514
93321,16,2,646,715413,16,715397
93322,10,-15,194,159430,10,159420
93323,17,3,264,743895,17,743878
93324,14,-10,604,339604,14,339590
93325,10,11,742,984310,10,984300
93326,14,9,318,931334,14,931320
93327,6,4,274,756535,6,756529
93328,17,-16,957,153972,17,153955
93329,14,0,3,648207,14,648193
93330,6,-14,662,201191,6,201185
93331,17,13,558,1057454,17,1057437
93332,11,16,411,1150121,11,1150110
93333,14,4,631,777865,14,777851
93334,17,8,462,901638,17,901621
93335,5,1,362,665157,5,665152
93336,13,16,277,1149122,13,1149109
93337,13,-17,294,117680,13,117667
93338,5,4,169,754262,5,754257
93339,11,8,241,899937,11,899926
93340,8,16,553,1136900,8,1136892
93341,17,-16,956,153962,17,153945
93342,12,17,888,1184597,12,1184585
93343,17,-16,7,146772,17,146755
93344,18,17,732,1183364,18,1183346
93345,5,8,442,884887,5,884882
93346,6,13,765,1047207,6,1047201
93347,16,1,363,682781,16,682765
93348,17,-5,569,495234,17,495217
93349,20,-18,4,85248,20,85228
93350,18,4,483,776728,18,776710
93351,14,-18,96,85965,14,85951
93352,18,13,921,1060058,18,1060040
93353,9,15,645,1108123,9,1108114
93354,9,-16,104,126286,9,126277
93355,7,-5,598,481030,7,481023
93356,16,6,679,841221,16,841205
93357,14,2,259,712522,14,712508
93358,6,16,497,1135758,6,1135752
93359,19,18,377,1211835,19,1211816
93360,17,-6,610,463803,17,463786
93361,5,-15,613,168621,5,168616
93362,15,-17,820,121635,15,121620
93363,8,17,786,1172063,8,1172055
93364,17,-8,488,401216,17,401199
93365,10,-9,119,346134,10,346124
93366,12,11,491,994437,12,994425
93367,20,-20,341,25481,20,25461
93368,16,12,250,1023907,16,1023891
93369,11,-12,703,277676,11,277665
93370,5,9,358,914317,5,914312
93371,12,18,807,1214828,12,1214816
93372,6,-3,985,552497,6,552491
93373,15,18,181,1210436,15,1210421
93374,6,-13,974,239458,6,239452
93375,8,-12,908,269471,8,269463
93376,16,7,387,869890,16,869874
93377,9,-10,737,328480,9,328471
93378,7,-9,897,363778,7,363771
93379,11,-10,795,341071,11,341060
93380,19,7,140,868067,19,868048
93381,14,5,818,809764,14,809750
93382,12,5,574,807977,12,807965
93383,11,15,359,1119402,11,1119391
93384,14,3,393,744848,14,744834
93385,16,14,189,1086913,16,1086897
93386,7,3,599,731597,7,731590
93387,11,-5,986,498268,11,498257
93388,7,7,723,860042,7,860035
93389,12,2,761,716271,12,716259
93390,15,3,243,743704,15,743689
93391,20,0,106,649083,20,649063
93392,15,9,132,930049,15,930034
93393,13,2,102,711357,13,711344
93394,16,-4,561,526331,16,526315
93395,12,2,296,712825,12,712813
93396,14,-7,682,433262,14,433248
93397,10,8,190,879229,10,879219
93398,10,19,134,1220354,10,1220344
93399,15,-2,252,587037,15,587022
93400,9,5,411,790030,9,790021
93401,6,-5,447,477616,6,477610
93402,7,-17,947,113467,7,113460
93403,12,-5,216,492574,12,492562
93404,17,-13,344,243610,17,243593
93405,13,-19,14,53990,13,53977
93406,14,-16,582,151301,14,151287
93407,5,2,790,705125,5,705120
93408,10,15,963,1115010,10,1115000
93409,17,-4,489,525745,17,525728
93410,7,-19,18,31905,7,31898
93411,14,-1,260,618570,14,618556
93412,16,5,981,810989,16,810973
93413,15,-10,883,341767,15,341752
93414,9,12,773,1015864,9,1015855
93415,20,9,347,931565,20,931545
93416,14,4,69,773764,14,773750
93417,6,-7,131,408564,6,408558
93418,10,-12,395,258194,10,258184
93419,9,2,722,703885,9,703876
93420,20,-15,132,178817,20,178797
93421,13,-4,388,525116,13,525103
93422,19,-10,273,337064,19,337045
93423,20,12,108,1022838,20,1022818
93424,14,18,777,1214610,14,1214596
93425,10,16,146,1128201,10,1128191
93426,12,-5,142,492014,12,492002
93427,10,17,450,1164982,10,1164972
93428,5,17,992,1176672,5,1176667
93429,18,8,509,902011,18,901993
93430,7,7,685,859316,7,859309
93431,7,7,580,857145,7,857138
93432,9,-10,937,332648,9,332639
93433,17,7,384,869852,17,869835
93434,16,17,387,1180843,16,1180827
93435,9,6,185,816236,9,816227
93436,6,-4,633,513074,6,513068
93437,11,4,426,776349,11,776338
93438,12,2,472,714190,12,714178
93439,17,2,873,717014,17,716997
93440,11,-18,815,91192,11,91181
93441,17,13,491,1056862,17,1056845
93442,7,-5,426,477217,7,477210
93443,19,-18,644,89923,19,89904
93444,19,-4,285,524290,19,524271
93445,11,13,869,1059736,11,1059725
93446,14,-15,606,182218,14,182204
93447,16,4,358,775830,16,775814
93448,7,16,396,1133649,7,1133642
93449,17,-10,299,337224,17,337207
93450,11,-17,380,118286,11,118275
93451,12,3,141,742899,12,742887
93452,16,-2,942,592330,16,592314
93453,17,-19,193,55585,17,55568
93454,15,2,213,712210,15,712195
93455,17,16,687,1152014,17,1151997
93456,16,-5,655,495798,16,495782
93457,16,18,374,1211822,16,1211806
93458,18,19,336,1243490,18,1243472
93459,18,11,650,995467,18,995449
93460,7,-5,859,486621,7,486614
93461,5,-18,985,83846,5,83841
93462,10,0,100,627639,10,627629
93463,6,16,756,1140835,6,1140829
93464,20,-13,99,241799,20,241779
93465,17,17,140,1178921,17,1178904
93466,8,11,638,982073,8,982065
93467,13,2,782,716350,13,716337
93468,9,7,758,860797,9,860788
93469,12,3,260,743854,12,743842
93470,15,-7,106,429072,15,429057
93471,6,-7,58,407233,6,407227
93472,18,-1,954,623830,18,623812
93473,6,-15,741,171337,6,171331
93474,8,5,566,793295,8,793287
93475,10,-6,265,442608,10,442598
93476,13,-5,182,492321,13,492308
93477,14,-11,401,306924,14,306910
93478,15,-11,502,307770,15,307755
93479,15,16,778,1152629,15,1152614
93480,15,16,351,1149690,15,1149675
93481,8,-13,25,218908,8,218900
93482,5,16,673,1139290,5,1139285
93483,9,-16,346,131382,9,131373
93484,17,2,128,711586,17,711569
93485,13,-17,936,122405,13,122392
93486,8,15,769,1110805,8,1110797
93487,16,18,938,1215833,16,1215817
93488,7,10,816,955196,7,955189
93489,11,-12,77,273099,11,273088
93490,18,-10,165,336329,18,336311
93491,16,14,357,1088207,16,1088191
93492,16,-14,690,214941,16,214925
93493,20,-8,688,402779,20,402759
93494,5,6,131,815036,5,815031
93495,8,-3,908,550798,8,550790
93496,11,-14,115,210201,11,210190
93497,14,-13,980,248435,14,248421
93498,15,1,463,683512,15,683497
93499,9,17,726,1170802,9,1170793
93500,17,-14,930,216720,17,216703
93501,9,-18,454,72199,9,72190
93502,5,-1,451,603851,5,603846
93503,18,17,977,1185275,18,1185257
93504,12,19,308,1243258,12,1243246
93505,5,-13,536,229735,5,229730
93506,6,-18,538,73966,6,73960
93507,13,2,220,712238,13,712225
93508,19,-7,540,432420,19,432401
93509,9,15,946,1114653,9,1114644
93510,18,-2,217,586793,18,586775
93511,20,19,153,1242002,20,1241982
93512,11,16,103,1147795,11,1147784
93513,6,19,128,1220265,6,1220259
93514,17,1,164,681177,17,681160
93515,8,-1,139,596818,8,596810
93516,9,5,897,800525,9,800516
93517,12,-19,522,58051,12,58039
93518,9,17,956,1175816,9,1175807
93519,16,-12,380,275329,16,275313
93520,15,15,143,1117880,15,1117865
93521,20,18,896,1215537,20,1215517
93522,6,-19,815,49226,6,49220
93523,20,-6,7,459211,20,459191
93524,18,-18,179,86690,18,86672
93525,15,14,679,1090791,15,1090776
93526,20,-16,46,147113,20,147093
93527,19,-15,951,185034,19,185015
93528,10,-17,475,103598,10,103588
93529,12,10,341,962409,12,962397
93530,14,17,791,1183828,14,1183814
93531,12,15,280,1118856,12,1118844
93532,15,-9,321,368949,15,368934
93533,12,-19,602,58747,12,58735
93534,20,17,787,1183754,20,1183734
93535,11,-15,899,184566,11,184555
93536,12,-13,571,245263,12,245251
93537,15,-11,979,311376,15,311361
93538,8,-11,815,298542,8,298534
93539,12,0,770,654176,12,654164
93540,15,8,753,903892,15,903877
93541,20,0,962,655641,20,655621
93542,17,1,452,683421,17,683404
93543,8,5,796,798235,8,798227
93544,9,15,834,1112185,9,1112176
93545,9,-5,639,481883,9,481874
93546,11,-10,699,340376,11,340365
93547,7,19,197,1221868,7,1221861
93548,16,-12,614,276963,16,276947
93549,13,-13,51,241441,13,241428
93550,8,7,791,861569,8,861561
93551,12,3,798,747863,12,747851
93552,9,16,944,1144834,9,1144825
93553,14,-14,565,213938,14,213924
93554,14,-4,58,522496,14,522482
93555,8,-13,709,233477,8,233469
93556,13,-20,983,30306,13,30293
93557,8,2,183,692645,8,692637
93558,13,-10,678,340207,13,340194
93559,15,9,990,936456,15,936441
93560,19,19,2,1240660,19,1240641
93561,8,16,439,1134669,8,1134661
93562,17,-2,187,586472,17,586455
93563,13,15,749,1122375,13,1122362
93564,9,4,440,760125,9,760116
93565,18,-14,698,214991,18,214973
93566,7,-5,848,486378,7,486371
93567,16,-3,391,556676,16,556660
93568,12,15,81,1117397,12,1117385
93569,13,-20,450,26232,13,26219
93570,20,0,109,649099,20,649079
93571,18,5,605,808223,18,808205
93572,7,-19,672,46219,7,46212
93573,10,-14,623,200435,10,200425
93574,10,-6,149,439964,10,439954
93575,17,-14,991,217215,17,217198
93576,18,-20,991,30384,18,30366
93577,5,-20,550,12050,5,12045
93578,11,-14,970,217053,11,217042
93579,20,-12,962,279790,20,279770
93580,10,6,366,820485,10,820475
93581,5,-6,497,447532,5,447527
93582,13,17,667,1182840,13,1182827
93583,8,1,47,658120,8,658112
93584,17,14,777,1091577,17,1091560
93585,15,-9,935,373997,15,373982
93586,14,5,252,805675,14,805661
93587,8,5,858,799543,8,799535
93588,5,9,586,919194,5,919189
93589,6,-9,884,363440,6,363434
93590,10,9,336,913832,10,913822
93591,5,-6,165,440372,5,440367
93592,5,4,233,755747,5,755742
93593,15,18,966,1216093,15,1216078
93594,13,19,898,1248065,13,1248052
93595,6,-6,506,447762,6,447756
93596,14,5,875,810149,14,810135
93597,18,-20,185,24256,18,24238
93598,18,6,451,839388,18,839370
93599,17,6,157,836940,17,836923
93600,9,2,628,701921,9,701912
93601,12,-16,795,152744,12,152732
93602,6,-11,927,300985,6,300979
93603,18,6,391,838869,18,838851
93604,20,-4,345,524798,20,524778
93605,10,-7,885,424841,10,424831
93606,17,-12,892,279197,17,279180
93607,19,17,794,1183848,19,1183829
93608,15,14,960,1092943,15,1092928
93609,8,-18,610,75502,8,75494
93610,15,8,88,898609,15,898594
93611,8,12,40,999971,8,999963
93612,18,-3,721,559513,18,559495
93613,20,-7,923,435151,20,435131
93614,16,5,670,808664,16,808648
93615,9,-3,753,547318,9,547309
93616,17,-16,868,153373,17,153356
93617,14,-10,68,335697,14,335683
93618,16,-15,245,179551,16,179535
93619,13,-18,933,92005,13,91992
93620,11,2,194,712056,11,712045
93621,20,-8,351,400369,20,400349
93622,11,-4,266,524146,11,524135
93623,18,0,155,649406,18,649388
93624,7,13,378,1038843,7,1038836
93625,18,13,567,1057498,18,1057480
93626,14,-6,667,464236,14,464222
93627,7,13,219,1035446,7,1035439
93628,15,-18,73,85775,15,85760
93629,14,-18,497,88940,14,88926
93630,10,-5,988,489507,10,489497
93631,6,-3,351,538094,6,538088
93632,17,17,787,1183761,17,1183744
93633,7,-10,298,318988,7,318981
93634,6,10,836,955541,6,955535
93635,8,14,101,1064100,8,1064092
93636,17,17,232,1179596,17,1179579
93637,6,-16,424,133178,6,133172
93638,11,-14,956,216921,11,216910
93639,5,16,501,1135828,5,1135823
93640,16,13,744,1058774,16,1058758
93641,16,-11,932,310976,16,310960
93642,18,4,928,780117,18,780099
93643,15,-2,913,592098,15,592083
93644,5,13,112,1033140,5,1033135
93645,19,-11,524,307926,19,307907
93646,18,-19,511,57944,18,57926
93647,7,9,370,914559,7,914552
93648,5,13,143,1033726,5,1033721
93649,20,11,15,990980,20,990960
93650,18,15,911,1123446,18,1123428
93651,10,-7,430,415112,10,415102
93652,16,5,503,807475,16,807459
93653,14,12,272,1024161,14,1024147
93654,12,16,794,1152778,12,1152766
93655,20,-9,114,367440,20,367420
93656,14,-16,20,146926,14,146912
93657,10,-1,864,612433,10,612423
93658,12,-7,844,434472,12,434460
93659,5,-12,398,258272,5,258267
93660,20,-20,850,29374,20,29354
93661,20,-19,28,54095,20,54075
93662,10,6,718,828586,10,828576
93663,16,10,593,964470,16,964454
93664,12,-1,452,620152,12,620140
93665,17,1,881,686649,17,686632
93666,18,9,415,932049,18,932031
93667,12,-11,723,309388,12,309376
93668,12,-3,833,560451,12,560439
93669,10,0,991,646915,10,646905
93670,10,18,978,1207534,10,1207524
93671,15,-9,681,371813,15,371798
93672,9,-14,607,200048,9,200039
93673,7,-6,999,458110,7,458103
93674,14,12,143,1023064,14,1023050
93675,17,-8,503,401359,17,401342
93676,6,7,668,859005,6,858999
93677,15,5,79,804398,15,804383
93678,5,12,217,1003885,5,1003880
93679,11,3,975,749322,11,749311
93680,19,-19,318,56447,19,56428
93681,10,-16,689,138789,10,138779
93682,19,-6,18,459284,19,459265
93683,7,12,591,1011790,7,1011783
93684,7,1,493,668081,7,668074
93685,11,-7,280,430410,11,430399
93686,9,7,3,844867,9,844858
93687,11,19,277,1242988,11,1242977
93688,20,2,561,714812,20,714792
93689,18,7,240,868726,18,868708
93690,14,13,312,1055483,14,1055469
93691,13,-10,622,339703,13,339690
93692,10,8,796,892711,10,892701
93693,17,19,64,1241259,17,1241242
93694,7,-4,762,515678,7,515671
93695,15,6,847,842548,15,842533
93696,8,10,929,957561,8,957553
93697,5,-13,321,225196,5,225191
93698,9,4,518,761769,9,761760
93699,5,-14,191,190601,5,190596
93700,10,-2,942,583068,10,583058
93701,16,5,969,810944,16,810928
93702,19,3,848,748225,19,748206
93703,18,-8,306,400029,18,400011
93704,13,-11,576,308327,13,308314
93705,9,19,132,1220310,9,1220301
93706,15,-7,818,434257,15,434242
93707,17,7,617,871552,17,871535
93708,20,3,653,746789,20,746769
93709,6,11,747,984405,6,984399
93710,9,11,599,981301,9,981292
93711,19,-2,41,585442,19,585423
93712,19,3,404,744928,19,744909
93713,10,-9,486,354643,10,354633
93714,13,-8,904,404314,13,404301
93715,9,14,336,1069273,9,1069264
93716,15,-13,379,243832,15,243817
93717,12,16,172,1148315,12,1148303
93718,6,-17,127,96094,6,96088
93719,14,-7,857,434572,14,434558
93720,11,-15,107,178578,11,178567
93721,18,-12,71,273071,18,273053
93722,14,10,958,967207,14,967193
93723,7,5,221,786379,7,786372
93724,7,17,581,1167618,7,1167611
93725,9,16,123,1127613,9,1127604
93726,11,-2,179,586374,11,586363
93727,17,18,769,1214547,17,1214530
93728,17,-12,863,278982,17,278965
93729,15,1,119,680756,15,680741
93730,10,4,611,763891,10,763881
93731,9,-1,859,612301,9,612292
93732,10,-2,298,569234,10,569224
93733,8,-2,940,583011,8,583003
93734,10,-10,934,332502,10,332492
93735,12,-14,251,211381,12,211369
93736,7,-11,557,293532,7,293525
93737,11,14,692,1090918,11,1090907
93738,18,14,221,1087137,18,1087119
93739,20,9,154,930204,20,930184
93740,17,-10,59,335637,17,335620
93741,14,-8,854,403934,14,403920
93742,14,0,387,651024,14,651010
93743,14,8,764,903993,14,903979
93744,20,-9,751,372392,20,372372
93745,9,-8,388,383509,9,383500
93746,19,-14,601,214262,19,214243
93747,5,-15,788,172180,5,172175
93748,7,13,239,1035791,7,1035784
93749,20,5,587,808070,20,808050
93750,13,-1,455,620187,13,620174
93751,12,-13,224,242684,12,242672
93752,16,15,18,1116922,16,1116906
93753,10,-6,117,439225,10,439215
93754,19,13,175,1054494,19,1054475
93755,17,19,189,1242247,17,1242230
93756,13,-1,337,619276,13,619263
93757,16,-20,601,27368,16,27352
93758,7,12,42,1000075,7,1000068
93759,13,-18,186,86729,13,86716
93760,10,1,234,662337,10,662327
93761,16,-11,721,309336,16,309320
93762,11,-2,866,591741,11,591730
93763,19,9,827,935193,19,935174
93764,20,-10,603,339567,20,339547
93765,10,8,160,878579,10,878569
93766,14,-7,321,430788,14,430774
93767,6,10,705,952768,6,952762
93768,5,-20,787,17329,5,17324
93769,18,-16,637,151689,18,151671
93770,20,18,728,1214167,20,1214147
93771,16,1,205,681520,16,681504
93772,8,-11,820,298641,8,298633
93773,6,-6,980,457702,6,457696
93774,12,-15,842,184095,12,184083
93775,11,-13,691,246026,11,246015
93776,13,-5,144,492045,13,492032
93777,11,-16,339,149391,11,149380
93778,17,12,367,1024798,17,1024781
93779,13,2,703,715928,13,715915
93780,20,-11,253,305711,20,305691
93781,18,5,322,806126,18,806108
93782,19,-19,398,57125,19,57106
93783,15,-16,364,149575,15,149560
93784,17,-13,8,241093,17,241076
93785,5,11,807,985767,5,985762
93786,13,-9,6,366676,13,366663
93787,10,-3,863,549698,10,549688
93788,19,17,597,1182297,19,1182278
93789,7,5,153,784737,7,784730
93790,12,8,364,900818,12,900806
93791,11,-2,592,589585,11,589574
93792,16,-7,795,434044,16,434028
93793,17,6,539,840131,17,840114
93794,6,-13,156,221711,6,221705
93795,12,-15,746,183338,12,183326
93796,6,-19,907,51055,6,51049
93797,6,-18,816,80131,6,80125
93798,11,0,298,650326,11,650315
93799,5,-18,489,72970,5,72965
93800,17,6,816,842344,17,842327
93801,8,-13,436,227508,8,227500
93802,15,18,188,1210540,15,1210525
93803,12,12,110,1022866,12,1022854
93804,19,14,24,1085559,19,1085540
93805,18,-20,98,23507,18,23489
93806,5,-7,657,419705,5,419700
93807,14,19,898,1248069,14,1248055
93808,6,1,142,660290,6,660284
93809,16,-19,485,57691,16,57675
93810,6,-2,990,583955,6,583949
93811,15,18,841,1215092,15,1215077
93812,16,4,43,773578,16,773562
93813,16,-14,253,211421,16,211405
93814,14,-1,937,623730,14,623716
93815,7,-19,556,43606,7,43599
93816,6,16,721,1140100,6,1140094
93817,19,-13,13,241159,19,241140
93818,19,-20,767,28717,19,28698
93819,18,-9,526,370853,18,370835
93820,17,-19,838,60454,17,60437
93821,9,8,918,895121,9,895112
93822,19,5,817,809748,19,809729
93823,12,-17,525,119419,12,119407
93824,15,-13,688,246018,15,246003
93825,20,-11,112,304600,20,304580
93826,20,-4,537,526180,20,526160
93827,7,18,140,1189927,7,1189920
93828,10,-12,442,259145,10,259135
93829,20,-13,316,243404,20,243384
93830,8,-7,116,408273,8,408265
93831,9,-3,185,534346,9,534337
93832,17,0,135,649272,17,649255
93833,7,17,488,1165793,7,1165786
93834,13,-13,248,242883,13,242870
93835,15,-8,390,400653,15,400638
93836,10,9,580,918992,10,918982
93837,6,-16,498,134909,6,134903
93838,8,-7,536,417394,8,417386
93839,18,-2,771,590905,18,590887
93840,15,-4,57,522464,15,522449
93841,11,-16,490,150625,11,150614
93842,20,-14,361,212218,20,212198
93843,20,9,92,929730,20,929710
93844,11,18,334,1211552,11,1211541
93845,12,2,635,715340,12,715328
93846,9,-1,913,613675,9,613666
93847,7,13,516,1041824,7,1041817
93848,13,7,153,868146,13,868133
93849,6,-20,848,18872,6,18866
93850,18,-11,638,308820,18,308802
93851,7,-15,223,160111,7,160104
93852,12,9,644,933820,12,933808
93853,14,4,477,776695,14,776681
93854,12,-8,252,399699,12,399687
93855,13,5,220,805506,13,805493
93856,6,18,822,1204121,6,1204115
93857,14,5,494,807405,14,807391
93858,5,-12,480,259968,5,259963
93859,13,-12,321,274924,13,274911
93860,7,13,613,1044024,7,1044017
93861,14,-4,655,527044,14,527030
93862,14,-11,156,304971,14,304957
93863,12,13,127,1054149,12,1054137
93864,9,-15,621,168742,9,168733
93865,13,-2,947,592371,13,592358
93866,20,-16,510,150771,20,150751
93867,20,13,849,1059593,20,1059573
93868,14,19,866,1247812,14,1247798
93869,17,3,774,747674,17,747657
93870,15,0,901,655129,15,655114
93871,14,0,666,653353,14,653339
93872,9,12,228,1004107,9,1004098
93873,15,7,727,872300,15,872285
93874,15,18,549,1213002,15,1212987
93875,18,0,437,651402,18,651384
93876,13,-19,485,57694,13,57681
93877,10,-2,165,566247,10,566237
93878,17,4,802,779134,17,779117
93879,19,-4,788,527920,19,527901
93880,6,-18,813,80016,6,80010
93881,16,-20,746,28540,16,28524
93882,8,-4,210,504133,8,504125
93883,15,12,763,1027723,15,1027708
93884,9,-18,334,69717,9,69708
93885,5,6,522,824218,5,824213
93886,13,2,678,715725,13,715712
93887,15,-11,235,305531,15,305516
93888,7,-20,776,17102,7,17095
93889,8,11,329,975478,8,975470
93890,8,7,155,848106,8,848098
93891,13,3,72,742359,13,742346
93892,5,2,156,691927,5,691922
93893,11,14,778,1091587,11,1091576
93894,15,16,173,1148324,15,1148309
93895,9,10,305,943954,9,943945
93896,17,5,933,810649,17,810632
93897,13,19,787,1247180,13,1247167
93898,10,-12,810,267077,10,267067
93899,8,9,841,924730,8,924722
93900,17,4,603,777693,17,777676
93901,19,13,433,1056473,19,1056454
93902,10,-19,253,37132,10,37122
93903,10,-5,922,488090,10,488080
93904,12,15,204,1118342,12,1118330
93905,14,12,606,1026517,14,1026503
93906,9,14,687,1077508,9,1077499
93907,6,-15,30,155994,6,155988
93908,10,-8,437,384404,10,384394
93909,16,7,686,872035,16,872019
93910,12,18,8,1208977,12,1208965
93911,7,-4,116,501856,7,501849
93912,12,-2,827,591411,12,591399
93913,17,-3,777,560054,17,560037
93914,18,17,362,1180684,18,1180666
93915,13,-7,500,432095,13,432082
93916,11,-16,487,150597,11,150586
93917,8,-19,378,39689,8,39681
93918,15,4,469,776643,15,776628
93919,8,15,891,1113391,8,1113383
93920,9,-9,94,345637,9,345628
93921,14,-11,943,311075,14,311061
93922,15,15,845,1122957,15,1122942
93923,5,18,120,1189456,5,1189451
93924,11,-10,176,336394,11,336383
93925,8,-1,595,606897,8,606889
93926,9,-20,330,7387,9,7378
93927,13,18,774,1214589,13,1214576
93928,13,18,703,1214038,13,1214025
93929,19,-4,68,522563,19,522544
93930,12,4,689,778287,12,778275
93931,9,-9,727,359616,9,359607
93932,14,-20,58,23221,14,23207
93933,13,-1,396,619720,13,619707
93934,19,12,443,1025308,19,1025289
93935,14,15,470,1120115,14,1120101
93936,15,-9,611,371445,15,371430
93937,8,18,727,1201859,8,1201851
93938,6,-7,330,413049,6,413043
93939,17,5,704,808930,17,808913
93940,11,-16,468,150496,11,150485
93941,17,-10,589,339460,17,339443
93942,12,8,396,901100,12,901088
93943,13,10,338,962377,13,962364
93944,6,-3,771,547733,6,547727
93945,8,7,19,845169,8,845161
93946,5,8,830,893226,5,893221
93947,13,11,417,993918,13,993905
93948,16,-12,461,275859,16,275843
93949,14,3,925,748844,14,748830
93950,13,13,619,1057959,13,1057946
93951,9,2,768,704730,9,704721
93952,17,6,516,839964,17,839947
93953,20,9,40,929352,20,929332
93954,20,-3,918,561140,20,561120
93955,7,-2,810,580085,7,580078
93956,20,7,448,870407,20,870387
93957,15,-13,503,244747,15,244732
93958,9,10,439,946979,9,946970
93959,13,-3,251,555571,13,555558
93960,7,5,979,802328,7,802321
93961,17,4,631,777872,17,777855
93962,16,-11,739,309459,16,309443
93963,16,18,309,1211320,16,1211304
93964,8,5,874,800008,8,800000
93965,13,6,933,843189,13,843176
93966,20,-2,351,587739,20,587719
93967,19,-16,857,153208,19,153189
93968,5,19,554,1230041,5,1230036
93969,6,12,933,1019639,6,1019633
93970,10,9,716,921833,10,921823
93971,12,-5,868,497357,12,497345
93972,17,-18,720,90519,17,90502
93973,19,-8,508,401417,19,401398
93974,18,-1,89,617262,18,617244
93975,7,-3,833,549023,7,549016
93976,12,-6,378,462066,12,462054
93977,14,9,863,935467,14,935453
93978,8,-15,946,175642,8,175634
93979,11,-12,726,277817,11,277806
93980,10,2,465,698585,10,698575
93981,19,-4,150,523215,19,523196
93982,8,-16,31,124478,8,124470
93983,14,19,262,1242833,14,1242819
93984,17,8,870,904712,17,904695
93985,5,-1,844,612008,5,612003
93986,16,-3,804,560249,16,560233
93987,13,3,985,749410,13,749397
93988,14,-8,254,399706,14,399692
93989,5,-18,924,82541,5,82536
93990,18,11,972,997854,18,997836
93991,13,15,96,1117503,13,1117490
93992,15,-8,345,400333,15,400318
93993,13,3,103,742630,13,742617
93994,19,2,309,712919,19,712900
93995,10,12,301,1005810,10,1005800
93996,13,8,27,898083,13,898070
93997,8,-18,819,80185,8,80177
93998,14,-2,371,587842,14,587828
93999,16,-8,862,403998,16,403982
94000,6,-9,298,350105,6,350099
94001,18,12,173,1023312,18,1023294
94002,10,-14,313,193492,10,193482
94003,11,11,924,997633,11,997622
94004,10,3,202,723278,10,723268
94005,18,17,848,1184373,18,1184355
94006,5,4,368,758532,5,758527
94007,12,12,303,1024370,12,1024358
94008,13,11,70,991404,13,991391
94009,15,-13,749,246575,15,246560
94010,10,13,668,1045168,10,1045158
94011,5,-4,348,507201,5,507196
94012,19,8,379,900957,19,900938
94013,6,-5,640,481888,6,481882
94014,6,-15,641,169340,6,169334
94015,5,7,566,856840,5,856835
94016,19,-20,185,24265,19,24246
94017,13,8,498,901906,13,901893
94018,14,18,764,1214493,14,1214479
94019,9,16,550,1136814,9,1136805
94020,8,-17,305,100110,8,100102
94021,5,15,919,1114004,5,1113999
94022,10,-19,316,38324,10,38314
94023,9,18,61,1188107,9,1188098
94024,15,8,438,901491,15,901476
94025,11,19,928,1248240,11,1248229
94026,6,8,889,894438,6,894432
94027,5,8,477,885586,5,885581
94028,6,17,263,1160865,6,1160859
94029,9,-14,813,204329,9,204320
94030,20,15,853,1123009,20,1122989
94031,15,14,545,1089743,15,1089728
94032,18,-15,957,185090,18,185072
94033,8,-12,279,255615,8,255607
94034,20,14,404,1088620,20,1088600
94035,5,-18,78,64216,5,64211
94036,20,-11,899,310768,20,310748
94037,9,-4,15,499639,9,499630
94038,10,-10,113,315024,10,315014
94039,13,-18,482,88879,13,88866
94040,15,19,355,1243639,15,1243624
94041,9,-16,941,144257,9,144248
94042,5,-19,823,49448,5,49443
94043,5,-1,889,613029,5,613024
94044,18,-11,47,303989,18,303971
94045,16,8,665,903221,16,903205
94046,5,9,13,907031,5,907026
94047,8,-6,715,452182,8,452174
94048,18,-5,85,491552,18,491534
94049,6,-4,979,520483,6,520477
94050,11,-18,973,92297,11,92286
94051,7,8,871,894092,7,894085
94052,11,16,460,1150416,11,1150405
94053,20,-18,76,85820,20,85800
94054,11,5,624,808361,11,808350
94055,20,-11,695,309200,20,309180
94056,16,11,732,996093,16,996077
94057,13,10,86,960506,13,960493
94058,16,9,265,930860,16,930844
94059,8,-8,955,395796,8,395788
94060,5,18,116,1189357,5,1189352
94061,11,-20,877,29556,11,29545
94062,11,-18,353,87999,11,87988
94063,18,-11,899,310776,18,310758
94064,9,-3,185,534355,9,534346
94065,13,18,529,1212853,13,1212840
94066,14,-15,58,178219,14,178205
94067,13,-6,606,463777,13,463764
94068,11,11,603,995188,11,995177
94069,6,-7,846,423842,6,423836
94070,16,-2,924,592176,16,592160
94071,16,-12,112,273364,16,273348
94072,17,-1,163,617768,17,617751
94073,11,7,13,867140,11,867129
94074,18,-4,916,528953,18,528935
94075,6,-11,723,296860,6,296854
94076,11,10,595,964492,11,964481
94077,15,16,770,1152547,15,1152532
94078,5,-4,276,505587,5,505582
94079,10,-7,576,418271,10,418261
94080,16,14,785,1091641,16,1091625
94081,9,7,60,846130,9,846121
94082,20,6,784,842054,20,842034
94083,14,-13,943,248158,14,248144
94084,18,-4,376,525040,18,525022
94085,11,9,904,935789,11,935778
94086,11,-15,61,178227,11,178216
94087,10,18,427,1195850,10,1195840
94088,16,10,454,963284,16,963268
94089,8,-17,222,98199,8,98191
94090,18,15,832,1122887,18,1122869
94091,10,16,740,1140535,10,1140525
94092,10,-4,533,511024,10,511014
94093,20,-14,298,211723,20,211703
94094,16,10,861,966427,16,966411
94095,6,19,458,1228028,6,1228022
94096,12,1,739,685619,12,685607
94097,10,-2,456,572522,10,572512
94098,8,-8,421,384037,8,384029
94099,11,-20,682,28052,11,28041
94100,6,-18,885,81553,6,81547
94101,20,5,1,803807,20,803787
94102,11,1,133,680895,11,680884
94103,6,9,90,908611,6,908605
94104,15,1,814,686175,15,686160
94105,5,19,565,1230282,5,1230277
94106,5,11,756,984625,5,984620
94107,20,11,904,997443,20,997423
94108,7,2,730,704059,7,704052
94109,6,16,615,1138083,6,1138077
94110,17,-19,901,60833,17,60816
94111,16,-5,324,493546,16,493530
94112,18,-15,590,182117,18,182099
94113,13,-13,594,245410,13,245397
94114,15,-13,184,242416,15,242401
94115,17,13,733,1058695,17,1058678
94116,6,-5,275,474108,6,474102
94117,16,1,685,685195,16,685179
94118,18,-17,715,120899,18,120881
94119,14,-11,640,308832,14,308818
94120,9,-3,502,541742,9,541733
94121,17,-11,462,307457,17,307440
94122,5,3,500,729538,5,729533
94123,19,-5,551,495095,19,495076
94124,18,2,93,711270,18,711252
94125,10,3,18,719210,10,719200
94126,10,-12,366,257607,10,257597
94127,19,-10,440,338298,19,338279
94128,8,-3,838,549141,8,549133
94129,17,19,604,1245677,17,1245660
94130,15,0,880,654930,15,654915
94131,18,-12,287,274636,18,274618
94132,15,-17,724,121012,15,120997
94133,19,-14,564,213926,19,213907
94134,18,-2,933,592249,18,592231
94135,19,-6,133,460113,19,460094
94136,15,14,380,1088394,15,1088379
94137,10,17,499,1165988,10,1165978
94138,15,14,7,1085418,15,1085403
94139,6,-18,151,65761,6,65755
94140,19,-19,941,61096,19,61077
94141,19,-5,243,492811,19,492792
94142,10,16,13,1125482,10,1125472
94143,8,9,459,916336,8,916328
94144,6,-8,297,381669,6,381663
94145,13,-19,25,54087,13,54074
94146,7,-5,818,485632,7,485625
94147,13,13,883,1059856,13,1059843
94148,20,-6,317,461638,20,461618
94149,7,-6,984,457754,7,457747
94150,15,-6,204,460734,15,460719
94151,11,9,616,933641,11,933630
94152,20,-3,863,560691,20,560671
94153,9,-4,708,514657,9,514648
94154,17,-6,636,464040,17,464023
94155,11,2,150,711738,11,711727
94156,16,16,868,1153270,16,1153254
94157,6,17,369,1163244,6,1163238
94158,12,6,994,843699,12,843687
94159,13,9,658,933914,13,933901
94160,9,-14,997,208233,9,208224
94161,5,1,551,669418,5,669413
94162,18,-18,800,91083,18,91065
94163,5,-4,84,501203,5,501198
94164,16,-3,974,561572,16,561556
94165,10,8,498,886147,10,886137
94166,16,13,909,1059959,16,1059943
94167,16,14,771,1091525,16,1091509
94168,9,18,688,1201161,9,1201152
94169,19,-10,294,337152,19,337133
94170,11,-1,364,619524,11,619513
94171,8,-20,937,20652,8,20644
94172,11,12,5,1022158,11,1022147
94173,18,16,373,1149845,18,1149827
94174,8,-8,845,393373,8,393365
94175,11,14,23,1085547,11,1085536
94176,7,-17,406,102087,7,102080
94177,10,14,156,1065387,10,1065377
94178,17,-13,668,245856,17,245839
94179,7,-14,838,204727,7,204720
94180,11,-20,95,23472,11,23461
94181,7,-10,825,330312,7,330305
94182,15,-4,521,526060,15,526045
94183,15,7,110,867828,15,867813
94184,19,16,683,1151994,19,1151975
94185,9,12,52,1000265,9,1000256
94186,18,7,12,867134,18,867116
94187,5,9,778,923160,5,923155
94188,6,-6,922,456451,6,456445
94189,20,-14,131,210336,20,210316
94190,18,3,120,742758,18,742740
94191,8,7,34,845550,8,845542
94192,18,-19,771,60019,18,60001
94193,13,-4,739,527588,13,527575
94194,8,-11,412,290275,8,290267
94195,13,7,207,868468,13,868455
94196,16,4,565,777373,16,777357
94197,13,-15,546,181787,13,181774
94198,19,-9,767,372621,19,372602
94199,13,0,186,649663,13,649650
94200,10,-13,194,222572,10,222562
94201,14,-20,8,5281,14,5267
94202,5,-20,237,5346,5,5341
94203,15,-13,502,244734,15,244719
94204,10,-18,505,73320,10,73310
94205,7,-11,774,297843,7,297836
94206,13,8,542,902228,13,902215
94207,10,-3,426,539886,10,539876
94208,7,15,483,1104721,7,1104714
94209,13,-7,522,432295,13,432282
94210,17,-17,235,117197,17,117180
94211,11,14,884,1092379,11,1092368
94212,9,16,858,1142937,9,1142928
94213,13,2,385,713514,13,713501
94214,5,-14,4,186507,5,186502
94215,14,14,994,1093269,14,1093255
94216,20,19,51,1241129,20,1241109
94217,11,-7,291,430522,11,430511
94218,13,12,950,1029420,13,1029407
94219,20,9,964,936301,20,936281
94220,8,6,269,818285,8,818277
94221,11,11,311,993144,11,993133
94222,17,16,808,1152927,17,1152910
94223,10,-10,746,328678,10,328668
94224,11,-16,210,148499,11,148488
94225,20,15,571,1120946,20,1120926
94226,5,17,657,1169387,5,1169382
94227,7,3,183,722795,7,722788
94228,14,7,705,872161,14,872147
94229,8,-1,236,599111,8,599103
94230,16,17,658,1182759,16,1182743
94231,16,-20,1000,30457,16,30441
94232,6,10,118,940264,6,940258
94233,12,18,286,1211210,12,1211198
94234,15,2,619,715189,15,715174
94235,7,-11,660,295705,7,295698
94236,10,0,995,647052,10,647042
94237,8,-9,498,354970,8,354962
94238,8,-13,435,227486,8,227478
94239,6,16,576,1137285,6,1137279
94240,12,-10,171,336375,12,336363
94241,18,7,213,868517,18,868499
94242,14,-20,975,30226,14,30212
94243,20,-2,617,589794,20,589774
94244,17,3,14,741924,17,741907
94245,17,-12,632,277110,17,277093
94246,9,-7,694,420608,9,420599
94247,15,-19,651,59115,15,59100
94248,7,9,862,925079,7,925072
94249,13,19,652,1246071,13,1246058
94250,8,-15,946,175650,8,175642
94251,18,-10,428,338197,18,338179
94252,16,11,570,994978,16,994962
94253,9,-13,921,238290,9,238281
94254,16,-8,863,404015,16,403999
94255,8,-15,49,156416,8,156408
94256,15,18,468,1212423,15,1212408
94257,17,19,382,1243871,17,1243854
94258,20,17,326,1180423,20,1180403
94259,18,3,851,748262,18,748244
94260,16,-4,630,526867,16,526851
94261,12,-4,883,528698,12,528686
94262,12,-1,256,618545,12,618533
94263,17,-13,166,242242,17,242225
94264,16,1,715,685400,16,685384
94265,5,17,95,1157287,5,1157282
94266,7,18,493,1197283,7,1197276
94267,17,-12,346,275116,17,275099
94268,11,9,832,935227,11,935216
94269,10,11,505,979256,10,979246
94270,9,-7,581,418389,9,418380
94271,9,13,607,1043887,9,1043878
94272,13,17,660,1182780,13,1182767
94273,20,16,729,1152314,20,1152294
94274,11,-9,458,370196,11,370185
94275,10,2,27,689136,10,689126
94276,8,14,621,1075756,8,1075748
94277,17,6,591,840548,17,840531
94278,17,-15,771,183523,17,183506
94279,10,-8,122,377937,10,377927
94280,20,8,757,903944,20,903924
94281,15,7,972,873905,15,873890
94282,9,0,140,628533,9,628524
94283,8,-7,900,425199,8,425191
94284,10,-14,535,198103,10,198093
94285,16,2,839,716781,16,716765
94286,8,15,693,1109188,8,1109180
94287,12,11,281,992903,12,992891
94288,6,8,12,875431,6,875425
94289,6,11,889,987662,6,987656
94290,14,14,992,1093255,14,1093241
94291,8,2,489,699048,8,699040
94292,16,18,632,1213525,16,1213509
94293,18,19,102,1241595,18,1241577
94294,16,-16,967,154065,16,154049
94295,16,10,906,966768,16,966752
94296,15,14,555,1089788,15,1089773
94297,11,3,413,744973,11,744962
94298,13,12,590,1026404,13,1026391
94299,16,13,340,1055741,16,1055725
94300,16,-20,648,27750,16,27734
94301,11,-16,714,152139,11,152128
94302,10,-16,343,131296,10,131286
94303,15,-10,126,336052,15,336037
94304,16,-6,623,463925,16,463909
94305,18,-14,293,211696,18,211678
94306,16,-16,669,151824,16,151808
94307,16,-8,862,404004,16,403988
94308,19,-12,807,278414,19,278395
94309,15,-4,313,524538,15,524523
94310,12,14,24,1085561,12,1085549
94311,12,-17,621,120152,12,120140
94312,13,-6,553,463466,13,463453
94313,7,-1,809,611242,7,611235
94314,7,14,729,1078425,7,1078418
94315,20,-2,552,589305,20,589285
94316,8,7,734,860356,8,860348
94317,14,10,56,960276,14,960262
94318,9,16,318,1131926,9,1131917
94319,17,-19,738,59829,17,59812
94320,5,8,452,885056,5,885051
94321,7,-2,325,569757,7,569750
94322,11,-1,771,622490,11,622479
94323,8,9,275,912437,8,912429
94324,8,0,136,628423,8,628415
94325,15,5,884,810213,15,810198
94326,19,-14,518,213545,19,213526
94327,14,-19,196,55607,14,55593
94328,12,6,244,837594,12,837582
94329,10,5,643,794905,10,794895
94330,12,3,968,749275,12,749263
94331,16,4,580,777469,16,777453
94332,11,8,412,901272,11,901261
94333,8,11,999,989802,8,989794
94334,10,11,246,973538,10,973528
94335,17,9,162,930286,17,930269
94336,6,9,710,921711,6,921705
94337,19,-9,71,367165,19,367146
94338,7,0,841,643648,7,643641
94339,19,14,388,1088444,19,1088425
94340,10,4,882,770009,10,769999
94341,7,15,677,1108819,7,1108812
94342,15,-17,617,120115,15,120100
94343,6,16,279,1131119,6,1131113
94344,16,-13,606,245544,16,245528
94345,6,7,325,851834,6,851828
94346,8,3,964,739889,8,739881
94347,8,-20,747,16462,8,16454
94348,9,14,624,1075811,9,1075802
94349,6,12,694,1014366,6,1014360
94350,20,-2,694,590384,20,590364
94351,10,16,319,1131955,10,1131945
94352,18,-10,911,341909,18,341891
94353,7,9,911,926108,7,926101
94354,16,15,263,1118736,16,1118720
94355,9,2,708,703584,9,703575
94356,9,8,0,875160,9,875151
94357,9,-3,425,539862,9,539853
94358,11,-5,520,494888,11,494877
94359,16,-11,113,304605,16,304589
94360,10,-13,465,228041,10,228031
94361,19,-7,290,430522,19,430503
94362,13,-13,500,244691,13,244678
94363,10,-4,827,516935,10,516925
94364,16,13,695,1058446,16,1058430
94365,18,-17,911,122267,18,122249
94366,10,11,280,974263,10,974253
94367,5,10,312,944155,5,944150
94368,14,16,875,1153318,14,1153304
94369,18,17,431,1181152,18,1181134
94370,14,1,781,685945,14,685931
94371,17,6,334,838380,17,838363
94372,14,11,914,997529,14,997515
94373,16,-18,148,86385,16,86369
94374,16,-11,796,309927,16,309911
94375,10,-4,483,509842,10,509832
94376,13,-3,784,560109,13,560096
94377,12,-3,104,554519,12,554507
94378,20,2,41,710835,20,710815
94379,9,4,231,755681,9,755672
94380,13,-20,449,26216,13,26203
94381,9,-9,535,355807,9,355798
94382,14,-10,349,337608,14,337594
94383,12,18,221,1210760,12,1210748
94384,7,2,430,697860,7,697853
94385,7,0,916,645251,7,645244
94386,13,10,669,965080,13,965067
94387,11,10,927,966989,11,966978
94388,10,-1,42,594759,10,594749
94389,8,15,268,1100326,8,1100318
94390,6,-12,797,266714,6,266708
94391,20,-3,949,561401,20,561381
94392,16,-15,471,181264,16,181248
94393,9,-10,959,333044,9,333035
94394,9,-19,59,32723,9,32714
94395,12,-16,393,149777,12,149765
94396,17,-15,536,181708,17,181691
94397,19,15,501,1120347,19,1120328
94398,9,10,262,943018,9,943009
94399,7,-5,840,486160,7,486153
94400,11,-6,65,459574,11,459563
94401,17,19,953,1248460,17,1248443
94402,13,-15,179,179072,13,179059
94403,16,-18,193,86796,16,86780
94404,13,8,748,903849,13,903836
94405,18,-10,409,338061,18,338043
94406,15,-2,338,587632,15,587617
94407,18,-15,39,178086,18,178068
94408,20,-18,938,92021,20,92001
94409,20,-7,876,434723,20,434703
94410,11,14,866,1092203,11,1092192
94411,16,-4,495,525818,16,525802
94412,14,6,119,836698,14,836684
94413,6,19,464,1228119,6,1228113
94414,13,-20,731,28428,13,28415
94415,7,-14,653,200993,7,200986
94416,20,-15,701,182978,20,182958
94417,18,19,180,1242179,18,1242161
94418,10,7,705,859738,10,859728
94419,20,8,954,905371,20,905351
94420,14,-16,850,153149,14,153135
94421,12,12,461,1025443,12,1025431
94422,14,-11,674,309076,14,309062
94423,20,-2,775,590928,20,590908
94424,14,11,308,993124,14,993110
94425,13,-10,343,337554,13,337541
94426,14,15,138,1117837,14,1117823
94427,19,5,860,810035,19,810016
94428,14,-10,636,339847,14,339833
94429,20,-8,194,399281,20,399261
94430,11,5,447,807080,11,807069
94431,16,-4,754,527677,16,527661
94432,14,6,18,835947,14,835933
94433,19,-13,834,247240,19,247221
94434,12,-2,355,587767,12,587755
94435,9,-15,833,173197,9,173188
94436,8,8,666,889777,8,889769
94437,13,-18,60,85660,13,85647
94438,15,12,265,1024100,15,1024085
94439,15,-13,772,246793,15,246778
94440,6,11,110,970822,6,970816
94441,7,4,884,770085,7,770078
94442,11,-13,534,244976,11,244965
94443,20,9,464,932386,20,932366
94444,14,-3,585,558420,14,558406
94445,11,-12,999,280105,11,280094
94446,8,-18,155,65893,8,65885
94447,17,3,859,748333,17,748316
94448,12,16,404,1150044,12,1150032
94449,12,15,26,1116992,12,1116980
94450,9,-20,739,16237,9,16228
94451,5,6,335,819919,5,819914
94452,13,0,655,653267,13,653254
94453,11,-6,494,462985,11,462974
94454,16,-15,764,183470,16,183454
94455,17,-14,672,214788,17,214771
94456,5,18,771,1203029,5,1203024
94457,8,-19,445,41083,8,41075
94458,20,15,101,1117564,20,1117544
94459,9,5,361,789015,9,789006
94460,12,10,316,962223,12,962211
94461,9,6,139,815201,9,815192
94462,17,-12,263,274468,17,274451
94463,7,-18,294,68926,7,68919
94464,10,-12,795,266684,10,266674
94465,12,15,840,1122918,12,1122906
94466,13,5,372,806524,13,806511
94467,15,-16,881,153470,15,153455
94468,9,16,293,1131361,9,1131352
94469,5,-8,315,382097,5,382092
94470,12,-12,853,278853,12,278841
94471,11,16,786,1152699,11,1152688
94472,10,14,426,1071389,10,1071379
94473,5,-18,563,74483,5,74478
94474,7,-15,980,176332,7,176325
94475,18,5,195,805302,18,805284
94476,8,4,699,765612,8,765604
94477,9,11,211,972700,9,972691
94478,13,3,78,742414,13,742401
94479,20,18,825,1214938,20,1214918
94480,17,-18,860,91455,17,91438
94481,19,-11,773,309805,19,309786
94482,15,-15,280,179798,15,179783
94483,18,-15,796,183670,18,183652
94484,10,11,228,973025,10,973015
94485,14,-17,307,117808,14,117794
94486,6,13,4,1030941,6,1030935
94487,18,-3,330,556215,18,556197
94488,18,3,530,745724,18,745706
94489,9,3,450,728522,9,728513
94490,9,15,558,1106361,9,1106352
94491,18,19,764,1246954,18,1246936
94492,8,-8,984,396482,8,396474
94493,11,2,414,713773,11,713762
94494,12,8,674,903311,12,903299
94495,17,15,659,1121640,17,1121623
94496,8,-8,206,379860,8,379852
94497,6,1,926,677220,6,677214
94498,8,14,506,1073110,8,1073102
94499,17,11,699,995796,17,995779
94500,10,-8,217,380151,10,380141
94501,5,13,955,1051208,5,1051203
94502,19,13,180,1054563,19,1054544
94503,16,4,383,775999,16,775983
94504,18,-8,963,404746,18,404728
94505,11,10,310,962157,11,962146
94506,17,16,390,1149954,17,1149937
94507,19,19,62,1241232,19,1241213
94508,12,-6,406,462247,12,462235
94509,11,-13,819,247132,11,247121
94510,11,18,116,1209895,11,1209884
94511,12,-1,554,620953,12,620941
94512,13,17,827,1184161,13,1184148
94513,18,19,85,1241502,18,1241484
94514,12,12,633,1026734,12,1026722
94515,7,-7,704,420795,7,420788
94516,14,16,698,1152071,14,1152057
94517,13,-10,420,338153,13,338140
94518,7,15,495,1104899,7,1104892
94519,8,-17,306,100137,8,100129
94520,18,-12,452,275782,18,275764
94521,13,5,564,807884,13,807871
94522,9,-5,868,486880,9,486871
94523,10,16,921,1144377,10,1144367
94524,17,10,956,967198,17,967181
94525,18,-11,441,307291,18,307273
94526,7,-5,135,471019,7,471012
94527,5,17,417,1164198,5,1164193
94528,11,9,887,935631,11,935620
94529,6,1,141,660270,6,660264
94530,13,-16,456,150417,13,150404
94531,17,16,524,1150833,17,1150816
94532,9,-1,220,598571,9,598562
94533,11,19,510,1244997,11,1244986
94534,18,-10,173,336388,18,336370
94535,16,-11,929,310956,16,310940
94536,7,12,799,1016415,7,1016408
94537,11,12,865,1028576,11,1028565
94538,15,17,211,1179461,15,1179446
94539,18,-15,621,182327,18,182309
94540,13,-18,912,91856,13,91843
94541,11,8,264,900038,11,900027
94542,17,-20,642,27686,17,27669
94543,12,-19,859,60616,12,60604
94544,20,3,571,746081,20,746061
94545,10,-5,247,473469,10,473459
94546,19,6,354,838527,19,838508
94547,5,-6,660,450963,5,450958
94548,13,10,579,964351,13,964338
94549,10,-18,747,78621,10,78611
94550,19,12,621,1026666,19,1026647
94551,15,11,10,990950,15,990935
94552,11,4,80,773828,11,773817
94553,5,2,42,689535,5,689530
94554,18,-14,176,210648,18,210630
94555,11,-12,277,274579,11,274568
94556,17,-17,510,119321,17,119304
94557,5,-8,642,389114,5,389109
94558,20,-18,815,91202,20,91182
94559,8,-17,539,105053,8,105045
94560,7,-9,924,364360,7,364353
94561,8,-11,285,287278,8,287270
94562,5,19,947,1238486,5,1238481
94563,5,-20,675,14916,5,14911
94564,6,-10,24,313123,6,313117
94565,20,19,223,1242523,20,1242503
94566,11,14,994,1093270,11,1093259
94567,6,0,118,628005,6,627999
94568,20,-11,761,309666,20,309646
94569,19,7,711,872179,19,872160
94570,10,7,18,845143,10,845133
94571,14,13,218,1054854,14,1054840
94572,13,18,701,1214023,13,1214010
94573,14,5,367,806510,14,806496
94574,8,3,849,737192,8,737184
94575,7,11,889,987669,7,987662
94576,5,4,738,766705,5,766700
94577,8,11,309,974995,8,974987
94578,16,-2,19,585283,16,585267
94579,15,7,898,873452,15,873437
94580,5,14,917,1082247,5,1082242
94581,9,-4,163,502954,9,502945
94582,7,16,366,1132964,7,1132957
94583,13,3,873,748393,13,748380
94584,7,14,537,1073797,7,1073790
94585,9,6,214,816883,9,816874
94586,12,-19,16,54008,12,53996
94587,19,17,648,1182676,19,1182657
94588,5,15,877,1113113,5,1113108
94589,20,17,313,1180318,20,1180298
94590,12,18,259,1211065,12,1211053
94591,16,1,965,687368,16,687352
94592,5,1,846,675366,5,675361
94593,19,6,973,843544,19,843525
94594,20,-9,693,371921,20,371901
94595,18,15,487,1120262,18,1120244
94596,8,18,835,1204392,8,1204384
94597,13,0,379,650965,13,650952
94598,5,-17,269,99210,5,99205
94599,11,14,95,1086220,11,1086209
94600,8,-8,496,385689,8,385681
94601,16,-17,910,122250,16,122234
94602,10,-8,429,384228,10,384218
94603,13,-17,102,116351,13,116338
94604,18,-18,423,88467,18,88449
94605,16,15,136,1117817,16,1117801
94606,9,-9,120,346189,9,346180
94607,8,5,987,802492,8,802484
94608,14,-10,833,341350,14,341336
94609,12,1,915,686998,12,686986
94610,16,-11,577,308349,16,308333
94611,13,-9,834,373144,13,373131
94612,10,6,419,821835,10,821825
94613,6,-19,488,41987,6,41981
94614,20,10,791,965983,20,965963
94615,17,-4,619,526755,17,526738
94616,7,2,371,696710,7,696703
94617,20,-3,313,556067,20,556047
94618,7,-18,678,76901,7,76894
94619,19,-17,220,117099,19,117080
94620,13,4,398,776069,13,776056
94621,8,16,12,1125473,8,1125465
94622,18,-1,178,617881,18,617863
94623,17,11,585,995083,17,995066
94624,5,-9,349,351290,5,351285
94625,10,10,971,958290,10,958280
94626,6,14,847,1080812,6,1080806
94627,16,-3,793,560184,16,560168
94628,14,19,393,1243986,14,1243972
94629,13,-15,281,179808,13,179795
94630,6,4,696,765548,6,765542
94631,12,5,322,806128,12,806116
94632,11,-3,338,556285,11,556274
94633,9,-16,723,139572,9,139563
94634,5,-15,573,167846,5,167841
94635,6,3,316,725858,6,725852
94636,18,-17,594,119984,18,119966
94637,20,-3,459,557320,20,557300
94638,19,15,121,1117714,19,1117695
94639,17,4,367,775892,17,775875
94640,11,-19,302,56348,11,56337
94641,20,0,118,649157,20,649137
94642,20,17,279,1180023,20,1180003
94643,19,1,665,685101,19,685082
94644,16,-15,816,183915,16,183899
94645,10,-16,850,142262,10,142252
94646,18,3,733,747389,18,747371
94647,5,-11,529,292932,5,292927
94648,10,-19,768,48437,10,48427
94649,11,-17,645,120299,11,120288
94650,20,3,941,749012,20,748992
94651,11,-9,788,372798,11,372787
94652,8,-7,598,418653,8,418645
94653,13,14,687,1090885,13,1090872
94654,5,-9,298,350110,5,350105
94655,17,-4,638,526892,17,526875
94656,5,14,7,1061882,5,1061877
94657,14,3,964,749233,14,749219
94658,11,15,677,1121754,11,1121743
94659,12,-9,835,373149,12,373137
94660,5,15,835,1112216,5,1112211
94661,20,-19,215,55784,20,55764
94662,8,-7,393,414463,8,414455
94663,10,9,315,913428,10,913418
94664,13,-13,675,245897,13,245884
94665,13,8,70,898424,13,898411
94666,12,-6,434,462474,12,462462
94667,15,-6,402,462191,15,462176
94668,19,7,734,872395,19,872376
94669,11,9,895,935691,11,935680
94670,7,-3,490,541564,7,541557
94671,6,3,550,730404,6,730398
94672,16,-2,318,587524,16,587508
94673,15,-20,628,27551,15,27536
94674,12,10,266,961851,12,961839
94675,19,-4,930,529038,19,529019
94676,11,15,531,1120648,11,1120637
94677,20,11,532,994703,20,994683
94678,6,-2,593,575371,6,575365
94679,18,-10,528,338954,18,338936
94680,7,-5,165,471740,7,471733
94681,10,2,250,694009,10,693999
94682,20,5,385,806640,20,806620
94683,9,0,621,638833,9,638824
94684,19,-7,956,435420,19,435401
94685,7,4,401,759344,7,759337
94686,8,12,596,1011860,8,1011852
94687,12,4,271,775159,12,775147
94688,13,8,837,904475,13,904462
94689,16,-9,481,370483,16,370467
94690,19,-6,533,463268,19,463249
94691,10,-15,929,175203,10,175193
94692,19,-3,262,555624,19,555605
94693,13,2,918,717308,13,717295
94694,10,11,321,975276,10,975266
94695,7,-7,842,423740,7,423733
94696,5,-5,687,482884,5,482879
94697,8,-10,630,326173,8,326165
94698,12,11,381,993649,12,993637
94699,19,-17,476,119026,19,119007
94700,19,8,387,901038,19,901019
94701,19,14,178,1086841,19,1086822
94702,15,0,679,653471,15,653456
94703,12,-19,246,55984,12,55972
94704,12,-3,764,559913,12,559901
94705,18,11,365,993539,18,993521
94706,17,17,778,1183668,17,1183651
94707,16,-4,64,522540,16,522524
94708,19,18,265,1211111,19,1211092
94709,17,6,475,839601,17,839584
94710,14,-8,447,400975,14,400961
94711,12,11,323,993230,12,993218
94712,6,2,30,689253,6,689247
94713,18,8,611,902767,18,902749
94714,13,4,557,777307,13,777294
94715,13,-9,132,367535,13,367522
94716,12,-4,713,527435,12,527423
94717,13,-15,113,178640,13,178627
94718,6,4,720,766212,6,766206
94719,19,6,883,842809,19,842790
94720,17,16,754,1152434,17,1152417
94721,14,16,486,1150582,14,1150568
94722,7,-16,669,138451,7,138444
94723,17,-18,615,89692,17,89675
94724,15,6,85,836372,15,836357
94725,19,-6,197,460684,19,460665
94726,7,-7,290,412155,7,412148
94727,6,-2,731,578313,6,578307
94728,10,-6,886,455744,10,455734
94729,7,9,527,917933,7,917926
94730,13,-1,814,622830,13,622817
94731,8,-5,8,467949,8,467941
94732,14,-12,222,274157,14,274143
94733,7,-9,76,345272,7,345265
94734,8,-4,476,509681,8,509673
94735,19,10,467,963426,19,963407
94736,5,1,627,670961,5,670956
94737,11,7,122,867901,11,867890
94738,11,-10,921,342009,11,341998
94739,19,13,725,1058627,19,1058608
94740,5,4,35,751342,5,751337
94741,5,-9,405,352444,5,352439
94742,5,-13,691,232923,5,232918
94743,5,3,977,740277,5,740272
94744,5,19,425,1227381,5,1227376
94745,5,-2,897,581982,5,581977
94746,15,-2,173,586322,15,586307
94747,16,3,645,746707,16,746691
94748,18,7,970,873877,18,873859
94749,16,13,99,1053960,16,1053944
94750,19,-11,25,303851,19,303832
94751,14,2,484,714276,14,714262
94752,6,-12,334,256894,6,256888
94753,5,-16,508,135106,5,135101
94754,15,17,117,1178712,15,1178697
94755,11,-19,881,60756,11,60745
94756,12,-9,917,373866,12,373854
94757,8,-3,587,543682,8,543674
94758,10,-15,103,157685,10,157675
94759,13,8,229,899840,13,899827
94760,17,-6,251,461126,17,461109
94761,20,16,786,1152709,20,1152689
94762,10,-14,998,208302,10,208292
94763,11,7,671,871971,11,871960
94764,6,9,805,923843,6,923837
94765,15,18,424,1212186,15,1212171
94766,13,-17,640,120290,13,120277
94767,8,8,194,879363,8,879355
94768,6,-8,350,382794,6,382788
94769,7,-13,951,239017,7,239010
94770,8,14,701,1077781,8,1077773
94771,15,4,814,779252,15,779237
94772,9,-12,405,258464,9,258455
94773,6,-7,275,411695,6,411689
94774,16,-13,308,243351,16,243335
94775,20,-7,880,434761,20,434741
94776,13,4,288,775273,13,775260
94777,9,16,648,1138856,9,1138847
94778,19,1,869,686579,19,686560
94779,16,10,591,964453,16,964437
94780,11,-7,638,432982,11,432971
94781,15,19,737,1246779,15,1246764
94782,19,-8,799,403605,19,403586
94783,14,-4,249,524066,14,524052
94784,15,14,356,1088196,15,1088181
94785,20,4,813,779248,20,779228
94786,19,-2,881,591908,19,591889
94787,12,14,385,1088415,12,1088403
94788,6,-10,176,316482,6,316476
94789,9,19,962,1238791,9,1238782
94790,16,14,155,1086696,16,1086680
94791,8,2,401,697313,8,697305
94792,11,-2,309,587446,11,587435
94793,17,-11,325,306341,17,306324
94794,12,-16,563,151145,12,151133
94795,13,-13,909,247844,13,247831
94796,10,-5,258,473739,10,473729
94797,10,-19,622,45168,10,45158
94798,16,7,656,871823,16,871807
94799,16,-2,199,586586,16,586570
94800,15,14,192,1086931,15,1086916
94801,6,12,414,1007950,6,1007944
94802,13,14,645,1090485,13,1090472
94803,9,4,841,769122,9,769113
94804,16,10,701,965313,16,965297
94805,15,6,407,839058,15,839043
94806,13,-18,765,90829,13,90816
94807,15,-12,110,273336,15,273321
94808,7,4,488,761068,7,761061
94809,7,-9,218,348213,7,348206
94810,8,-5,235,473198,8,473190
94811,13,-8,629,402267,13,402254
94812,14,-16,844,153094,14,153080
94813,16,4,117,774095,16,774079
94814,17,15,738,1122273,17,1122256
94815,8,7,846,862737,8,862729
94816,7,6,134,815120,7,815113
94817,7,-17,704,108591,7,108584
94818,20,12,614,1026566,20,1026546
94819,11,-16,842,153066,11,153055
94820,17,1,541,684177,17,684160
94821,13,-2,139,586148,13,586135
94822,9,-10,500,323535,9,323526
94823,15,11,207,992292,15,992277
94824,13,-6,131,460086,13,460073
94825,10,-5,836,486094,10,486084
94826,14,5,770,809392,14,809378
94827,14,-6,490,462952,14,462938
94828,9,11,33,969221,9,969212
94829,9,-16,325,131028,9,131019
94830,20,-16,843,153084,20,153064
94831,7,19,827,1235811,7,1235804
94832,10,-2,556,574622,10,574612
94833,11,13,441,1056541,11,1056530
94834,8,-11,984,302382,8,302374
94835,6,11,485,978803,6,978797
94836,7,3,292,725245,7,725238
94837,10,9,147,909857,10,909847
94838,17,-12,251,274358,17,274341
94839,17,15,587,1121061,17,1121044
94840,20,8,403,901199,20,901179
94841,5,-8,210,379983,5,379978
94842,15,3,945,749035,15,749020
94843,18,18,510,1212711,18,1212693
94844,10,-6,314,443622,10,443612
94845,12,-7,652,433044,12,433032
94846,11,-3,592,558478,11,558467
94847,17,-18,598,89575,17,89558
94848,15,-12,394,275405,15,275390
94849,15,10,578,964340,15,964325
94850,14,0,11,648272,14,648258
94851,12,16,622,1151492,12,1151480
94852,5,-8,451,384649,5,384644
94853,12,8,722,903714,12,903702
94854,18,10,343,962415,18,962397
94855,9,-17,666,107835,9,107826
94856,19,-10,446,338368,19,338349
94857,11,-15,837,184056,11,184045
94858,15,13,596,1057779,15,1057764
94859,11,3,996,749520,11,749509
94860,16,-2,816,591292,16,591276
94861,15,-14,11,209424,15,209409
94862,8,-16,1000,145701,8,145693
94863,6,10,208,941971,6,941965
94864,18,-11,394,306895,18,306877
94865,5,6,664,827313,5,827308
94866,7,12,498,1009782,7,1009775
94867,8,19,557,1230080,8,1230072
94868,7,-15,693,170198,7,170191
94869,9,19,81,1219309,9,1219300
94870,12,-18,410,88356,12,88344
94871,7,18,602,1199386,7,1199379
94872,19,4,232,774970,19,774951
94873,13,8,442,901524,13,901511
94874,6,15,431,1103584,6,1103578
94875,5,0,493,636115,5,636110
94876,20,-2,876,591830,20,591810
94877,17,6,693,841377,17,841360
94878,9,-12,618,262882,9,262873
94879,16,19,485,1244780,16,1244764
94880,18,15,37,1117066,18,1117048
94881,14,2,366,713363,14,713349
94882,13,-9,167,367763,13,367750
94883,12,1,34,680065,12,680053
94884,10,-12,282,255652,10,255642
94885,16,-9,124,367514,16,367498
94886,17,9,92,929737,17,929720
94887,14,2,773,716323,14,716309
94888,10,10,777,954272,10,954262
94889,17,2,56,710959,17,710942
94890,17,-10,853,341498,17,341481
94891,5,-20,557,12214,5,12209
94892,17,-5,45,491186,17,491169
94893,17,-20,485,26449,17,26432
94894,16,-6,884,465809,16,465793
94895,8,-4,2,499398,8,499390
94896,11,19,847,1247603,11,1247592
94897,14,-7,166,429549,14,429535
94898,10,-9,421,352860,10,352850
94899,7,0,371,633337,7,633330
94900,8,-8,567,387402,8,387394
94901,19,-18,963,92227,19,92208
94902,13,-16,571,151202,13,151189
94903,18,-15,273,179759,18,179741
94904,10,-4,372,507757,10,507747
94905,7,-15,66,156742,7,156735
94906,15,-6,3,459173,15,459158
94907,20,-11,665,309027,20,309007
94908,11,13,135,1054200,11,1054189
94909,8,14,99,1064048,8,1064040
94910,20,0,466,651650,20,651630
94911,12,19,159,1242047,12,1242035
94912,16,-8,470,401107,16,401091
94913,12,-16,772,152576,12,152564
94914,6,12,614,1012357,6,1012351
94915,11,-15,882,184454,11,184443
94916,18,16,694,1152043,18,1152025
94917,16,-4,181,523473,16,523457
94918,11,2,625,715236,11,715225
94919,8,5,778,797870,8,797862
94920,11,8,169,899300,11,899289
94921,13,4,926,780099,13,780086
94922,17,1,283,682126,17,682109
94923,11,-6,722,464671,11,464660
94924,5,-9,628,357508,5,357503
94925,10,-1,672,608352,10,608342
94926,9,16,674,1139334,9,1139325
94927,11,2,264,712543,11,712532
94928,14,-10,717,340459,14,340445
94929,12,-10,777,340902,12,340890
94930,10,16,617,1138138,10,1138128
94931,6,-1,368,602176,6,602170
94932,6,7,612,857772,6,857766
94933,20,-4,867,528505,20,528485
94934,13,-1,66,617047,13,617034
94935,14,17,666,1182832,14,1182818
94936,8,-18,770,79152,8,79144
94937,19,16,563,1151114,19,1151095
94938,12,-15,476,181310,12,181298
94939,7,-13,32,219114,7,219107
94940,7,16,69,1126658,7,1126651
94941,17,-7,206,429847,17,429830
94942,11,16,826,1153055,11,1153044
94943,5,-5,832,485966,5,485961
94944,13,18,874,1215326,13,1215313
94945,11,10,165,961152,11,961141
94946,7,-17,286,99636,7,99629
94947,5,9,256,912037,5,912032
94948,17,0,505,652005,17,651988
94949,16,-12,259,274418,16,274402
94950,20,6,606,840661,20,840641
94951,20,-11,609,308625,20,308605
94952,11,-7,945,435321,11,435310
94953,13,0,613,652905,13,652892
94954,13,14,197,1086960,13,1086947
94955,12,16,1000,1154295,12,1154283
94956,6,8,510,886431,6,886425
94957,5,-8,555,387077,5,387072
94958,9,-2,638,576312,9,576303
94959,11,-9,576,371254,11,371243
94960,14,18,667,1213817,14,1213803
94961,8,15,875,1113068,8,1113060
94962,6,-1,789,610843,6,610837
94963,6,-5,237,473264,6,473258
94964,11,-14,256,211464,11,211453
94965,10,16,203,1129473,10,1129463
94966,13,-8,887,404168,13,404155
94967,20,-19,788,60119,20,60099
94968,19,14,37,1085722,19,1085703
94969,18,7,253,868862,18,868844
94970,15,-2,698,590418,15,590403
94971,15,6,945,843294,15,843279
94972,19,19,742,1246816,19,1246797
94973,12,-19,158,55318,12,55306
94974,15,-4,846,528286,15,528271
94975,19,-8,509,401432,19,401413
94976,10,19,972,1239037,10,1239027
94977,18,17,858,1184451,18,1184433
94978,16,-17,362,118163,16,118147
94979,19,-15,492,181417,19,181398
94980,7,6,660,827187,7,827180
94981,15,5,407,806747,15,806732
94982,11,1,604,684611,11,684600
94983,20,14,743,1091268,20,1091248
94984,20,-4,808,528051,20,528031
94985,13,9,887,935634,13,935621
94986,20,-12,429,275617,20,275597
94987,17,-4,284,524267,17,524250
94988,9,-12,681,264261,9,264252
94989,14,-15,449,181097,14,181083
94990,15,2,735,716128,15,716113
94991,20,-8,331,400236,20,400216
94992,17,14,307,1087835,17,1087818
94993,9,5,920,800948,9,800939
94994,5,-15,885,174258,5,174253
94995,14,-1,94,617296,14,617282
94996,17,-18,563,89343,17,89326
94997,10,-13,968,239334,10,239324
94998,11,16,598,1151327,11,1151316
94999,19,-4,402,525249,19,525230
95000,12,-12,384,275327,12,275315
95001,18,15,186,1118227,18,1118209
95002,14,16,57,1147505,14,1147491
95003,10,-12,553,261527,10,261517
95004,6,-13,181,222234,6,222228
95005,15,-11,373,306746,15,306731
95006,5,7,365,852685,5,852680
95007,5,18,528,1198120,5,1198115
95008,20,2,788,716390,20,716370
95009,6,-13,225,223161,6,223155
95010,9,-16,720,139500,9,139491
95011,6,16,441,1134723,6,1134717
95012,17,-8,859,403983,17,403966
95013,16,10,685,965209,16,965193
95014,15,-11,278,305906,15,305891
95015,9,4,693,765523,9,765514
95016,14,8,445,901538,14,901524
95017,8,12,621,1012572,8,1012564
95018,9,9,788,923427,9,923418
95019,20,0,134,649257,20,649237
95020,17,-20,16,9427,17,9410
95021,15,-5,103,491714,15,491699
95022,15,12,975,1029625,15,1029610
95023,16,-15,115,178672,16,178656
95024,18,2,942,717491,18,717473
95025,13,-15,237,179463,13,179450
95026,8,0,893,644752,8,644744
95027,17,11,560,994879,17,994862
95028,5,11,290,974536,5,974531
95029,6,-18,686,77079,6,77073
95030,11,1,930,687144,11,687133
95031,5,17,409,1164012,5,1164007
95032,19,-20,749,28585,19,28566
95033,6,3,66,720214,6,720208
95034,6,-14,139,189556,6,189550
95035,20,-13,440,244228,20,244208
95036,5,-13,95,220470,5,220465
95037,16,16,558,1151074,16,1151058
95038,17,-17,706,120801,17,120784
95039,14,-6,421,462378,14,462364
95040,15,4,428,776356,15,776341
95041,8,-20,794,17551,8,17543
95042,5,15,98,1096572,5,1096567
95043,8,-12,587,262228,8,262220
95044,13,7,434,870283,13,870270
95045,7,19,280,1223698,7,1223691
95046,12,-10,405,338001,12,337989
95047,16,10,173,961209,16,961193
95048,19,-5,390,493886,19,493867
95049,14,17,177,1179215,14,1179201
95050,13,2,461,714113,13,714100
95051,18,10,729,965510,18,965492
95052,20,8,200,899532,20,899512
95053,19,9,365,931728,19,931709
95054,18,6,426,839188,18,839170
95055,10,-19,132,34524,10,34514
95056,19,13,978,1060481,19,1060462
95057,18,-17,629,120213,18,120195
95058,18,2,383,713497,18,713479
95059,9,1,841,675247,9,675238
95060,18,-7,949,435345,18,435327
95061,10,7,484,855234,10,855224
95062,11,8,91,898625,11,898614
95063,12,7,891,873408,12,873396
95064,16,10,792,966003,16,965987
95065,17,17,944,1184963,17,1184946
95066,18,7,835,873047,18,873029
95067,7,-15,392,163871,7,163864
95068,9,-16,295,130456,9,130447
95069,13,13,995,1060586,13,1060573
95070,17,15,985,1124028,17,1124011
95071,9,-14,32,187218,9,187209
95072,8,0,882,644521,8,644513
95073,8,3,583,731246,8,731238
95074,16,10,41,960168,16,960152
95075,7,-3,619,544323,7,544316
95076,6,0,915,645235,6,645229
95077,9,-10,357,320324,9,320315
95078,15,14,920,1092606,15,1092591
95079,15,-4,370,524995,15,524980
95080,14,3,68,742331,14,742317
95081,7,-11,476,291734,7,291727
95082,14,-1,802,622739,14,622725
95083,19,19,16,1240794,19,1240775
95084,9,-4,492,510043,9,510034
95085,12,7,47,867393,12,867381
95086,6,4,385,758936,6,758930
95087,8,-15,90,157379,8,157371
95088,15,-7,372,431187,15,431172
95089,9,-4,924,519230,9,519221
95090,8,-5,763,484471,8,484463
95091,18,14,401,1088588,18,1088570
95092,20,7,212,868487,20,868467
95093,19,12,122,1022939,19,1022920
95094,7,-13,162,221810,7,221803
95095,7,-13,31,219098,7,219091
95096,15,-1,117,617448,15,617433
95097,19,-3,904,561040,19,561021
95098,12,-9,886,373609,12,373597
95099,8,13,73,1032340,8,1032332
95100,13,6,508,839911,13,839898
95101,10,-5,251,473587,10,473577
95102,6,-7,941,425921,6,425915
95103,10,-16,904,143396,10,143386
95104,17,-20,247,24661,17,24644
95105,8,0,378,633529,8,633521
95106,12,6,169,837007,12,836995
95107,5,-13,865,237062,5,237057
95108,18,-14,879,216386,18,216368
95109,5,14,635,1076128,5,1076123
95110,19,8,385,901009,19,900990
95111,14,15,322,1119145,14,1119131
95112,5,3,231,723883,5,723878
95113,19,-5,683,495991,19,495972
95114,16,17,543,1181932,16,1181916
95115,16,-16,80,147465,16,147449
95116,17,-18,454,88689,17,88672
95117,20,-8,41,398230,20,398210
95118,6,-19,195,35904,6,35898
95119,12,1,582,684497,12,684485
95120,7,-6,528,448211,7,448204
95121,20,-10,843,341417,20,341397
95122,9,-11,285,287287,9,287278
95123,20,6,782,842030,20,842010
95124,14,14,848,1092038,14,1092024
95125,5,-1,208,598246,5,598241
95126,8,16,81,1126872,8,1126864
95127,14,-17,995,122739,14,122725
95128,12,6,85,836374,12,836362
95129,19,18,360,1211711,19,1211692
95130,9,0,571,637680,9,637671
95131,7,11,430,977658,7,977651
95132,13,-10,887,341781,13,341768
95133,7,-1,9,593897,7,593890
95134,14,17,73,1178437,14,1178423
95135,8,10,159,941015,8,941007
95136,20,3,177,743179,20,743159
95137,11,16,702,1152079,11,1152068
95138,20,-12,423,275589,20,275569
95139,10,16,398,1133718,10,1133708
95140,15,-19,165,55345,15,55330
95141,8,-6,339,444114,8,444106
95142,12,1,319,682386,12,682374
95143,6,-4,494,510102,6,510096
95144,15,11,283,992917,15,992902
95145,13,18,388,1211915,13,1211902
95146,6,-3,972,552234,6,552228
95147,15,-4,98,522789,15,522774
95148,9,-5,990,489539,9,489530
95149,20,6,711,841549,20,841529
95150,10,-3,739,546950,10,546940
95151,14,-17,65,115971,14,115957
95152,7,-16,9,124001,7,123994
95153,12,-8,586,401939,12,401927
95154,10,-4,745,515364,10,515354
95155,6,-11,561,293600,6,293594
95156,6,-14,739,202783,6,202777
95157,16,-19,330,56552,16,56536
95158,15,-15,97,178523,15,178508
95159,18,-10,965,342336,18,342318
95160,10,4,565,762814,10,762804
95161,16,2,277,712627,16,712611
95162,16,-7,300,430589,16,430573
95163,9,17,894,1174600,9,1174591
95164,11,-20,72,23323,11,23312
95165,17,-12,847,278792,17,278775
95166,18,0,214,649864,18,649846
95167,6,6,15,812542,6,812536
95168,13,-14,226,211151,13,211138
95169,16,9,957,936215,16,936199
95170,17,-7,877,434743,17,434726
95171,10,-13,351,225758,10,225748
95172,10,17,107,1157555,10,1157545
95173,16,-4,382,525077,16,525061
95174,18,-9,414,369801,18,369783
95175,10,-7,544,417590,10,417580
95176,16,9,465,932400,16,932384
95177,14,-4,976,529450,14,529436
95178,9,-19,378,39698,9,39689
95179,15,3,383,744760,15,744745
95180,5,19,532,1229584,5,1229579
95181,7,1,503,668293,7,668286
95182,7,14,14,1062084,7,1062077
95183,8,7,467,854826,8,854818
95184,15,13,651,1058153,15,1058138
95185,8,-11,319,288184,8,288176
95186,5,8,550,887285,5,887280
95187,13,-10,788,341001,13,340988
95188,19,-15,487,181366,19,181347
95189,9,-7,101,407997,9,407988
95190,12,16,218,1148709,12,1148697
95191,18,-1,429,619971,18,619953
95192,9,-14,97,188689,9,188680
95193,19,-18,335,87823,19,87804
95194,16,3,707,747220,16,747204
95195,7,6,858,831589,7,831582
95196,12,-16,558,151100,12,151088
95197,13,3,130,742817,13,742804
95198,20,-17,740,121123,20,121103
95199,19,-3,743,559689,19,559670
95200,5,-4,491,510027,5,510022
95201,5,5,34,782326,5,782321
95202,19,-12,543,276553,19,276534
95203,19,-5,293,493250,19,493231
95204,16,-4,697,527345,16,527329
95205,6,0,447,635108,6,635102
95206,11,15,136,1117818,11,1117807
95207,9,-13,806,235858,9,235849
95208,9,-4,131,502270,9,502261
95209,17,0,502,651983,17,651966
95210,15,4,738,778699,15,778684
95211,6,-3,188,534435,6,534429
95212,20,-19,82,54544,20,54524
95213,19,18,529,1212862,19,1212843
95214,16,-13,890,247701,16,247685
95215,9,18,466,1196738,9,1196729
95216,5,9,744,922350,5,922345
95217,12,1,999,687568,12,687556
95218,5,2,299,695059,5,695054
95219,11,4,270,775142,11,775131
95220,10,-14,212,191265,10,191255
95221,10,-5,599,481092,10,481082
95222,13,13,740,1058738,13,1058725
95223,19,-7,96,428956,19,428937
95224,8,4,383,758922,8,758914
95225,10,-2,666,576991,10,576981
95226,20,-12,439,275702,20,275682
95227,8,-18,384,70673,8,70665
95228,5,14,95,1063942,5,1063937
95229,8,-20,313,7061,8,7053
95230,15,-11,521,307890,15,307875
95231,5,-8,162,378977,5,378972
95232,14,-5,473,494545,14,494531
95233,12,-17,540,119552,12,119540
95234,8,4,305,757126,8,757118
95235,16,11,90,991513,16,991497
95236,11,-18,618,89702,11,89691
95237,10,3,438,728275,10,728265
95238,11,-17,296,117726,11,117715
95239,6,1,30,657695,6,657689
95240,18,-8,174,399164,18,399146
95241,12,-6,460,462686,12,462674
95242,16,6,653,841027,16,841011
95243,11,5,388,806649,11,806638
95244,9,19,83,1219356,9,1219347
95245,11,-19,664,59164,11,59153
95246,14,2,651,715472,14,715458
95247,16,-4,681,527258,16,527242
95248,11,-20,624,27517,11,27506
95249,18,18,670,1213827,18,1213809
95250,12,-9,766,372602,12,372590
95251,9,-14,373,194927,9,194918
95252,6,16,640,1138699,6,1138693
95253,10,16,225,1130038,10,1130028
95254,7,13,292,1037026,7,1037019
95255,10,-11,878,299998,10,299988
95256,10,16,872,1143232,10,1143222
95257,19,2,271,712579,19,712560
95258,19,13,323,1055576,19,1055557
95259,14,-8,546,401717,14,401703
95260,5,-8,642,389119,5,389114
95261,13,-5,140,492011,13,491998
95262,5,16,882,1143442,5,1143437
95263,18,-18,654,90046,18,90028
95264,11,-2,218,586799,11,586788
95265,14,-4,42,522365,14,522351
95266,13,-3,642,558919,13,558906
95267,10,-6,525,448162,10,448152
95268,11,15,514,1120519,11,1120508
95269,5,9,899,925824,5,925819
95270,5,-2,983,583850,5,583845
95271,19,-12,654,277336,19,277317
95272,18,15,959,1123841,18,1123823
95273,13,-6,951,466340,13,466327
95274,17,4,109,774070,17,774053
95275,9,-10,799,329746,9,329737
95276,18,10,44,960200,18,960182
95277,19,-6,873,465692,19,465673
95278,19,15,82,1117405,19,1117386
95279,17,-4,940,529131,17,529114
95280,5,-11,827,298831,5,298826
95281,17,-14,684,214907,17,214890
95282,10,-19,575,44210,10,44200
95283,5,10,728,953207,5,953202
95284,9,14,17,1062157,9,1062148
95285,8,-4,525,510870,8,510862
95286,7,0,76,626883,7,626876
95287,16,14,272,1087533,16,1087517
95288,13,18,239,1210899,13,1210886
95289,12,-1,827,622899,12,622887
95290,8,-8,768,391818,8,391810
95291,11,-6,926,466142,11,466131
95292,11,-16,864,153333,11,153322
95293,14,4,804,779148,14,779134
95294,5,-18,283,68653,5,68648
95295,7,-10,507,323701,7,323694
95296,13,-5,763,496596,13,496583
95297,11,6,795,842133,11,842122
95298,12,18,384,1211902,12,1211890
95299,10,1,333,664556,10,664546
95300,15,-5,959,498065,15,498050
95301,10,12,900,1018916,10,1018906
95302,11,-4,334,524684,11,524673
95303,18,2,828,716676,18,716658
95304,11,19,59,1241204,11,1241193
95305,16,10,693,965251,16,965235
95306,11,3,549,745864,11,745853
95307,13,-5,955,498053,13,498040
95308,13,17,821,1184114,13,1184101
95309,18,-18,384,88185,18,88167
95310,10,11,876,987356,10,987346
95311,20,9,540,932999,20,932979
95312,9,12,599,1011985,9,1011976
95313,17,5,502,807453,17,807436
95314,6,-17,31,94211,6,94205
95315,19,10,355,962501,19,962482
95316,13,-13,867,247496,13,247483
95317,6,14,679,1077247,6,1077241
95318,7,3,941,739315,7,739308
95319,15,9,620,933669,15,933654
95320,11,16,775,1152607,11,1152596
95321,9,-6,845,454842,9,454833
95322,7,-4,434,508985,7,508978
95323,16,18,547,1212981,16,1212965
95324,16,-11,132,304762,16,304746
95325,12,-16,722,152214,12,152202
95326,7,7,19,845176,7,845169
95327,19,11,676,995644,19,995625
95328,19,0,229,649963,19,649944
95329,9,-8,461,384870,9,384861
95330,19,13,705,1058534,19,1058515
95331,8,13,607,1043895,8,1043887
95332,18,-9,740,372295,18,372277
95333,5,2,637,702112,5,702107
95334,11,17,960,1185130,11,1185119
95335,13,-19,519,57998,13,57985
95336,7,-10,902,331876,7,331869
95337,7,1,669,671774,7,671767
95338,5,12,315,1006099,5,1006094
95339,10,-16,580,136611,10,136601
95340,9,10,696,952530,9,952521
95341,8,-8,84,377268,8,377260
95342,12,17,481,1181528,12,1181516
95343,18,10,271,961870,18,961852
95344,5,9,950,926948,5,926943
95345,13,7,336,869486,13,869473
95346,19,17,475,1181478,19,1181459
95347,5,-6,608,449882,5,449877
95348,13,6,965,843455,13,843442
95349,9,17,166,1158777,9,1158768
95350,11,0,722,653848,11,653837
95351,10,-16,13,124195,10,124185
95352,6,-3,837,549094,6,549088
95353,11,-11,801,309946,11,309935
95354,20,-3,587,558441,20,558421
95355,11,17,130,1178828,11,1178817
95356,18,17,292,1180152,18,1180134
95357,20,-1,28,616754,20,616734
95358,18,16,204,1148592,18,1148574
95359,5,16,344,1132480,5,1132475
95360,5,10,132,940537,5,940532
95361,9,-9,685,358623,9,358614
95362,12,-11,487,307609,12,307597
95363,6,16,22,1125663,6,1125657
95364,14,-2,876,591834,14,591820
95365,11,18,995,1216278,11,1216267
95366,18,4,980,780444,18,780426
95367,12,17,878,1184549,12,1184537
95368,19,-5,492,494669,19,494650
95369,18,-9,807,372950,18,372932
95370,9,-18,409,71200,9,71191
95371,19,11,309,993136,19,993117
95372,13,10,95,960627,13,960614
95373,12,18,862,1215234,12,1215222
95374,17,6,829,842434,17,842417
95375,7,16,395,1133605,7,1133598
95376,14,7,567,871183,14,871169
95377,6,-10,827,330332,6,330326
95378,7,-14,329,193894,7,193887
95379,14,4,629,777840,14,777826
95380,6,19,410,1226868,6,1226862
95381,11,16,972,1154087,11,1154076
95382,19,-14,378,212493,19,212474
95383,12,5,138,804791,12,804779
95384,13,-17,759,121275,13,121262
95385,7,-17,202,97665,7,97658
95386,5,-19,459,41370,5,41365
95387,20,-12,648,277290,20,277270
95388,14,12,958,1029483,14,1029469
95389,16,19,386,1243932,16,1243916
95390,12,7,56,867442,12,867430
95391,20,-5,574,495267,20,495247
95392,6,16,542,1136662,6,1136656
95393,14,2,935,717423,14,717409
95394,15,-17,69,116018,15,116003
95395,10,17,24,1155808,10,1155798
95396,5,-15,668,169772,5,169767
95397,10,-17,707,108662,10,108652
95398,17,2,124,711542,17,711525
95399,5,-9,415,352703,5,352698
95400,14,19,966,1248520,14,1248506
95401,9,1,895,676471,9,676462
95402,5,12,11,999255,5,999250
95403,13,17,277,1179995,13,1179982
95404,16,3,719,747311,16,747295
95405,12,-2,486,588823,12,588811
95406,18,-17,794,121501,18,121483
95407,12,6,961,843390,12,843378
95408,12,9,703,934268,12,934256
95409,5,18,460,1196632,5,1196627
95410,13,16,609,1151408,13,1151395
95411,16,12,165,1023261,16,1023245
95412,20,1,183,681344,20,681324
95413,19,19,520,1245094,19,1245075
95414,16,-19,696,59431,16,59415
95415,11,5,521,807605,11,807594
95416,15,-18,777,90900,15,90885
95417,10,-15,479,165871,10,165861
95418,5,-7,264,411450,5,411445
95419,15,0,432,651367,15,651352
95420,9,-5,36,468643,9,468634
95421,15,-20,793,28958,15,28943
95422,13,9,349,931566,13,931553
95423,15,19,568,1245421,15,1245406
95424,16,-17,937,122410,16,122394
95425,10,-11,184,285122,10,285112
95426,6,10,93,939659,6,939653
95427,11,6,655,841037,11,841026
95428,17,18,850,1215174,17,1215157
95429,9,18,321,1193678,9,1193669
95430,7,-14,308,193375,7,193368
95431,12,-14,284,211641,12,211629
95432,9,-4,572,511772,9,511763
95433,9,10,418,946491,9,946482
95434,20,6,478,839615,20,839595
95435,5,5,252,786906,5,786901
95436,12,18,246,1210944,12,1210932
95437,19,16,721,1152250,19,1152231
95438,18,-2,375,587886,18,587868
95439,20,7,786,872701,20,872681
95440,6,-6,423,445849,6,445843
95441,9,1,251,662684,9,662675
95442,15,14,119,1086411,15,1086396
95443,16,4,965,780342,16,780326
95444,6,1,968,678088,6,678082
95445,16,5,2,803812,16,803796
95446,10,6,861,831673,10,831663
95447,11,3,609,746383,11,746372
95448,7,-13,341,225563,7,225556
95449,10,-20,816,18129,10,18119
95450,18,-17,319,117862,18,117844
95451,11,-6,374,462036,11,462025
95452,18,9,548,933061,18,933043
95453,19,18,997,1216298,19,1216279
95454,12,-17,953,122506,12,122494
95455,16,-6,799,465286,16,465270
95456,12,11,391,993752,12,993740
95457,11,1,768,685875,11,685864
95458,6,14,736,1078537,6,1078531
95459,20,8,482,901762,20,901742
95460,20,14,374,1088361,20,1088341
95461,12,-12,580,276773,12,276761
95462,11,-13,383,243840,11,243829
95463,20,-4,550,526272,20,526252
95464,20,13,681,1058365,20,1058345
95465,19,-9,403,369704,19,369685
95466,10,-10,323,319548,10,319538
95467,20,14,327,1088019,20,1087999
95468,5,7,544,856398,5,856393
95469,14,11,558,994869,14,994855
95470,15,13,788,1059165,15,1059150
95471,18,-14,734,215222,18,215204
95472,6,17,619,1168486,6,1168480
95473,11,-13,23,241252,11,241241
95474,19,12,866,1028607,19,1028588
95475,19,-13,926,247998,19,247979
95476,9,15,6,1094562,9,1094553
95477,7,16,219,1129891,7,1129884
95478,12,3,954,749128,12,749116
95479,17,-10,874,341666,17,341649
95480,9,10,573,949835,9,949826
95481,20,15,424,1119785,20,1119765
95482,16,17,784,1183733,16,1183717
95483,13,-4,378,525048,13,525035
95484,15,12,550,1026093,15,1026078
95485,16,-20,878,29582,16,29566
95486,8,-1,90,595798,8,595790
95487,10,6,511,823956,10,823946
95488,13,-12,86,273159,13,273146
95489,6,15,782,1111059,6,1111053
95490,6,-11,949,301595,6,301589
95491,7,-4,46,500272,7,500265
95492,5,10,292,943673,5,943668
95493,13,-8,38,398203,13,398190
95494,12,-7,999,435771,12,435759
95495,19,-7,499,432070,19,432051
95496,12,-6,657,464150,12,464138
95497,14,-17,997,122746,14,122732
95498,20,4,679,778244,20,778224
95499,19,10,772,965794,19,965775
95500,11,12,268,1024110,11,1024099
95501,17,-17,911,122274,17,122257
95502,8,-19,644,45725,8,45717
95503,20,-1,108,617404,20,617384
95504,16,-16,408,149912,16,149896
95505,15,0,355,650723,15,650708
95506,19,-12,340,275074,19,275055
95507,12,16,92,1147724,12,1147712
95508,19,-6,665,464226,19,464207
95509,16,-19,696,59437,16,59421
95510,9,-16,256,129615,9,129606
95511,9,-18,244,67821,9,67812
95512,15,-16,973,154098,15,154083
95513,12,-19,964,61241,12,61229
95514,12,15,781,1122521,12,1122509
95515,14,-7,751,433727,14,433713
95516,11,12,19,1022232,11,1022221
95517,18,-11,310,306267,18,306249
95518,6,4,173,754384,6,754378
95519,7,2,465,698592,7,698585
95520,15,-8,847,403883,15,403868
95521,10,-17,23,94070,10,94060
95522,7,15,834,1112192,7,1112185
95523,16,19,215,1242458,16,1242442
95524,13,-9,863,373409,13,373396
95525,19,4,690,778315,19,778296
95526,14,-3,284,555794,14,555780
95527,12,6,725,841672,12,841660
95528,5,18,160,1190309,5,1190304
95529,14,9,767,934655,14,934641
95530,16,-3,777,560060,16,560044
95531,19,11,748,996227,19,996208
95532,14,-13,805,247046,14,247032
95533,19,-6,98,459829,19,459810
95534,10,7,27,845322,10,845312
95535,15,-17,181,116787,15,116772
95536,14,1,547,684241,14,684227
95537,12,-5,464,494480,12,494468
95538,17,-15,65,178244,17,178227
95539,15,2,38,710822,15,710807
95540,10,15,922,1114063,10,1114053
95541,16,-7,792,434028,16,434012
95542,12,-5,691,496080,12,496068
95543,6,-3,158,533789,6,533783
95544,6,3,269,724703,6,724697
95545,18,-11,151,304925,18,304907
95546,8,-11,117,283720,8,283712
95547,16,-14,733,215215,16,215199
95548,7,-18,274,68490,7,68483
95549,6,16,171,1128712,6,1128706
95550,12,-10,823,341292,12,341280
95551,9,4,78,752283,9,752274
95552,9,15,818,1111762,9,1111753
95553,14,-15,658,182702,14,182688
95554,14,-20,847,29367,14,29353
95555,18,-6,445,462525,18,462507
95556,19,5,53,804227,19,804208
95557,9,-19,10,31665,9,31656
95558,6,11,398,977067,6,977061
95559,15,-15,803,183765,15,183750
95560,7,17,848,1173634,7,1173627
95561,20,2,47,710865,20,710845
95562,5,9,679,921035,5,921030
95563,13,15,386,1119604,13,1119591
95564,10,-11,793,298155,10,298145
95565,13,-14,337,212048,13,212035
95566,13,15,98,1117519,13,1117506
95567,10,-20,162,3593,10,3583
95568,6,-18,953,83181,6,83175
95569,8,-20,819,18201,8,18193
95570,9,-17,175,97101,9,97092
95571,10,18,340,1194103,10,1194093
95572,11,-3,647,558947,11,558936
95573,7,-17,974,114002,7,113995
95574,6,4,675,765188,6,765182
95575,12,17,995,1185437,12,1185425
95576,8,-8,707,390569,8,390561
95577,6,1,13,657289,6,657283
95578,9,-1,585,606665,9,606656
95579,11,11,677,995653,11,995642
95580,15,-9,163,367739,15,367724
95581,18,-7,314,430727,18,430709
95582,18,-14,417,212833,18,212815
95583,18,0,326,650473,18,650455
95584,16,12,321,1024473,16,1024457
95585,5,-16,487,134695,5,134690
95586,10,4,442,760162,10,760152
95587,5,17,525,1166592,5,1166587
95588,5,5,542,792897,5,792892
95589,16,-14,12,209429,16,209413
95590,19,6,800,842180,19,842161
95591,15,4,339,775667,15,775652
95592,18,1,508,683860,18,683842
95593,6,-15,465,165532,6,165526
95594,8,-16,158,127440,8,127432
95595,5,7,225,849581,5,849576
95596,7,-18,292,68901,7,68894
95597,8,-8,180,379415,8,379407
95598,5,18,862,1204940,5,1204935
95599,20,10,793,966044,20,966024
95600,16,-11,327,306373,16,306357
95601,11,11,0,990835,11,990824
95602,11,-20,903,29763,11,29752
95603,15,4,554,777262,15,777247
95604,15,11,12,990961,15,990946
95605,8,6,947,833557,8,833549
95606,6,-20,687,15241,6,15235
95607,12,-1,857,623127,12,623115
95608,13,15,555,1120808,13,1120795
95609,12,17,635,1182576,12,1182564
95610,10,14,715,1078136,10,1078126
95611,9,17,884,1174301,9,1174292
95612,14,-3,428,557014,14,557000
95613,6,-5,601,481135,6,481129
95614,6,-19,71,32975,6,32969
95615,19,12,973,1029603,19,1029584
95616,6,16,835,1142508,6,1142502
95617,15,-4,306,524458,15,524443
95618,19,13,210,1054804,19,1054785
95619,12,2,619,715191,12,715179
95620,17,12,295,1024316,17,1024299
95621,11,-8,557,401770,11,401759
95622,6,13,708,1045925,6,1045919
95623,15,12,480,1025594,15,1025579
95624,15,14,984,1093179,15,1093164
95625,5,16,671,1139281,5,1139276
95626,6,-2,264,568506,6,568500
95627,16,18,606,1213277,16,1213261
95628,16,6,222,837407,16,837391
95629,12,-12,743,277953,12,277941
95630,6,-18,448,72043,6,72037
95631,12,-5,602,495479,12,495467
95632,14,15,574,1120958,14,1120944
95633,8,10,685,952297,8,952289
95634,13,11,852,997034,13,997021
95635,19,-10,697,340370,19,340351
95636,13,2,364,713347,13,713334
95637,13,-1,647,621559,13,621546
95638,9,-7,810,422968,9,422959
95639,16,11,474,994329,16,994313
95640,7,-13,183,222317,7,222310
95641,11,-6,724,464674,11,464663
95642,13,18,961,1216049,13,1216036
95643,8,-19,397,40196,8,40188
95644,14,19,918,1248188,14,1248174
95645,5,-9,603,357083,5,357078
95646,8,-12,786,266510,8,266502
95647,5,-4,634,513093,5,513088
95648,19,15,691,1121834,19,1121815
95649,19,11,982,997933,19,997914
95650,18,0,971,655727,18,655709
95651,18,-2,757,590792,18,590774
95652,11,4,209,774742,11,774731
95653,12,-12,504,276308,12,276296
95654,16,-13,402,243962,16,243946
95655,9,9,882,925435,9,925426
95656,10,-5,941,488520,10,488510
95657,8,3,622,732118,8,732110
95658,19,9,359,931680,19,931661
95659,19,13,476,1056758,19,1056739
95660,5,12,75,1000684,5,1000679
95661,16,-2,301,587396,16,587380
95662,20,6,509,839920,20,839900
95663,9,11,336,975651,9,975642
95664,17,4,507,776894,17,776877
95665,19,16,129,1147984,19,1147965
95666,17,-2,520,589071,17,589054
95667,5,9,582,919034,5,919029
95668,19,-20,190,24337,19,24318
95669,20,-19,506,57899,20,57879
95670,19,-10,970,342388,19,342369
95671,5,3,688,733758,5,733753
95672,14,6,574,840437,14,840423
95673,15,16,149,1148146,15,1148131
95674,19,-19,687,59364,19,59345
95675,13,16,71,1147596,13,1147583
95676,8,-16,281,130161,8,130153
95677,9,3,601,731685,9,731676
95678,16,-12,994,280071,16,280055
95679,18,11,297,993091,18,993073
95680,7,6,82,813929,7,813922
95681,18,8,995,905692,18,905674
95682,10,-6,131,439488,10,439478
95683,7,10,156,940928,7,940921
95684,16,14,708,1091021,16,1091005
95685,17,-18,569,89371,17,89354
95686,12,18,68,1209503,12,1209491
95687,8,16,48,1126190,8,1126182
95688,19,-9,478,370445,19,370426
95689,12,13,823,1059410,12,1059398
95690,7,-2,346,570114,7,570107
95691,19,-6,952,466356,19,466337
95692,17,8,624,902903,17,902886
95693,7,1,404,666013,7,666006
95694,16,-14,999,217306,16,217290
95695,7,-3,324,537461,7,537454
95696,19,-6,324,461675,19,461656
95697,14,11,382,993653,14,993639
95698,7,5,793,798200,7,798193
95699,19,-16,303,149191,19,149172
95700,6,-1,100,596011,6,596005
95701,17,-20,803,29044,17,29027
95702,7,4,374,758691,7,758684
95703,5,10,785,954433,5,954428
95704,18,-19,83,54582,18,54564
95705,11,16,6,1147159,11,1147148
95706,18,5,676,808705,18,808687
95707,19,-16,411,149951,19,149932
95708,6,-19,428,40744,6,40738
95709,14,-15,161,178970,14,178956
95710,14,-14,860,216238,14,216224
95711,15,6,937,843206,15,843191
95712,11,-18,296,87537,11,87526
95713,17,13,263,1055136,17,1055119
95714,16,-13,992,248514,16,248498
95715,17,-10,253,336955,17,336938
95716,5,6,57,813439,5,813434
95717,14,16,244,1148841,14,1148827
95718,13,-7,373,431199,13,431186
95719,20,-10,989,342590,20,342570
95720,20,-16,406,149901,20,149881
95721,18,10,989,967386,18,967368
95722,13,18,872,1215312,13,1215299
95723,12,-6,134,460114,12,460102
95724,7,5,578,793618,7,793611
95725,13,-10,990,342601,13,342588
95726,7,-8,924,395076,7,395069
95727,14,6,450,839363,14,839349
95728,16,-20,919,29832,16,29816
95729,19,19,291,1243083,19,1243064
95730,20,17,167,1179144,20,1179124
95731,14,5,657,808585,14,808571
95732,18,16,281,1149177,18,1149159
95733,14,18,456,1212363,14,1212349
95734,5,12,454,1008791,5,1008786
95735,7,11,759,984710,7,984703
95736,8,-16,993,145491,8,145483
95737,17,-9,224,368178,17,368161
95738,15,0,580,652664,15,652649
95739,14,7,220,868543,14,868529
95740,12,5,696,808863,12,808851
95741,16,16,20,1147231,16,1147215
95742,16,-11,933,310981,16,310965
95743,7,16,108,1127347,7,1127340
95744,5,7,618,857894,5,857889
95745,20,12,893,1028826,20,1028806
95746,7,14,357,1069698,7,1069691
95747,19,-5,978,498223,19,498204
95748,6,-12,58,250835,6,250829
95749,13,9,287,931033,13,931020
95750,19,19,937,1248290,19,1248271
95751,5,0,117,627995,5,627990
95752,18,15,466,1120089,18,1120071
95753,16,12,701,1027350,16,1027334
95754,10,1,379,665498,10,665488
95755,17,-4,623,526791,17,526774
95756,12,10,560,964172,12,964160
95757,14,7,298,869157,14,869143
95758,15,0,100,649029,15,649014
95759,5,-16,882,142971,5,142966
95760,13,10,373,962630,13,962617
95761,20,-9,310,368881,20,368861
95762,20,17,240,1179697,20,1179677
95763,11,4,719,778563,11,778552
95764,9,-3,469,540980,9,540971
95765,18,18,139,1210091,18,1210073
95766,6,10,929,957567,6,957561
95767,18,-20,199,24403,18,24385
95768,13,7,427,870209,13,870196
95769,14,17,88,1178503,14,1178489
95770,13,-4,680,527245,13,527232
95771,20,-16,96,147626,20,147606
95772,7,-17,728,109121,7,109114
95773,20,7,786,872711,20,872691
95774,5,4,458,760479,5,760474
95775,8,-1,219,598534,8,598526
95776,10,9,880,925410,10,925400
95777,16,3,732,747376,16,747360
95778,20,-5,688,496062,20,496042
95779,6,-2,789,579575,6,579569
95780,5,-20,647,14186,5,14181
95781,8,-1,681,608539,8,608531
95782,17,-7,622,432873,17,432856
95783,8,11,722,983923,8,983915
95784,7,-1,105,596097,7,596090
95785,5,6,161,815669,5,815664
95786,9,-18,704,77515,9,77506
95787,9,16,0,1125168,9,1125159
95788,7,-4,558,511459,7,511452
95789,8,-12,629,263125,8,263117
95790,17,-10,402,337965,17,337948
95791,9,3,895,738104,9,738095
95792,5,7,869,863286,5,863281
95793,5,18,695,1201293,5,1201288
95794,6,-6,830,454584,6,454578
95795,12,-11,994,311464,12,311452
95796,15,-20,838,29302,15,29287
95797,17,-2,568,589428,17,589411
95798,20,-6,962,466405,20,466385
95799,17,6,538,840125,17,840108
95800,6,-11,0,281139,6,281133
95801,8,-13,409,226828,8,226820
95802,14,18,652,1213666,14,1213652
95803,20,4,689,778297,20,778277
95804,19,-12,981,279980,19,279961
95805,14,14,319,1087932,14,1087918
95806,5,19,939,1238307,5,1238302
95807,15,4,710,778487,15,778472
95808,11,0,197,649765,11,649754
95809,17,10,656,964984,17,964967
95810,19,14,977,1093128,19,1093109
95811,19,14,430,1088854,19,1088835
95812,13,-18,599,89580,13,89567
95813,11,2,969,717705,11,717694
95814,16,-11,648,308902,16,308886
95815,18,0,338,650623,18,650605
95816,18,-8,320,400167,18,400149
95817,12,-14,898,216495,12,216483
95818,13,-6,775,465078,13,465065
95819,11,-15,168,178998,11,178987
95820,7,17,994,1176714,7,1176707
95821,6,9,684,921124,6,921118
95822,9,11,812,985888,9,985879
95823,11,10,610,964624,11,964613
95824,5,2,101,690831,5,690826
95825,9,-12,652,263692,9,263683
95826,16,12,860,1028529,16,1028513
95827,17,16,16,1147211,17,1147194
95828,17,-14,823,215936,17,215919
95829,15,-3,933,561267,15,561252
95830,6,-14,840,204761,6,204755
95831,12,-15,596,182157,12,182145
95832,6,4,501,761362,6,761356
95833,8,-18,567,74584,8,74576
95834,9,-10,861,331020,9,331011
95835,5,10,108,939954,5,939949
95836,9,-18,872,81257,9,81248
95837,19,-14,178,210676,19,210657
95838,14,-6,723,464674,14,464660
95839,5,5,684,795872,5,795867
95840,13,0,252,650074,13,650061
95841,9,17,379,1163455,9,1163446
95842,5,3,677,733463,5,733458
95843,5,4,60,751857,5,751852
95844,7,5,871,799941,7,799934
95845,6,11,478,978661,6,978655
95846,19,12,66,1022544,19,1022525
95847,16,16,901,1153522,16,1153506
95848,5,-11,355,289027,5,289022
95849,8,-16,91,125972,8,125964
95850,8,14,920,1082319,8,1082311
95851,13,-19,641,59059,13,59046
95852,18,-16,448,150348,18,150330
95853,12,17,197,1179374,12,1179362
95854,11,-9,324,368976,11,368965
95855,7,-1,653,607997,7,607990
95856,9,-17,125,96051,9,96042
95857,15,-3,787,560131,15,560116
95858,14,19,160,1242050,14,1242036
95859,7,5,688,795939,7,795932
95860,17,17,638,1182600,17,1182583
95861,16,-16,777,152623,16,152607
95862,5,-2,376,570710,5,570705
95863,10,-18,541,74055,10,74045
95864,19,-1,296,618902,19,618883
95865,10,-17,154,96680,10,96670
95866,7,-19,289,37838,7,37831
95867,5,-18,806,79855,5,79850
95868,10,-9,518,355380,10,355370
95869,18,8,60,898346,18,898328
95870,8,-7,470,415897,8,415889
95871,16,16,470,1150481,16,1150465
95872,8,7,37,845635,8,845627
95873,9,-19,403,40304,9,40295
95874,6,6,596,825828,6,825822
95875,5,5,343,788708,5,788703
95876,7,-18,803,79779,7,79772
95877,19,15,444,1119949,19,1119930
95878,17,6,376,838709,17,838692
95879,14,10,61,960293,14,960279
95880,15,-14,116,210217,15,210202
95881,10,-7,723,421180,10,421170
95882,15,-5,739,496457,15,496442
95883,16,-17,978,122674,16,122658
95884,10,12,831,1017171,10,1017161
95885,13,-3,543,558110,13,558097
95886,14,-20,802,29035,14,29021
95887,11,15,703,1121952,11,1121941
95888,20,-11,780,309831,20,309811
95889,5,1,789,674134,5,674129
95890,15,5,134,804767,15,804752
95891,15,9,963,936286,15,936271
95892,19,6,474,839579,19,839560
95893,20,-3,166,554945,20,554925
95894,9,18,253,1192403,9,1192394
95895,12,-17,453,118864,12,118852
95896,17,-6,53,459511,17,459494
95897,16,-7,745,433687,16,433671
95898,11,7,161,868200,11,868189
95899,16,13,493,1056877,16,1056861
95900,18,-4,676,527194,18,527176
95901,15,13,563,1057477,15,1057462
95902,11,18,17,1209031,11,1209020
95903,11,-2,710,590489,11,590478
95904,14,-15,900,184583,14,184569
95905,6,19,286,1223836,6,1223830
95906,18,-13,264,243031,18,243013
95907,13,-15,957,185093,13,185080
95908,13,-3,584,558392,13,558379
95909,13,15,105,1117577,13,1117564
95910,19,-9,533,370958,19,370939
95911,18,0,39,648561,18,648543
95912,19,16,908,1153595,19,1153576
95913,9,1,350,664873,9,664864
95914,13,-3,619,558723,13,558710
95915,10,-8,643,389148,10,389138
95916,15,-17,876,122017,15,122002
95917,10,16,927,1144534,10,1144524
95918,13,-14,780,215644,13,215631
95919,14,-2,723,590591,14,590577
95920,18,-6,275,461335,18,461317
95921,9,1,649,671382,9,671373
95922,9,-5,583,480666,9,480657
95923,19,-14,214,211010,19,210991
95924,16,-4,261,524127,16,524111
95925,19,13,505,1057002,19,1056983
95926,8,-16,390,132371,8,132363
95927,14,3,625,746542,14,746528
95928,9,-5,57,469105,9,469096
95929,5,2,796,705189,5,705184
95930,8,-20,573,12511,8,12503
95931,13,16,607,1151392,13,1151379
95932,6,3,850,737221,6,737215
95933,13,5,388,806652,13,806639
95934,5,15,959,1114929,5,1114924
95935,19,15,429,1119820,19,1119801
95936,19,3,670,746910,19,746891
95937,18,19,341,1243515,18,1243497
95938,17,12,283,1024219,17,1024202
95939,7,0,613,638693,7,638686
95940,15,15,848,1122967,15,1122952
95941,16,5,133,804747,16,804731
95942,16,19,18,1240830,16,1240814
95943,14,3,281,744030,14,744016
95944,19,-5,249,492839,19,492820
95945,10,1,86,658896,10,658886
95946,12,15,563,1120867,12,1120855
95947,5,-20,184,4294,5,4289
95948,10,-9,4,343816,10,343806
95949,15,6,801,842192,15,842177
95950,9,10,833,955494,9,955485
95951,16,4,351,775766,16,775750
95952,16,17,4,1177894,16,1177878
95953,6,19,189,1221699,6,1221693
95954,18,-17,89,116244,18,116226
95955,8,-9,493,354869,8,354861
95956,6,-9,967,365112,6,365106
95957,15,0,697,653629,15,653614
95958,18,10,495,963582,18,963564
95959,13,-2,223,586815,13,586802
95960,5,0,377,633492,5,633487
95961,14,-8,487,401207,14,401193
95962,17,-8,134,398839,17,398822
95963,9,-5,86,469972,9,469963
95964,19,-9,747,372363,19,372344
95965,18,8,512,902029,18,902011
95966,14,-9,696,371942,14,371928
95967,16,6,938,843221,16,843205
95968,17,-5,69,491377,17,491360
95969,12,-17,387,118355,12,118343
95970,18,5,540,807732,18,807714
95971,14,-2,85,585776,14,585762
95972,14,10,478,963471,14,963457
95973,10,-11,506,292495,10,292485
95974,13,-5,500,494727,13,494714
95975,5,-1,199,597978,5,597973
95976,19,-10,218,336704,19,336685
95977,7,15,483,1104728,7,1104721
95978,17,-9,231,368255,17,368238
95979,19,19,377,1243819,19,1243800
95980,5,-16,844,142111,5,142106
95981,20,6,166,836997,20,836977
95982,5,-10,456,322546,5,322541
95983,13,-10,730,340564,13,340551
95984,20,-20,280,24989,20,24969
95985,12,-12,498,276226,12,276214
95986,9,-1,210,598283,9,598274
95987,17,16,989,1154188,17,1154171
95988,12,-8,489,401233,12,401221
95989,9,3,127,721594,9,721585
95990,18,-8,74,398553,18,398535
95991,10,-9,560,356265,10,356255
95992,8,-3,208,534883,8,534875
95993,12,2,326,713050,12,713038
95994,18,10,943,967087,18,967069
95995,18,13,551,1057412,18,1057394
95996,18,19,104,1241620,18,1241602
95997,7,4,145,753709,7,753702
95998,13,-2,566,589395,13,589382
95999,19,-17,218,117085,19,117066
96000,18,5,690,808833,18,808815
96001,20,19,723,1246667,20,1246647
96002,17,5,936,810665,17,810648
96003,16,-11,287,305987,16,305971
96004,20,-3,792,560160,20,560140
96005,18,-2,120,586022,18,586004
96006,16,18,561,1213042,16,1213026
96007,7,-18,302,69111,7,69104
96008,17,12,352,1024671,17,1024654
96009,12,14,591,1089979,12,1089967
96010,5,-18,664,76692,5,76687
96011,7,-14,341,194136,7,194129
96012,11,-10,417,338125,11,338114
96013,18,7,301,869204,18,869186
96014,19,-17,512,119359,19,119340
96015,10,15,237,1099554,10,1099544
96016,9,7,921,864334,9,864325
96017,9,3,389,727230,9,727221
96018,11,9,24,929215,11,929204
96019,8,-14,700,202014,8,202006
96020,8,-3,918,551035,8,551027
96021,6,-15,473,165693,6,165687
96022,13,-19,405,57163,13,57150
96023,10,-11,74,282739,10,282729
96024,9,-9,664,358226,9,358217
96025,8,16,600,1137787,8,1137779
96026,11,-18,613,89666,11,89655
96027,13,6,900,842925,13,842912
96028,15,-9,192,367907,15,367892
96029,16,13,411,1056320,16,1056304
96030,17,-9,205,367998,17,367981
96031,5,-9,196,347750,5,347745
96032,16,-15,239,179489,16,179473
96033,11,19,642,1245996,11,1245985
96034,10,10,116,940207,10,940197
96035,8,-18,634,76016,8,76008
96036,6,-18,874,81302,6,81296
96037,7,-13,45,219387,7,219380
96038,19,1,665,685110,19,685091
96039,16,2,788,716396,16,716380
96040,5,17,57,1156589,5,1156584
96041,10,-8,970,396142,10,396132
96042,14,-8,657,402543,14,402529
96043,14,-20,62,23266,14,23252
96044,7,1,912,676864,7,676857
96045,11,-19,668,59188,11,59177
96046,16,-17,617,120121,16,120105
96047,10,17,20,1155681,10,1155671
96048,11,12,866,1028608,11,1028597
96049,12,-10,767,340853,12,340841
96050,17,-7,486,431972,17,431955
96051,19,-10,846,341446,19,341427
96052,18,-2,660,590086,18,590068
96053,9,8,499,886203,9,886194
96054,9,-1,957,614547,9,614538
96055,20,-1,463,620274,20,620254
96056,16,7,370,869685,16,869669
96057,15,-5,298,493296,15,493281
96058,18,-13,372,243766,18,243748
96059,8,-2,803,579922,8,579914
96060,5,-10,362,320425,5,320420
96061,15,-8,613,402191,15,402176
96062,19,-15,889,184513,19,184494
96063,13,14,409,1088655,13,1088642
96064,5,15,813,1111659,5,1111654
96065,13,4,225,774898,13,774885
96066,18,-20,742,28493,18,28475
96067,7,5,148,784634,7,784627
96068,9,-16,682,138645,9,138636
96069,12,13,532,1057178,12,1057166
96070,14,6,447,839336,14,839322
96071,6,-17,847,111410,6,111404
96072,9,-17,678,108020,9,108011
96073,11,-3,701,559365,11,559354
96074,20,16,45,1147406,20,1147386
96075,8,3,473,728964,8,728956
96076,12,12,129,1022991,12,1022979
96077,12,9,688,934121,12,934109
96078,10,3,928,739002,10,738992
96079,8,7,702,859703,8,859695
96080,12,10,144,960990,12,960978
96081,14,3,139,742892,14,742878
96082,18,-13,701,246149,18,246131
96083,6,-17,995,114419,6,114413
96084,15,13,679,1058342,15,1058327
96085,19,-10,693,340323,19,340304
96086,7,8,906,894902,7,894895
96087,16,2,165,711852,16,711836
96088,16,-1,562,620986,16,620970
96089,10,-13,527,229514,10,229504
96090,20,6,232,837524,20,837504
96091,11,-4,870,528540,11,528529
96092,12,-5,576,495283,12,495271
96093,6,-6,155,440084,6,440078
96094,9,-8,578,387560,9,387551
96095,17,5,928,810602,17,810585
96096,6,5,273,787373,6,787367
96097,20,11,747,996213,20,996193
96098,12,15,83,1117406,12,1117394
96099,13,-13,42,241375,13,241362
96100,9,3,438,728284,9,728275
96101,11,-19,752,59904,11,59893
96102,15,-6,698,464507,15,464492
96103,10,-18,179,66426,10,66416
96104,17,-4,501,525893,17,525876
96105,7,14,74,1063476,7,1063469
96106,14,16,960,1153941,14,1153927
96107,10,0,57,626503,10,626493
96108,5,-14,934,206782,5,206777
96109,18,4,502,776873,18,776855
96110,20,4,119,774108,20,774088
96111,16,-15,907,184649,16,184633
96112,6,0,939,645748,6,645742
96113,15,0,115,649141,15,649126
96114,9,-5,682,482726,9,482717
96115,9,18,547,1198523,9,1198514
96116,19,11,41,991166,19,991147
96117,6,-12,61,250910,6,250904
96118,7,-19,563,43848,7,43841
96119,11,-12,21,272654,11,272643
96120,10,3,428,728009,10,727999
96121,10,18,395,1195182,10,1195172
96122,12,6,153,836927,12,836915
96123,11,-11,904,310818,11,310807
96124,18,-9,74,367194,18,367176
96125,14,-4,726,527524,14,527510
96126,15,-3,171,554984,15,554969
96127,19,17,290,1180129,19,1180110
96128,16,-2,710,590495,16,590479
96129,19,-18,329,87774,19,87755
96130,7,-14,13,186756,7,186749
96131,11,-14,265,211496,11,211485
96132,9,1,700,672266,9,672257
96133,14,-2,466,588648,14,588634
96134,19,-9,735,372232,19,372213
96135,20,18,884,1215422,20,1215402
96136,18,-9,18,366742,18,366724
96137,17,15,707,1122009,17,1121992
96138,7,-18,146,65669,7,65662
96139,19,15,114,1117647,19,1117628
96140,13,17,592,1182231,13,1182218
96141,7,-20,644,14117,7,14110
96142,17,4,847,779622,17,779605
96143,11,-8,244,399638,11,399627
96144,8,-17,518,104698,8,104690
96145,15,14,437,1088886,15,1088871
96146,18,-4,490,525775,18,525757
96147,13,-2,38,585409,13,585396
96148,7,-2,62,564238,7,564231
96149,13,-18,661,90101,13,90088
96150,5,18,136,1189824,5,1189819
96151,13,-13,115,241886,13,241873
96152,12,7,889,873391,12,873379
96153,9,-4,127,502178,9,502169
96154,20,18,984,1216206,20,1216186
96155,14,-13,256,242950,14,242936
96156,6,-17,886,112273,6,112267
96157,13,-18,161,86491,13,86478
96158,9,-15,664,169712,9,169703
96159,8,13,904,1050106,8,1050098
96160,12,-13,204,242555,12,242543
96161,11,-5,259,492955,11,492944
96162,16,-1,463,620280,16,620264
96163,15,15,679,1121763,15,1121748
96164,6,-3,433,540037,6,540031
96165,13,-1,286,618854,13,618841
96166,5,-10,875,331374,5,331369
96167,15,-9,497,370609,15,370594
96168,20,13,145,1054268,20,1054248
96169,12,9,64,929524,12,929512
96170,10,12,943,1019899,10,1019889
96171,13,15,245,1118616,13,1118603
96172,13,11,755,996303,13,996290
96173,15,2,117,711479,15,711464
96174,16,-19,243,55962,16,55946
96175,18,16,909,1153606,18,1153588
96176,6,-2,627,576100,6,576094
96177,11,-15,463,181210,11,181199
96178,8,5,300,787861,8,787853
96179,10,-14,8,186632,10,186622
96180,17,-3,698,559334,17,559317
96181,13,6,662,841091,13,841078
96182,13,9,675,934035,13,934022
96183,17,-2,371,587849,17,587832
96184,19,15,599,1121179,19,1121160
96185,15,11,591,995135,15,995120
96186,18,-19,374,56914,18,56896
96187,17,14,987,1093204,17,1093187
96188,8,11,799,985577,8,985569
96189,7,-2,107,565160,7,565153
96190,19,-2,201,586609,19,586590
96191,13,-18,120,86118,13,86105
96192,16,15,587,1121067,16,1121051
96193,18,18,337,1211579,18,1211561
96194,19,6,524,840071,19,840052
96195,15,4,732,778667,15,778652
96196,20,3,494,745515,20,745495
96197,5,1,622,670796,5,670791
96198,13,12,820,1028148,13,1028135
96199,17,14,389,1088463,17,1088446
96200,18,-17,715,120907,18,120889
96201,16,19,551,1245298,16,1245282
96202,10,1,407,666089,10,666079
96203,17,-14,955,216921,17,216904
96204,18,-9,375,369466,18,369448
96205,14,1,844,686395,14,686381
96206,11,6,162,836965,11,836954
96207,12,17,552,1181989,12,1181977
96208,12,-20,908,29774,12,29762
96209,20,-5,334,493638,20,493618
96210,13,-18,616,89694,13,89681
96211,14,15,200,1118301,14,1118287
96212,9,-17,229,98264,9,98255
96213,6,-2,495,573358,6,573352
96214,8,1,298,663676,8,663668
96215,8,-14,633,200697,8,200689
96216,12,-7,472,431887,12,431875
96217,16,2,556,714793,16,714777
96218,20,-12,961,279776,20,279756
96219,13,-10,71,335730,13,335717
96220,13,0,16,648331,13,648318
96221,20,19,469,1244646,20,1244626
96222,5,-1,478,604512,5,604507
96223,14,8,681,903368,14,903354
96224,8,15,615,1107517,8,1107509
96225,9,-20,290,6487,9,6478
96226,6,8,667,889792,6,889786
96227,10,-19,679,46437,10,46427
96228,14,-6,315,461612,14,461598
96229,10,-6,809,454226,10,454216
96230,6,10,192,941694,6,941688
96231,16,-9,332,369076,16,369060
96232,13,10,2,959844,13,959831
96233,20,13,871,1059760,20,1059740
96234,20,-4,905,528868,20,528848
96235,19,-18,44,85524,19,85505
96236,8,7,563,856772,8,856764
96237,14,1,292,682163,14,682149
96238,10,-1,884,612941,10,612931
96239,18,5,244,805647,18,805629
96240,12,-15,318,180074,12,180062
96241,6,0,599,638295,6,638289
96242,14,-9,581,371275,14,371261
96243,8,-19,796,48888,8,48880
96244,18,2,471,714185,18,714167
96245,18,-18,329,87782,18,87764
96246,13,-16,371,149635,13,149622
96247,12,6,84,836362,12,836350
96248,9,8,405,884135,9,884126
96249,17,-14,653,214617,17,214600
96250,12,-4,343,524767,12,524755
96251,20,15,650,1121575,20,1121555
96252,7,-17,562,105634,7,105627
96253,7,14,34,1062594,7,1062587
96254,18,-16,35,146993,18,146975
96255,18,-1,523,620751,18,620733
96256,8,9,805,923851,8,923843
96257,10,19,265,1223369,10,1223359
96258,17,3,757,747558,17,747541
96259,19,15,86,1117443,19,1117424
96260,12,-9,932,373963,12,373951
96261,7,8,380,883472,7,883465
96262,20,17,17,1177992,20,1177972
96263,14,16,507,1150703,14,1150689
96264,10,-5,99,470283,10,470273
96265,15,-6,29,459401,15,459386
96266,10,0,363,633113,10,633103
96267,11,-1,946,623768,11,623757
96268,12,17,550,1181984,12,1181972
96269,11,-7,358,431066,11,431055
96270,17,3,584,746203,17,746186
96271,12,9,68,929557,12,929545
96272,8,18,52,1187824,8,1187816
96273,16,-17,945,122466,16,122450
96274,13,-19,673,59208,13,59195
96275,17,7,553,871105,17,871088
96276,5,-3,121,533048,5,533043
96277,5,-15,413,164375,5,164370
96278,9,10,710,952861,9,952852
96279,16,-15,549,181851,16,181835
96280,5,17,317,1162161,5,1162156
96281,11,-2,519,589062,11,589051
96282,10,9,635,920282,10,920272
96283,13,-11,737,309432,13,309419
96284,15,-5,318,493467,15,493452
96285,8,8,937,895569,8,895561
96286,5,6,831,831074,5,831069
96287,16,-8,532,401586,16,401570
96288,7,-19,899,50912,7,50905
96289,20,0,975,655758,20,655738
96290,15,-5,211,492531,15,492516
96291,20,18,846,1215146,20,1215126
96292,11,-1,34,616833,11,616822
96293,16,-20,14,8165,16,8149
96294,15,-14,991,217220,15,217205
96295,9,11,944,988735,9,988726
96296,11,14,683,1090842,11,1090831
96297,16,7,299,869177,16,869161
96298,16,10,227,961555,16,961539
96299,10,17,912,1174930,10,1174920
96300,20,17,959,1185110,20,1185090
96301,14,16,976,1154113,14,1154099
96302,15,1,232,681736,15,681721
96303,8,-1,154,597115,8,597107
96304,8,-5,263,473816,8,473808
96305,19,-13,249,242894,19,242875
96306,13,-16,80,147468,13,147455
96307,18,2,386,713523,18,713505
96308,18,10,622,964725,18,964707
96309,7,-12,854,268212,7,268205
96310,13,-1,889,623376,13,623363
96311,7,-13,767,234975,7,234968
96312,15,5,992,811083,15,811068
96313,10,-10,983,333662,10,333652
96314,5,2,470,698680,5,698675
96315,14,4,876,779795,14,779781
96316,16,-17,763,121285,16,121269
96317,16,11,786,996533,16,996517
96318,20,-2,847,591588,20,591568
96319,9,-20,912,20205,9,20196
96320,18,-17,958,122535,18,122517
96321,20,10,449,963237,20,963217
96322,17,-17,539,119525,17,119508
96323,5,17,489,1165797,5,1165792
96324,5,-7,544,417595,5,417590
96325,14,-20,233,24545,14,24531
96326,14,-11,370,306737,14,306723
96327,12,16,155,1148183,12,1148171
96328,11,-4,356,524904,11,524893
96329,18,-11,278,305914,18,305896
96330,7,9,164,910256,7,910249
96331,7,12,255,1004811,7,1004804
96332,12,-8,152,398995,12,398983
96333,10,-14,577,199225,10,199215
96334,9,-2,986,583923,9,583914
96335,14,6,480,839644,14,839630
96336,17,-7,965,435469,17,435452
96337,15,9,166,930306,15,930291
96338,20,-11,770,309764,20,309744
96339,12,-12,641,277230,12,277218
96340,10,8,928,895315,10,895305
96341,9,-16,107,126393,9,126384
96342,12,-13,195,242493,12,242481
96343,17,12,489,1025667,17,1025650
96344,19,-20,682,28061,19,28042
96345,11,8,390,901065,11,901054
96346,7,-5,656,482239,7,482232
96347,19,9,813,935075,19,935056
96348,10,6,433,822164,10,822154
96349,5,5,837,799157,5,799152
96350,5,13,195,1034916,5,1034911
96351,20,-10,13,335225,20,335205
96352,17,-20,876,29555,17,29538
96353,10,-6,51,437927,10,437917
96354,12,1,942,687210,12,687198
96355,5,-13,882,237473,5,237468
96356,14,-15,60,178227,14,178213
96357,12,-11,949,311144,12,311132
96358,19,9,80,929634,19,929615
96359,14,-16,105,147702,14,147688
96360,19,6,647,840980,19,840961
96361,18,-13,901,247738,18,247720
96362,14,19,598,1245651,14,1245637
96363,15,10,108,960716,15,960701
96364,15,11,837,996901,15,996886
96365,6,16,23,1125694,6,1125688
96366,16,0,412,651232,16,651216
96367,18,0,795,654326,18,654308
96368,19,-6,742,464847,19,464828
96369,10,-8,829,393103,10,393093
96370,6,2,615,701626,6,701620
96371,17,15,810,1122706,17,1122689
96372,17,2,89,711224,17,711207
96373,18,19,58,1241201,18,1241183
96374,15,-17,533,119464,15,119449
96375,7,4,579,763070,7,763063
96376,14,-12,962,279794,14,279780
96377,19,-3,67,554253,19,554234
96378,15,3,56,742255,15,742240
96379,12,12,549,1026089,12,1026077
96380,5,6,99,814307,5,814302
96381,15,2,905,717228,15,717213
96382,13,9,904,935792,13,935779
96383,13,-5,15,490869,13,490856
96384,19,8,894,904905,19,904886
96385,5,-16,345,131364,5,131359
96386,14,18,826,1214959,14,1214945
96387,15,-16,597,151397,15,151382
96388,7,-16,87,125825,7,125818
96389,14,-11,831,310191,14,310177
96390,14,-14,912,216641,14,216627
96391,18,-13,265,243049,18,243031
96392,9,-12,413,258639,9,258630
96393,5,2,179,692584,5,692579
96394,7,-6,160,440232,7,440225
96395,13,-12,61,272972,13,272959
96396,19,-7,185,429694,19,429675
96397,8,-15,917,174974,8,174966
96398,13,-6,384,462093,13,462080
96399,14,-2,231,586879,14,586865
96400,7,12,834,1017240,7,1017233
96401,10,0,914,645198,10,645188
96402,7,-3,131,533269,7,533262
96403,19,-11,403,306944,19,306925
96404,9,3,997,740732,9,740723
96405,7,16,374,1133126,7,1133119
96406,18,-1,117,617456,18,617438
96407,18,17,389,1180865,18,1180847
96408,15,-12,324,274968,15,274953
96409,8,-1,171,597458,8,597450
96410,20,10,24,960030,20,960010
96411,17,6,270,837827,17,837810
96412,19,-7,114,429123,19,429104
96413,11,17,391,1180865,11,1180854
96414,12,-6,666,464229,12,464217
96415,8,-17,643,107320,8,107312
96416,12,4,229,774956,12,774944
96417,8,16,395,1133613,8,1133605
96418,12,1,949,687282,12,687270
96419,8,8,279,881311,8,881303
96420,8,-8,264,381075,8,381067
96421,12,12,168,1023299,12,1023287
96422,16,3,897,748577,16,748561
96423,17,-9,281,368634,17,368617
96424,8,-16,636,137774,8,137766
96425,5,12,523,1010304,5,1010299
96426,16,-5,553,495114,16,495098
96427,20,-4,176,523414,20,523394
96428,7,-14,920,206557,7,206550
96429,14,-15,120,178697,14,178683
96430,6,3,850,737227,6,737221
96431,20,15,631,1121423,20,1121403
96432,16,2,153,711755,16,711739
96433,19,-20,634,27602,19,27583
96434,14,16,632,1151627,14,1151613
96435,12,10,697,965270,12,965258
96436,16,-10,674,340186,16,340170
96437,10,-5,859,486631,10,486621
96438,20,-3,667,559095,20,559075
96439,5,17,300,1161787,5,1161782
96440,5,-5,475,478293,5,478288
96441,6,-15,656,169631,6,169625
96442,7,15,972,1115215,7,1115208
96443,11,-18,808,91150,11,91139
96444,11,3,295,744126,11,744115
96445,12,2,911,717270,12,717258
96446,8,10,671,952048,8,952040
96447,7,4,70,752146,7,752139
96448,10,-18,403,71070,10,71060
96449,16,5,181,805160,16,805144
96450,18,1,966,687385,18,687367
96451,19,-2,999,592704,19,592685
96452,13,-10,142,336194,13,336181
96453,20,10,96,960652,20,960632
96454,19,8,798,904275,19,904256
96455,13,16,805,1152901,13,1152888
96456,8,17,320,1162228,8,1162220
96457,10,18,280,1192976,10,1192966
96458,15,1,650,684993,15,684978
96459,8,-15,564,167594,8,167586
96460,15,-5,76,491437,15,491422
96461,15,-4,181,523478,15,523463
96462,18,-18,81,85832,18,85814
96463,14,7,594,871403,14,871389
96464,18,-15,780,183591,18,183573
96465,18,-10,187,336465,18,336447
96466,10,4,727,766426,10,766416
96467,11,-14,95,210073,11,210062
96468,15,5,6,803837,15,803822
96469,10,14,517,1073371,10,1073361
96470,5,-1,71,595356,5,595351
96471,11,-11,939,311037,11,311026
96472,14,13,853,1059629,14,1059615
96473,11,3,890,748515,11,748504
96474,13,-5,242,492803,13,492790
96475,19,14,373,1088348,19,1088329
96476,12,2,869,716994,12,716982
96477,7,4,980,771904,7,771897
96478,12,4,756,778843,12,778831
96479,18,16,355,1149724,18,1149706
96480,11,3,972,749314,11,749303
96481,9,3,706,734194,9,734185
96482,18,16,582,1151203,18,1151185
96483,17,12,706,1027385,17,1027368
96484,6,5,865,799803,6,799797
96485,12,-1,975,623958,12,623946
96486,19,-9,756,372490,19,372471
96487,16,-11,323,306327,16,306311
96488,8,18,240,1192083,8,1192075
96489,12,10,526,963909,12,963897
96490,14,-7,574,432630,14,432616
96491,8,-14,386,195252,8,195244
96492,7,19,572,1230432,7,1230425
96493,19,-8,660,402572,19,402553
96494,11,8,67,898398,11,898387
96495,17,-15,406,180770,17,180753
96496,6,16,514,1136121,6,1136115
96497,15,5,311,806039,15,806024
96498,15,-9,815,373015,15,373000
96499,5,12,921,1019418,5,1019413
96500,14,7,532,870965,14,870951
96501,11,11,37,991146,11,991135
96502,10,11,245,973501,10,973491
96503,15,5,759,809311,15,809296
96504,5,-3,988,552559,5,552554
96505,19,-18,691,90249,19,90230
96506,11,2,21,710641,11,710630
96507,5,4,79,752315,5,752310
96508,17,-15,944,184981,17,184964
96509,14,-20,800,29016,14,29002
96510,17,-5,17,490905,17,490888
96511,11,-1,195,618013,11,618002
96512,17,18,421,1212168,17,1212151
96513,11,-1,526,620756,11,620745
96514,10,-4,997,520949,10,520939
96515,17,-10,128,336064,17,336047
96516,9,-4,952,519864,9,519855
96517,5,11,852,986752,5,986747
96518,17,17,301,1180214,17,1180197
96519,6,-6,643,450645,6,450639
96520,8,-7,857,424053,8,424045
96521,8,14,373,1070066,8,1070058
96522,17,-4,110,522866,17,522849
96523,16,4,582,777486,16,777470
96524,5,1,284,663376,5,663371
96525,18,13,876,1059810,18,1059792
96526,17,-12,51,272873,17,272856
96527,12,14,976,1093110,12,1093098
96528,15,-12,847,278797,15,278782
96529,16,-16,436,150213,16,150197
96530,9,5,537,792788,9,792779
96531,20,-2,954,592391,20,592371
96532,19,-3,299,555979,19,555960
96533,18,-4,119,522923,18,522905
96534,9,-13,700,233170,9,233161
96535,12,-4,92,522743,12,522731
96536,13,-4,627,526824,13,526811
96537,17,-13,697,246109,17,246092
96538,8,-17,88,95371,8,95363
96539,11,-16,392,149755,11,149744
96540,10,-14,850,205038,10,205028
96541,5,2,59,689927,5,689922
96542,18,12,905,1028989,18,1028971
96543,5,-3,937,551510,5,551505
96544,16,-17,190,116860,16,116844
96545,18,14,279,1087606,18,1087588
96546,7,11,743,984316,7,984309
96547,20,-14,192,210792,20,210772
96548,10,-5,552,479935,10,479925
96549,13,-8,452,401031,13,401018
96550,18,16,702,1152087,18,1152069
96551,7,-11,124,283811,7,283804
96552,14,16,527,1150840,14,1150826
96553,10,-10,87,314537,10,314527
96554,16,-12,66,273032,16,273016
96555,14,12,743,1027595,14,1027581
96556,11,-13,195,242494,11,242483
96557,15,13,787,1059143,15,1059128
96558,19,12,662,1027012,19,1026993
96559,14,10,225,961545,14,961531
96560,12,-14,334,212024,12,212012
96561,12,-4,983,529510,12,529498
96562,16,-11,539,308091,16,308075
96563,8,18,738,1202174,8,1202166
96564,12,-16,309,149223,12,149211
96565,16,-4,149,523207,16,523191
96566,9,13,188,1034706,9,1034697
96567,10,-4,396,508244,10,508234
96568,7,7,352,852415,7,852408
96569,18,-20,200,24413,18,24395
96570,19,8,732,903779,19,903760
96571,18,-16,615,151586,18,151568
96572,5,-4,494,510107,5,510102
96573,6,0,981,646725,6,646719
96574,15,-17,578,119900,15,119885
96575,8,-4,712,514721,8,514713
96576,19,7,519,870917,19,870898
96577,15,18,794,1214779,15,1214764
96578,11,-4,752,527653,11,527642
96579,6,14,634,1076101,6,1076095
96580,13,-16,941,153852,13,153839
96581,10,-7,570,418093,10,418083
96582,13,-15,375,180551,13,180538
96583,18,15,606,1121221,18,1121203
96584,15,8,745,903848,15,903833
96585,11,16,694,1152044,11,1152033
96586,16,-7,704,433443,16,433427
96587,10,-12,944,270151,10,270141
96588,18,-9,140,367603,18,367585
96589,16,-8,660,402578,16,402562
96590,19,9,865,935484,19,935465
96591,16,-6,684,464384,16,464368
96592,6,6,372,820709,6,820703
96593,12,-12,699,277647,12,277635
96594,8,0,775,642352,8,642344
96595,9,7,981,865576,9,865567
96596,5,10,271,943290,5,943285
96597,6,-1,370,602190,6,602184
96598,9,-14,15,186821,9,186812
96599,7,-17,672,107950,7,107943
96600,9,9,207,911184,9,911175
96601,16,-10,26,335341,16,335325
96602,7,8,770,892154,7,892147
96603,19,-15,228,179393,19,179374
96604,15,-4,105,522848,15,522833
96605,19,-19,103,54749,19,54730
96606,5,10,540,949017,5,949012
96607,10,12,207,1003625,10,1003615
96608,16,17,38,1178169,16,1178153
96609,17,-12,291,274670,17,274653
96610,15,-14,399,212688,15,212673
96611,15,4,871,779764,15,779749
96612,12,0,455,651576,12,651564
96613,7,15,260,1100136,7,1100129
96614,19,-2,152,586212,19,586193
96615,15,-15,22,177974,15,177959
96616,19,-11,848,310343,19,310324
96617,5,-6,229,441930,5,441925
96618,10,0,209,630013,10,630003
96619,15,17,743,1183411,15,1183396
96620,10,17,922,1175112,10,1175102
96621,12,-6,503,463048,12,463036
96622,15,19,289,1243058,15,1243043
96623,11,-5,756,496554,11,496543
96624,13,-4,88,522724,13,522711
96625,20,-16,428,150125,20,150105
96626,15,10,643,964879,15,964864
96627,7,-16,522,135417,7,135410
96628,6,7,120,847374,6,847368
96629,20,19,975,1248629,20,1248609
96630,6,-16,110,126458,6,126452
96631,14,6,524,840075,14,840061
96632,16,10,315,962196,16,962180
96633,20,8,369,900854,20,900834
96634,11,9,296,931104,11,931093
96635,19,-1,249,618495,19,618476
96636,10,14,365,1069940,10,1069930
96637,11,-13,489,244623,11,244612
96638,14,-8,46,398252,14,398238
96639,13,12,744,1027610,13,1027597
96640,11,-14,381,212515,11,212504
96641,16,6,603,840627,16,840611
96642,19,18,662,1213766,19,1213747
96643,19,-13,52,241484,19,241465
96644,7,-2,697,577770,7,577763
96645,11,7,869,873302,11,873291
96646,20,16,661,1151874,20,1151854
96647,15,1,742,685650,15,685635
96648,10,5,364,789109,10,789099
96649,6,-1,310,600798,6,600792
96650,16,-8,794,403568,16,403552
96651,14,-3,65,554233,14,554219
96652,12,1,9,679804,12,679792
96653,9,-8,778,392043,9,392034
96654,12,8,837,904477,12,904465
96655,11,17,671,1182874,11,1182863
96656,17,-18,864,91485,17,91468
96657,17,12,596,1026417,17,1026400
96658,18,16,651,1151790,18,1151772
96659,6,0,139,628490,6,628484
96660,10,-9,835,362205,10,362195
96661,8,12,135,1002036,8,1002028
96662,7,5,611,794355,7,794348
96663,8,-9,958,365025,8,365017
96664,7,14,267,1067759,7,1067752
96665,7,-20,652,14335,7,14328
96666,17,18,702,1214033,17,1214016
96667,8,12,534,1010545,8,1010537
96668,19,14,186,1086876,19,1086857
96669,5,0,56,626494,5,626489
96670,8,6,422,821913,8,821905
96671,13,17,326,1180426,13,1180413
96672,16,12,391,1024933,16,1024917
96673,11,1,454,683445,11,683434
96674,8,-13,868,237135,8,237127
96675,9,-7,237,410820,9,410811
96676,15,-4,587,526516,15,526501
96677,5,12,985,1020844,5,1020839
96678,20,-8,868,404048,20,404028
96679,13,9,697,934199,13,934186
96680,10,-5,425,477202,10,477192
96681,15,4,77,773795,15,773780
96682,10,7,112,847272,10,847262
96683,6,17,239,1160384,6,1160378
96684,17,-12,408,275509,17,275492
96685,15,-5,600,495479,15,495464
96686,12,-18,300,87571,12,87559
96687,13,-19,460,57501,13,57488
96688,7,6,502,823720,7,823713
96689,18,6,413,839109,18,839091
96690,12,4,666,778108,12,778096
96691,9,1,56,658295,9,658286
96692,7,9,313,913375,7,913368
96693,8,-13,408,226803,8,226795
96694,10,-12,829,267564,10,267554
96695,6,19,766,1234509,6,1234503
96696,15,-16,477,150536,15,150521
96697,14,-13,84,241650,14,241636
96698,12,-20,934,29904,12,29892
96699,12,13,76,1053794,12,1053782
96700,9,-10,859,330993,9,330984
96701,15,-18,70,85746,15,85731
96702,17,-11,994,311471,17,311454
96703,9,-1,479,604549,9,604540
96704,12,15,331,1119230,12,1119218
96705,18,4,854,779672,18,779654
96706,19,19,658,1246119,19,1246100
96707,19,-11,165,305067,19,305048
96708,17,9,933,936039,17,936022
96709,7,6,808,830564,7,830557
96710,12,11,204,992276,12,992264
96711,16,-6,418,462359,16,462343
96712,19,-18,6,85275,19,85256
96713,7,-1,989,615291,7,615284
96714,6,-17,133,96227,6,96221
96715,14,12,902,1028945,14,1028931
96716,16,11,299,993102,16,993086
96717,10,-2,113,565318,10,565308
96718,16,-12,798,278346,16,278330
96719,16,-20,167,24033,16,24017
96720,15,-7,306,430638,15,430623
96721,18,8,990,905646,18,905628
96722,13,15,728,1122186,13,1122173
96723,19,-7,210,429893,19,429874
96724,6,6,798,830293,6,830287
96725,19,6,300,838079,19,838060
96726,11,-3,390,556671,11,556660
96727,14,13,515,1057079,14,1057065
96728,16,-5,903,497656,16,497640
96729,19,-19,666,59179,19,59160
96730,16,18,216,1210734,16,1210718
96731,5,12,75,1000689,5,1000684
96732,12,-4,422,525383,12,525371
96733,7,-6,445,446240,7,446233
96734,6,6,206,816720,6,816714
96735,14,10,380,962664,14,962650
96736,14,10,706,965337,14,965323
96737,18,-10,140,336189,18,336171
96738,6,-14,890,205826,6,205820
96739,10,16,924,1144464,10,1144454
96740,13,-18,756,90792,13,90779
96741,11,-19,128,55041,11,55030
96742,8,-5,138,471061,8,471053
96743,11,-8,660,402579,11,402568
96744,9,2,161,692084,9,692075
96745,16,-3,179,555058,16,555042
96746,6,14,604,1075295,6,1075289
96747,19,17,581,1182130,19,1182111
96748,8,4,721,766229,8,766221
96749,20,8,473,901690,20,901670
96750,12,19,212,1242437,12,1242425
96751,8,11,205,972612,8,972604
96752,8,10,15,937811,8,937803
96753,7,-10,450,322423,7,322416
96754,16,-20,972,30187,16,30171
96755,11,13,669,1058270,11,1058259
96756,6,-10,107,314873,6,314867
96757,19,0,804,654444,19,654425
96758,13,-17,255,117357,13,117344
96759,9,19,736,1233846,9,1233837
96760,15,16,134,1148045,15,1148030
96761,6,-18,780,79411,6,79405
96762,10,3,366,726782,10,726772
96763,14,5,779,809434,14,809420
96764,7,-17,86,95288,7,95281
96765,6,5,353,788830,6,788824
96766,17,-4,521,526067,17,526050
96767,9,9,525,917908,9,917899
96768,13,0,80,648812,13,648799
96769,14,2,720,716039,14,716025
96770,7,-19,138,34667,7,34660
96771,19,10,636,964845,19,964826
96772,6,19,969,1238942,6,1238936
96773,13,-16,770,152564,13,152551
96774,15,14,10,1085456,15,1085441
96775,10,-16,622,137587,10,137577
96776,6,-4,674,513946,6,513940
96777,7,11,65,969869,7,969862
96778,10,-1,990,615310,10,615300
96779,5,0,843,643681,5,643676
96780,19,0,633,653041,19,653022
96781,9,11,224,972958,9,972949
96782,19,15,364,1119438,19,1119419
96783,12,-8,161,399046,12,399034
96784,12,10,85,960490,12,960478
96785,14,-14,527,213578,14,213564
96786,13,6,337,838414,13,838401
96787,18,12,105,1022820,18,1022802
96788,20,1,931,687153,20,687133
96789,17,-18,788,90987,17,90970
96790,7,-9,383,351987,7,351980
96791,9,-10,120,315204,9,315195
96792,14,-6,824,465436,14,465422
96793,15,-6,313,461609,15,461594
96794,17,-9,576,371261,17,371244
96795,5,2,856,706420,5,706415
96796,14,-10,588,339454,14,339440
96797,18,14,438,1088898,18,1088880
96798,8,16,452,1134977,8,1134969
96799,19,2,538,714663,19,714644
96800,5,4,114,753074,5,753069
96801,14,-1,386,619669,14,619655
96802,6,2,660,702614,6,702608
96803,8,12,0,999054,8,999046
96804,7,-6,581,449294,7,449287
96805,9,19,267,1223421,9,1223412
96806,12,-5,361,493738,12,493726
96807,5,-6,922,456456,5,456451
96808,5,-10,773,329111,5,329106
96809,18,7,568,871210,18,871192
96810,10,-13,608,231407,10,231397
96811,14,-15,729,183217,14,183203
96812,13,-9,319,368946,13,368933
96813,6,17,734,1170956,6,1170950
96814,14,-12,904,279312,14,279298
96815,19,-1,16,616643,19,616624
96816,9,-5,250,473558,9,473549
96817,7,-13,464,228012,7,228005
96818,11,-19,686,59354,11,59343
96819,20,-15,147,178907,20,178887
96820,7,0,731,641443,7,641436
96821,14,-14,62,209780,14,209766
96822,6,0,432,634701,6,634695
96823,20,15,691,1121844,20,1121824
96824,5,10,460,947376,5,947371
96825,11,18,493,1212576,11,1212565
96826,20,5,646,808507,20,808487
96827,16,8,344,900716,16,900700
96828,8,7,951,864867,8,864859
96829,9,19,88,1219489,9,1219480
96830,8,10,347,944852,8,944844
96831,13,2,725,716063,13,716050
96832,6,17,524,1166564,6,1166558
96833,8,-3,757,547414,8,547406
96834,16,3,895,748560,16,748544
96835,7,16,5,1125314,7,1125307
96836,6,10,584,950108,6,950102
96837,20,1,220,681650,20,681630
96838,7,-8,0,375266,7,375259
96839,19,6,862,842652,19,842633
96840,20,-17,999,122774,20,122754
96841,13,-18,376,88137,13,88124
96842,13,-14,223,211103,13,211090
96843,16,-14,608,214321,16,214305
96844,20,-1,859,623136,20,623116
96845,18,-13,366,243725,18,243707
96846,14,19,567,1245417,14,1245403
96847,14,8,381,900959,14,900945
96848,20,-20,747,28552,20,28532
96849,11,14,58,1085867,11,1085856
96850,13,18,205,1210670,13,1210657
96851,11,-5,909,497704,11,497693
96852,17,-6,845,465544,17,465527
96853,5,15,677,1108834,5,1108829
96854,19,-10,536,339068,19,339049
96855,5,-10,704,327825,5,327820
96856,18,5,678,808730,18,808712
96857,18,-2,731,590610,18,590592
96858,8,18,41,1187481,8,1187473
96859,9,0,576,637817,9,637808
96860,15,18,489,1212567,15,1212552
96861,14,9,514,932833,14,932819
96862,13,6,787,842067,13,842054
96863,8,-18,272,68431,8,68423
96864,8,14,908,1082119,8,1082111
96865,17,-20,279,24938,17,24921
96866,7,6,882,832118,7,832111
96867,15,12,840,1028374,15,1028359
96868,15,1,654,685031,15,685016
96869,16,-13,280,243181,16,243165
96870,6,4,91,752597,6,752591
96871,19,-5,27,491033,19,491014
96872,9,-9,582,356762,9,356753
96873,15,13,771,1059030,15,1059015
96874,10,-2,301,569299,10,569289
96875,17,19,200,1242324,17,1242307
96876,18,3,598,746307,18,746289
96877,15,-4,6,522096,15,522081
96878,17,-7,852,434541,17,434524
96879,5,9,831,924417,5,924412
96880,11,-6,20,459300,11,459289
96881,7,-4,806,516598,7,516591
96882,10,-11,305,287881,10,287871
96883,14,18,914,1215620,14,1215606
96884,18,0,589,652739,18,652721
96885,6,-8,595,387940,6,387934
96886,12,18,372,1211813,12,1211801
96887,14,19,840,1247582,14,1247568
96888,5,12,124,1001858,5,1001853
96889,7,3,815,736376,7,736369
96890,7,12,911,1019176,7,1019169
96891,7,3,590,731370,7,731363
96892,8,2,350,696232,8,696224
96893,7,17,238,1160359,7,1160352
96894,7,6,531,824403,7,824396
96895,15,15,477,1120131,15,1120116
96896,5,14,3,1061772,5,1061767
96897,14,-11,116,304650,14,304636
96898,17,-6,678,464287,17,464270
96899,18,-7,844,434480,18,434462
96900,18,-8,295,399967,18,399949
96901,6,-14,700,202020,6,202014
96902,19,-20,982,30295,19,30276
96903,7,-1,993,615385,7,615378
96904,15,18,282,1211188,15,1211173
96905,16,-1,98,617323,16,617307
96906,5,1,201,661608,5,661603
96907,7,18,778,1203199,7,1203192
96908,6,16,771,1141081,6,1141075
96909,12,-16,442,150293,12,150281
96910,6,13,971,1051538,6,1051532
96911,7,10,636,951300,7,951293
96912,15,-19,386,57018,15,57003
96913,13,-13,837,247259,13,247246
96914,15,4,395,776061,15,776046
96915,20,-19,115,54924,20,54904
96916,19,-6,362,461948,19,461929
96917,17,-18,710,90414,17,90397
96918,15,-12,398,275426,15,275411
96919,14,-2,202,586622,14,586608
96920,9,-2,659,576792,9,576783
96921,9,0,498,636208,9,636199
96922,17,-3,799,560210,17,560193
96923,10,-9,645,357858,10,357848
96924,12,-20,812,29145,12,29133
96925,14,-18,543,89248,14,89234
96926,15,-18,193,86801,15,86786
96927,13,2,468,714160,13,714147
96928,6,-4,594,512246,6,512240
96929,8,15,688,1109022,8,1109014
96930,17,-9,336,369134,17,369117
96931,13,-4,622,526778,13,526765
96932,8,-17,729,109139,8,109131
96933,17,-2,61,585611,17,585594
96934,6,16,727,1140215,6,1140209
96935,8,-15,576,167902,8,167894
96936,20,-4,871,528570,20,528550
96937,15,-15,765,183484,15,183469
96938,18,19,244,1242673,18,1242655
96939,10,-13,243,223549,10,223539
96940,12,15,593,1121090,12,1121078
96941,16,-12,346,275122,16,275106
96942,12,10,414,963010,12,962998
96943,8,10,423,946579,8,946571
96944,18,-19,400,57140,18,57122
96945,18,-2,608,589703,18,589685
96946,5,-15,488,166078,5,166073
96947,19,8,670,903279,19,903260
96948,18,-2,745,590716,18,590698
96949,8,-20,953,20986,8,20978
96950,16,8,876,904742,16,904726
96951,7,6,678,827583,7,827576
96952,11,-16,275,149013,11,149002
96953,16,-16,673,151871,16,151855
96954,20,16,967,1154049,20,1154029
96955,8,13,935,1050755,8,1050747
96956,18,-17,884,122068,18,122050
96957,13,16,697,1152065,13,1152052
96958,14,2,20,710629,14,710615
96959,11,-10,802,341169,11,341158
96960,5,14,280,1068085,5,1068080
96961,12,2,974,717716,12,717704
96962,18,19,695,1246439,18,1246421
96963,19,18,53,1209334,19,1209315
96964,17,-9,828,373093,17,373076
96965,16,11,878,997244,16,997228
96966,16,15,728,1122192,16,1122176
96967,5,-18,508,73394,5,73389
96968,11,-5,779,496644,11,496633
96969,9,15,621,1107646,9,1107637
96970,13,8,176,899321,13,899308
96971,6,-16,650,138089,6,138083
96972,11,-7,437,431605,11,431594
96973,16,15,220,1118486,16,1118470
96974,10,15,442,1103816,10,1103806
96975,6,18,503,1197500,6,1197494
96976,8,-6,210,441482,8,441474
96977,19,12,480,1025603,19,1025584
96978,20,-1,772,622499,20,622479
96979,14,17,754,1183492,14,1183478
96980,15,-12,973,279894,15,279879
96981,16,12,283,1024225,16,1024209
96982,10,-11,252,286574,10,286564
96983,6,-16,858,142469,6,142463
96984,10,-15,720,170908,10,170898
96985,12,-11,387,306832,12,306820
96986,15,17,556,1182018,15,1182003
96987,15,17,596,1182281,15,1182266
96988,13,-19,128,55044,13,55031
96989,6,5,98,783649,6,783643
96990,16,-4,222,523859,16,523843
96991,10,15,102,1096727,10,1096717
96992,20,-12,563,276678,20,276658
96993,9,-14,27,187112,9,187103
96994,20,-3,410,556838,20,556818
96995,15,-6,534,463272,15,463257
96996,14,15,117,1117671,14,1117657
96997,17,-20,47,23138,17,23121
96998,13,6,252,837666,13,837653
96999,6,14,441,1071674,6,1071668
97000,6,-2,484,573133,6,573127
97001,16,-11,188,305238,16,305222
97002,8,5,431,790489,8,790481
97003,8,12,853,1017791,8,1017783
97004,6,12,788,1016179,6,1016173
97005,9,-4,227,504558,9,504549
97006,6,15,859,1112734,6,1112728
97007,12,10,776,965832,12,965820
97008,19,14,352,1088163,19,1088144
97009,18,0,840,654656,18,654638
97010,8,-15,487,166064,8,166056
97011,10,-2,152,566051,10,566041
97012,10,7,776,861194,10,861184
97013,8,-11,45,281975,8,281967
97014,13,-1,731,622210,13,622197
97015,20,15,972,1123961,20,1123941
97016,19,6,909,843026,19,843007
97017,11,-14,17,209466,11,209455
97018,15,-19,613,58807,15,58792
97019,13,7,139,868058,13,868045
97020,19,-4,870,528549,19,528530
97021,18,7,26,867195,18,867177
97022,15,-6,799,465291,15,465276
97023,12,-4,59,522497,12,522485
97024,9,-10,387,320893,9,320884
97025,15,-17,905,122218,15,122203
97026,10,1,491,668001,10,667991
97027,5,-19,817,49277,5,49272
97028,19,-7,10,428356,19,428337
97029,5,-9,929,364445,5,364440
97030,18,-15,828,183996,18,183978
97031,17,19,821,1247392,17,1247375
97032,6,16,186,1129140,6,1129134
97033,8,-17,8,93733,8,93725
97034,8,-3,233,535443,8,535435
97035,17,-20,688,28126,17,28109
97036,6,12,456,1008836,6,1008830
97037,12,6,334,838382,12,838370
97038,6,-12,468,259738,6,259732
97039,8,-3,675,545730,8,545722
97040,6,-8,19,375764,6,375758
97041,19,11,371,993587,19,993568
97042,15,14,339,1088095,15,1088080
97043,11,6,975,843554,11,843543
97044,8,19,579,1230605,8,1230597
97045,11,-3,202,555217,11,555206
97046,7,-7,376,414073,7,414066
97047,8,-15,621,168760,8,168752
97048,18,-12,4,272553,18,272535
97049,11,2,155,711761,11,711750
97050,18,12,419,1025105,18,1025087
97051,7,18,201,1191303,7,1191296
97052,6,-5,457,477869,6,477863
97053,17,-17,188,116832,17,116815
97054,13,-10,802,341172,13,341159
97055,16,-2,387,587966,16,587950
97056,15,-11,214,305404,15,305389
97057,10,-4,777,516026,10,516016
97058,19,-1,114,617436,19,617417
97059,14,8,566,902391,14,902377
97060,17,4,406,776136,17,776119
97061,6,0,69,626800,6,626794
97062,20,-11,743,309478,20,309458
97063,9,3,862,737522,9,737513
97064,9,9,572,918845,9,918836
97065,7,4,680,765279,7,765272
97066,14,-8,540,401671,14,401657
97067,10,-11,187,285200,10,285190
97068,12,18,351,1211643,12,1211631
97069,19,-20,259,24764,19,24745
97070,14,11,273,992811,14,992797
97071,11,18,352,1211643,11,1211632
97072,16,-13,271,243095,16,243079
97073,20,-3,140,554785,20,554765
97074,8,-10,885,331580,8,331572
97075,20,-9,97,367357,20,367337
97076,13,6,343,838446,13,838433
97077,19,-9,634,371565,19,371546
97078,6,-20,811,18078,6,18072
97079,17,1,914,686994,17,686977
97080,9,18,306,1193389,9,1193380
97081,8,15,899,1113590,8,1113582
97082,6,2,249,693975,6,693969
97083,8,-11,565,293674,8,293666
97084,20,14,450,1088979,20,1088959
97085,7,-15,801,172529,7,172522
97086,20,14,30,1085620,20,1085600
97087,14,16,33,1147306,14,1147292
97088,7,5,341,788662,7,788655
97089,19,3,794,747843,19,747824
97090,10,-18,94,64589,10,64579
97091,7,14,153,1065287,7,1065280
97092,15,1,727,685511,15,685496
97093,10,18,869,1205099,10,1205089
97094,8,0,94,627474,8,627466
97095,19,10,968,967243,19,967224
97096,13,-12,147,273645,13,273632
97097,15,-1,874,623252,15,623237
97098,20,0,948,655455,20,655435
97099,19,-10,370,337725,19,337706
97100,18,11,270,992807,18,992789
97101,10,-15,517,166616,10,166606
97102,19,-20,433,26083,19,26064
97103,18,-1,216,618255,18,618237
97104,20,-16,924,153723,20,153703
97105,16,-15,727,183206,16,183190
97106,13,-13,178,242357,13,242344
97107,7,-12,713,264926,7,264919
97108,6,5,730,796860,6,796854
97109,18,1,387,682960,18,682942
97110,7,5,26,782130,7,782123
97111,14,-5,621,495576,14,495562
97112,9,-3,655,545210,9,545201
97113,17,1,208,681536,17,681519
97114,5,18,73,1188380,5,1188375
97115,10,-18,158,65965,10,65955
97116,16,14,336,1088080,16,1088064
97117,20,19,84,1241477,20,1241457
97118,8,-10,545,324421,8,324413
97119,16,13,145,1054274,16,1054258
97120,7,-20,850,18899,7,18892
97121,15,-9,487,370516,15,370501
97122,8,-11,456,291330,8,291322
97123,9,2,986,709288,9,709279
97124,19,-14,903,216537,19,216518
97125,10,-6,739,452717,10,452707
97126,16,11,805,996688,16,996672
97127,9,11,829,986136,9,986127
97128,19,14,994,1093279,19,1093260
97129,15,8,22,898070,15,898055
97130,8,-3,450,540546,8,540538
97131,9,-10,291,318828,9,318819
97132,8,-18,178,66397,8,66389
97133,11,-12,100,273249,11,273238
97134,11,-15,566,181957,11,181946
97135,10,-16,804,141298,10,141288
97136,17,-16,307,149207,17,149190
97137,12,5,427,806873,12,806861
97138,20,-15,762,183441,20,183421
97139,10,-9,637,357709,10,357699
97140,13,16,462,1150424,13,1150411
97141,8,13,252,1035971,8,1035963
97142,15,-18,120,86123,15,86108
97143,11,11,450,994107,11,994096
97144,6,-7,302,412371,6,412365
97145,18,19,20,1240854,18,1240836
97146,20,19,255,1242771,20,1242751
97147,12,16,331,1149502,12,1149490
97148,11,13,719,1058593,11,1058582
97149,13,-1,38,616889,13,616876
97150,14,-12,63,272983,14,272969
97151,17,-1,478,620413,17,620396
97152,6,-5,366,476181,6,476175
97153,12,-12,811,278445,12,278433
97154,20,0,321,650404,20,650384
97155,12,4,617,777764,12,777752
97156,5,-18,43,63286,5,63281
97157,6,-8,0,375272,6,375266
97158,12,-7,86,428892,12,428880
97159,10,-20,816,18139,10,18129
97160,18,-3,575,558345,18,558327
97161,16,-1,333,619249,16,619233
97162,16,-3,593,558491,16,558475
97163,11,-1,199,618045,11,618034
97164,9,2,1000,709511,9,709502
97165,13,-20,68,23298,13,23285
97166,17,12,270,1024133,17,1024116
97167,17,14,919,1092599,17,1092582
97168,19,8,15,898043,19,898024
97169,7,-16,302,130542,7,130535
97170,16,14,721,1091141,16,1091125
97171,20,-19,839,60476,20,60456
97172,7,12,773,1015871,7,1015864
97173,6,4,52,751651,6,751645
97174,19,19,742,1246825,19,1246806
97175,17,-17,460,118931,17,118914
97176,20,7,982,874012,20,873992
97177,6,-7,496,416446,6,416440
97178,16,4,494,776776,16,776760
97179,19,18,927,1215747,19,1215728
97180,12,-5,82,491512,12,491500
97181,19,0,599,652766,19,652747
97182,19,9,517,932870,19,932851
97183,17,11,478,994346,17,994329
97184,20,1,720,685436,20,685416
97185,8,13,942,1050885,8,1050877
97186,7,-11,575,293881,7,293874
97187,6,-18,267,68334,6,68328
97188,10,-14,686,201780,10,201770
97189,16,-20,67,23289,16,23273
97190,12,13,802,1059279,12,1059267
97191,13,19,548,1245270,13,1245257
97192,7,10,572,949784,7,949777
97193,9,10,593,950284,9,950275
97194,9,10,301,943865,9,943856
97195,17,16,511,1150740,17,1150723
97196,11,14,939,1092812,11,1092801
97197,15,7,888,873390,15,873375
97198,9,-16,270,129901,9,129892
97199,14,1,480,683651,14,683637
97200,15,11,499,994483,15,994468
97201,14,-14,357,212180,14,212166
97202,5,14,409,1070936,5,1070931
97203,16,-5,272,493052,16,493036
97204,13,17,12,1177927,13,1177914
97205,16,10,711,965349,16,965333
97206,10,3,207,723343,10,723333
97207,20,-12,358,275222,20,275202
97208,7,15,717,1109760,7,1109753
97209,6,11,227,973016,6,973010
97210,16,-20,991,30390,16,30374
97211,13,5,627,808402,13,808389
97212,15,-14,884,216394,15,216379
97213,11,-17,462,118947,11,118936
97214,10,-11,940,301327,10,301317
97215,18,11,165,992024,18,992006
97216,9,6,506,823843,9,823834
97217,15,-8,871,404053,15,404038
97218,7,9,884,925470,7,925463
97219,18,10,889,966614,18,966596
97220,8,7,545,856412,8,856404
97221,7,-6,802,454088,7,454081
97222,18,-13,395,243921,18,243903
97223,19,19,557,1245342,19,1245323
97224,20,15,370,1119494,20,1119474
97225,14,18,230,1210825,14,1210811
97226,15,13,576,1057629,15,1057614
97227,10,-19,832,49633,10,49623
97228,15,6,463,839494,15,839479
97229,7,2,724,703934,7,703927
97230,6,-19,614,44953,6,44947
97231,12,-3,146,554809,12,554797
97232,20,-10,15,335254,20,335234
97233,20,-16,437,150232,20,150212
97234,18,12,433,1025243,18,1025225
97235,20,12,498,1025717,20,1025697
97236,6,18,312,1193497,6,1193491
97237,18,-3,801,560230,18,560212
97238,14,-2,777,590956,14,590942
97239,18,-8,272,399785,18,399767
97240,11,17,890,1184636,11,1184625
97241,14,1,842,686365,14,686351
97242,18,14,929,1092700,18,1092682
97243,6,16,502,1135862,6,1135856
97244,18,5,991,811079,18,811061
97245,10,-15,47,156350,10,156340
97246,14,0,125,649203,14,649189
97247,9,7,473,855010,9,855001
97248,7,-1,992,615369,7,615362
97249,11,-16,583,151308,11,151297
97250,17,-10,502,338821,17,338804
97251,11,-7,205,429840,11,429829
97252,11,-2,814,591268,11,591257
97253,19,12,957,1029470,19,1029451
97254,14,-3,286,555828,14,555814
97255,12,0,955,655556,12,655544
97256,18,19,350,1243600,18,1243582
97257,15,-9,321,368954,15,368939
97258,14,3,24,741961,14,741947
97259,5,-17,865,111750,5,111745
97260,16,-17,948,122480,16,122464
97261,7,0,930,645563,7,645556
97262,13,-20,587,27273,13,27260
97263,7,-14,141,189577,7,189570
97264,14,16,332,1149522,14,1149508
97265,16,12,267,1024110,16,1024094
97266,8,-13,147,221500,8,221492
97267,11,-8,9,397953,11,397942
97268,5,-12,843,267881,5,267876
97269,20,-3,72,554287,20,554267
97270,14,0,885,655011,14,654997
97271,19,-18,359,88017,19,87998
97272,17,17,129,1178819,17,1178802
97273,6,-10,562,324882,6,324876
97274,8,-2,482,573065,8,573057
97275,14,4,900,779920,14,779906
97276,6,18,894,1205707,6,1205701
97277,6,16,888,1143549,6,1143543
97278,16,7,925,873607,16,873591
97279,14,16,46,1147420,14,1147406
97280,8,-13,536,229743,8,229735
97281,19,-14,889,216436,19,216417
97282,18,19,802,1247289,18,1247271
97283,14,17,564,1182043,14,1182029
97284,18,-11,527,307958,18,307940
97285,14,2,650,715451,14,715437
97286,20,19,636,1245965,20,1245945
97287,12,-11,580,308380,12,308368
97288,16,0,324,650448,16,650432
97289,6,-7,870,424351,6,424345
97290,9,-5,41,468802,9,468793
97291,20,-14,152,210485,20,210465
97292,10,10,107,939910,10,939900
97293,17,-16,381,149703,17,149686
97294,18,17,172,1179184,18,1179166
97295,7,9,187,910685,7,910678
97296,8,-15,891,174380,8,174372
97297,5,-12,619,262916,5,262911
97298,17,16,598,1151334,17,1151317
97299,6,10,815,955180,6,955174
97300,18,19,969,1248553,18,1248535
97301,17,-4,850,528317,17,528300
97302,9,2,706,703546,9,703537
97303,16,-20,578,27199,16,27183
97304,16,-17,321,117879,16,117863
97305,14,-15,625,182391,14,182377
97306,13,-6,885,465824,13,465811
97307,6,18,756,1202632,6,1202626
97308,8,0,784,642498,8,642490
97309,10,-11,319,288194,10,288184
97310,5,18,133,1189718,5,1189713
97311,17,6,308,838124,17,838107
97312,7,-18,263,68199,7,68192
97313,18,2,170,711889,18,711871
97314,7,-11,519,292728,7,292721
97315,12,-13,220,242667,12,242655
97316,17,1,142,680982,17,680965
97317,6,-14,467,196807,6,196801
97318,12,0,524,652148,12,652136
97319,7,-2,240,567929,7,567922
97320,6,-16,150,127287,6,127281
97321,12,-13,444,244257,12,244245
97322,5,-10,169,316361,5,316356
97323,19,-7,434,431580,19,431561
97324,10,8,690,890375,10,890365
97325,7,14,649,1076507,7,1076500
97326,8,-9,794,361379,8,361371
97327,15,-16,548,151036,15,151021
97328,14,0,249,650066,14,650052
97329,5,-17,497,104210,5,104205
97330,16,13,611,1057901,16,1057885
97331,8,-7,460,415691,8,415683
97332,6,11,848,986646,6,986640
97333,19,10,297,962059,19,962040
97334,8,-19,807,49082,8,49074
97335,16,-10,722,340517,16,340501
97336,18,-15,50,178171,18,178153
97337,12,19,331,1243456,12,1243444
97338,13,3,707,747223,13,747210
97339,19,-1,679,621789,19,621770
97340,12,-10,24,335312,12,335300
97341,9,-5,207,472533,9,472524
97342,13,-16,635,151666,13,151653
97343,13,-13,487,244595,13,244582
97344,5,-19,362,39343,5,39338
97345,20,-8,17,398020,20,398000
97346,7,9,60,908035,7,908028
97347,15,-4,989,529557,15,529542
97348,14,5,584,808049,14,808035
97349,18,-14,696,214976,18,214958
97350,17,-11,444,307321,17,307304
97351,15,1,25,679993,15,679978
97352,19,16,504,1150687,19,1150668
97353,8,-9,784,361117,8,361109
97354,14,-20,911,29794,14,29780
97355,6,0,849,643798,6,643792
97356,15,-8,731,403068,15,403053
97357,5,0,518,636502,5,636497
97358,13,13,395,1056164,13,1056151
97359,7,14,847,1080819,7,1080812
97360,16,-19,148,55221,16,55205
97361,9,-8,594,387915,9,387906
97362,15,15,891,1123271,15,1123256
97363,13,7,465,870477,13,870464
97364,13,4,131,774198,13,774185
97365,16,1,847,686420,16,686404
97366,11,9,187,930429,11,930418
97367,19,9,169,930330,19,930311
97368,8,-1,893,613132,8,613124
97369,9,-1,175,597514,9,597505
97370,20,-16,260,148864,20,148844
97371,7,15,998,1115688,7,1115681
97372,16,-19,834,60401,16,60385
97373,5,-9,994,365486,5,365481
97374,14,-20,949,29982,14,29968
97375,16,-15,363,180440,16,180424
97376,18,1,837,686322,18,686304
97377,20,13,646,1058118,20,1058098
97378,9,2,985,709273,9,709264
97379,9,-9,912,364175,9,364166
97380,17,-17,178,116775,17,116758
97381,5,-4,731,515118,5,515113
97382,7,-12,784,266443,7,266436
97383,18,-7,307,430655,18,430637
97384,12,2,893,717136,12,717124
97385,8,-15,573,167854,8,167846
97386,12,12,482,1025612,12,1025600
97387,7,-14,966,207605,7,207598
97388,8,-1,861,612380,8,612372
97389,17,-14,974,217089,17,217072
97390,18,-7,633,432945,18,432927
97391,11,5,7,803841,11,803830
97392,7,-18,896,81865,7,81858
97393,18,2,403,713708,18,713690
97394,8,-9,829,362043,8,362035
97395,20,9,295,931096,20,931076
97396,14,-2,660,590090,14,590076
97397,14,-1,33,616833,14,616819
97398,12,-10,895,341825,12,341813
97399,6,-15,254,160859,6,160853
97400,12,2,980,717747,12,717735
97401,11,-10,228,336751,11,336740
97402,14,19,996,1248766,14,1248752
97403,17,-5,704,496182,17,496165
97404,15,-4,693,527316,15,527301
97405,9,-1,647,607863,9,607854
97406,12,1,209,681542,12,681530
97407,5,8,449,885027,5,885022
97408,13,-5,464,494483,13,494470
97409,17,4,47,773593,17,773576
97410,12,-19,410,57175,12,57163
97411,11,-14,846,216116,11,216105
97412,14,-6,370,461994,14,461980
97413,13,-14,301,211737,13,211724
97414,10,-3,556,543031,10,543021
97415,19,-12,812,278461,19,278442
97416,5,8,864,893951,5,893946
97417,19,16,518,1150797,19,1150778
97418,7,-14,494,197373,7,197366
97419,19,-13,139,242016,19,241997
97420,11,18,610,1213320,11,1213309
97421,14,19,890,1248001,14,1247987
97422,14,13,424,1056404,14,1056390
97423,20,14,748,1091322,20,1091302
97424,17,-5,297,493279,17,493262
97425,5,-5,755,484298,5,484293
97426,10,-11,141,284229,10,284219
97427,20,-3,674,559174,20,559154
97428,12,-13,475,244477,12,244465
97429,11,-6,951,466341,11,466330
97430,10,-9,812,361688,10,361678
97431,19,8,926,905155,19,905136
97432,9,-7,539,417435,9,417426
97433,5,15,127,1097281,5,1097276
97434,18,15,838,1122915,18,1122897
97435,13,-18,877,91580,13,91567
97436,8,-20,569,12429,8,12421
97437,12,10,616,964666,12,964654
97438,9,2,318,695455,9,695446
97439,7,-2,44,563828,7,563821
97440,8,-3,548,542829,8,542821
97441,8,-8,200,379787,8,379779
97442,5,0,133,628348,5,628343
97443,9,7,944,864716,9,864707
97444,19,13,93,1053923,19,1053904
97445,9,3,183,722804,9,722795
97446,14,-18,398,88286,14,88272
97447,10,-3,130,533257,10,533247
97448,18,17,828,1184178,18,1184160
97449,9,3,698,734042,9,734033
97450,17,-5,821,496955,17,496938
97451,6,-2,827,580514,6,580508
97452,7,-12,705,264770,7,264763
97453,14,-12,1000,280133,14,280119
97454,11,-4,160,523279,11,523268
97455,16,2,425,713848,16,713832
97456,19,7,440,870327,19,870308
97457,13,1,923,687082,13,687069
97458,11,-10,632,339763,11,339752
97459,20,-5,157,492169,20,492149
97460,9,-5,962,488963,9,488954
97461,8,-15,165,158971,8,158963
97462,18,10,391,962774,18,962756
97463,11,6,851,842561,11,842550
97464,16,-8,982,404897,16,404881
97465,6,10,935,957657,6,957651
97466,10,15,899,1113600,10,1113590
97467,19,-18,279,87431,19,87412
97468,7,-5,580,480621,7,480614
97469,14,-2,243,586981,14,586967
97470,14,18,667,1213821,14,1213807
97471,10,-4,639,513232,10,513222
97472,5,-16,749,140116,5,140111
97473,18,0,413,651239,18,651221
97474,10,17,222,1159906,10,1159896
97475,19,-20,181,24203,19,24184
97476,13,-4,357,524921,13,524908
97477,20,-8,471,401116,20,401096
97478,5,4,160,754031,5,754026
97479,9,17,709,1170413,9,1170404
97480,7,-11,460,291434,7,291427
97481,15,-15,178,179070,15,179055
97482,19,8,811,904348,19,904329
97483,11,-1,367,619551,11,619540
97484,10,16,502,1135872,10,1135862
97485,20,-18,703,90348,20,90328
97486,19,-3,250,555559,19,555540
97487,19,-11,797,309935,19,309916
97488,5,-3,829,548888,5,548883
97489,6,-15,672,169812,6,169806
97490,11,-9,993,374206,11,374195
97491,17,19,570,1245447,17,1245430
97492,5,-18,508,73399,5,73394
97493,15,0,788,654261,15,654246
97494,14,2,205,712147,14,712133
97495,13,-19,225,55827,13,55814
97496,19,-10,636,339856,19,339837
97497,20,-8,887,404178,20,404158
97498,6,7,900,863919,6,863913
97499,6,-2,869,581393,6,581387
97500,5,2,83,690367,5,690362
97501,5,5,694,796055,5,796050
97502,20,-12,699,277657,20,277637
97503,16,14,768,1091494,16,1091478
97504,9,-11,982,302306,9,302297
97505,12,12,716,1027428,12,1027416
97506,5,18,681,1201029,5,1201024
97507,13,-7,863,434636,13,434623
97508,15,-14,507,213419,15,213404
97509,15,-9,701,371986,15,371971
97510,6,-3,332,537742,6,537736
97511,16,-11,95,304451,16,304435
97512,17,-5,968,498190,17,498173
97513,16,-14,972,217084,16,217068
97514,12,19,477,1244718,12,1244706
97515,14,-11,218,305418,14,305404
97516,19,-19,541,58191,19,58172
97517,6,-16,269,129872,6,129866
97518,20,8,552,902309,20,902289
97519,11,-5,468,494500,11,494489
97520,12,-11,268,305845,12,305833
97521,14,-3,676,559198,14,559184
97522,15,19,326,1243404,15,1243389
97523,15,18,25,1209083,15,1209068
97524,9,11,402,977178,9,977169
97525,14,13,468,1056700,14,1056686
97526,7,8,459,885224,7,885217
97527,6,-17,309,100204,6,100198
97528,7,-6,991,457982,7,457975
97529,17,13,831,1059467,17,1059450
97530,18,-9,734,372201,18,372183
97531,17,8,579,902506,17,902489
97532,14,-13,293,243268,14,243254
97533,14,-5,88,491594,14,491580
97534,13,-3,180,555077,13,555064
97535,11,-14,277,211616,11,211605
97536,9,-9,909,364094,9,364085
97537,10,-20,790,17437,10,17427
97538,13,-17,262,117417,13,117404
97539,10,-2,877,581629,10,581619
97540,6,-1,982,615131,6,615125
97541,10,-12,802,266829,10,266819
97542,18,-7,378,431234,18,431216
97543,10,5,831,799002,10,798992
97544,15,-5,642,495723,15,495708
97545,13,7,622,871575,13,871562
97546,18,0,262,650140,18,650122
97547,9,-13,519,229395,9,229386
97548,8,-11,414,290365,8,290357
97549,10,5,846,799301,10,799291
97550,20,16,606,1151379,20,1151359
97551,17,3,901,748588,17,748571
97552,13,18,124,1209934,13,1209921
97553,12,12,587,1026377,12,1026365
97554,9,-17,278,99402,9,99393
97555,15,1,940,687184,15,687169
97556,8,-3,29,531162,8,531154
97557,12,-15,976,185181,12,185169
97558,16,1,927,687132,16,687116
97559,8,-13,296,224787,8,224779
97560,12,-6,870,465669,12,465657
97561,17,-20,140,23838,17,23821
97562,9,-13,843,236638,9,236629
97563,13,6,830,842463,13,842450
97564,16,-17,690,120685,16,120669
97565,13,-15,880,184431,13,184418
97566,15,-15,630,182440,15,182425
97567,12,-12,573,276760,12,276748
97568,14,-6,116,459960,14,459946
97569,20,-9,302,368803,20,368783
97570,15,-17,24,115737,15,115722
97571,13,-16,163,148121,13,148108
97572,7,-6,920,456427,7,456420
97573,20,-4,0,522055,20,522035
97574,5,16,612,1138015,5,1138010
97575,12,-13,424,244090,12,244078
97576,6,14,111,1064357,6,1064351
97577,13,9,612,933608,13,933595
97578,17,12,828,1028233,17,1028216
97579,19,8,420,901343,19,901324
97580,14,17,39,1178172,14,1178158
97581,6,-13,155,221667,6,221661
97582,14,-1,589,621176,14,621162
97583,19,1,846,686402,19,686383
97584,11,16,213,1148669,11,1148658
97585,13,6,991,843696,13,843683
97586,11,5,664,808625,11,808614
97587,16,8,7,897964,16,897948
97588,15,-15,156,178963,15,178948
97589,14,-6,422,462394,14,462380
97590,14,-16,988,154205,14,154191
97591,10,8,134,877958,10,877948
97592,17,19,209,1242423,17,1242406
97593,11,-13,652,245792,11,245781
97594,15,11,734,996109,15,996094
97595,7,11,649,982304,7,982297
97596,8,17,667,1169666,8,1169658
97597,8,-15,417,164455,8,164447
97598,20,-4,543,526225,20,526205
97599,7,3,809,736272,7,736265
97600,20,8,585,902556,20,902536
97601,20,-19,455,57479,20,57459
97602,16,-4,19,522184,16,522168
97603,5,7,417,853816,5,853811
97604,15,-7,932,435217,15,435202
97605,5,-5,6,467913,5,467908
97606,9,3,480,729125,9,729116
97607,16,8,46,898237,16,898221
97608,16,-6,204,460740,16,460724
97609,7,18,456,1196552,7,1196545
97610,18,0,118,649165,18,649147
97611,7,8,356,882954,7,882947
97612,11,16,402,1150020,11,1150009
97613,10,7,330,851934,10,851924
97614,19,-14,2,209377,19,209358
97615,11,5,8,803845,11,803834
97616,6,17,960,1175970,6,1175964
97617,20,-5,608,495529,20,495509
97618,12,-4,460,525563,12,525551
97619,16,19,844,1247603,16,1247587
97620,15,-8,835,403827,15,403812
97621,18,-12,745,277963,18,277945
97622,19,1,895,686789,19,686770
97623,19,3,49,742198,19,742179
97624,20,-16,746,152351,20,152331
97625,10,12,233,1004258,10,1004248
97626,6,7,612,857778,6,857772
97627,7,-3,266,536182,7,536175
97628,20,3,155,743002,20,742982
97629,5,-1,29,594332,5,594327
97630,13,5,588,808083,13,808070
97631,20,5,375,806551,20,806531
97632,9,-20,978,21594,9,21585
97633,11,19,719,1246618,11,1246607
97634,17,-15,10,177900,17,177883
97635,13,-1,429,619974,13,619961
97636,20,-9,812,372989,20,372969
97637,14,15,918,1123497,14,1123483
97638,11,6,260,837761,11,837750
97639,18,13,947,1060262,18,1060244
97640,10,-3,997,552758,10,552748
97641,10,18,148,1190089,10,1190079
97642,15,-20,524,26764,15,26749
97643,10,15,457,1104134,10,1104124
97644,5,-14,7,186567,5,186562
97645,15,-14,562,213889,15,213874
97646,16,7,752,872454,16,872438
97647,12,16,131,1148020,12,1148008
97648,11,-13,486,244584,11,244573
97649,8,17,113,1157668,8,1157660
97650,10,-12,406,258492,10,258482
97651,5,-13,21,218766,5,218761
97652,11,13,979,1060481,11,1060470
97653,14,6,803,842198,14,842184
97654,5,18,253,1192408,5,1192403
97655,8,12,605,1012172,8,1012164
97656,8,13,973,1051590,8,1051582
97657,12,-4,311,524514,12,524502
97658,16,-3,629,558823,16,558807
97659,14,14,95,1086224,14,1086210
97660,15,10,196,961339,15,961324
97661,20,-17,655,120428,20,120408
97662,5,18,728,1201897,5,1201892
97663,18,-7,953,435385,18,435367
97664,16,-12,460,275833,16,275817
97665,9,-15,90,157388,9,157379
97666,8,12,656,1013395,8,1013387
97667,8,-14,660,201130,8,201122
97668,11,-11,570,308266,11,308255
97669,14,-18,36,85496,14,85482
97670,10,19,807,1235370,10,1235360
97671,17,9,515,932858,17,932841
97672,5,18,329,1193864,5,1193859
97673,17,-20,107,23576,17,23559
97674,7,15,393,1102802,7,1102795
97675,8,-19,543,43328,8,43320
97676,6,-4,237,504848,6,504842
97677,9,-3,332,537751,9,537742
97678,15,2,305,712885,15,712870
97679,11,-20,243,24653,11,24642
97680,5,-6,681,451387,5,451382
97681,8,-3,877,550055,8,550047
97682,20,-11,896,310708,20,310688
97683,8,-10,393,321098,8,321090
97684,17,-1,940,623748,17,623731
97685,8,-14,508,197651,8,197643
97686,11,-8,135,398842,11,398831
97687,13,-9,825,373076,13,373063
97688,14,2,353,713277,14,713263
97689,10,16,4,1125262,10,1125252
97690,19,-18,748,90727,19,90708
97691,19,-10,882,341755,19,341736
97692,14,15,992,1124087,14,1124073
97693,7,-11,540,293223,7,293216
97694,7,9,208,911207,7,911200
97695,9,5,581,793684,9,793675
97696,9,-11,12,281382,9,281373
97697,10,4,390,759061,10,759051
97698,18,17,69,1178395,18,1178377
97699,6,-2,961,583418,6,583412
97700,20,-19,890,60807,20,60787
97701,17,-16,171,148145,17,148128
97702,20,-11,308,306251,20,306231
97703,7,-8,233,380467,7,380460
97704,16,-12,880,279107,16,279091
97705,15,0,739,653967,15,653952
97706,17,5,872,810144,17,810127
97707,10,-19,818,49305,10,49295
97708,13,-3,629,558826,13,558813
97709,7,-17,158,96785,7,96778
97710,20,-5,103,491724,20,491704
97711,9,-7,222,410543,9,410534
97712,15,-2,4,585145,15,585130
97713,15,-13,931,248085,15,248070
97714,8,10,775,954219,8,954211
97715,8,-13,798,235719,8,235711
97716,17,-8,339,400300,17,400283
97717,8,-12,32,250291,8,250283
97718,13,-15,402,180708,13,180695
97719,20,-16,101,147676,20,147656
97720,14,-20,977,30246,14,30232
97721,9,0,520,636575,9,636566
97722,11,11,869,997187,11,997176
97723,14,1,315,682355,14,682341
97724,14,7,623,871587,14,871573
97725,14,-8,392,400687,14,400673
97726,15,3,757,747563,15,747548
97727,10,-15,608,168506,10,168496
97728,18,-15,347,180324,18,180306
97729,17,-14,814,215908,17,215891
97730,19,5,189,805231,19,805212
97731,12,4,60,773676,12,773664
97732,8,4,354,758216,8,758208
97733,5,5,567,793319,5,793314
97734,8,12,340,1006629,8,1006621
97735,7,9,988,927817,7,927810
97736,13,10,137,960950,13,960937
97737,14,-16,571,151206,14,151192
97738,7,15,175,1098246,7,1098239
97739,15,14,452,1088987,15,1088972
97740,9,8,30,875764,9,875755
97741,11,-10,323,337378,11,337367
97742,7,7,418,853836,7,853829
97743,16,4,169,774502,16,774486
97744,20,-3,330,556225,20,556205
97745,13,12,253,1023945,13,1023932
97746,16,19,395,1244011,16,1243995
97747,14,-3,198,555173,14,555159
97748,11,-14,333,212023,11,212012
97749,7,-12,457,259433,7,259426
97750,20,-13,966,248338,20,248318
97751,8,-2,52,564052,8,564044
97752,13,17,938,1184918,13,1184905
97753,12,-9,338,369164,12,369152
97754,9,10,502,948198,9,948189
97755,9,7,115,847324,9,847315
97756,9,-10,475,323073,9,323064
97757,8,8,951,895861,8,895853
97758,18,18,793,1214775,18,1214757
97759,9,-14,932,206749,9,206740
97760,6,-17,939,113253,6,113247
97761,12,4,731,778655,12,778643
97762,18,7,569,871230,18,871212
97763,13,17,921,1184822,13,1184809
97764,5,18,971,1207326,5,1207321
97765,11,8,554,902317,11,902306
97766,13,-14,324,211922,13,211909
97767,5,10,206,941903,5,941898
97768,19,-15,462,181175,19,181156
97769,19,7,223,868570,19,868551
97770,10,18,452,1196435,10,1196425
97771,19,-4,123,522980,19,522961
97772,5,15,222,1099279,5,1099274
97773,7,18,840,1204547,7,1204540
97774,19,19,332,1243470,19,1243451
97775,17,-11,918,310882,17,310865
97776,6,-4,120,501950,6,501944
97777,13,-6,102,459854,13,459841
97778,12,15,768,1122460,12,1122448
97779,10,3,170,722441,10,722431
97780,19,12,312,1024403,19,1024384
97781,17,15,17,1116917,17,1116900
97782,20,15,296,1119003,20,1118983
97783,11,10,426,963098,11,963087
97784,10,15,524,1105654,10,1105644
97785,19,2,338,713162,19,713143
97786,13,6,323,838300,13,838287
97787,19,-9,330,369052,19,369033
97788,9,12,705,1014585,9,1014576
97789,10,-7,213,410416,10,410406
97790,13,-2,259,587079,13,587066
97791,8,16,350,1132595,8,1132587
97792,7,7,850,862818,7,862811
97793,10,-12,554,261553,10,261543
97794,19,14,938,1092812,19,1092793
97795,5,0,930,645568,5,645563
97796,19,17,486,1181554,19,1181535
97797,6,3,962,739832,6,739826
97798,10,13,455,1040586,10,1040576
97799,18,15,431,1119843,18,1119825
97800,11,-6,544,463383,11,463372
97801,11,9,569,933248,11,933237
97802,13,-1,168,617814,13,617801
97803,18,17,797,1183913,18,1183895
97804,20,-6,584,463619,20,463599
97805,14,-18,924,91934,14,91920
97806,8,-13,274,224294,8,224286
97807,20,-2,954,592401,20,592381
97808,18,19,383,1243879,18,1243861
97809,8,2,26,689117,8,689109
97810,5,-3,484,541371,5,541366
97811,10,6,331,819764,10,819754
97812,15,4,303,775387,15,775372
97813,13,5,920,810487,13,810474
97814,16,11,825,996821,16,996805
97815,19,-1,496,620532,19,620513
97816,7,-3,310,537171,7,537164
97817,20,17,254,1179809,20,1179789
97818,7,17,175,1158964,7,1158957
97819,18,-3,293,555918,18,555900
97820,14,-1,979,623976,14,623962
97821,7,-10,708,327909,7,327902
97822,20,-3,356,556396,20,556376
97823,13,-11,238,305551,13,305538
97824,15,-6,712,464561,15,464546
97825,17,11,119,991700,17,991683
97826,13,9,291,931055,13,931042
97827,10,9,984,927764,10,927754
97828,10,13,405,1039533,10,1039523
97829,13,-1,136,617594,13,617581
97830,17,-17,898,122162,17,122145
97831,18,8,227,899792,18,899774
97832,17,-20,808,29113,17,29096
97833,20,-19,693,59407,20,59387
97834,8,10,764,953944,8,953936
97835,13,12,145,1023090,13,1023077
97836,6,5,189,785617,6,785611
97837,15,10,697,965275,15,965260
97838,6,13,466,1040741,6,1040735
97839,14,0,177,649582,14,649568
97840,14,-17,202,116937,14,116923
97841,8,0,98,627570,8,627562
97842,14,1,694,685253,14,685239
97843,9,14,391,1070424,9,1070415
97844,15,5,100,804525,15,804510
97845,12,-9,323,368967,12,368955
97846,19,-15,114,178657,19,178638
97847,5,-12,75,251210,5,251205
97848,10,-10,356,320311,10,320301
97849,14,-3,693,559297,14,559283
97850,6,-19,717,47293,6,47287
97851,13,-20,34,20082,13,20069
97852,5,18,470,1196804,5,1196799
97853,5,-16,906,143491,5,143486
97854,17,10,64,960322,17,960305
97855,6,7,685,859322,6,859316
97856,9,6,219,817033,9,817024
97857,9,-9,369,351721,9,351712
97858,6,-2,307,569392,6,569386
97859,20,4,639,777906,20,777886
97860,19,3,647,746743,19,746724
97861,16,6,920,843104,16,843088
97862,16,-14,642,214569,16,214553
97863,10,8,748,891660,10,891650
97864,6,3,513,729730,6,729724
97865,14,-8,956,404677,14,404663
97866,16,-8,946,404578,16,404562
97867,16,-11,151,304931,16,304915
97868,6,11,261,973785,6,973779
97869,8,-8,256,380924,8,380916
97870,20,-14,763,215455,20,215435
97871,9,2,71,690180,9,690171
97872,8,17,272,1161163,8,1161155
97873,18,-20,46,23122,18,23104
97874,15,14,149,1086631,15,1086616
97875,12,3,145,742918,12,742906
97876,10,8,936,895562,10,895552
97877,5,-2,432,572001,5,571996
97878,11,17,803,1183938,11,1183927
97879,16,-13,705,246203,16,246187
97880,11,-12,593,276840,11,276829
97881,20,8,204,899597,20,899577
97882,17,19,24,1240915,17,1240898
97883,20,14,967,1093002,20,1092982
97884,16,14,759,1091412,16,1091396
97885,8,-8,914,394931,8,394923
97886,11,9,164,930285,11,930274
97887,17,12,526,1025882,17,1025865
97888,14,-8,519,401470,14,401456
97889,7,3,626,732247,7,732240
97890,19,-13,300,243322,19,243303
97891,15,-16,382,149715,15,149700
97892,8,-7,497,416473,8,416465
97893,5,15,955,1114852,5,1114847
97894,6,17,616,1168426,6,1168420
97895,19,7,469,870512,19,870493
97896,15,-19,121,54980,15,54965
97897,8,18,637,1200279,8,1200271
97898,10,-10,41,313529,10,313519
97899,13,8,704,903557,13,903544
97900,10,-3,856,549578,10,549568
97901,13,-14,207,210935,13,210922
97902,13,-14,318,211856,13,211843
97903,11,9,24,929216,11,929205
97904,14,3,285,744072,14,744058
97905,17,-4,659,527081,17,527064
97906,8,13,329,1037817,8,1037809
97907,11,4,54,773647,11,773636
97908,7,-19,182,35607,7,35600
97909,5,3,286,725139,5,725134
97910,14,0,731,653920,14,653906
97911,20,4,619,777790,20,777770
97912,11,9,631,933765,11,933754
97913,14,-17,246,117300,14,117286
97914,19,-2,355,587776,19,587757
97915,13,4,782,779020,13,779007
97916,19,-2,284,587267,19,587248
97917,11,-9,221,368160,11,368149
97918,7,3,696,734003,7,733996
97919,16,-20,89,23431,16,23415
97920,18,5,925,810579,18,810561
97921,17,-11,547,308134,17,308117
97922,11,12,306,1024383,11,1024372
97923,7,-13,963,239257,7,239250
97924,6,7,960,865049,6,865043
97925,20,4,171,774517,20,774497
97926,14,10,282,961948,14,961934
97927,20,2,587,714986,20,714966
97928,8,10,127,940466,8,940458
97929,9,-12,390,258059,9,258050
97930,16,17,331,1180476,16,1180460
97931,13,14,837,1091993,13,1091980
97932,18,5,744,809223,18,809205
97933,17,-3,810,560307,17,560290
97934,15,13,176,1054507,15,1054492
97935,5,9,725,921977,5,921972
97936,14,-9,561,371136,14,371122
97937,7,11,330,975504,7,975497
97938,6,11,581,980939,6,980933
97939,9,18,353,1194312,9,1194303
97940,14,16,657,1151826,14,1151812
97941,18,-12,469,275967,18,275949
97942,14,9,257,930843,14,930829
97943,18,-16,589,151338,18,151320
97944,11,1,117,680730,11,680719
97945,20,-6,853,465594,20,465574
97946,10,8,981,896537,10,896527
97947,8,17,371,1163290,8,1163282
97948,6,13,99,1032841,6,1032835
97949,13,-3,940,561330,13,561317
97950,14,13,647,1058130,14,1058116
97951,17,-19,13,53988,17,53971
97952,5,-13,414,226950,5,226945
97953,10,1,676,671879,10,671869
97954,9,-5,241,473381,9,473372
97955,13,4,991,780511,13,780498
97956,16,11,181,992094,16,992078
97957,7,-15,552,167381,7,167374
97958,8,-9,848,362469,8,362461
97959,8,-15,509,166452,8,166444
97960,16,-6,786,465166,16,465150
97961,15,-12,662,277415,15,277400
97962,7,9,155,910044,7,910037
97963,17,-7,981,435578,17,435561
97964,15,-14,400,212701,15,212686
97965,9,-13,943,238807,9,238798
97966,20,-6,490,462962,20,462942
97967,8,13,189,1034731,8,1034723
97968,5,-1,560,606140,5,606135
97969,9,19,847,1236315,9,1236306
97970,10,13,388,1039089,10,1039079
97971,19,0,168,649521,19,649502
97972,18,-6,227,460928,18,460910
97973,10,-8,939,395422,10,395412
97974,13,-19,285,56235,13,56222
97975,12,18,102,1209753,12,1209741
97976,13,-8,315,400115,13,400102
97977,12,-12,982,279981,12,279969
97978,12,-3,236,555441,12,555429
97979,11,14,360,1088228,11,1088217
97980,12,15,859,1123044,12,1123032
97981,17,-11,823,310143,17,310126
97982,10,-16,428,133299,10,133289
97983,19,-5,184,492330,19,492311
97984,17,-3,866,560729,17,560712
97985,19,11,789,996576,19,996557
97986,15,0,609,652854,15,652839
97987,5,6,313,819274,5,819269
97988,13,-14,96,210083,13,210070
97989,10,-3,853,549495,10,549485
97990,16,-3,314,556073,16,556057
97991,12,15,61,1117245,12,1117233
97992,10,-2,787,579524,10,579514
97993,13,0,46,648607,13,648594
97994,12,-19,997,61439,12,61427
97995,19,14,44,1085764,19,1085745
97996,7,-15,968,176082,7,176075
97997,20,-3,351,556363,20,556343
97998,12,19,263,1242834,12,1242822
97999,6,1,745,673257,6,673251
98000,10,-5,436,477423,10,477413
98001,19,-2,853,591629,19,591610
98002,15,18,595,1213189,15,1213174
98003,9,-20,178,4092,9,4083
98004,17,14,90,1086156,17,1086139
98005,19,-3,386,556670,19,556651
98006,18,4,815,779268,18,779250
98007,10,-13,24,218871,10,218861
98008,17,19,654,1246082,17,1246065
98009,15,7,40,867325,15,867310
98010,11,-7,120,429167,11,429156
98011,12,-4,745,527631,12,527619
98012,15,-16,207,148458,15,148443
98013,7,17,720,1170626,7,1170619
98014,6,15,219,1099214,6,1099208
98015,13,4,580,777472,13,777459
98016,5,-7,881,424668,5,424663
98017,14,-2,501,588921,14,588907
98018,10,-1,152,597072,10,597062
98019,19,-19,826,60336,19,60317
98020,5,-8,139,378389,5,378384
98021,18,4,956,780296,18,780278
98022,12,-11,572,308267,12,308255
98023,7,19,605,1231058,7,1231051
98024,16,15,852,1122990,16,1122974
98025,13,-14,565,213941,13,213928
98026,16,12,626,1026692,16,1026676
98027,7,-19,541,43282,7,43275
98028,20,-6,239,461041,20,461021
98029,19,1,910,686942,19,686923
98030,9,3,962,739841,9,739832
98031,17,-2,926,592192,17,592175
98032,6,-3,130,533263,6,533257
98033,11,-14,317,211853,11,211842
98034,9,0,683,640309,9,640300
98035,20,5,959,810883,20,810863
98036,19,-10,749,340741,19,340722
98037,15,-7,43,428644,15,428629
98038,12,-1,141,617600,12,617588
98039,7,-1,21,594155,7,594148
98040,14,0,544,652347,14,652333
98041,14,15,927,1123555,14,1123541
98042,17,-15,25,178003,17,177986
98043,13,8,927,905164,13,905151
98044,17,-18,429,88503,17,88486
98045,9,-8,328,382416,9,382407
98046,9,19,981,1239206,9,1239197
98047,7,18,991,1207700,7,1207693
98048,9,16,501,1135837,9,1135828
98049,6,-6,495,447529,6,447523
98050,15,4,477,776700,15,776685
98051,18,10,551,964075,18,964057
98052,12,11,237,992518,12,992506
98053,11,10,807,966155,11,966144
98054,18,0,191,649702,18,649684
98055,16,11,978,997889,16,997873
98056,17,-4,20,522208,17,522191
98057,9,1,361,665125,9,665116
98058,14,17,256,1179823,14,1179809
98059,13,-6,796,465225,13,465212
98060,20,1,423,683163,20,683143
98061,14,-8,758,403270,14,403256
98062,5,19,458,1228033,5,1228028
98063,8,-15,68,156758,8,156750
98064,6,-11,607,294625,6,294619
98065,16,9,422,932106,16,932090
98066,6,14,297,1068399,6,1068393
98067,17,-17,797,121525,17,121508
98068,20,-14,562,213899,20,213879
98069,6,3,220,723596,6,723590
98070,11,3,800,747873,11,747862
98071,14,1,447,683368,14,683354
98072,5,2,517,699648,5,699643
98073,14,15,746,1122342,14,1122328
98074,19,14,350,1088156,19,1088137
98075,20,6,493,839748,20,839728
98076,15,-19,971,61284,15,61269
98077,17,-2,945,592359,17,592342
98078,20,2,30,710719,20,710699
98079,5,-17,272,99295,5,99290
98080,11,8,262,900012,11,900001
98081,9,-7,992,427022,9,427013
98082,7,12,672,1013854,7,1013847
98083,19,-15,173,179029,19,179010
98084,13,-5,203,492444,13,492431
98085,20,12,4,1022158,20,1022138
98086,7,1,244,662545,7,662538
98087,9,18,952,1206953,9,1206944
98088,15,-15,244,179532,15,179517
98089,20,-16,607,151477,20,151457
98090,8,-3,479,541210,8,541202
98091,20,13,577,1057653,20,1057633
98092,10,-9,143,346645,10,346635
98093,13,-12,218,274111,13,274098
98094,13,5,14,803891,13,803878
98095,11,-6,526,463216,11,463205
98096,8,8,759,891854,8,891846
98097,8,6,169,815871,8,815863
98098,5,-6,190,441039,5,441034
98099,10,0,349,632772,10,632762
98100,17,0,18,648349,17,648332
98101,17,12,889,1028778,17,1028761
98102,18,13,866,1059724,18,1059706
98103,20,-2,74,585691,20,585671
98104,20,-8,319,400152,20,400132
98105,17,-2,780,590993,17,590976
98106,12,4,614,777755,12,777743
98107,7,-20,873,19424,7,19417
98108,18,18,408,1212063,18,1212045
98109,16,2,736,716133,16,716117
98110,16,18,784,1214666,16,1214650
98111,7,8,355,882938,7,882931
98112,10,2,251,694043,10,694033
98113,17,13,137,1054210,17,1054193
98114,10,10,42,938426,10,938416
98115,9,8,186,879114,9,879105
98116,10,-7,390,414388,10,414378
98117,20,-5,572,495257,20,495237
98118,8,8,444,884945,8,884937
98119,15,-11,979,311381,15,311366
98120,13,-6,949,466333,13,466320
98121,6,5,610,794329,6,794323
98122,8,13,786,1047689,8,1047681
98123,6,5,761,797488,6,797482
98124,7,18,185,1191001,7,1190994
98125,13,6,189,837175,13,837162
98126,12,12,429,1025203,12,1025191
98127,11,13,83,1053847,11,1053836
98128,15,7,95,867703,15,867688
98129,10,16,816,1142124,10,1142114
98130,19,-17,233,117176,19,117157
98131,15,-12,616,276996,15,276981
98132,13,-19,639,59046,13,59033
98133,9,17,705,1170328,9,1170319
98134,18,17,105,1178600,18,1178582
98135,11,2,741,716140,11,716129
98136,10,18,590,1199166,10,1199156
98137,11,8,32,898117,11,898106
98138,14,0,673,653396,14,653382
98139,13,-4,532,526133,13,526120
98140,10,4,145,753719,10,753709
98141,14,-4,876,528638,14,528624
98142,14,17,328,1180452,14,1180438
98143,10,0,741,641648,10,641638
98144,20,-13,328,243481,20,243461
98145,13,19,768,1247037,13,1247024
98146,18,-16,317,149295,18,149277
98147,13,10,527,963921,13,963908
98148,13,0,643,653136,13,653123
98149,5,7,91,846826,5,846821
98150,5,-20,578,12628,5,12623
98151,6,3,823,736577,6,736571
98152,13,6,99,836487,13,836474
98153,18,-15,175,179050,18,179032
98154,17,-15,422,180927,17,180910
98155,18,19,384,1243903,18,1243885
98156,18,6,731,841705,18,841687
98157,11,4,71,773769,11,773758
98158,14,12,708,1027396,14,1027382
98159,11,18,16,1209024,11,1209013
98160,16,3,100,742575,16,742559
98161,9,-8,828,393094,9,393085
98162,9,-10,307,319157,9,319148
98163,18,8,773,904090,18,904072
98164,18,18,715,1214069,18,1214051
98165,13,11,788,996561,13,996548
98166,8,-19,235,36753,8,36745
98167,8,18,678,1200970,8,1200962
98168,12,-8,388,400623,12,400611
98169,19,7,484,870649,19,870630
98170,8,-8,183,379455,8,379447
98171,19,1,112,680703,19,680684
98172,7,7,456,854614,7,854607
98173,8,-10,275,318508,8,318500
98174,8,-13,984,239664,8,239656
98175,5,-4,508,510483,5,510478
98176,8,-1,1,593762,8,593754
98177,13,9,554,933131,13,933118
98178,11,15,953,1123789,11,1123778
98179,14,-18,628,89802,14,89788
98180,19,1,414,683123,19,683104
98181,13,-7,741,433680,13,433667
98182,8,-18,721,77982,8,77974
98183,10,-14,194,190713,10,190703
98184,12,-19,220,55810,12,55798
98185,8,-9,168,347162,8,347154
98186,10,2,809,705491,10,705481
98187,8,8,187,879131,8,879123
98188,12,16,488,1150589,12,1150577
98189,5,2,11,688762,5,688757
98190,14,-8,141,398893,14,398879
98191,9,-11,89,282996,9,282987
98192,7,14,188,1065922,7,1065915
98193,12,-5,117,491827,12,491815
98194,9,12,168,1002849,9,1002840
98195,15,8,208,899632,15,899617
98196,18,-8,294,399951,18,399933
98197,18,-10,899,341853,18,341835
98198,18,15,807,1122679,18,1122661
98199,13,-17,362,118166,13,118153
98200,14,-10,713,340442,14,340428
98201,5,-11,707,296473,5,296468
98202,12,0,458,651591,12,651579
98203,6,-20,947,20846,6,20840
98204,9,-13,637,231959,9,231950
98205,18,-1,569,621046,18,621028
98206,12,-4,214,523757,12,523745
98207,8,4,969,771696,8,771688
98208,19,7,278,868994,19,868975
98209,13,18,27,1209096,13,1209083
98210,8,-7,869,424326,8,424318
98211,11,17,511,1181744,11,1181733
98212,13,-16,111,147761,13,147748
98213,19,-9,804,372917,19,372898
98214,18,-13,833,247218,18,247200
98215,6,-10,496,323437,6,323431
98216,14,7,391,869901,14,869887
98217,18,12,346,1024628,18,1024610
98218,6,-20,932,20557,6,20551
98219,20,8,673,903310,20,903290
98220,20,-1,13,616590,20,616570
98221,14,11,329,993254,14,993240
98222,18,19,254,1242756,18,1242738
98223,17,-15,865,184341,17,184324
98224,17,2,455,714077,17,714060
98225,9,14,904,1082050,9,1082041
98226,18,6,636,840924,18,840906
98227,7,14,456,1072002,7,1071995
98228,13,15,933,1123608,13,1123595
98229,10,-17,894,112438,10,112428
98230,8,0,25,625847,8,625839
98231,13,-9,91,367297,13,367284
98232,17,1,422,683148,17,683131
98233,8,-6,241,442158,8,442150
98234,12,0,553,652408,12,652396
98235,18,-12,86,273167,18,273149
98236,14,19,362,1243703,14,1243689
98237,18,6,942,843270,18,843252
98238,8,10,267,943177,8,943169
98239,12,-8,924,404405,12,404393
98240,9,2,93,690617,9,690608
98241,10,7,891,863725,10,863715
98242,18,4,761,778877,18,778859
98243,19,3,509,745621,19,745602
98244,8,-19,193,35866,8,35858
98245,20,12,869,1028628,20,1028608
98246,10,3,537,730079,10,730069
98247,6,12,473,1009276,6,1009270
98248,10,-2,609,575748,10,575738
98249,11,3,710,747262,11,747251
98250,6,3,570,730925,6,730919
98251,14,7,150,868127,14,868113
98252,18,2,27,710666,18,710648
98253,18,-9,234,368278,18,368260
98254,9,4,360,758360,9,758351
98255,14,13,203,1054738,14,1054724
98256,14,9,376,931783,14,931769
98257,16,-9,104,367368,16,367352
98258,5,-19,317,38348,5,38343
98259,6,4,782,767718,6,767712
98260,15,18,444,1212299,15,1212284
98261,19,-13,831,247206,19,247187
98262,7,-11,339,288569,7,288562
98263,15,6,656,841047,15,841032
98264,19,2,55,710938,19,710919
98265,12,3,708,747233,12,747221
98266,10,-9,46,344609,10,344599
98267,18,5,103,804547,18,804529
98268,8,14,839,1080677,8,1080669
98269,14,1,923,687086,14,687072
98270,18,17,566,1182051,18,1182033
98271,10,1,808,674589,10,674579
98272,20,13,624,1058000,20,1057980
98273,19,13,812,1059353,19,1059334
98274,7,-5,416,477060,7,477053
98275,19,-6,335,461769,19,461750
98276,9,-13,774,235231,9,235222
98277,14,-18,393,88248,14,88234
98278,18,1,494,683791,18,683773
98279,5,7,384,853117,5,853112
98280,6,-20,32,793,6,787
98281,16,12,65,1022536,16,1022520
98282,19,-8,521,401501,19,401482
98283,20,10,541,964001,20,963981
98284,19,-9,383,369530,19,369511
98285,16,0,583,652682,16,652666
98286,18,-18,938,92029,18,92011
98287,11,6,944,843277,11,843266
98288,12,10,965,967218,12,967206
98289,17,17,637,1182594,17,1182577
98290,8,7,682,859287,8,859279
98291,6,-14,739,202789,6,202783
98292,8,-19,225,36530,8,36522
98293,19,-14,80,209955,19,209936
98294,16,11,331,993289,16,993273
98295,13,18,948,1215931,13,1215918
98296,16,4,754,778817,16,778801
98297,14,16,629,1151565,14,1151551
98298,7,-7,603,418711,7,418704
98299,10,-13,191,222510,10,222500
98300,9,-2,220,567496,9,567487
98301,5,11,40,969291,5,969286
98302,5,0,219,630259,5,630254
98303,9,-4,226,504511,9,504502
98304,13,-5,962,498094,13,498081
98305,18,-1,671,621723,18,621705
98306,6,13,449,1040421,6,1040415
98307,17,-5,501,494737,17,494720
98308,16,-16,226,148660,16,148644
98309,15,-3,716,559475,15,559460
98310,12,14,651,1090538,12,1090526
98311,19,-14,997,217264,19,217245
98312,17,17,800,1183921,17,1183904
98313,14,-18,155,86456,14,86442
98314,7,0,59,626574,7,626567
98315,5,5,721,796669,5,796664
98316,14,6,536,840108,14,840094
98317,18,-3,234,555410,18,555392
98318,13,17,227,1179546,13,1179533
98319,17,19,122,1241780,17,1241763
98320,20,-3,245,555492,20,555472
98321,12,-5,779,496646,12,496634
98322,5,-1,170,597404,5,597399
98323,7,-1,588,606735,7,606728
98324,14,-9,902,373757,14,373743
98325,19,-16,264,148913,19,148894
98326,11,8,765,904011,11,904000
98327,9,-15,403,164152,9,164143
98328,16,-17,456,118904,16,118888
98329,17,0,832,654586,17,654569
98330,6,-11,29,281697,6,281691
98331,16,-12,600,276886,16,276870
98332,19,12,807,1028033,19,1028014
98333,20,14,421,1088774,20,1088754
98334,20,8,526,902155,20,902135
98335,8,-20,781,17207,8,17199
98336,8,-7,996,427158,8,427150
98337,5,8,720,891140,5,891135
98338,19,17,67,1178376,19,1178357
98339,7,-8,659,389534,7,389527
98340,18,12,159,1023222,18,1023204
98341,13,12,636,1026756,13,1026743
98342,8,14,243,1067243,8,1067235
98343,20,13,837,1059516,20,1059496
98344,9,3,972,740175,9,740166
98345,6,10,168,941226,6,941220
98346,9,19,921,1237929,9,1237920
98347,15,-16,470,150520,15,150505
98348,7,12,340,1006636,7,1006629
98349,12,-16,828,152980,12,152968
98350,14,-9,794,372854,14,372840
98351,10,4,8,750727,10,750717
98352,5,14,283,1068117,5,1068112
98353,7,-13,627,231781,7,231774
98354,8,-8,110,377685,8,377677
98355,14,-14,996,217245,14,217231
98356,7,-12,340,257056,7,257049
98357,13,3,275,743962,13,743949
98358,20,-19,181,55482,20,55462
98359,7,2,739,704210,7,704203
98360,18,-9,643,371622,18,371604
98361,10,-15,803,172593,10,172583
98362,12,9,55,929490,12,929478
98363,13,-16,561,151133,13,151120
98364,14,-9,365,369398,14,369384
98365,15,18,511,1212742,15,1212727
98366,5,10,176,941319,5,941314
98367,20,13,697,1058481,20,1058461
98368,17,-20,633,27579,17,27562
98369,20,-16,278,149043,20,149023
98370,17,12,77,1022607,17,1022590
98371,15,3,564,746023,15,746008
98372,10,17,847,1173601,10,1173591
98373,7,6,434,822225,7,822218
98374,18,5,23,803916,18,803898
98375,14,1,794,686045,14,686031
98376,11,1,515,683927,11,683916
98377,5,17,223,1159910,5,1159905
98378,15,-5,586,495376,15,495361
98379,20,-19,448,57425,20,57405
98380,8,-14,608,200081,8,200073
98381,18,14,368,1088311,18,1088293
98382,17,-1,302,618980,17,618963
98383,16,-10,26,335347,16,335331
98384,7,-6,35,437615,7,437608
98385,10,11,357,976072,10,976062
98386,11,0,658,653292,11,653281
98387,5,7,104,847064,5,847059
98388,18,6,500,839810,18,839792
98389,16,-3,203,555231,16,555215
98390,19,16,112,1147849,19,1147830
98391,10,0,325,632154,10,632144
98392,8,-12,252,254943,8,254935
98393,13,-2,801,591149,13,591136
98394,18,9,435,932206,18,932188
98395,6,17,805,1172616,6,1172610
98396,10,17,416,1164154,10,1164144
98397,12,-6,451,462592,12,462580
98398,15,13,611,1057906,15,1057891
98399,16,-7,522,432301,16,432285
98400,18,18,651,1213658,18,1213640
98401,9,0,479,635776,9,635767
98402,20,-6,97,459814,20,459794
98403,11,-12,144,273590,11,273579
98404,19,-4,587,526525,19,526506
98405,12,-4,111,522882,12,522870
98406,8,13,319,1037587,8,1037579
98407,17,17,979,1185297,17,1185280
98408,13,-11,957,311217,13,311204
98409,14,-4,299,524408,14,524394
98410,11,-10,218,336705,11,336694
98411,15,5,533,807701,15,807686
98412,8,17,750,1171293,8,1171285
98413,10,-15,431,164805,10,164795
98414,6,-9,574,356609,6,356603
98415,9,-7,126,408483,9,408474
98416,18,-12,110,273344,18,273326
98417,10,-1,592,606811,10,606801
98418,11,-17,983,122704,11,122693
98419,10,-4,176,503241,10,503231
98420,15,18,353,1211656,15,1211641
98421,6,-16,261,129732,6,129726
98422,10,17,273,1161187,10,1161177
98423,13,-15,219,179307,13,179294
98424,9,4,736,766636,9,766627
98425,10,-12,746,265644,10,265634
98426,7,15,327,1101494,7,1101487
98427,15,-6,679,464291,15,464276
98428,8,19,835,1236026,8,1236018
98429,6,-9,416,352738,6,352732
98430,15,-16,784,152683,15,152668
98431,12,-4,81,522652,12,522640
98432,9,-5,176,471957,9,471948
98433,10,16,277,1131055,10,1131045
98434,13,-7,350,430992,13,430979
98435,10,-16,909,143593,10,143583
98436,16,-3,72,554293,16,554277
98437,18,11,611,995253,18,995235
98438,12,8,867,904691,12,904679
98439,15,18,979,1216182,15,1216167
98440,20,8,606,902723,20,902703
98441,9,-17,897,112481,9,112472
98442,10,-17,142,96414,10,96404
98443,11,2,854,716848,11,716837
98444,14,-17,18,115700,14,115686
98445,19,12,795,1027983,19,1027964
98446,12,-20,780,28839,12,28827
98447,12,11,888,997320,12,997308
98448,16,-1,573,621075,16,621059
98449,20,-18,690,90237,20,90217
98450,18,19,373,1243797,18,1243779
98451,17,5,184,805191,17,805174
98452,18,-7,575,432641,18,432623
98453,9,-6,621,450178,9,450169
98454,11,-11,273,305870,11,305859
98455,12,16,846,1153165,12,1153153
98456,14,-4,577,526460,14,526446
98457,18,16,537,1150913,18,1150895
98458,13,10,693,965254,13,965241
98459,12,-17,295,117704,12,117692
98460,10,-4,483,509852,10,509842
98461,5,-7,865,424221,5,424216
98462,9,0,704,640782,9,640773
98463,13,7,457,870446,13,870433
98464,7,-7,199,410062,7,410055
98465,19,15,64,1117261,19,1117242
98466,9,7,212,849271,9,849262
98467,18,3,975,749330,18,749312
98468,18,5,242,805635,18,805617
98469,11,17,441,1181234,11,1181223
98470,8,15,779,1110990,8,1110982
98471,5,-20,809,18018,5,18013
98472,15,-6,202,460722,15,460707
98473,18,-1,828,622917,18,622899
98474,13,6,882,842787,13,842774
98475,7,12,169,1002881,7,1002874
98476,12,-1,206,618156,12,618144
98477,6,-12,576,262050,6,262044
98478,12,-19,647,59089,12,59077
98479,6,10,203,941830,6,941824
98480,14,9,29,929289,14,929275
98481,14,-10,80,335797,14,335783
98482,18,18,940,1215840,18,1215822
98483,16,1,487,683706,16,683690
98484,13,-7,446,431688,13,431675
98485,9,-8,962,395944,9,395935
98486,12,13,924,1060102,12,1060090
98487,12,2,820,716586,12,716574
98488,19,-10,562,339295,19,339276
98489,10,18,180,1190841,10,1190831
98490,10,19,935,1238180,10,1238170
98491,19,-1,757,622368,19,622349
98492,7,-13,503,229003,7,228996
98493,17,-8,186,399235,17,399218
98494,7,17,6,1155412,7,1155405
98495,11,14,184,1086862,11,1086851
98496,19,-17,451,118836,19,118817
98497,20,-16,549,151047,20,151027
98498,9,12,380,1007320,9,1007311
98499,20,-11,985,311439,20,311419
98500,18,-9,169,367769,18,367751
98501,13,-20,55,23194,13,23181
98502,7,8,488,885908,7,885901
98503,15,10,469,963438,15,963423
98504,20,-10,956,342269,20,342249
98505,20,6,626,840824,20,840804
98506,11,-17,247,117300,11,117289
98507,10,-5,889,487397,10,487387
98508,18,10,915,966904,18,966886
98509,18,6,333,838359,18,838341
98510,19,-17,974,122629,19,122610
98511,19,-2,95,585847,19,585828
98512,20,-5,26,491021,20,491001
98513,9,-20,615,13444,9,13435
98514,6,10,711,952896,6,952890
98515,13,4,511,776955,13,776942
98516,18,14,364,1088282,18,1088264
98517,5,-8,758,391625,5,391620
98518,13,-10,167,336347,13,336334
98519,15,-4,192,523549,15,523534
98520,9,-2,357,570341,9,570332
98521,14,-16,1,146715,14,146701
98522,8,-1,116,596292,8,596284
98523,7,-3,449,540512,7,540505
98524,7,-17,301,100023,7,100016
98525,5,-1,984,615194,5,615189
98526,6,12,38,999947,6,999941
98527,8,-10,190,316762,8,316754
98528,17,7,4,867057,17,867040
98529,5,9,272,912347,5,912342
98530,7,-5,62,469214,7,469207
98531,15,8,338,900652,15,900637
98532,14,11,986,997971,14,997957
98533,9,4,370,758605,9,758596
98534,6,-3,355,538163,6,538157
98535,12,-4,573,526429,12,526417
98536,6,-1,490,604773,6,604767
98537,15,-3,864,560705,15,560690
98538,5,8,240,880528,5,880523
98539,9,4,643,764569,9,764560
98540,18,0,444,651471,18,651453
98541,15,9,771,934703,15,934688
98542,6,-17,162,96847,6,96841
98543,14,-11,124,304685,14,304671
98544,13,-9,616,371461,13,371448
98545,11,-1,598,621235,11,621224
98546,7,-19,843,50033,7,50026
98547,8,5,575,793537,8,793529
98548,14,-6,362,461952,14,461938
98549,20,-18,856,91428,20,91408
98550,8,-19,503,42352,8,42344
98551,18,1,719,685427,18,685409
98552,12,9,536,932980,12,932968
98553,14,-20,884,29597,14,29583
98554,5,16,372,1133068,5,1133063
98555,13,-5,6,490817,13,490804
98556,14,-19,709,59530,14,59516
98557,18,1,911,686953,18,686935
98558,19,-12,891,279189,19,279170
98559,18,7,230,868645,18,868627
98560,15,-3,689,559280,15,559265
98561,20,-2,631,589871,20,589851
98562,20,-3,89,554400,20,554380
98563,10,-5,712,483384,10,483374
98564,20,-2,287,587293,20,587273
98565,14,-18,385,88197,14,88183
98566,14,-18,928,91967,14,91953
98567,15,-2,714,590518,15,590503
98568,19,14,771,1091534,19,1091515
98569,14,1,394,682988,14,682974
98570,8,-6,133,439554,8,439546
98571,5,16,932,1144609,5,1144604
98572,5,4,159,754007,5,754002
98573,9,19,336,1225114,9,1225105
98574,8,7,868,863244,8,863236
98575,9,8,154,878422,9,878413
98576,11,-10,274,337074,11,337063
98577,10,-14,37,187337,10,187327
98578,13,-18,914,91879,13,91866
98579,15,-17,904,122200,15,122185
98580,11,19,61,1241224,11,1241213
98581,9,-1,489,604744,9,604735
98582,9,-14,14,186792,9,186783
98583,18,7,511,870817,18,870799
98584,12,1,204,681512,12,681500
98585,9,0,636,639210,9,639201
98586,8,-6,886,455752,8,455744
98587,10,14,100,1064073,10,1064063
98588,20,2,30,710729,20,710709
98589,9,-12,390,258068,9,258059
98590,11,-2,909,592085,11,592074
98591,9,16,919,1144339,9,1144330
98592,6,18,762,1202811,6,1202805
98593,12,-11,647,308893,12,308881
98594,15,-5,164,492250,15,492235
98595,15,4,860,779702,15,779687
98596,5,-6,929,456617,5,456612
98597,19,4,335,775640,19,775621
98598,15,-6,137,460141,15,460126
98599,15,-5,780,496667,15,496652
98600,11,16,529,1150856,11,1150845
98601,14,1,422,683152,14,683138
98602,6,6,479,823255,6,823249
98603,14,12,102,1022786,14,1022772
98604,12,-19,390,57049,12,57037
98605,18,11,760,996340,18,996322
98606,20,11,404,993863,20,993843
98607,20,-11,495,307711,20,307691
98608,12,5,592,808111,12,808099
98609,13,7,371,869695,13,869682
98610,16,4,391,776029,16,776013
98611,6,-14,163,190013,6,190007
98612,18,-20,255,24750,18,24732
98613,20,0,424,651328,20,651308
98614,5,-9,267,349437,5,349432
98615,20,17,493,1181603,20,1181583
98616,11,6,840,842525,11,842514
98617,10,-19,675,46319,10,46309
98618,11,16,390,1149955,11,1149944
98619,13,-9,38,366902,13,366889
98620,15,-14,586,214141,15,214126
98621,15,0,526,652190,15,652175
98622,19,-20,867,29483,19,29464
98623,16,-17,566,119784,16,119768
98624,19,-11,246,305626,19,305607
98625,15,-4,353,524867,15,524852
98626,19,-5,761,496586,19,496567
98627,19,-13,517,244867,19,244848
98628,8,5,806,798480,8,798472
98629,13,-2,177,586355,13,586342
98630,17,6,741,841751,17,841734
98631,9,14,727,1078384,9,1078375
98632,11,17,770,1183568,11,1183557
98633,7,6,329,819704,7,819697
98634,20,-8,270,399773,20,399753
98635,9,-8,950,395703,9,395694
98636,12,1,112,680705,12,680693
98637,10,8,679,890149,10,890139
98638,15,19,441,1244497,15,1244482
98639,6,3,916,738675,6,738669
98640,10,9,405,915241,10,915231
98641,5,5,616,794485,5,794480
98642,19,-19,648,59100,19,59081
98643,11,1,606,684623,11,684612
98644,14,14,338,1088091,14,1088077
98645,6,6,443,822458,6,822452
98646,16,17,672,1182879,16,1182863
98647,10,5,288,787720,10,787710
98648,5,-12,973,270850,5,270845
98649,6,-13,99,220613,6,220607
98650,17,15,438,1119882,17,1119865
98651,13,5,332,806225,13,806212
98652,14,7,768,872579,14,872565
98653,8,-12,403,258377,8,258369
98654,8,7,662,858813,8,858805
98655,7,18,266,1192701,7,1192694
98656,11,12,68,1022555,11,1022544
98657,16,3,275,743968,16,743952
98658,7,12,351,1006821,7,1006814
98659,7,-5,206,472485,7,472478
98660,8,6,502,823728,8,823720
98661,13,-11,889,310660,13,310647
98662,8,-10,392,321073,8,321065
98663,12,4,121,774114,12,774102
98664,13,10,848,966320,13,966307
98665,7,3,83,720591,7,720584
98666,18,-16,150,148058,18,148040
98667,5,10,484,947829,5,947824
98668,13,6,197,837213,13,837200
98669,17,5,943,810718,17,810701
98670,16,6,967,843473,16,843457
98671,16,15,962,1123853,16,1123837
98672,18,-13,702,246162,18,246144
98673,20,-4,778,527875,20,527855
98674,7,-20,753,16603,7,16596
98675,18,-13,278,243158,18,243140
98676,11,-19,500,57832,11,57821
98677,19,6,544,840159,19,840140
98678,8,0,76,626891,8,626883
98679,18,3,48,742185,18,742167
98680,19,-14,922,216704,19,216685
98681,20,9,913,935872,20,935852
98682,14,1,924,687098,14,687084
98683,16,-4,162,523294,16,523278
98684,20,7,943,873720,20,873700
98685,7,-20,716,15721,7,15714
98686,16,13,352,1055818,16,1055802
98687,11,6,982,843589,11,843578
98688,13,8,397,901113,13,901100
98689,14,-20,324,25368,14,25354
98690,5,-5,927,488192,5,488187
98691,7,0,9,625406,7,625399
98692,18,-4,973,529442,18,529424
98693,19,13,534,1057198,19,1057179
98694,14,-8,958,404703,14,404689
98695,16,0,544,652353,16,652337
98696,19,-10,594,339489,19,339470
98697,18,9,615,933641,18,933623
98698,18,-20,303,25184,18,25166
98699,18,17,819,1184104,18,1184086
98700,14,17,566,1182055,14,1182041
98701,16,6,136,836805,16,836789
98702,6,-13,601,231183,6,231177
98703,6,-2,803,579928,6,579922
98704,20,-6,516,463164,20,463144
98705,8,-9,147,346760,8,346752
98706,7,19,552,1229967,7,1229960
98707,15,14,777,1091582,15,1091567
98708,5,1,760,673525,5,673520
98709,17,-9,564,371145,17,371128
98710,13,0,353,650711,13,650698
98711,5,6,679,827618,5,827613
98712,16,5,599,808191,16,808175
98713,16,-14,183,210702,16,210686
98714,12,5,698,808895,12,808883
98715,17,-16,753,152452,17,152435
98716,13,-2,470,588681,13,588668
98717,20,10,477,963468,20,963448
98718,13,-10,737,340630,13,340617
98719,16,15,890,1123267,16,1123251
98720,12,-9,660,371705,12,371693
98721,18,-10,408,338031,18,338013
98722,14,10,926,966976,14,966962
98723,9,2,841,706182,9,706173
98724,16,17,631,1182551,16,1182535
98725,8,14,767,1079162,8,1079154
98726,11,-12,89,273193,11,273182
98727,11,-1,985,624076,11,624065
98728,15,10,496,963612,15,963597
98729,13,-3,13,553942,13,553929
98730,16,-9,856,373348,16,373332
98731,12,-20,5,3825,12,3813
98732,5,15,743,1110319,5,1110314
98733,10,2,901,707328,10,707318
98734,17,14,140,1086572,17,1086555
98735,12,5,955,810834,12,810822
98736,18,2,907,717253,18,717235
98737,12,-12,137,273567,12,273555
98738,8,5,820,798791,8,798783
98739,7,19,421,1227298,7,1227291
98740,12,7,110,867830,12,867818
98741,19,-7,128,429224,19,429205
98742,19,-5,746,496502,19,496483
98743,11,5,756,809271,11,809260
98744,11,11,827,996823,11,996812
98745,16,7,32,867251,16,867235
98746,10,6,997,834693,10,834683
98747,7,-7,60,407288,7,407281
98748,8,-12,492,260232,8,260224
98749,18,8,896,904955,18,904937
98750,5,15,389,1102718,5,1102713
98751,8,3,798,736017,8,736009
98752,12,4,348,775729,12,775717
98753,17,-11,875,310597,17,310580
98754,20,19,516,1245041,20,1245021
98755,18,-17,197,116925,18,116907
98756,11,-20,265,24804,11,24793
98757,9,9,854,924915,9,924906
98758,13,-3,188,555113,13,555100
98759,19,-16,446,150324,19,150305
98760,13,-1,561,620981,13,620968
98761,7,-16,538,135751,7,135744
98762,20,9,914,935884,20,935864
98763,6,16,963,1145325,6,1145319
98764,6,-7,996,427164,6,427158
98765,17,-5,127,491929,17,491912
98766,19,19,455,1244581,19,1244562
98767,20,2,428,713868,20,713848
98768,15,2,752,716230,15,716215
98769,20,-17,736,121095,20,121075
98770,13,-14,831,216000,13,215987
98771,10,-4,92,501351,10,501341
98772,13,-13,696,246087,13,246074
98773,20,-10,331,337447,20,337427
98774,15,14,813,1091856,15,1091841
98775,12,7,995,874076,12,874064
98776,10,16,57,1126397,10,1126387
98777,18,10,555,964114,18,964096
98778,19,7,637,871688,19,871669
98779,5,16,500,1135814,5,1135809
98780,11,10,996,967412,11,967401
98781,6,-12,370,257654,6,257648
98782,6,-3,197,534612,6,534606
98783,16,-14,345,212102,16,212086
98784,20,7,467,870493,20,870473
98785,9,9,377,914656,9,914647
98786,11,-12,714,277759,11,277748
98787,17,19,622,1245869,17,1245852
98788,6,17,822,1172974,6,1172968
98789,9,-20,592,12940,9,12931
98790,13,-19,581,58633,13,58620
98791,14,1,949,687286,14,687272
98792,5,19,741,1233963,5,1233958
98793,13,-9,678,371795,13,371782
98794,12,-12,16,272626,12,272614
98795,11,16,521,1150827,11,1150816
98796,7,-3,648,545072,7,545065
98797,16,2,600,715078,16,715062
98798,10,-13,394,226619,10,226609
98799,9,2,469,698639,9,698630
98800,15,-6,650,464116,15,464101
98801,19,-11,480,307568,19,307549
98802,15,-7,185,429699,15,429684
98803,10,14,423,1071322,10,1071312
98804,19,-16,695,152017,19,151998
98805,18,-12,48,272841,18,272823
98806,17,2,286,712735,17,712718
98807,20,-12,679,277512,20,277492
98808,13,-20,516,26693,13,26680
98809,10,19,419,1227244,10,1227234
98810,18,17,808,1184019,18,1184001
98811,12,18,604,1213249,12,1213237
98812,11,18,961,1216050,11,1216039
98813,5,-12,900,269229,5,269224
98814,15,-20,517,26731,15,26716
98815,10,12,180,1003089,10,1003079
98816,20,-10,656,340015,20,339995
98817,11,-1,200,618066,11,618055
98818,12,9,152,930168,12,930156
98819,15,-12,43,272809,15,272794
98820,14,16,564,1151117,14,1151103
98821,18,9,509,932808,18,932790
98822,19,-13,269,243086,19,243067
98823,19,-18,898,91745,19,91726
98824,16,18,744,1214341,16,1214325
98825,8,-16,985,145181,8,145173
98826,17,14,504,1089411,17,1089394
98827,16,11,739,996135,16,996119
98828,15,-19,979,61340,15,61325
98829,19,2,922,717336,19,717317
98830,10,1,690,672094,10,672084
98831,17,5,395,806676,17,806659
98832,7,-5,268,473954,7,473947
98833,9,-2,561,574706,9,574697
98834,18,5,733,809140,18,809122
98835,13,7,191,868383,13,868370
98836,13,-9,911,373810,13,373797
98837,17,8,121,898902,17,898885
98838,20,19,108,1241642,20,1241622
98839,19,-5,414,494073,19,494054
98840,5,-19,445,41088,5,41083
98841,12,0,761,654131,12,654119
98842,13,-8,932,404453,13,404440
98843,16,-5,635,495676,16,495660
98844,5,-8,83,377251,5,377246
98845,13,12,627,1026705,13,1026692
98846,10,4,549,762424,10,762414
98847,12,4,913,780006,12,779994
98848,6,0,573,637761,6,637755
98849,6,-8,281,381385,6,381379
98850,19,17,578,1182117,19,1182098
98851,10,18,714,1201591,10,1201581
98852,12,-5,903,497658,12,497646
98853,12,-16,601,151442,12,151430
98854,15,-19,841,60492,15,60477
98855,9,11,655,982437,9,982428
98856,20,10,6,959881,20,959861
98857,10,16,623,1138299,10,1138289
98858,10,3,816,736405,10,736395
98859,11,18,945,1215910,11,1215899
98860,6,-19,40,32346,6,32340
98861,8,-7,356,413593,8,413585
98862,10,4,242,755963,10,755953
98863,8,-2,107,565168,8,565160
98864,13,2,239,712359,13,712346
98865,7,7,622,857998,7,857991
98866,16,-4,300,524421,16,524405
98867,15,-14,318,211861,15,211846
98868,17,17,778,1183675,17,1183658
98869,18,-5,189,492376,18,492358
98870,16,-19,717,59598,16,59582
98871,16,-4,315,524549,16,524533
98872,19,6,986,843631,19,843612
98873,12,18,892,1215518,12,1215506
98874,9,-8,524,386419,9,386410
98875,13,15,522,1120563,13,1120550
98876,13,3,676,746999,13,746986
98877,7,0,100,627656,7,627649
98878,9,9,108,909065,9,909056
98879,9,5,67,783079,9,783070
98880,20,-16,607,151487,20,151467
98881,7,2,494,699166,7,699159
98882,12,-3,218,555315,12,555303
98883,14,16,973,1154109,14,1154095
98884,20,10,948,967113,20,967093
98885,13,-11,609,308628,13,308615
98886,7,-18,682,77018,7,77011
98887,13,-19,623,58918,13,58905
98888,7,16,225,1130045,7,1130038
98889,15,5,859,810012,15,809997
98890,15,12,933,1029239,15,1029224
98891,15,19,639,1245982,15,1245967
98892,6,13,48,1031800,6,1031794
98893,6,-16,530,135581,6,135575
98894,9,16,937,1144718,9,1144709
98895,19,-11,64,304203,19,304184
98896,5,4,779,767599,5,767594
98897,15,-19,920,60948,15,60933
98898,13,2,573,714879,13,714866
98899,10,6,65,813596,10,813586
98900,7,8,389,883721,7,883714
98901,14,8,289,900267,14,900253
98902,8,-11,655,295587,8,295579
98903,8,-8,44,376341,8,376333
98904,10,7,700,859644,10,859634
98905,11,-12,53,272911,11,272900
98906,7,10,579,949967,7,949960
98907,7,17,620,1168522,7,1168515
98908,6,10,115,940160,6,940154
98909,17,-6,767,464981,17,464964
98910,17,-11,237,305545,17,305528
98911,8,3,24,719346,8,719338
98912,16,17,421,1181053,16,1181037
98913,18,-20,566,27129,18,27111
98914,9,9,707,921631,9,921622
98915,19,15,538,1120693,19,1120674
98916,13,18,142,1210137,13,1210124
98917,20,13,786,1059139,20,1059119
98918,5,-5,758,484338,5,484333
98919,13,-12,999,280108,13,280095
98920,17,-7,295,430557,17,430540
98921,14,18,65,1209485,14,1209471
98922,17,-8,384,400596,17,400579
98923,16,-3,999,561763,16,561747
98924,20,7,863,873261,20,873241
98925,12,-14,373,212422,12,212410
98926,9,3,335,726233,9,726224
98927,17,-8,535,401627,17,401610
98928,18,-10,437,338256,18,338238
98929,20,0,666,653363,20,653343
98930,12,-17,97,116320,12,116308
98931,10,-7,486,416253,10,416243
98932,17,13,641,1058097,17,1058080
98933,20,1,81,680405,20,680385
98934,7,-11,309,288017,7,288010
98935,6,-11,524,292832,6,292826
98936,17,0,956,655562,17,655545
98937,7,13,595,1043573,7,1043566
98938,11,-15,36,178064,11,178053
98939,6,-12,573,261979,6,261973
98940,7,-4,273,505536,7,505529
98941,18,-19,162,55343,18,55325
98942,14,-14,135,210380,14,210366
98943,5,9,967,927413,5,927408
98944,9,15,108,1096834,9,1096825
98945,18,-9,565,371152,18,371134
98946,14,4,518,777022,14,777008
98947,19,0,29,648461,19,648442
98948,5,-6,377,444896,5,444891
98949,13,0,889,655040,13,655027
98950,13,19,585,1245562,13,1245549
98951,14,-15,1000,185415,14,185401
98952,11,-18,207,86904,11,86893
98953,20,-1,36,616864,20,616844
98954,15,-19,716,59581,15,59566
98955,15,7,826,872995,15,872980
98956,20,9,417,932067,20,932047
98957,20,-7,445,431678,20,431658
98958,16,6,389,838840,16,838824
98959,18,-10,407,338019,18,338001
98960,18,-9,586,371309,18,371291
98961,15,18,404,1212036,15,1212021
98962,18,11,794,996632,18,996614
98963,11,-19,417,57213,11,57202
98964,17,5,219,805491,17,805474
98965,19,-13,386,243869,19,243850
98966,12,-3,958,561478,12,561466
98967,5,-5,108,470513,5,470508
98968,10,12,114,1001623,10,1001613
98969,20,2,472,714200,20,714180
98970,7,0,40,626151,7,626144
98971,5,11,835,986286,5,986281
98972,12,-1,439,620032,12,620020
98973,14,11,336,993333,14,993319
98974,18,9,219,930699,18,930681
98975,9,7,138,847792,9,847783
98976,8,-17,300,100000,8,99992
98977,18,-14,81,209967,18,209949
98978,6,-6,0,436839,6,436833
98979,10,15,850,1112581,10,1112571
98980,20,-6,771,465043,20,465023
98981,12,-7,275,430374,12,430362
98982,13,-11,858,310445,13,310432
98983,10,16,483,1135551,10,1135541
98984,12,-15,154,178942,12,178930
98985,14,-16,488,150607,14,150593
98986,17,-2,748,590723,17,590706
98987,12,-12,318,274892,12,274880
98988,18,-14,730,215202,18,215184
98989,15,-8,970,404806,15,404791
98990,9,5,476,791482,9,791473
98991,15,-7,150,429393,15,429378
98992,14,-10,559,339250,14,339236
98993,5,-14,443,196375,5,196370
98994,18,7,549,871077,18,871059
98995,15,0,20,648377,15,648362
98996,12,-18,43,85513,12,85501
98997,10,-14,363,194625,10,194615
98998,15,14,732,1091196,15,1091181
98999,5,3,804,736185,5,736180
99000,8,-10,535,324177,8,324169
99001,6,11,258,973739,6,973733
99002,8,-16,401,132635,8,132627
99003,9,1,927,677248,9,677239
99004,14,-6,282,461391,14,461377
99005,7,-8,665,389656,7,389649
99006,8,1,120,659742,8,659734
99007,5,7,610,857726,5,857721
99008,6,-7,627,419163,6,419157
99009,19,2,572,714876,19,714857
99010,13,14,694,1090924,13,1090911
99011,14,18,368,1211807,14,1211793
99012,18,-15,171,179006,18,178988
99013,11,-8,296,399967,11,399956
99014,8,-10,720,328101,8,328093
99015,8,-8,390,383575,8,383567
99016,15,-1,873,623248,15,623233
99017,16,-13,603,245501,16,245485
99018,11,2,743,716159,11,716148
99019,16,11,157,991956,16,991940
99020,13,-15,241,179505,13,179492
99021,11,-15,912,184718,11,184707
99022,11,-17,874,121985,11,121974
99023,16,-17,493,119200,16,119184
99024,9,-15,914,174929,9,174920
99025,15,14,173,1086797,15,1086782
99026,8,5,188,785592,8,785584
99027,6,-14,153,189827,6,189821
99028,19,-10,361,337650,19,337631
99029,16,-15,369,180493,16,180477
99030,8,3,548,730369,8,730361
99031,14,4,271,775163,14,775149
99032,11,19,170,1242109,11,1242098
99033,13,8,413,901281,13,901268
99034,20,15,940,1123658,20,1123638
99035,13,-2,326,587559,13,587546
99036,10,3,677,733473,10,733463
99037,14,7,29,867227,14,867213
99038,10,-9,463,353907,10,353897
99039,18,-17,112,116394,18,116376
99040,12,-2,84,585772,12,585760
99041,13,-1,143,617625,13,617612
99042,17,-6,101,459848,17,459831
99043,8,-13,936,238693,8,238685
99044,12,9,509,932810,12,932798
99045,9,-11,838,299096,9,299087
99046,6,3,630,732361,6,732355
99047,8,0,613,638701,8,638693
99048,13,17,607,1182382,13,1182369
99049,18,-8,633,402335,18,402317
99050,16,-1,471,620337,16,620321
99051,14,-10,65,335666,14,335652
99052,19,-12,667,277446,19,277427
99053,13,-10,521,338907,13,338894
99054,15,16,175,1148379,15,1148364
99055,6,-7,942,425962,6,425956
99056,16,6,210,837286,16,837270
99057,18,19,200,1242332,18,1242314
99058,16,7,468,870498,16,870482
99059,18,-18,966,92240,18,92222
99060,11,7,875,873339,11,873328
99061,15,9,74,929608,15,929593
99062,20,-2,81,585736,20,585716
99063,15,-12,404,275480,15,275465
99064,6,19,646,1231942,6,1231936
99065,14,15,15,1116888,14,1116874
99066,9,-18,974,83671,9,83662
99067,19,-4,707,527407,19,527388
99068,14,-6,544,463387,14,463373
99069,15,-10,347,337581,15,337566
99070,9,7,681,859256,9,859247
99071,15,1,308,682279,15,682264
99072,15,-6,602,463756,15,463741
99073,20,-10,308,337291,20,337271
99074,20,4,284,775251,20,775231
99075,6,-18,559,74452,6,74446
99076,8,-4,714,514782,8,514774
99077,5,-13,480,228450,5,228445
99078,11,5,841,809906,11,809895
99079,16,9,967,936335,16,936319
99080,8,-18,609,75472,8,75464
99081,15,-12,372,275291,15,275276
99082,17,-1,629,621439,17,621422
99083,9,-2,324,569731,9,569722
99084,12,1,530,684072,12,684060
99085,18,6,382,838749,18,838731
99086,16,10,900,966691,16,966675
99087,10,-18,380,70600,10,70590
99088,6,11,356,976043,6,976037
99089,7,18,818,1204035,7,1204028
99090,8,2,163,692110,8,692102
99091,18,12,641,1026854,18,1026836
99092,16,-19,167,55356,16,55340
99093,15,17,964,1185157,15,1185142
99094,11,-11,144,304863,11,304852
99095,20,3,813,747975,20,747955
99096,13,7,672,871981,13,871968
99097,6,-3,866,549776,6,549770
99098,19,-3,721,559522,19,559503
99099,20,9,196,930505,20,930485
99100,5,15,283,1100616,5,1100611
99101,14,5,290,805984,14,805970
99102,17,-7,22,428475,17,428458
99103,5,9,504,917366,5,917361
99104,13,-14,874,216300,13,216287
99105,13,-4,6,522099,13,522086
99106,6,3,969,740058,6,740052
99107,19,-16,43,147084,19,147065
99108,6,-6,659,450905,6,450899
99109,5,-2,126,565599,5,565594
99110,20,-5,452,494341,20,494321
99111,7,-2,146,565970,7,565963
99112,20,-15,546,181797,20,181777
99113,12,6,12,835869,12,835857
99114,13,5,274,805839,13,805826
99115,5,-11,245,286391,5,286386
99116,19,6,689,841326,19,841307
99117,8,3,112,721284,8,721276
99118,10,-14,745,202902,10,202892
99119,7,2,856,706427,7,706420
99120,13,18,764,1214496,13,1214483
99121,8,13,177,1034473,8,1034465
99122,9,-5,319,475193,9,475184
99123,14,10,301,962066,14,962052
99124,17,12,1000,1029821,17,1029804
99125,17,13,940,1060211,17,1060194
99126,19,-12,558,276644,19,276625
99127,20,13,977,1060471,20,1060451
99128,14,-4,264,524145,14,524131
99129,9,7,309,851482,9,851473
99130,5,4,641,764484,5,764479
99131,10,15,116,1097031,10,1097021
99132,16,10,779,965887,16,965871
99133,8,-11,585,294173,8,294165
99134,15,3,107,742656,15,742641
99135,11,0,838,654642,11,654631
99136,13,2,506,714446,13,714433
99137,9,-12,136,252532,9,252523
99138,20,-7,18,428440,20,428420
99139,13,3,143,742908,13,742895
99140,17,-7,122,429191,17,429174
99141,19,9,899,935737,19,935718
99142,10,7,102,847031,10,847021
99143,15,18,860,1215234,15,1215219
99144,15,1,118,680734,15,680719
99145,13,8,704,903560,13,903547
99146,9,-12,747,265686,9,265677
99147,11,1,783,685958,11,685947
99148,10,17,269,1161051,10,1161041
99149,19,-13,696,246096,19,246077
99150,6,14,928,1082522,6,1082516
99151,11,10,820,966233,11,966222
99152,14,-16,609,151501,14,151487
99153,18,14,123,1086433,18,1086415
99154,8,-4,756,515548,8,515540
99155,16,6,584,840504,16,840488
99156,17,19,292,1243089,17,1243072
99157,18,-17,270,117486,18,117468
99158,9,18,653,1200507,9,1200498
99159,16,-16,419,150013,16,149997
99160,7,-3,382,538852,7,538845
99161,7,-12,927,269736,7,269729
99162,19,-11,423,307154,19,307135
99163,8,2,999,709493,8,709485
99164,14,3,877,748418,14,748404
99165,16,3,818,747999,16,747983
99166,8,2,347,696090,8,696082
99167,17,-9,178,367818,17,367801
99168,19,-12,787,278275,19,278256
99169,9,-20,664,14665,9,14656
99170,10,-18,775,79207,10,79197
99171,12,3,588,746233,12,746221
99172,15,-2,171,586313,15,586298
99173,18,7,174,868266,18,868248
99174,6,-15,789,172193,6,172187
99175,5,0,319,631997,5,631992
99176,18,-12,371,275272,18,275254
99177,10,-5,165,471750,10,471740
99178,19,17,191,1179340,19,1179321
99179,5,-14,426,196068,5,196063
99180,10,-7,712,420980,10,420970
99181,5,14,502,1073060,5,1073055
99182,14,15,501,1120351,14,1120337
99183,14,-7,68,428807,14,428793
99184,10,-7,603,418721,10,418711
99185,5,18,520,1197964,5,1197959
99186,11,9,738,934465,11,934454
99187,16,-20,254,24732,16,24716
99188,5,15,127,1097286,5,1097281
99189,18,7,282,869047,18,869029
99190,7,11,874,987318,7,987311
99191,15,-12,235,274239,15,274224
99192,11,19,664,1246146,11,1246135
99193,18,11,670,995604,18,995586
99194,5,-20,467,9994,5,9989
99195,12,-19,300,56345,12,56333
99196,9,-3,50,531644,9,531635
99197,6,9,967,927429,6,927423
99198,9,16,771,1141090,9,1141081
99199,17,2,609,715130,17,715113
99200,16,-18,819,91240,16,91224
99201,8,13,935,1050763,8,1050755
99202,18,17,127,1178798,18,1178780
99203,13,-17,132,116467,13,116454
99204,15,14,301,1087759,15,1087744
99205,20,-20,541,26941,20,26921
99206,20,9,949,936167,20,936147
99207,17,-11,504,307791,17,307774
99208,14,-8,725,403030,14,403016
99209,13,16,364,1149777,13,1149764
99210,14,11,797,996657,14,996643
99211,11,5,902,810369,11,810358
99212,8,-6,481,447131,8,447123
99213,14,-5,953,498045,14,498031
99214,15,11,553,994815,15,994800
99215,12,12,680,1027188,12,1027176
99216,8,14,934,1082693,8,1082685
99217,11,14,54,1085835,11,1085824
99218,7,18,36,1187365,7,1187358
99219,8,6,645,826827,8,826819
99220,19,-5,804,496845,19,496826
99221,6,-19,681,46518,6,46512
99222,16,12,861,1028555,16,1028539
99223,13,11,112,991648,13,991635
99224,9,-18,420,71450,9,71441
99225,6,4,86,752479,6,752473
99226,7,-15,793,172312,7,172305
99227,9,-19,182,35616,9,35607
99228,5,-16,650,138094,5,138089
99229,10,-3,472,541073,10,541063
99230,10,0,799,642857,10,642847
99231,19,-13,375,243792,19,243773
99232,15,-1,922,623618,15,623603
99233,14,-19,495,57799,14,57785
99234,14,0,942,655396,14,655382
99235,11,-2,398,588071,11,588060
99236,14,-6,785,465157,14,465143
99237,20,-9,471,370355,20,370335
99238,20,-3,46,554151,20,554131
99239,7,-5,531,479570,7,479563
99240,7,-1,979,614977,7,614970
99241,5,12,422,1008119,5,1008114
99242,6,18,531,1198198,6,1198192
99243,14,12,81,1022658,14,1022644
99244,15,-16,210,148504,15,148489
99245,20,5,646,808517,20,808497
99246,11,-8,449,400990,11,400979
99247,16,-18,815,91208,16,91192
99248,8,11,288,974493,8,974485
99249,20,6,450,839373,20,839353
99250,15,7,393,869936,15,869921
99251,16,-13,165,242236,16,242220
99252,19,-20,98,23516,19,23497
99253,14,13,849,1059597,14,1059583
99254,10,-12,760,266018,10,266008
99255,19,-15,815,183896,19,183877
99256,6,5,772,797777,6,797771
99257,14,13,646,1058122,14,1058108
99258,10,-5,259,473788,10,473778
99259,12,-15,382,180575,12,180563
99260,20,-15,130,178782,20,178762
99261,16,-13,599,245453,16,245437
99262,10,-9,476,354326,10,354316
99263,13,-13,828,247165,13,247152
99264,12,8,375,900894,12,900882
99265,18,13,817,1059386,18,1059368
99266,7,-19,437,40947,7,40940
99267,20,4,472,776660,20,776640
99268,19,12,2,1022134,19,1022115
99269,17,11,514,994584,17,994567
99270,11,15,875,1123169,11,1123158
99271,14,9,582,933349,14,933335
99272,14,-3,161,554923,14,554909
99273,8,9,237,911728,8,911720
99274,7,10,19,937938,7,937931
99275,18,5,4,803825,18,803807
99276,19,-17,2,115578,19,115559
99277,9,15,234,1099522,9,1099513
99278,11,8,348,900739,11,900728
99279,10,-15,305,162037,10,162027
99280,19,17,97,1178544,19,1178525
99281,6,-19,124,34336,6,34330
99282,12,3,913,748728,12,748716
99283,9,-8,503,385871,9,385862
99284,14,-18,611,89666,14,89652
99285,12,-17,550,119628,12,119616
99286,13,-8,897,404284,13,404271
99287,17,-6,44,459453,17,459436
99288,18,10,524,963901,18,963883
99289,19,14,213,1087067,19,1087048
99290,6,7,72,846370,6,846364
99291,6,17,119,1157810,6,1157804
99292,16,11,740,996155,16,996139
99293,20,10,94,960625,20,960605
99294,18,-9,325,368986,18,368968
99295,12,-13,19,241189,12,241177
99296,12,4,662,778071,12,778059
99297,15,-7,447,431692,15,431677
99298,7,-8,926,395135,7,395128
99299,12,11,649,995460,12,995448
99300,15,1,855,686472,15,686457
99301,8,-13,183,222325,8,222317
99302,12,-1,839,623000,12,622988
99303,14,6,832,842474,14,842460
99304,18,-20,834,29281,18,29263
99305,15,-4,840,528216,15,528201
99306,17,17,110,1178621,17,1178604
99307,12,13,870,1059737,12,1059725
99308,14,-5,142,492018,14,492004
99309,19,1,502,683831,19,683812
99310,7,0,230,630477,7,630470
99311,18,-7,915,435080,18,435062
99312,7,18,905,1205870,7,1205863
99313,13,10,241,961617,13,961604
99314,6,-4,725,514981,6,514975
99315,17,-11,137,304822,17,304805
99316,18,-18,841,91309,18,91291
99317,17,-15,111,178621,17,178604
99318,9,-9,361,351538,9,351529
99319,15,5,418,806808,15,806793
99320,9,-1,533,605648,9,605639
99321,10,-6,44,437797,10,437787
99322,20,-17,99,116351,20,116331
99323,12,-16,545,151011,12,150999
99324,20,-6,277,461352,20,461332
99325,17,-15,940,184948,17,184931
99326,9,-8,876,394062,9,394053
99327,13,-1,720,622149,13,622136
99328,18,-4,467,525604,18,525586
99329,11,1,377,682889,11,682878
99330,14,-16,571,151210,14,151196
99331,19,11,434,994056,19,994037
99332,11,-14,186,210728,11,210717
99333,6,-4,215,504235,6,504229
99334,15,-3,456,557298,15,557283
99335,19,-5,942,497957,19,497938
99336,11,11,580,995020,11,995009
99337,16,5,922,810515,16,810499
99338,9,-7,984,426888,9,426879
99339,17,2,836,716746,17,716729
99340,9,-8,858,393672,9,393663
99341,20,0,722,653858,20,653838
99342,5,10,437,946881,5,946876
99343,18,-15,865,184349,18,184331
99344,13,-15,430,180990,13,180977
99345,20,16,105,1147817,20,1147797
99346,12,13,782,1059079,12,1059067
99347,14,-8,477,401156,14,401142
99348,12,14,414,1088692,12,1088680
99349,11,-6,816,465383,11,465372
99350,20,-13,833,247228,20,247208
99351,7,-6,786,453733,7,453726
99352,17,-16,798,152755,17,152738
99353,19,15,210,1118383,19,1118364
99354,10,17,859,1173887,10,1173877
99355,11,19,744,1246835,11,1246824
99356,15,-17,121,116439,15,116424
99357,13,-8,1,397840,13,397827
99358,12,-19,737,59816,12,59804
99359,19,2,715,716016,19,715997
99360,5,2,491,699108,5,699103
99361,11,-11,272,305870,11,305859
99362,17,-6,229,460970,17,460953
99363,14,-6,448,462551,14,462537
99364,12,-8,103,398646,12,398634
99365,17,-5,313,493401,17,493384
99366,13,10,836,966269,13,966256
99367,7,-14,46,187577,7,187570
99368,14,-12,439,275706,14,275692
99369,14,11,481,994376,14,994362
99370,20,-9,265,368530,20,368510
99371,7,14,427,1071405,7,1071398
99372,10,18,455,1196501,10,1196491
99373,13,-15,387,180602,13,180589
99374,12,-1,897,623428,12,623416
99375,19,-13,424,244099,19,244080
99376,10,-3,239,535662,10,535652
99377,10,-19,159,35239,10,35229
99378,14,9,964,936305,14,936291
99379,11,-15,371,180511,11,180500
99380,17,-8,992,404954,17,404937
99381,11,-7,173,429614,11,429603
99382,18,-12,798,278354,18,278336
99383,16,-16,139,147967,16,147951
99384,9,-4,4,499440,9,499431
99385,9,-19,611,44883,9,44874
99386,16,-2,734,590643,16,590627
99387,15,-15,18,177962,15,177947
99388,17,8,260,900011,17,899994
99389,11,-5,218,492574,11,492563
99390,13,8,74,898461,13,898448
99391,18,10,284,961958,18,961940
99392,11,17,51,1178278,11,1178267
99393,20,10,481,963494,20,963474
99394,5,7,194,848879,5,848874
99395,5,7,879,863484,5,863479
99396,14,9,855,935414,14,935400
99397,19,-11,407,306978,19,306959
99398,6,-13,228,223222,6,223216
99399,12,0,114,649137,12,649125
99400,5,2,274,694507,5,694502
99401,13,-4,514,526012,13,525999
99402,11,-9,869,373460,11,373449
99403,16,16,290,1149233,16,1149217
99404,11,-8,606,402112,11,402101
99405,7,8,577,887851,7,887844
99406,15,-7,709,433471,15,433456
99407,13,12,642,1026871,13,1026858
99408,11,15,229,1118519,11,1118508
99409,6,-3,828,548856,6,548850
99410,20,15,584,1121021,20,1121001
99411,12,7,760,872503,12,872491
99412,20,-2,197,586574,20,586554
99413,16,12,154,1023167,16,1023151
99414,18,14,295,1087718,18,1087700
99415,8,5,184,785501,8,785493
99416,15,6,309,838128,15,838113
99417,11,11,870,997194,11,997183
99418,19,11,462,994246,19,994227
99419,19,-9,790,372825,19,372806
99420,14,8,430,901397,14,901383
99421,13,-13,595,245412,13,245399
99422,19,4,569,777394,19,777375
99423,12,-8,313,400090,12,400078
99424,19,-6,141,460197,19,460178
99425,20,19,190,1242266,20,1242246
99426,6,13,994,1051989,6,1051983
99427,8,8,860,893857,8,893849
99428,18,17,28,1178066,18,1178048
99429,13,3,281,744033,13,744020
99430,9,6,848,831435,9,831426
99431,9,-7,351,413506,9,413497
99432,5,-6,968,457406,5,457401
99433,17,-19,702,59445,17,59428
99434,15,14,936,1092792,15,1092777
99435,5,-3,165,533923,5,533918
99436,7,-8,928,395140,7,395133
99437,7,-7,694,420615,7,420608
99438,12,14,636,1090399,12,1090387
99439,7,-6,43,437778,7,437771
99440,8,12,642,1013213,8,1013205
99441,12,-17,120,116425,12,116413
99442,17,-16,179,148229,17,148212
99443,7,-9,91,345576,7,345569
99444,11,5,719,809050,11,809039
99445,13,-1,906,623519,13,623506
99446,10,15,467,1104368,10,1104358
99447,10,-9,51,344748,10,344738
99448,16,5,160,804958,16,804942
99449,16,3,840,748132,16,748116
99450,5,3,400,727414,5,727409
99451,19,19,206,1242415,19,1242396
99452,17,-9,755,372443,17,372426
99453,13,4,140,774280,13,774267
99454,14,11,452,994143,14,994129
99455,17,-10,159,336271,17,336254
99456,6,19,480,1228484,6,1228478
99457,5,-13,447,227760,5,227755
99458,10,17,547,1166996,10,1166986
99459,20,-5,474,494572,20,494552
99460,12,4,944,780216,12,780204
99461,16,17,745,1183431,16,1183415
99462,9,1,967,678047,9,678038
99463,20,-5,359,493738,20,493718
99464,18,-16,616,151596,18,151578
99465,17,8,644,903101,17,903084
99466,12,-12,751,278027,12,278015
99467,12,-10,390,337854,12,337842
99468,15,-3,265,555645,15,555630
99469,11,-19,597,58724,11,58713
99470,7,17,669,1169725,7,1169718
99471,19,19,766,1247009,19,1246990
99472,7,-6,180,440851,7,440844
99473,12,5,748,809250,12,809238
99474,16,-19,281,56205,16,56189
99475,20,8,765,904021,20,904001
99476,8,-12,771,266184,8,266176
99477,14,-3,777,560064,14,560050
99478,6,-17,702,108548,6,108542
99479,18,-20,145,23883,18,23865
99480,14,17,803,1183942,14,1183928
99481,11,3,904,748633,11,748622
99482,12,11,746,996190,12,996178
99483,8,-6,471,446871,8,446863
99484,9,18,90,1188721,9,1188712
99485,7,9,234,911676,7,911669
99486,11,-8,758,403271,11,403260
99487,14,1,668,685127,14,685113
99488,18,-8,695,402809,18,402791
99489,12,13,809,1059317,12,1059305
99490,12,19,32,1240974,12,1240962
99491,18,-17,772,121389,18,121371
99492,9,-12,962,270581,9,270572
99493,16,19,290,1243067,16,1243051
99494,19,4,809,779218,19,779199
99495,11,-12,242,274294,11,274283
99496,18,3,873,748401,18,748383
99497,17,11,84,991492,17,991475
99498,19,16,797,1152822,19,1152803
99499,5,-7,94,407844,5,407839
99500,20,-15,357,180378,20,180358
99501,15,10,547,964029,15,964014
99502,15,10,410,962968,15,962953
99503,16,1,794,686051,16,686035
99504,17,-17,872,121969,17,121952
99505,15,-3,227,555354,15,555339
99506,19,-15,295,179944,19,179925
99507,15,-7,610,432807,15,432792
99508,9,9,810,923942,9,923933
99509,20,-7,377,431227,20,431207
99510,19,-15,705,183022,19,183003
99511,15,-11,408,306986,15,306971
99512,10,13,260,1036203,10,1036193
99513,15,-14,563,213914,15,213899
99514,18,-8,857,403955,18,403937
99515,9,10,156,940937,9,940928
99516,10,16,165,1128593,10,1128583
99517,18,-12,764,278145,18,278127
99518,6,3,314,725822,6,725816
99519,16,-15,88,178465,16,178449
99520,13,19,823,1247421,13,1247408
99521,15,18,997,1216303,15,1216288
99522,8,-12,81,251347,8,251339
99523,16,0,626,652970,16,652954
99524,10,-17,299,99977,10,99967
99525,8,12,153,1002477,8,1002469
99526,20,5,736,809170,20,809150
99527,10,-20,238,5385,10,5375
99528,14,9,775,934786,14,934772
99529,13,8,569,902435,13,902422
99530,5,-16,484,134647,5,134642
99531,13,5,683,808794,13,808781
99532,16,-17,78,116121,16,116105
99533,11,8,156,899203,11,899192
99534,9,6,160,815655,9,815646
99535,12,-14,886,216410,12,216398
99536,13,8,55,898297,13,898284
99537,19,17,988,1185408,19,1185389
99538,9,-1,541,605788,9,605779
99539,5,16,870,1143160,5,1143155
99540,9,14,909,1082127,9,1082118
99541,15,2,37,710815,15,710800
99542,6,-1,876,612740,6,612734
99543,11,5,918,810467,11,810456
99544,17,-17,735,121071,17,121054
99545,7,2,602,701316,7,701309
99546,15,-1,67,617074,15,617059
99547,11,5,177,805101,11,805090
99548,11,-20,949,29983,11,29972
99549,12,-3,828,560409,12,560397
99550,19,-13,979,248424,19,248405
99551,10,19,715,1233376,10,1233366
99552,20,-20,830,29242,20,29222
99553,18,0,326,650481,18,650463
99554,10,10,283,943499,10,943489
99555,17,9,617,933647,17,933630
99556,15,3,842,748174,15,748159
99557,6,-16,595,136971,6,136965
99558,5,3,727,734672,5,734667
99559,18,14,623,1090264,18,1090246
99560,9,-13,122,221013,9,221004
99561,15,8,603,902701,15,902686
99562,18,-16,597,151405,18,151387
99563,8,-4,412,508574,8,508566
99564,6,-1,630,607524,6,607518
99565,17,-12,51,272880,17,272863
99566,19,1,245,681819,19,681800
99567,19,-10,626,339727,19,339708
99568,15,-12,398,275431,15,275416
99569,15,-13,272,243112,15,243097
99570,20,-17,714,120858,20,120838
99571,7,18,484,1197099,7,1197092
99572,20,14,713,1091112,20,1091092
99573,18,18,346,1211624,18,1211606
99574,11,18,20,1209034,11,1209023
99575,14,4,129,774159,14,774145
99576,18,5,518,807593,18,807575
99577,19,19,200,1242341,19,1242322
99578,20,-6,83,459675,20,459655
99579,14,-13,844,247317,14,247303
99580,7,-8,574,387528,7,387521
99581,6,8,456,885162,6,885156
99582,19,-8,283,399875,19,399856
99583,5,-17,409,102154,5,102149
99584,6,19,770,1234591,6,1234585
99585,7,10,99,939799,7,939792
99586,13,-6,4,459179,13,459166
99587,14,7,827,873005,14,872991
99588,15,5,22,803909,15,803894
99589,13,-20,590,27283,13,27270
99590,9,11,527,979786,9,979777
99591,16,-17,242,117268,16,117252
99592,16,10,864,966472,16,966456
99593,8,9,49,907840,8,907832
99594,8,18,566,1198820,8,1198812
99595,16,-11,984,311429,16,311413
99596,16,-9,221,368166,16,368150
99597,16,-17,868,121937,16,121921
99598,11,-11,411,307012,11,307001
99599,20,15,369,1119485,20,1119465
99600,6,4,999,772302,6,772296
99601,10,8,614,888613,10,888603
99602,20,-17,261,117415,20,117395
99603,9,-7,244,410992,9,410983
99604,7,-4,425,508890,7,508883
99605,17,10,459,963338,17,963321
99606,9,-11,599,294429,9,294420
99607,10,8,942,895685,10,895675
99608,15,-9,418,369847,15,369832
99609,14,4,439,776419,14,776405
99610,19,-20,497,26541,19,26522
99611,10,18,444,1196252,10,1196242
99612,16,19,910,1248158,16,1248142
99613,7,-7,298,412289,7,412282
99614,14,4,238,775016,14,775002
99615,14,6,634,840890,14,840876
99616,11,-4,259,524114,11,524103
99617,12,0,988,655831,12,655819
99618,11,6,589,840531,11,840520
99619,8,0,486,635954,8,635946
99620,5,17,272,1161168,5,1161163
99621,9,10,770,954091,9,954082
99622,5,-19,655,45942,5,45937
99623,5,12,784,1016084,5,1016079
99624,14,-2,761,590824,14,590810
99625,14,-9,786,372776,14,372762
99626,17,-3,327,556177,17,556160
99627,7,12,391,1007550,7,1007543
99628,8,5,442,790757,8,790749
99629,9,-13,360,225911,9,225902
99630,7,6,247,817760,7,817753
99631,5,0,775,642357,5,642352
99632,15,15,437,1119873,15,1119858
99633,15,6,501,839838,15,839823
99634,17,-11,441,307298,17,307281
99635,20,-14,218,211057,20,211037
99636,20,-6,169,460436,20,460416
99637,8,15,191,1098574,8,1098566
99638,6,-13,443,227653,6,227647
99639,20,9,938,936104,20,936084
99640,7,-13,38,219180,7,219173
99641,16,-20,588,27278,16,27262
99642,6,-5,490,478614,6,478608
99643,12,-20,196,24370,12,24358
99644,7,14,213,1066425,7,1066418
99645,15,-14,126,210263,15,210248
99646,13,17,893,1184672,13,1184659
99647,19,-17,934,122394,19,122375
99648,19,2,860,716927,19,716908
99649,10,9,163,910250,10,910240
99650,17,12,290,1024272,17,1024255
99651,13,-13,827,247148,13,247135
99652,8,-5,702,483220,8,483212
99653,16,13,550,1057395,16,1057379
99654,16,-6,202,460728,16,460712
99655,19,8,503,901970,19,901951
99656,11,-1,219,618271,11,618260
99657,19,-2,423,588302,19,588283
99658,10,14,929,1082605,10,1082595
99659,18,9,902,935773,18,935755
99660,10,14,710,1077978,10,1077968
99661,19,6,908,843011,19,842992
99662,20,-9,759,372538,20,372518
99663,18,-8,946,404586,18,404568
99664,18,-2,578,589484,18,589466
99665,5,-5,32,468548,5,468543
99666,7,-6,814,454335,7,454328
99667,10,-16,985,145191,10,145181
99668,12,-17,278,117538,12,117526
99669,7,13,298,1037111,7,1037104
99670,13,-3,501,557659,13,557646
99671,13,-12,257,274414,13,274401
99672,13,-8,918,404391,13,404378
99673,14,-14,864,216264,14,216250
99674,13,2,589,715005,13,714992
99675,9,-4,456,509348,9,509339
99676,6,-9,840,362328,6,362322
99677,18,-6,974,466523,18,466505
99678,13,6,709,841521,13,841508
99679,9,2,222,693357,9,693348
99680,8,2,403,697393,8,697385
99681,20,4,743,778728,20,778708
99682,6,-18,892,81773,6,81767
99683,7,-4,132,502304,7,502297
99684,5,13,221,1035472,5,1035467
99685,15,-19,550,58322,15,58307
99686,8,1,310,663901,8,663893
99687,11,-4,48,522398,11,522387
99688,14,13,665,1058266,14,1058252
99689,12,-12,636,277178,12,277166
99690,18,-11,660,309007,18,308989
99691,15,14,375,1088368,15,1088353
99692,14,3,744,747469,14,747455
99693,6,2,596,701165,6,701159
99694,14,-1,445,620104,14,620090
99695,7,10,950,957952,7,957945
99696,5,-7,205,410210,5,410205
99697,19,15,212,1118412,19,1118393
99698,9,11,5,968579,9,968570
99699,20,-8,402,400781,20,400761
99700,14,-3,175,555014,14,555000
99701,5,-8,122,377942,5,377937
99702,14,1,624,684767,14,684753
99703,14,13,331,1055666,14,1055652
99704,8,8,96,877140,8,877132
99705,16,-6,916,466086,16,466070
99706,9,10,751,953618,9,953609
99707,18,2,715,716024,18,716006
99708,15,11,663,995561,15,995546
99709,17,-18,90,85926,17,85909
99710,9,19,61,1218809,9,1218800
99711,17,3,233,743639,17,743622
99712,7,7,169,848361,7,848354
99713,6,-11,297,287589,6,287583
99714,9,-19,361,39329,9,39320
99715,10,-16,455,134018,10,134008
99716,8,13,745,1046729,8,1046721
99717,13,-14,682,214878,13,214865
99718,16,-8,186,399241,16,399225
99719,15,15,905,1123382,15,1123367
99720,9,-20,797,17648,9,17639
99721,8,-13,21,218774,8,218766
99722,12,1,663,685088,12,685076
99723,11,18,446,1212305,11,1212294
99724,14,12,871,1028644,14,1028630
99725,12,5,939,810681,12,810669
99726,5,-3,434,540061,5,540056
99727,13,-3,897,560990,13,560977
99728,13,0,684,653500,13,653487
99729,19,-17,583,119917,19,119898
99730,20,3,542,745830,20,745810
99731,11,-14,337,212049,11,212038
99732,16,-5,692,496092,16,496076
99733,9,-12,142,252634,9,252625
99734,10,2,873,706772,10,706762
99735,20,9,112,929881,20,929861
99736,20,2,655,715512,20,715492
99737,16,8,137,899017,16,899001
99738,9,4,231,755690,9,755681
99739,8,-8,474,385083,8,385075
99740,14,19,733,1246743,14,1246729
99741,14,-10,844,341432,14,341418
99742,11,-11,475,307533,11,307522
99743,6,-16,98,126165,6,126159
99744,17,18,623,1213414,17,1213397
99745,9,13,637,1044478,9,1044469
99746,13,12,53,1022459,13,1022446
99747,12,-2,63,585635,12,585623
99748,9,2,367,696616,9,696607
99749,10,6,745,829107,10,829097
99750,8,-4,49,500370,8,500362
99751,14,-2,438,588430,14,588416
99752,17,-18,423,88474,17,88457
99753,8,-5,311,474945,8,474937
99754,10,8,571,887764,10,887754
99755,14,-10,20,335279,14,335265
99756,10,-4,630,513052,10,513042
99757,12,-15,281,179810,12,179798
99758,20,2,839,716791,20,716771
99759,14,-6,218,460845,14,460831
99760,9,-18,843,80587,9,80578
99761,19,3,58,742293,19,742274
99762,12,-18,807,91145,12,91133
99763,12,-10,150,336212,12,336200
99764,18,-8,727,403052,18,403034
99765,19,-5,232,492690,19,492671
99766,8,-8,991,396589,8,396581
99767,10,11,779,985151,10,985141
99768,16,-3,517,557803,16,557787
99769,17,7,910,873525,17,873508
99770,13,-8,263,399745,13,399732
99771,13,-10,206,336586,13,336573
99772,18,-11,303,306174,18,306156
99773,5,5,30,782215,5,782210
99774,18,-6,516,463172,18,463154
99775,18,-20,236,24575,18,24557
99776,10,-19,828,49572,10,49562
99777,14,16,951,1153881,14,1153867
99778,6,-19,719,47330,6,47324
99779,10,-12,40,250413,10,250403
99780,12,-19,604,58766,12,58754
99781,14,5,235,805572,14,805558
99782,14,-10,369,337716,14,337702
99783,13,6,751,841805,13,841792
99784,18,2,919,717319,18,717301
99785,12,-3,918,561142,12,561130
99786,16,-17,234,117181,16,117165
99787,12,-16,979,154131,12,154119
99788,7,11,442,977860,7,977853
99789,5,13,372,1038740,5,1038735
99790,11,11,224,992420,11,992409
99791,11,1,787,685980,11,685969
99792,10,-16,202,128469,10,128459
99793,5,-9,647,357900,5,357895
99794,5,-13,479,228436,5,228431
99795,13,-19,500,57835,13,57822
99796,19,-15,575,182042,19,182023
99797,8,8,718,891100,8,891092
99798,5,-20,896,19872,5,19867
99799,5,17,170,1158878,5,1158873
99800,10,-18,486,72881,10,72871
99801,7,16,966,1145393,7,1145386
99802,9,18,252,1192368,9,1192359
99803,11,14,880,1092309,11,1092298
99804,20,3,919,748783,20,748763
99805,15,-2,551,589296,15,589281
99806,7,-13,778,235323,7,235316
99807,5,16,581,1137368,5,1137363
99808,20,-16,347,149468,20,149448
99809,19,-11,874,310584,19,310565
99810,18,17,67,1178384,18,1178366
99811,5,-20,648,14260,5,14255
99812,15,-2,915,592116,15,592101
99813,10,9,133,909621,10,909611
99814,7,7,106,847148,7,847141
99815,7,-13,751,234487,7,234480
99816,18,13,442,1056570,18,1056552
99817,16,11,877,997226,16,997210
99818,16,16,942,1153822,16,1153806
99819,5,-14,291,193066,5,193061
99820,20,14,167,1086761,20,1086741
99821,13,13,243,1055008,13,1054995
99822,5,-20,434,9280,5,9275
99823,19,18,730,1214193,19,1214174
99824,13,0,524,652151,13,652138
99825,13,-14,587,214149,13,214136
99826,12,-15,18,177964,12,177952
99827,9,-9,70,345087,9,345078
99828,17,16,60,1147529,17,1147512
99829,5,19,608,1231133,5,1231128
99830,17,8,368,900838,17,900821
99831,13,4,798,779111,13,779098
99832,16,-16,555,151089,16,151073
99833,6,4,878,769951,6,769945
99834,13,19,613,1245743,13,1245730
99835,11,-1,559,620970,11,620959
99836,10,5,372,789318,10,789308
99837,14,-8,257,399717,14,399703
99838,14,-6,439,462485,14,462471
99839,14,-5,998,498326,14,498312
99840,17,3,292,744106,17,744089
99841,6,-11,234,286126,6,286120
99842,20,-9,363,369370,20,369350
99843,8,15,221,1099270,8,1099262
99844,13,-20,810,29140,13,29127
99845,11,7,353,869588,11,869577
99846,7,-2,284,568876,7,568869
99847,9,-10,583,325233,9,325224
99848,15,4,800,779120,15,779105
99849,7,-10,554,324637,7,324630
99850,17,6,978,843582,17,843565
99851,12,10,944,967096,12,967084
99852,13,-1,131,617561,13,617548
99853,12,14,263,1087472,12,1087460
99854,14,12,467,1025470,14,1025456
99855,11,4,643,777942,11,777931
99856,5,9,192,910791,5,910786
99857,8,-10,849,330825,8,330817
99858,18,4,78,773826,18,773808
99859,14,-8,498,401313,14,401299
99860,19,7,129,867955,19,867936
99861,19,-12,786,278267,19,278248
99862,9,-15,194,159439,9,159430
99863,7,-8,7,375468,7,375461
99864,9,-20,159,3478,9,3469
99865,11,-12,732,277850,11,277839
99866,9,-16,591,136876,9,136867
99867,10,1,557,669539,10,669529
99868,13,-1,859,623139,13,623126
99869,11,-5,960,498069,11,498058
99870,19,14,74,1086025,19,1086006
99871,7,-2,297,569207,7,569200
99872,16,19,946,1248387,16,1248371
99873,8,6,723,828698,8,828690
99874,13,16,940,1153818,13,1153805
99875,6,5,373,789339,6,789333
99876,14,8,901,904991,14,904977
99877,9,-4,236,504814,9,504805
99878,5,3,988,740508,5,740503
99879,16,-10,182,336430,16,336414
99880,10,-14,683,201703,10,201693
99881,13,15,323,1119150,13,1119137
99882,17,11,393,993763,17,993746
99883,5,-6,603,449822,5,449817
99884,6,3,867,737621,6,737615
99885,10,14,251,1067417,10,1067407
99886,9,3,599,731606,9,731597
99887,7,-10,971,333362,7,333355
99888,7,-9,830,362079,7,362072
99889,5,16,26,1125745,5,1125740
99890,16,11,673,995619,16,995603
99891,11,4,484,776730,11,776719
99892,14,7,764,872545,14,872531
99893,20,-14,967,217022,20,217002
99894,9,-2,471,572851,9,572842
99895,5,-17,60,94692,5,94687
99896,18,-3,200,555197,18,555179
99897,20,-14,267,211514,20,211494
99898,9,12,593,1011807,9,1011798
99899,6,0,257,630971,6,630965
99900,10,6,96,814290,10,814280
99901,8,-9,833,362167,8,362159
99902,20,-8,195,399300,20,399280
99903,20,2,833,716719,20,716699
99904,18,12,786,1027922,18,1027904
99905,16,-16,515,150802,16,150786
99906,5,-8,109,377659,5,377654
99907,19,6,126,836730,19,836711
99908,9,-17,868,111825,9,111816
99909,5,10,77,939161,5,939156
99910,17,-13,22,241241,17,241224
99911,17,-19,614,58823,17,58806
99912,17,11,437,994070,17,994053
99913,20,-5,253,492912,20,492892
99914,19,-9,362,369355,19,369336
99915,13,-5,171,492274,13,492261
99916,13,-15,11,177915,13,177902
99917,16,-18,337,87837,16,87821
99918,5,9,235,911690,5,911685
99919,6,2,195,692882,6,692876
99920,8,3,722,734539,8,734531
99921,19,0,154,649385,19,649366
99922,7,17,364,1163129,7,1163122
99923,20,-3,927,561201,20,561181
99924,8,19,875,1237033,8,1237025
99925,12,17,380,1180778,12,1180766
99926,14,8,302,900343,14,900329
99927,8,0,765,642200,8,642192
99928,13,-14,962,216944,13,216931
99929,16,-20,475,26329,16,26313
99930,10,-15,796,172354,10,172344
99931,20,12,51,1022446,20,1022426
99932,10,12,881,1018442,10,1018432
99933,11,-7,720,433559,11,433548
99934,13,-7,833,434360,13,434347
99935,7,7,879,863491,7,863484
99936,14,-5,771,496624,14,496610
99937,19,17,860,1184480,19,1184461
99938,6,0,642,639345,6,639339
99939,15,-15,700,182951,15,182936
99940,6,14,528,1073617,6,1073611
99941,16,19,696,1246451,16,1246435
99942,7,-18,927,82633,7,82626
99943,8,5,766,797680,8,797672
99944,14,-12,795,278327,14,278313
99945,5,-19,516,42704,5,42699
99946,17,-11,232,305519,17,305502
99947,19,-9,900,373750,19,373731
99948,10,12,845,1017571,10,1017561
99949,9,-18,128,65332,9,65323
99950,20,-17,910,122260,20,122240
99951,11,-17,709,120824,11,120813
99952,5,-1,678,608487,5,608482
99953,13,-6,80,459651,13,459638
99954,10,19,474,1228343,10,1228333
99955,10,7,911,864106,10,864096
99956,6,-16,994,145521,6,145515
99957,10,18,454,1196473,10,1196463
99958,14,17,320,1180369,14,1180355
99959,16,-15,183,179093,16,179077
99960,12,-18,89,85895,12,85883
99961,20,13,326,1055623,20,1055603
99962,8,2,142,691654,8,691646
99963,6,-9,501,355031,6,355025
99964,20,9,188,930438,20,930418
99965,8,10,47,938569,8,938561
99966,12,10,182,961261,12,961249
99967,15,17,399,1180903,15,1180888
99968,10,18,812,1203901,10,1203891
99969,19,6,115,836653,19,836634
99970,10,-18,53,63540,10,63530
99971,7,15,931,1114272,7,1114265
99972,20,-12,67,273044,20,273024
99973,14,-17,308,117813,14,117799
99974,17,5,441,806977,17,806960
99975,7,10,983,958534,7,958527
99976,15,1,286,682136,15,682121
99977,17,16,163,1148237,17,1148220
99978,10,-1,329,601196,10,601186
99979,9,2,8,688668,9,688659
99980,5,16,146,1128206,5,1128201
99981,8,-19,73,33036,8,33028
99982,7,11,713,983716,7,983709
99983,13,-2,516,589036,13,589023
99984,6,-6,431,445981,6,445975
99985,14,2,834,716723,14,716709
99986,6,13,742,1046646,6,1046640
99987,9,9,421,915504,9,915495
99988,12,-2,747,590716,12,590704
99989,20,-10,540,339102,20,339082
99990,19,-2,818,591316,19,591297
99991,18,17,987,1185390,18,1185372
99992,16,-5,264,492985,16,492969
99993,19,-5,820,496949,19,496930
99994,12,-4,950,529183,12,529171
99995,17,-10,801,341169,17,341152
99996,5,18,526,1198095,5,1198090
99997,19,-17,653,120398,19,120379
99998,15,-5,405,493990,15,493975
99999,7,-8,16,375724,7,375717
100000,17,-17,187,116826,17,116809
